video;face_name;start_frame;end_frame;total_frame;start_time;end_time;duration
/net/per610a/home/mvp/mvp_db/news7-lv/2001/2001_03_18_19_00/2001_03_18_19_00.mpg;Takenori KANZAKI.jpg;2813;5285;35961;140;264;124
/net/per610a/home/mvp/mvp_db/news7-lv/2001/2001_03_20_19_00/2001_03_20_19_00.mpg;Junichiro KOIZUMI.jpg;9429;10417;35949;471;521;50
/net/per610a/home/mvp/mvp_db/news7-lv/2001/2001_03_22_19_00/2001_03_22_19_00.mpg;Junichiro KOIZUMI.jpg;11421;11709;35949;571;585;14
/net/per610a/home/mvp/mvp_db/news7-lv/2001/2001_03_22_19_00/2001_03_22_19_00.mpg;Junichiro KOIZUMI.jpg;11805;11925;35949;590;596;6
/net/per610a/home/mvp/mvp_db/news7-lv/2001/2001_03_28_19_00/2001_03_28_19_00.mpg;Junichiro KOIZUMI.jpg;13781;13993;35981;689;700;11
/net/per610a/home/mvp/mvp_db/news7-lv/2001/2001_04_12_19_00/2001_04_12_19_00.mpg;Junichiro KOIZUMI.jpg;5765;5993;35949;288;299;11
/net/per610a/home/mvp/mvp_db/news7-lv/2001/2001_04_12_19_00/2001_04_12_19_00.mpg;Junichiro KOIZUMI.jpg;10345;10345;35949;517;517;0
/net/per610a/home/mvp/mvp_db/news7-lv/2001/2001_04_12_19_00/2001_04_12_19_00.mpg;Junichiro KOIZUMI.jpg;22189;22361;35949;1110;1119;9
/net/per610a/home/mvp/mvp_db/news7-lv/2001/2001_04_12_19_00/2001_04_12_19_00.mpg;Junichiro KOIZUMI.jpg;23673;23713;35949;1184;1186;2
/net/per610a/home/mvp/mvp_db/news7-lv/2001/2001_04_12_19_00/2001_04_12_19_00.mpg;Junichiro KOIZUMI.jpg;26453;26497;35949;1323;1325;2
/net/per610a/home/mvp/mvp_db/news7-lv/2001/2001_04_12_19_00/2001_04_12_19_00.mpg;Junichiro KOIZUMI.jpg;28705;28733;35949;1436;1437;1
/net/per610a/home/mvp/mvp_db/news7-lv/2001/2001_04_12_19_00/2001_04_12_19_00.mpg;Junichiro KOIZUMI.jpg;31725;31853;35949;1587;1594;7
/net/per610a/home/mvp/mvp_db/news7-lv/2001/2001_04_12_19_00/2001_04_12_19_00.mpg;Junichiro KOIZUMI.jpg;33905;34165;35949;1696;1709;13
/net/per610a/home/mvp/mvp_db/news7-lv/2001/2001_04_12_19_00/2001_04_12_19_00.mpg;Junichiro KOIZUMI.jpg;35685;35741;35949;1785;1788;3
/net/per610a/home/mvp/mvp_db/news7-lv/2001/2001_04_13_19_00/2001_04_13_19_00.mpg;Taro ASO.jpg;681;761;35949;34;38;4
/net/per610a/home/mvp/mvp_db/news7-lv/2001/2001_04_13_19_00/2001_04_13_19_00.mpg;Taro ASO.jpg;8637;10065;35949;432;503;71
/net/per610a/home/mvp/mvp_db/news7-lv/2001/2001_04_13_19_00/2001_04_13_19_00.mpg;Taro ASO.jpg;12985;13269;35949;649;664;15
/net/per610a/home/mvp/mvp_db/news7-lv/2001/2001_04_16_19_00/2001_04_16_19_00.mpg;Taro ASO.jpg;16457;16909;35969;823;846;23
/net/per610a/home/mvp/mvp_db/news7-lv/2001/2001_04_17_19_00/2001_04_17_19_00.mpg;Shizuka KAMEI.jpg;6141;6493;35969;307;324;17
/net/per610a/home/mvp/mvp_db/news7-lv/2001/2001_04_17_19_00/2001_04_17_19_00.mpg;Yukio HATOYAMA.jpg;6141;6421;35969;307;321;14
/net/per610a/home/mvp/mvp_db/news7-lv/2001/2001_04_17_19_00/2001_04_17_19_00.mpg;Junichiro KOIZUMI.jpg;6701;6813;35969;335;340;5
/net/per610a/home/mvp/mvp_db/news7-lv/2001/2001_04_17_19_00/2001_04_17_19_00.mpg;Junichiro KOIZUMI.jpg;7029;7701;35969;351;385;34
/net/per610a/home/mvp/mvp_db/news7-lv/2001/2001_04_18_19_00/2001_04_18_19_00.mpg;Taro ASO.jpg;201;441;35981;10;22;12
/net/per610a/home/mvp/mvp_db/news7-lv/2001/2001_04_18_19_00/2001_04_18_19_00.mpg;Taro ASO.jpg;1765;3621;35981;88;181;93
/net/per610a/home/mvp/mvp_db/news7-lv/2001/2001_04_18_19_00/2001_04_18_19_00.mpg;Taro ASO.jpg;3709;4733;35981;185;236;51
/net/per610a/home/mvp/mvp_db/news7-lv/2001/2001_04_19_19_00/2001_04_19_19_00.mpg;Junichiro KOIZUMI.jpg;6865;8969;35997;343;448;105
/net/per610a/home/mvp/mvp_db/news7-lv/2001/2001_04_20_19_00/2001_04_20_19_00.mpg;Shizuka KAMEI.jpg;4773;6517;35989;238;326;88
/net/per610a/home/mvp/mvp_db/news7-lv/2001/2001_04_20_19_00/2001_04_20_19_00.mpg;Yukio HATOYAMA.jpg;7469;8713;35989;373;436;63
/net/per610a/home/mvp/mvp_db/news7-lv/2001/2001_04_21_19_00/2001_04_21_19_00.mpg;Junichiro KOIZUMI.jpg;5793;5933;36001;289;296;7
/net/per610a/home/mvp/mvp_db/news7-lv/2001/2001_04_21_19_00/2001_04_21_19_00.mpg;Junichiro KOIZUMI.jpg;6397;9325;36001;320;466;146
/net/per610a/home/mvp/mvp_db/news7-lv/2001/2001_04_21_19_00/2001_04_21_19_00.mpg;Junichiro KOIZUMI.jpg;5937;6125;36001;297;306;9
/net/per610a/home/mvp/mvp_db/news7-lv/2001/2001_04_22_19_00/2001_04_22_19_00.mpg;Yukio HATOYAMA.jpg;7425;9341;23913;371;467;96
/net/per610a/home/mvp/mvp_db/news7-lv/2001/2001_04_23_19_00/2001_04_23_19_00.mpg;Shizuka KAMEI.jpg;7853;8309;36009;392;415;23
/net/per610a/home/mvp/mvp_db/news7-lv/2001/2001_04_23_19_00/2001_04_23_19_00.mpg;Taro ASO.jpg;8729;8745;36009;436;437;1
/net/per610a/home/mvp/mvp_db/news7-lv/2001/2001_04_23_19_00/2001_04_23_19_00.mpg;Taro ASO.jpg;10613;11013;36009;531;551;20
/net/per610a/home/mvp/mvp_db/news7-lv/2001/2001_05_09_19_00/2001_05_09_19_00.mpg;Junichiro KOIZUMI.jpg;2365;2377;35961;118;118;0
/net/per610a/home/mvp/mvp_db/news7-lv/2001/2001_05_09_19_00/2001_05_09_19_00.mpg;Junichiro KOIZUMI.jpg;2513;3401;35961;125;170;45
/net/per610a/home/mvp/mvp_db/news7-lv/2001/2001_05_09_19_00/2001_05_09_19_00.mpg;Takenori KANZAKI.jpg;5561;6745;35961;278;337;59
/net/per610a/home/mvp/mvp_db/news7-lv/2001/2001_05_09_19_00/2001_05_09_19_00.mpg;Takenori KANZAKI.jpg;13449;13809;35961;672;690;18
/net/per610a/home/mvp/mvp_db/news7-lv/2001/2001_05_09_19_00/2001_05_09_19_00.mpg;Yukio HATOYAMA.jpg;13853;14785;35961;693;739;46
/net/per610a/home/mvp/mvp_db/news7-lv/2001/2001_05_10_19_00/2001_05_10_19_00.mpg;Kazuo SHII.jpg;15173;15461;35949;759;773;14
/net/per610a/home/mvp/mvp_db/news7-lv/2001/2001_05_17_19_00/2001_05_17_19_00.mpg;Yasuo FUKUDA.jpg;2545;3069;35961;127;153;26
/net/per610a/home/mvp/mvp_db/news7-lv/2001/2001_05_18_19_00/2001_05_18_19_00.mpg;Junichiro KOIZUMI.jpg;453;729;35961;22;36;14
/net/per610a/home/mvp/mvp_db/news7-lv/2001/2001_05_18_19_00/2001_05_18_19_00.mpg;Yoshihiko Noda.jpg;18069;18217;35961;903;911;8
/net/per610a/home/mvp/mvp_db/news7-lv/2001/2001_05_22_19_00/2001_05_22_19_00.mpg;Junichiro KOIZUMI.jpg;5817;6161;35949;291;308;17
/net/per610a/home/mvp/mvp_db/news7-lv/2001/2001_05_22_19_00/2001_05_22_19_00.mpg;Junichiro KOIZUMI.jpg;9057;10097;35949;453;505;52
/net/per610a/home/mvp/mvp_db/news7-lv/2001/2001_05_22_19_00/2001_05_22_19_00.mpg;Taro ASO.jpg;10173;10305;35949;509;515;6
/net/per610a/home/mvp/mvp_db/news7-lv/2001/2001_05_23_19_00/2001_05_23_19_00.mpg;Junichiro KOIZUMI.jpg;2493;8637;35957;124;432;308
/net/per610a/home/mvp/mvp_db/news7-lv/2001/2001_05_23_19_00/2001_05_23_19_00.mpg;Junichiro KOIZUMI.jpg;16685;16901;35957;834;845;11
/net/per610a/home/mvp/mvp_db/news7-lv/2001/2001_05_23_19_00/2001_05_23_19_00.mpg;Yasuo FUKUDA.jpg;14361;14661;35957;718;733;15
/net/per610a/home/mvp/mvp_db/news7-lv/2001/2001_05_23_19_00/2001_05_23_19_00.mpg;Yasuo FUKUDA.jpg;17057;17317;35957;853;866;13
/net/per610a/home/mvp/mvp_db/news7-lv/2001/2001_05_30_19_00/2001_05_30_19_00.mpg;Junichiro KOIZUMI.jpg;2009;2633;35957;100;131;31
/net/per610a/home/mvp/mvp_db/news7-lv/2001/2001_05_30_19_00/2001_05_30_19_00.mpg;Toranosuke Katayama.jpg;3517;3753;35957;175;187;12
/net/per610a/home/mvp/mvp_db/news7-lv/2001/2001_05_30_19_00/2001_05_30_19_00.mpg;Toranosuke Katayama.jpg;23173;23301;35957;1159;1165;6
/net/per610a/home/mvp/mvp_db/news7-lv/2001/2001_05_31_19_00/2001_05_31_19_00.mpg;Junichiro KOIZUMI.jpg;1525;1845;35957;76;92;16
/net/per610a/home/mvp/mvp_db/news7-lv/2001/2001_05_31_19_00/2001_05_31_19_00.mpg;Junichiro KOIZUMI.jpg;1949;2741;35957;97;137;40
/net/per610a/home/mvp/mvp_db/news7-lv/2001/2001_05_31_19_00/2001_05_31_19_00.mpg;Junichiro KOIZUMI.jpg;2825;2981;35957;141;149;8
/net/per610a/home/mvp/mvp_db/news7-lv/2001/2001_05_31_19_00/2001_05_31_19_00.mpg;Junichiro KOIZUMI.jpg;3081;5137;35957;154;257;103
/net/per610a/home/mvp/mvp_db/news7-lv/2001/2001_05_31_19_00/2001_05_31_19_00.mpg;Junichiro KOIZUMI.jpg;7761;8065;35957;388;403;15
/net/per610a/home/mvp/mvp_db/news7-lv/2001/2001_05_31_19_00/2001_05_31_19_00.mpg;Junichiro KOIZUMI.jpg;8529;8681;35957;426;434;8
/net/per610a/home/mvp/mvp_db/news7-lv/2001/2001_06_13_19_00/2001_06_13_19_00.mpg;Junichiro KOIZUMI.jpg;1669;1765;36001;83;88;5
/net/per610a/home/mvp/mvp_db/news7-lv/2001/2001_06_13_19_00/2001_06_13_19_00.mpg;Junichiro KOIZUMI.jpg;1893;1893;36001;94;94;0
/net/per610a/home/mvp/mvp_db/news7-lv/2001/2001_06_13_19_00/2001_06_13_19_00.mpg;Junichiro KOIZUMI.jpg;1965;2013;36001;98;100;2
/net/per610a/home/mvp/mvp_db/news7-lv/2001/2001_06_13_19_00/2001_06_13_19_00.mpg;Junichiro KOIZUMI.jpg;2101;2161;36001;105;108;3
/net/per610a/home/mvp/mvp_db/news7-lv/2001/2001_06_13_19_00/2001_06_13_19_00.mpg;Junichiro KOIZUMI.jpg;3393;3453;36001;169;172;3
/net/per610a/home/mvp/mvp_db/news7-lv/2001/2001_06_13_19_00/2001_06_13_19_00.mpg;Junichiro KOIZUMI.jpg;4221;4381;36001;211;219;8
/net/per610a/home/mvp/mvp_db/news7-lv/2001/2001_06_13_19_00/2001_06_13_19_00.mpg;Junichiro KOIZUMI.jpg;6525;9393;36001;326;469;143
/net/per610a/home/mvp/mvp_db/news7-lv/2001/2001_06_14_19_00/2001_06_14_19_00.mpg;Junichiro KOIZUMI.jpg;12253;12493;35989;613;625;12
/net/per610a/home/mvp/mvp_db/news7-lv/2001/2001_06_14_19_00/2001_06_14_19_00.mpg;Junichiro KOIZUMI.jpg;13261;14217;35989;663;711;48
/net/per610a/home/mvp/mvp_db/news7-lv/2001/2001_06_15_19_00/2001_06_15_19_00.mpg;Junichiro KOIZUMI.jpg;7729;7777;36001;386;389;3
/net/per610a/home/mvp/mvp_db/news7-lv/2001/2001_06_15_19_00/2001_06_15_19_00.mpg;Junichiro KOIZUMI.jpg;27377;28537;36001;1369;1427;58
/net/per610a/home/mvp/mvp_db/news7-lv/2001/2001_06_25_19_00/2001_06_25_19_00.mpg;Junichiro KOIZUMI.jpg;713;749;36061;35;37;2
/net/per610a/home/mvp/mvp_db/news7-lv/2001/2001_06_25_19_00/2001_06_25_19_00.mpg;Junichiro KOIZUMI.jpg;12613;13281;36061;630;664;34
/net/per610a/home/mvp/mvp_db/news7-lv/2001/2001_06_25_19_00/2001_06_25_19_00.mpg;Junichiro KOIZUMI.jpg;17053;17301;36061;853;865;12
/net/per610a/home/mvp/mvp_db/news7-lv/2001/2001_06_25_19_00/2001_06_25_19_00.mpg;Akihiro OHTA.jpg;13429;13537;36061;671;677;6
/net/per610a/home/mvp/mvp_db/news7-lv/2001/2001_06_25_19_00/2001_06_25_19_00.mpg;Yukio HATOYAMA.jpg;14725;16825;36061;736;841;105
/net/per610a/home/mvp/mvp_db/news7-lv/2001/2001_06_28_19_00/2001_06_28_19_00.mpg;Junichiro KOIZUMI.jpg;277;329;35961;13;16;3
/net/per610a/home/mvp/mvp_db/news7-lv/2001/2001_06_28_19_00/2001_06_28_19_00.mpg;Junichiro KOIZUMI.jpg;1893;1929;35961;94;96;2
/net/per610a/home/mvp/mvp_db/news7-lv/2001/2001_06_28_19_00/2001_06_28_19_00.mpg;Junichiro KOIZUMI.jpg;2513;2549;35961;125;127;2
/net/per610a/home/mvp/mvp_db/news7-lv/2001/2001_06_28_19_00/2001_06_28_19_00.mpg;Junichiro KOIZUMI.jpg;2617;3249;35961;130;162;32
/net/per610a/home/mvp/mvp_db/news7-lv/2001/2001_06_28_19_00/2001_06_28_19_00.mpg;Junichiro KOIZUMI.jpg;4721;4845;35961;236;242;6
/net/per610a/home/mvp/mvp_db/news7-lv/2001/2001_06_28_19_00/2001_06_28_19_00.mpg;Junichiro KOIZUMI.jpg;15177;15569;35961;759;778;19
/net/per610a/home/mvp/mvp_db/news7-lv/2001/2001_06_28_19_00/2001_06_28_19_00.mpg;Yukio HATOYAMA.jpg;2049;2609;35961;102;130;28
/net/per610a/home/mvp/mvp_db/news7-lv/2001/2001_06_28_19_00/2001_06_28_19_00.mpg;Yukio HATOYAMA.jpg;16289;16609;35961;814;830;16
/net/per610a/home/mvp/mvp_db/news7-lv/2001/2001_06_28_19_00/2001_06_28_19_00.mpg;Kazuo SHII.jpg;3289;3613;35961;164;180;16
/net/per610a/home/mvp/mvp_db/news7-lv/2001/2001_06_28_19_00/2001_06_28_19_00.mpg;Junichiro KOIZUMI.jpg;21125;21341;35961;1056;1067;11
/net/per610a/home/mvp/mvp_db/news7-lv/2001/2001_06_28_19_00/2001_06_28_19_00.mpg;Junichiro KOIZUMI.jpg;21405;21453;35961;1070;1073;3
/net/per610a/home/mvp/mvp_db/news7-lv/2001/2001_06_29_19_00/2001_06_29_19_00.mpg;Junichiro KOIZUMI.jpg;1701;1725;35957;85;86;1
/net/per610a/home/mvp/mvp_db/news7-lv/2001/2001_06_29_19_00/2001_06_29_19_00.mpg;Junichiro KOIZUMI.jpg;2873;4261;35957;143;213;70
/net/per610a/home/mvp/mvp_db/news7-lv/2001/2001_06_29_19_00/2001_06_29_19_00.mpg;Junichiro KOIZUMI.jpg;12225;12289;35957;611;614;3
/net/per610a/home/mvp/mvp_db/news7-lv/2001/2001_06_30_19_00/2001_06_30_19_00.mpg;Junichiro KOIZUMI.jpg;6217;6265;35957;311;313;2
/net/per610a/home/mvp/mvp_db/news7-lv/2001/2001_07_01_19_00/2001_07_01_19_00.mpg;Junichiro KOIZUMI.jpg;1425;1681;23909;71;84;13
/net/per610a/home/mvp/mvp_db/news7-lv/2001/2001_07_01_19_00/2001_07_01_19_00.mpg;Junichiro KOIZUMI.jpg;1929;2777;23909;96;138;42
/net/per610a/home/mvp/mvp_db/news7-lv/2001/2001_07_02_19_00/2001_07_02_19_00.mpg;Junichiro KOIZUMI.jpg;5933;6381;35953;296;319;23
/net/per610a/home/mvp/mvp_db/news7-lv/2001/2001_07_02_19_00/2001_07_02_19_00.mpg;Yasuo FUKUDA.jpg;11681;12257;35953;584;613;29
/net/per610a/home/mvp/mvp_db/news7-lv/2001/2001_07_03_19_00/2001_07_03_19_00.mpg;Yasuo FUKUDA.jpg;4105;4445;35953;205;222;17
/net/per610a/home/mvp/mvp_db/news7-lv/2001/2001_07_03_19_00/2001_07_03_19_00.mpg;Junichiro KOIZUMI.jpg;14485;14589;35953;724;729;5
/net/per610a/home/mvp/mvp_db/news7-lv/2001/2001_07_04_19_00/2001_07_04_19_00.mpg;Taro ASO.jpg;22089;22837;35953;1105;1142;37
/net/per610a/home/mvp/mvp_db/news7-lv/2001/2001_07_05_19_00/2001_07_05_19_00.mpg;Junichiro KOIZUMI.jpg;3145;3745;35953;157;187;30
/net/per610a/home/mvp/mvp_db/news7-lv/2001/2001_07_05_19_00/2001_07_05_19_00.mpg;Yasuo FUKUDA.jpg;4973;5581;35953;248;279;31
/net/per610a/home/mvp/mvp_db/news7-lv/2001/2001_07_05_19_00/2001_07_05_19_00.mpg;Junichiro KOIZUMI.jpg;14641;14977;35953;732;749;17
/net/per610a/home/mvp/mvp_db/news7-lv/2001/2001_07_05_19_00/2001_07_05_19_00.mpg;Junichiro KOIZUMI.jpg;20661;20985;35953;1033;1050;17
/net/per610a/home/mvp/mvp_db/news7-lv/2001/2001_07_06_19_00/2001_07_06_19_00.mpg;Yasuo FUKUDA.jpg;11209;11533;35953;560;577;17
/net/per610a/home/mvp/mvp_db/news7-lv/2001/2001_07_07_19_00/2001_07_07_19_00.mpg;Naoto KAN.jpg;6293;7565;35953;314;378;64
/net/per610a/home/mvp/mvp_db/news7-lv/2001/2001_07_07_19_00/2001_07_07_19_00.mpg;Takeo Hiranuma.jpeg;21521;21637;35953;1076;1082;6
/net/per610a/home/mvp/mvp_db/news7-lv/2001/2001_07_08_19_00/2001_07_08_19_00.mpg;Yukio HATOYAMA.jpg;7489;7789;23913;374;389;15
/net/per610a/home/mvp/mvp_db/news7-lv/2001/2001_07_09_19_00/2001_07_09_19_00.mpg;Natsuo YAMAGUCHI.jpg;23289;23969;35953;1165;1199;34
/net/per610a/home/mvp/mvp_db/news7-lv/2001/2001_07_11_19_00/2001_07_11_19_00.mpg;Junichiro KOIZUMI.jpg;881;2357;35953;44;117;73
/net/per610a/home/mvp/mvp_db/news7-lv/2001/2001_07_11_19_00/2001_07_11_19_00.mpg;Junichiro KOIZUMI.jpg;4369;5389;35953;218;269;51
/net/per610a/home/mvp/mvp_db/news7-lv/2001/2001_07_11_19_00/2001_07_11_19_00.mpg;Junichiro KOIZUMI.jpg;6465;6881;35953;323;344;21
/net/per610a/home/mvp/mvp_db/news7-lv/2001/2001_07_11_19_00/2001_07_11_19_00.mpg;Yukio HATOYAMA.jpg;2537;4269;35953;126;213;87
/net/per610a/home/mvp/mvp_db/news7-lv/2001/2001_07_12_19_00/2001_07_12_19_00.mpg;Ichiro OZAWA.jpg;6253;6449;35953;312;322;10
/net/per610a/home/mvp/mvp_db/news7-lv/2001/2001_07_17_19_00/2001_07_17_19_00.mpg;Junichiro KOIZUMI.jpg;13313;13405;35957;666;670;4
/net/per610a/home/mvp/mvp_db/news7-lv/2001/2001_07_17_19_00/2001_07_17_19_00.mpg;Ichiro OZAWA.jpg;20881;21741;35957;1044;1087;43
/net/per610a/home/mvp/mvp_db/news7-lv/2001/2001_07_17_19_00/2001_07_17_19_00.mpg;Toranosuke Katayama.jpg;21913;22329;35957;1096;1117;21
/net/per610a/home/mvp/mvp_db/news7-lv/2001/2001_07_19_19_00/2001_07_19_19_00.mpg;Junichiro KOIZUMI.jpg;153;377;35957;7;18;11
/net/per610a/home/mvp/mvp_db/news7-lv/2001/2001_07_19_19_00/2001_07_19_19_00.mpg;Junichiro KOIZUMI.jpg;6089;6689;35957;304;334;30
/net/per610a/home/mvp/mvp_db/news7-lv/2001/2001_07_20_19_00/2001_07_20_19_00.mpg;Kazuo SHII.jpg;13321;13761;35953;666;688;22
/net/per610a/home/mvp/mvp_db/news7-lv/2001/2001_07_23_19_00/2001_07_23_19_00.mpg;Junichiro KOIZUMI.jpg;997;1129;35961;49;56;7
/net/per610a/home/mvp/mvp_db/news7-lv/2001/2001_07_24_19_00/2001_07_24_19_00.mpg;Junichiro KOIZUMI.jpg;5217;5281;35961;260;264;4
/net/per610a/home/mvp/mvp_db/news7-lv/2001/2001_07_24_19_00/2001_07_24_19_00.mpg;Junichiro KOIZUMI.jpg;5557;5761;35961;277;288;11
/net/per610a/home/mvp/mvp_db/news7-lv/2001/2001_07_24_19_00/2001_07_24_19_00.mpg;Junichiro KOIZUMI.jpg;15129;15141;35961;756;757;1
/net/per610a/home/mvp/mvp_db/news7-lv/2001/2001_07_24_19_00/2001_07_24_19_00.mpg;Junichiro KOIZUMI.jpg;14669;14721;35961;733;736;3
/net/per610a/home/mvp/mvp_db/news7-lv/2001/2001_07_24_19_00/2001_07_24_19_00.mpg;Junichiro KOIZUMI.jpg;14785;14885;35961;739;744;5
/net/per610a/home/mvp/mvp_db/news7-lv/2001/2001_07_26_19_00/2001_07_26_19_00.mpg;Junichiro KOIZUMI.jpg;14005;15557;35961;700;778;78
/net/per610a/home/mvp/mvp_db/news7-lv/2001/2001_07_27_19_00/2001_07_27_19_00.mpg;Junichiro KOIZUMI.jpg;9505;9845;35961;475;492;17
/net/per610a/home/mvp/mvp_db/news7-lv/2001/2001_07_30_19_00/2001_07_30_19_00.mpg;Junichiro KOIZUMI.jpg;805;833;35973;40;41;1
/net/per610a/home/mvp/mvp_db/news7-lv/2001/2001_07_30_19_00/2001_07_30_19_00.mpg;Junichiro KOIZUMI.jpg;3025;3513;35973;151;175;24
/net/per610a/home/mvp/mvp_db/news7-lv/2001/2001_07_30_19_00/2001_07_30_19_00.mpg;Junichiro KOIZUMI.jpg;3577;5257;35973;178;263;85
/net/per610a/home/mvp/mvp_db/news7-lv/2001/2001_07_30_19_00/2001_07_30_19_00.mpg;Junichiro KOIZUMI.jpg;5333;5997;35973;266;300;34
/net/per610a/home/mvp/mvp_db/news7-lv/2001/2001_07_30_19_00/2001_07_30_19_00.mpg;Junichiro KOIZUMI.jpg;16573;17241;35973;829;862;33
/net/per610a/home/mvp/mvp_db/news7-lv/2001/2001_07_30_19_00/2001_07_30_19_00.mpg;Yukio HATOYAMA.jpg;10077;10221;35973;504;511;7
/net/per610a/home/mvp/mvp_db/news7-lv/2001/2001_07_30_19_00/2001_07_30_19_00.mpg;Junichiro KOIZUMI.jpg;14049;14261;35973;702;713;11
/net/per610a/home/mvp/mvp_db/news7-lv/2001/2001_07_31_19_00/2001_07_31_19_00.mpg;Junichiro KOIZUMI.jpg;13061;13993;35973;653;700;47
/net/per610a/home/mvp/mvp_db/news7-lv/2001/2001_07_31_19_00/2001_07_31_19_00.mpg;Yukio HATOYAMA.jpg;19425;19641;35973;971;982;11
/net/per610a/home/mvp/mvp_db/news7-lv/2001/2001_07_31_19_00/2001_07_31_19_00.mpg;Takeo Hiranuma.jpeg;25989;26237;35973;1300;1312;12
/net/per610a/home/mvp/mvp_db/news7-lv/2001/2001_08_01_19_00/2001_08_01_19_00.mpg;Kazuo SHII.jpg;10893;11405;35973;545;570;25
/net/per610a/home/mvp/mvp_db/news7-lv/2001/2001_08_01_19_00/2001_08_01_19_00.mpg;Yasuo FUKUDA.jpg;20589;21373;35973;1030;1069;39
/net/per610a/home/mvp/mvp_db/news7-lv/2001/2001_08_02_19_00/2001_08_02_19_00.mpg;Yasuo FUKUDA.jpg;4597;5077;35953;230;254;24
/net/per610a/home/mvp/mvp_db/news7-lv/2001/2001_08_03_19_00/2001_08_03_19_00.mpg;Naoto KAN.jpg;8941;9785;35953;447;489;42
/net/per610a/home/mvp/mvp_db/news7-lv/2001/2001_08_03_19_00/2001_08_03_19_00.mpg;Junichiro KOIZUMI.jpg;10245;10453;35953;512;523;11
/net/per610a/home/mvp/mvp_db/news7-lv/2001/2001_08_06_19_00/2001_08_06_19_00.mpg;Yukio HATOYAMA.jpg;12053;12569;35953;603;628;25
/net/per610a/home/mvp/mvp_db/news7-lv/2001/2001_08_07_19_00/2001_08_07_19_00.mpg;Junichiro KOIZUMI.jpg;5981;6329;35953;299;316;17
/net/per610a/home/mvp/mvp_db/news7-lv/2001/2001_08_07_19_00/2001_08_07_19_00.mpg;Junichiro KOIZUMI.jpg;16141;16509;35953;807;826;19
/net/per610a/home/mvp/mvp_db/news7-lv/2001/2001_08_07_19_00/2001_08_07_19_00.mpg;Junichiro KOIZUMI.jpg;18781;20477;35953;939;1024;85
/net/per610a/home/mvp/mvp_db/news7-lv/2001/2001_08_07_19_00/2001_08_07_19_00.mpg;Junichiro KOIZUMI.jpg;20569;21121;35953;1029;1056;27
/net/per610a/home/mvp/mvp_db/news7-lv/2001/2001_08_07_19_00/2001_08_07_19_00.mpg;Takenori KANZAKI.jpg;7477;8097;35953;374;405;31
/net/per610a/home/mvp/mvp_db/news7-lv/2001/2001_08_08_19_00/2001_08_08_19_00.mpg;Junichiro KOIZUMI.jpg;6513;6961;35953;325;348;23
/net/per610a/home/mvp/mvp_db/news7-lv/2001/2001_08_08_19_00/2001_08_08_19_00.mpg;Junichiro KOIZUMI.jpg;19505;19537;35953;975;977;2
/net/per610a/home/mvp/mvp_db/news7-lv/2001/2001_08_08_19_00/2001_08_08_19_00.mpg;Junichiro KOIZUMI.jpg;22601;22685;35953;1130;1135;5
/net/per610a/home/mvp/mvp_db/news7-lv/2001/2001_08_09_19_00/2001_08_09_19_00.mpg;Junichiro KOIZUMI.jpg;7633;8125;35953;381;406;25
/net/per610a/home/mvp/mvp_db/news7-lv/2001/2001_08_09_19_00/2001_08_09_19_00.mpg;Junichiro KOIZUMI.jpg;8197;9349;35953;410;467;57
/net/per610a/home/mvp/mvp_db/news7-lv/2001/2001_08_09_19_00/2001_08_09_19_00.mpg;Junichiro KOIZUMI.jpg;13709;13901;35953;685;695;10
/net/per610a/home/mvp/mvp_db/news7-lv/2001/2001_08_09_19_00/2001_08_09_19_00.mpg;Junichiro KOIZUMI.jpg;13977;14233;35953;699;712;13
/net/per610a/home/mvp/mvp_db/news7-lv/2001/2001_08_09_19_00/2001_08_09_19_00.mpg;Naoto KAN.jpg;11537;11913;35953;577;596;19
/net/per610a/home/mvp/mvp_db/news7-lv/2001/2001_08_09_19_00/2001_08_09_19_00.mpg;Junichiro KOIZUMI.jpg;15989;16353;35953;800;818;18
/net/per610a/home/mvp/mvp_db/news7-lv/2001/2001_08_09_19_00/2001_08_09_19_00.mpg;Junichiro KOIZUMI.jpg;16653;16953;35953;833;848;15
/net/per610a/home/mvp/mvp_db/news7-lv/2001/2001_08_10_19_00/2001_08_10_19_00.mpg;Junichiro KOIZUMI.jpg;1677;2141;35953;83;107;24
/net/per610a/home/mvp/mvp_db/news7-lv/2001/2001_08_10_19_00/2001_08_10_19_00.mpg;Junichiro KOIZUMI.jpg;4797;5545;35953;240;277;37
/net/per610a/home/mvp/mvp_db/news7-lv/2001/2001_08_10_19_00/2001_08_10_19_00.mpg;Junichiro KOIZUMI.jpg;5789;5881;35953;289;294;5
/net/per610a/home/mvp/mvp_db/news7-lv/2001/2001_08_10_19_00/2001_08_10_19_00.mpg;Junichiro KOIZUMI.jpg;9977;9977;35953;499;499;0
/net/per610a/home/mvp/mvp_db/news7-lv/2001/2001_08_10_19_00/2001_08_10_19_00.mpg;Junichiro KOIZUMI.jpg;10113;10113;35953;506;506;0
/net/per610a/home/mvp/mvp_db/news7-lv/2001/2001_08_10_19_00/2001_08_10_19_00.mpg;Junichiro KOIZUMI.jpg;10837;11393;35953;542;570;28
/net/per610a/home/mvp/mvp_db/news7-lv/2001/2001_08_13_19_00/2001_08_13_19_00.mpg;Junichiro KOIZUMI.jpg;2097;8297;35953;104;415;311
/net/per610a/home/mvp/mvp_db/news7-lv/2001/2001_08_13_19_00/2001_08_13_19_00.mpg;Junichiro KOIZUMI.jpg;11341;11541;35953;567;577;10
/net/per610a/home/mvp/mvp_db/news7-lv/2001/2001_08_13_19_00/2001_08_13_19_00.mpg;Junichiro KOIZUMI.jpg;20473;20517;35953;1024;1026;2
/net/per610a/home/mvp/mvp_db/news7-lv/2001/2001_08_13_19_00/2001_08_13_19_00.mpg;Junichiro KOIZUMI.jpg;20601;20693;35953;1030;1035;5
/net/per610a/home/mvp/mvp_db/news7-lv/2001/2001_08_13_19_00/2001_08_13_19_00.mpg;Junichiro KOIZUMI.jpg;25421;26717;35953;1272;1336;64
/net/per610a/home/mvp/mvp_db/news7-lv/2001/2001_08_13_19_00/2001_08_13_19_00.mpg;Takenori KANZAKI.jpg;13217;13885;35953;661;694;33
/net/per610a/home/mvp/mvp_db/news7-lv/2001/2001_08_14_19_00/2001_08_14_19_00.mpg;Yasuo FUKUDA.jpg;5233;5877;35953;261;294;33
/net/per610a/home/mvp/mvp_db/news7-lv/2001/2001_08_14_19_00/2001_08_14_19_00.mpg;Takeo Hiranuma.jpeg;10101;10197;35953;505;510;5
/net/per610a/home/mvp/mvp_db/news7-lv/2001/2001_08_14_19_00/2001_08_14_19_00.mpg;Junichiro KOIZUMI.jpg;28061;28129;35953;1404;1407;3
/net/per610a/home/mvp/mvp_db/news7-lv/2001/2001_08_15_19_00/2001_08_15_19_00.mpg;Junichiro KOIZUMI.jpg;8389;8969;35953;419;448;29
/net/per610a/home/mvp/mvp_db/news7-lv/2001/2001_08_15_19_00/2001_08_15_19_00.mpg;Toranosuke Katayama.jpg;12833;13017;35953;642;651;9
/net/per610a/home/mvp/mvp_db/news7-lv/2001/2001_08_15_19_00/2001_08_15_19_00.mpg;Taro ASO.jpg;13925;14301;35953;696;715;19
/net/per610a/home/mvp/mvp_db/news7-lv/2001/2001_08_16_19_00/2001_08_16_19_00.mpg;Junichiro KOIZUMI.jpg;4961;5053;35953;248;252;4
/net/per610a/home/mvp/mvp_db/news7-lv/2001/2001_08_17_19_00/2001_08_17_19_00.mpg;Junichiro KOIZUMI.jpg;11569;11809;35953;578;590;12
/net/per610a/home/mvp/mvp_db/news7-lv/2001/2001_08_17_19_00/2001_08_17_19_00.mpg;Junichiro KOIZUMI.jpg;13869;14065;35953;693;703;10
/net/per610a/home/mvp/mvp_db/news7-lv/2001/2001_08_17_19_00/2001_08_17_19_00.mpg;Junichiro KOIZUMI.jpg;14153;14213;35953;708;711;3
/net/per610a/home/mvp/mvp_db/news7-lv/2001/2001_08_17_19_00/2001_08_17_19_00.mpg;Shintaro ISHIHARA.jpg;11981;12465;35953;599;623;24
/net/per610a/home/mvp/mvp_db/news7-lv/2001/2001_08_17_19_00/2001_08_17_19_00.mpg;Junichiro KOIZUMI.jpg;14961;15661;35953;748;783;35
/net/per610a/home/mvp/mvp_db/news7-lv/2001/2001_08_18_19_00/2001_08_18_19_00.mpg;Shinzo ABE.jpg;13889;14857;35957;694;743;49
/net/per610a/home/mvp/mvp_db/news7-lv/2001/2001_08_20_19_00/2001_08_20_19_00.mpg;Shintaro ISHIHARA.jpg;25901;26437;35953;1296;1322;26
/net/per610a/home/mvp/mvp_db/news7-lv/2001/2001_08_28_19_00/2001_08_28_19_00.mpg;Junichiro KOIZUMI.jpg;8853;9137;35953;442;457;15
/net/per610a/home/mvp/mvp_db/news7-lv/2001/2001_08_28_19_00/2001_08_28_19_00.mpg;Junichiro KOIZUMI.jpg;25373;25413;35953;1269;1271;2
/net/per610a/home/mvp/mvp_db/news7-lv/2001/2001_08_29_19_00/2001_08_29_19_00.mpg;Junichiro KOIZUMI.jpg;4797;5117;35953;240;256;16
/net/per610a/home/mvp/mvp_db/news7-lv/2001/2001_08_29_19_00/2001_08_29_19_00.mpg;Junichiro KOIZUMI.jpg;20525;20897;35953;1027;1045;18
/net/per610a/home/mvp/mvp_db/news7-lv/2001/2001_08_29_19_00/2001_08_29_19_00.mpg;Junichiro KOIZUMI.jpg;21149;21645;35953;1058;1083;25
/net/per610a/home/mvp/mvp_db/news7-lv/2001/2001_08_29_19_00/2001_08_29_19_00.mpg;Yasuo FUKUDA.jpg;22237;22509;35953;1112;1126;14
/net/per610a/home/mvp/mvp_db/news7-lv/2001/2001_08_29_19_00/2001_08_29_19_00.mpg;Yasuo FUKUDA.jpg;22789;24285;35953;1140;1215;75
/net/per610a/home/mvp/mvp_db/news7-lv/2001/2001_08_29_19_00/2001_08_29_19_00.mpg;Yukio HATOYAMA.jpg;24369;24981;35953;1219;1249;30
/net/per610a/home/mvp/mvp_db/news7-lv/2001/2001_08_30_19_00/2001_08_30_19_00.mpg;Toru Hashimoto.jpg;3241;3725;35953;162;186;24
/net/per610a/home/mvp/mvp_db/news7-lv/2001/2001_08_30_19_00/2001_08_30_19_00.mpg;Masashi Nakano.jpg;10517;10809;35953;526;540;14
/net/per610a/home/mvp/mvp_db/news7-lv/2001/2001_08_31_19_00/2001_08_31_19_00.mpg;Junichiro KOIZUMI.jpg;10833;11329;35953;542;566;24
/net/per610a/home/mvp/mvp_db/news7-lv/2001/2001_09_01_19_00/2001_09_01_19_00.mpg;Junichiro KOIZUMI.jpg;22569;22713;35957;1129;1136;7
/net/per610a/home/mvp/mvp_db/news7-lv/2001/2001_09_01_19_00/2001_09_01_19_00.mpg;Junichiro KOIZUMI.jpg;23853;24133;35957;1193;1207;14
/net/per610a/home/mvp/mvp_db/news7-lv/2001/2001_09_04_19_00/2001_09_04_19_00.mpg;Junichiro KOIZUMI.jpg;925;1193;35957;46;59;13
/net/per610a/home/mvp/mvp_db/news7-lv/2001/2001_09_04_19_00/2001_09_04_19_00.mpg;Junichiro KOIZUMI.jpg;10349;10853;35957;517;542;25
/net/per610a/home/mvp/mvp_db/news7-lv/2001/2001_09_04_19_00/2001_09_04_19_00.mpg;Junichiro KOIZUMI.jpg;11069;11141;35957;553;557;4
/net/per610a/home/mvp/mvp_db/news7-lv/2001/2001_09_04_19_00/2001_09_04_19_00.mpg;Junichiro KOIZUMI.jpg;11017;11053;35957;551;553;2
/net/per610a/home/mvp/mvp_db/news7-lv/2001/2001_09_04_19_00/2001_09_04_19_00.mpg;Junichiro KOIZUMI.jpg;11153;11161;35957;558;558;0
/net/per610a/home/mvp/mvp_db/news7-lv/2001/2001_09_04_19_00/2001_09_04_19_00.mpg;Junichiro KOIZUMI.jpg;11409;11441;35957;570;572;2
/net/per610a/home/mvp/mvp_db/news7-lv/2001/2001_09_06_19_00/2001_09_06_19_00.mpg;Junichiro KOIZUMI.jpg;10581;11005;35957;529;550;21
/net/per610a/home/mvp/mvp_db/news7-lv/2001/2001_09_06_19_00/2001_09_06_19_00.mpg;Junichiro KOIZUMI.jpg;25753;25833;35957;1288;1292;4
/net/per610a/home/mvp/mvp_db/news7-lv/2001/2001_09_07_19_00/2001_09_07_19_00.mpg;Junichiro KOIZUMI.jpg;297;401;35957;14;20;6
/net/per610a/home/mvp/mvp_db/news7-lv/2001/2001_09_07_19_00/2001_09_07_19_00.mpg;Junichiro KOIZUMI.jpg;6585;6757;35957;329;338;9
/net/per610a/home/mvp/mvp_db/news7-lv/2001/2001_09_07_19_00/2001_09_07_19_00.mpg;Junichiro KOIZUMI.jpg;7129;7157;35957;356;358;2
/net/per610a/home/mvp/mvp_db/news7-lv/2001/2001_09_07_19_00/2001_09_07_19_00.mpg;Junichiro KOIZUMI.jpg;10401;10517;35957;520;526;6
/net/per610a/home/mvp/mvp_db/news7-lv/2001/2001_09_07_19_00/2001_09_07_19_00.mpg;Takeo Hiranuma.jpeg;6873;6989;35957;343;349;6
/net/per610a/home/mvp/mvp_db/news7-lv/2001/2001_09_08_19_00/2001_09_08_19_00.mpg;Yukio HATOYAMA.jpg;16721;17513;35957;836;876;40
/net/per610a/home/mvp/mvp_db/news7-lv/2001/2001_09_08_19_00/2001_09_08_19_00.mpg;Naoto KAN.jpg;19037;19973;35957;952;999;47
/net/per610a/home/mvp/mvp_db/news7-lv/2001/2001_09_12_19_00/2001_09_12_19_00.mpg;Yasuo FUKUDA.jpg;4233;5661;35961;211;283;72
/net/per610a/home/mvp/mvp_db/news7-lv/2001/2001_09_12_19_00/2001_09_12_19_00.mpg;Yasuo FUKUDA.jpg;18885;19425;35961;944;971;27
/net/per610a/home/mvp/mvp_db/news7-lv/2001/2001_09_16_19_00/2001_09_16_19_00.mpg;Shinzo ABE.jpg;28037;28145;35961;1402;1407;5
/net/per610a/home/mvp/mvp_db/news7-lv/2001/2001_09_19_19_00/2001_09_19_19_00.mpg;Takenori KANZAKI.jpg;1121;1217;35961;56;60;4
/net/per610a/home/mvp/mvp_db/news7-lv/2001/2001_09_19_19_00/2001_09_19_19_00.mpg;Takenori KANZAKI.jpg;1525;1565;35961;76;78;2
/net/per610a/home/mvp/mvp_db/news7-lv/2001/2001_09_19_19_00/2001_09_19_19_00.mpg;Junichiro KOIZUMI.jpg;1513;1517;35961;75;75;0
/net/per610a/home/mvp/mvp_db/news7-lv/2001/2001_09_19_19_00/2001_09_19_19_00.mpg;Junichiro KOIZUMI.jpg;1613;1701;35961;80;85;5
/net/per610a/home/mvp/mvp_db/news7-lv/2001/2001_09_19_19_00/2001_09_19_19_00.mpg;Junichiro KOIZUMI.jpg;2101;2181;35961;105;109;4
/net/per610a/home/mvp/mvp_db/news7-lv/2001/2001_09_19_19_00/2001_09_19_19_00.mpg;Junichiro KOIZUMI.jpg;3977;4681;35961;198;234;36
/net/per610a/home/mvp/mvp_db/news7-lv/2001/2001_09_19_19_00/2001_09_19_19_00.mpg;Junichiro KOIZUMI.jpg;5949;6961;35961;297;348;51
/net/per610a/home/mvp/mvp_db/news7-lv/2001/2001_09_20_19_00/2001_09_20_19_00.mpg;Akihiro OHTA.jpg;669;741;35961;33;37;4
/net/per610a/home/mvp/mvp_db/news7-lv/2001/2001_09_20_19_00/2001_09_20_19_00.mpg;Kazuo SHII.jpg;33869;33869;35961;1694;1694;0
/net/per610a/home/mvp/mvp_db/news7-lv/2001/2001_09_20_19_00/2001_09_20_19_00.mpg;Kazuo SHII.jpg;34197;34325;35961;1710;1717;7
/net/per610a/home/mvp/mvp_db/news7-lv/2001/2001_09_21_19_00/2001_09_21_19_00.mpg;Yasuo FUKUDA.jpg;19857;20405;35961;993;1020;27
/net/per610a/home/mvp/mvp_db/news7-lv/2001/2001_09_23_19_00/2001_09_23_19_00.mpg;Junichiro KOIZUMI.jpg;11393;11613;23889;569;580;11
/net/per610a/home/mvp/mvp_db/news7-lv/2001/2001_09_24_19_00/2001_09_24_19_00.mpg;Junichiro KOIZUMI.jpg;24317;25057;35957;1216;1253;37
/net/per610a/home/mvp/mvp_db/news7-lv/2001/2001_09_26_19_00/2001_09_26_19_00.mpg;Junichiro KOIZUMI.jpg;641;833;35961;32;41;9
/net/per610a/home/mvp/mvp_db/news7-lv/2001/2001_09_26_19_00/2001_09_26_19_00.mpg;Junichiro KOIZUMI.jpg;32641;32717;35961;1632;1636;4
/net/per610a/home/mvp/mvp_db/news7-lv/2001/2001_09_26_19_00/2001_09_26_19_00.mpg;Junichiro KOIZUMI.jpg;2221;2301;35961;111;115;4
/net/per610a/home/mvp/mvp_db/news7-lv/2001/2001_09_26_19_00/2001_09_26_19_00.mpg;Junichiro KOIZUMI.jpg;31777;32085;35961;1589;1605;16
/net/per610a/home/mvp/mvp_db/news7-lv/2001/2001_09_27_19_00/2001_09_27_19_00.mpg;Junichiro KOIZUMI.jpg;22269;22269;35961;1114;1114;0
/net/per610a/home/mvp/mvp_db/news7-lv/2001/2001_09_27_19_00/2001_09_27_19_00.mpg;Junichiro KOIZUMI.jpg;23301;24201;35961;1165;1210;45
/net/per610a/home/mvp/mvp_db/news7-lv/2001/2001_09_27_19_00/2001_09_27_19_00.mpg;Naoto KAN.jpg;31265;31421;35961;1564;1571;7
/net/per610a/home/mvp/mvp_db/news7-lv/2001/2001_09_29_19_00/2001_09_29_19_00.mpg;Junichiro KOIZUMI.jpg;27425;27701;35957;1372;1385;13
/net/per610a/home/mvp/mvp_db/news7-lv/2001/2001_10_02_19_00/2001_10_02_19_00.mpg;Junichiro KOIZUMI.jpg;409;601;35961;20;30;10
/net/per610a/home/mvp/mvp_db/news7-lv/2001/2001_10_05_19_00/2001_10_05_19_00.mpg;Kyoko Nakayama.jpg;11225;11777;69429;561;589;28
/net/per610a/home/mvp/mvp_db/news7-lv/2001/2001_10_05_19_00/2001_10_05_19_00.mpg;Kyoko Nakayama.jpg;11949;12445;69429;597;622;25
/net/per610a/home/mvp/mvp_db/news7-lv/2001/2001_10_05_19_00/2001_10_05_19_00.mpg;Kyoko Nakayama.jpg;12805;13785;69429;640;689;49
/net/per610a/home/mvp/mvp_db/news7-lv/2001/2001_10_05_19_00/2001_10_05_19_00.mpg;Junichiro KOIZUMI.jpg;14493;14697;69429;725;735;10
/net/per610a/home/mvp/mvp_db/news7-lv/2001/2001_10_05_19_00/2001_10_05_19_00.mpg;Junichiro KOIZUMI.jpg;43509;43581;69429;2177;2180;3
/net/per610a/home/mvp/mvp_db/news7-lv/2001/2001_10_05_19_00/2001_10_05_19_00.mpg;Junichiro KOIZUMI.jpg;57521;57549;69429;2878;2879;1
/net/per610a/home/mvp/mvp_db/news7-lv/2001/2001_10_05_19_00/2001_10_05_19_00.mpg;Junichiro KOIZUMI.jpg;36485;37277;69429;1825;1865;40
/net/per610a/home/mvp/mvp_db/news7-lv/2001/2001_10_05_19_00/2001_10_05_19_00.mpg;Junichiro KOIZUMI.jpg;38457;38585;69429;1924;1930;6
/net/per610a/home/mvp/mvp_db/news7-lv/2001/2001_10_08_19_00/2001_10_08_19_00.mpg;Junichiro KOIZUMI.jpg;45981;46025;71921;2300;2303;3
/net/per610a/home/mvp/mvp_db/news7-lv/2001/2001_10_08_19_00/2001_10_08_19_00.mpg;Junichiro KOIZUMI.jpg;46697;47385;71921;2336;2371;35
/net/per610a/home/mvp/mvp_db/news7-lv/2001/2001_10_09_19_00/2001_10_09_19_00.mpg;Junichiro KOIZUMI.jpg;60609;61345;71917;3033;3069;36
/net/per610a/home/mvp/mvp_db/news7-lv/2001/2001_10_10_19_00/2001_10_10_19_00.mpg;Yukio HATOYAMA.jpg;56313;56701;71921;2817;2837;20
/net/per610a/home/mvp/mvp_db/news7-lv/2001/2001_10_12_19_00/2001_10_12_19_00.mpg;Naoto KAN.jpg;6373;7513;71921;318;375;57
/net/per610a/home/mvp/mvp_db/news7-lv/2001/2001_10_12_19_00/2001_10_12_19_00.mpg;Naoto KAN.jpg;53441;54905;71921;2674;2747;73
/net/per610a/home/mvp/mvp_db/news7-lv/2001/2001_10_12_19_00/2001_10_12_19_00.mpg;Junichiro KOIZUMI.jpg;49861;50657;71921;2495;2534;39
/net/per610a/home/mvp/mvp_db/news7-lv/2001/2001_10_12_19_00/2001_10_12_19_00.mpg;Junichiro KOIZUMI.jpg;51077;52237;71921;2555;2613;58
/net/per610a/home/mvp/mvp_db/news7-lv/2001/2001_10_12_19_00/2001_10_12_19_00.mpg;Taro ASO.jpg;63937;64073;71921;3199;3206;7
/net/per610a/home/mvp/mvp_db/news7-lv/2001/2001_10_15_19_00/2001_10_15_19_00.mpg;Junichiro KOIZUMI.jpg;57693;57693;71921;2887;2887;0
/net/per610a/home/mvp/mvp_db/news7-lv/2001/2001_10_15_19_00/2001_10_15_19_00.mpg;Junichiro KOIZUMI.jpg;57821;57821;71921;2893;2893;0
/net/per610a/home/mvp/mvp_db/news7-lv/2001/2001_10_15_19_00/2001_10_15_19_00.mpg;Junichiro KOIZUMI.jpg;57997;57997;71921;2902;2902;0
/net/per610a/home/mvp/mvp_db/news7-lv/2001/2001_10_15_19_00/2001_10_15_19_00.mpg;Junichiro KOIZUMI.jpg;58109;58121;71921;2907;2908;1
/net/per610a/home/mvp/mvp_db/news7-lv/2001/2001_10_15_19_00/2001_10_15_19_00.mpg;Junichiro KOIZUMI.jpg;58189;58249;71921;2911;2914;3
/net/per610a/home/mvp/mvp_db/news7-lv/2001/2001_10_15_19_00/2001_10_15_19_00.mpg;Junichiro KOIZUMI.jpg;58541;59193;71921;2929;2962;33
/net/per610a/home/mvp/mvp_db/news7-lv/2001/2001_10_15_19_00/2001_10_15_19_00.mpg;Junichiro KOIZUMI.jpg;59677;59677;71921;2986;2986;0
/net/per610a/home/mvp/mvp_db/news7-lv/2001/2001_10_15_19_00/2001_10_15_19_00.mpg;Junichiro KOIZUMI.jpg;59841;59961;71921;2994;3000;6
/net/per610a/home/mvp/mvp_db/news7-lv/2001/2001_10_15_19_00/2001_10_15_19_00.mpg;Junichiro KOIZUMI.jpg;60197;60289;71921;3012;3016;4
/net/per610a/home/mvp/mvp_db/news7-lv/2001/2001_10_15_19_00/2001_10_15_19_00.mpg;Junichiro KOIZUMI.jpg;60665;61033;71921;3035;3054;19
/net/per610a/home/mvp/mvp_db/news7-lv/2001/2001_10_16_19_00/2001_10_16_19_00.mpg;Junichiro KOIZUMI.jpg;397;445;47849;19;22;3
/net/per610a/home/mvp/mvp_db/news7-lv/2001/2001_10_16_19_00/2001_10_16_19_00.mpg;Junichiro KOIZUMI.jpg;38845;38921;47849;1943;1947;4
/net/per610a/home/mvp/mvp_db/news7-lv/2001/2001_10_16_19_00/2001_10_16_19_00.mpg;Takenori KANZAKI.jpg;15053;15061;47849;753;753;0
/net/per610a/home/mvp/mvp_db/news7-lv/2001/2001_10_16_19_00/2001_10_16_19_00.mpg;Takenori KANZAKI.jpg;15257;15337;47849;763;767;4
/net/per610a/home/mvp/mvp_db/news7-lv/2001/2001_10_17_19_00/2001_10_17_19_00.mpg;Junichiro KOIZUMI.jpg;29725;29993;47849;1487;1500;13
/net/per610a/home/mvp/mvp_db/news7-lv/2001/2001_10_17_19_00/2001_10_17_19_00.mpg;Junichiro KOIZUMI.jpg;30689;31329;47849;1535;1567;32
/net/per610a/home/mvp/mvp_db/news7-lv/2001/2001_10_17_19_00/2001_10_17_19_00.mpg;Yukio HATOYAMA.jpg;33221;34061;47849;1662;1704;42
/net/per610a/home/mvp/mvp_db/news7-lv/2001/2001_10_17_19_00/2001_10_17_19_00.mpg;Takeo Hiranuma.jpeg;34873;35133;47849;1744;1757;13
/net/per610a/home/mvp/mvp_db/news7-lv/2001/2001_10_18_19_00/2001_10_18_19_00.mpg;Yasuo FUKUDA.jpg;27337;27469;47849;1367;1374;7
/net/per610a/home/mvp/mvp_db/news7-lv/2001/2001_10_18_19_00/2001_10_18_19_00.mpg;Ichiro OZAWA.jpg;41849;42225;47849;2093;2112;19
/net/per610a/home/mvp/mvp_db/news7-lv/2001/2001_10_19_19_00/2001_10_19_19_00.mpg;Kazuo SHII.jpg;34889;35101;47861;1745;1756;11
/net/per610a/home/mvp/mvp_db/news7-lv/2001/2001_10_19_19_00/2001_10_19_19_00.mpg;Kazuo SHII.jpg;35197;35981;47861;1761;1800;39
/net/per610a/home/mvp/mvp_db/news7-lv/2001/2001_10_20_19_00/2001_10_20_19_00.mpg;Kyoko Nakayama.jpg;16873;17013;35957;844;851;7
/net/per610a/home/mvp/mvp_db/news7-lv/2001/2001_10_20_19_00/2001_10_20_19_00.mpg;Kyoko Nakayama.jpg;17177;17745;35957;859;887;28
/net/per610a/home/mvp/mvp_db/news7-lv/2001/2001_10_20_19_00/2001_10_20_19_00.mpg;Junichiro KOIZUMI.jpg;22821;22933;35957;1141;1147;6
/net/per610a/home/mvp/mvp_db/news7-lv/2001/2001_10_20_19_00/2001_10_20_19_00.mpg;Junichiro KOIZUMI.jpg;23377;23949;35957;1169;1198;29
/net/per610a/home/mvp/mvp_db/news7-lv/2001/2001_10_23_19_00/2001_10_23_19_00.mpg;Yasuo FUKUDA.jpg;36537;37377;47869;1828;1870;42
/net/per610a/home/mvp/mvp_db/news7-lv/2001/2001_10_24_19_00/2001_10_24_19_00.mpg;Junichiro KOIZUMI.jpg;30897;31009;47869;1545;1551;6
/net/per610a/home/mvp/mvp_db/news7-lv/2001/2001_10_24_19_00/2001_10_24_19_00.mpg;Junichiro KOIZUMI.jpg;31645;32009;47869;1583;1601;18
/net/per610a/home/mvp/mvp_db/news7-lv/2001/2001_10_24_19_00/2001_10_24_19_00.mpg;Junichiro KOIZUMI.jpg;32173;32197;47869;1609;1610;1
/net/per610a/home/mvp/mvp_db/news7-lv/2001/2001_10_25_19_00/2001_10_25_19_00.mpg;Junichiro KOIZUMI.jpg;29249;29841;47849;1463;1493;30
/net/per610a/home/mvp/mvp_db/news7-lv/2001/2001_10_25_19_00/2001_10_25_19_00.mpg;Junichiro KOIZUMI.jpg;30073;30713;47849;1504;1536;32
/net/per610a/home/mvp/mvp_db/news7-lv/2001/2001_10_25_19_00/2001_10_25_19_00.mpg;Takenori KANZAKI.jpg;31681;32041;47849;1585;1603;18
/net/per610a/home/mvp/mvp_db/news7-lv/2001/2001_10_25_19_00/2001_10_25_19_00.mpg;Yukio HATOYAMA.jpg;32357;32789;47849;1618;1640;22
/net/per610a/home/mvp/mvp_db/news7-lv/2001/2001_10_25_19_00/2001_10_25_19_00.mpg;Yukio HATOYAMA.jpg;32881;33205;47849;1645;1661;16
/net/per610a/home/mvp/mvp_db/news7-lv/2001/2001_10_26_19_00/2001_10_26_19_00.mpg;Yasuo FUKUDA.jpg;32973;33097;47861;1649;1656;7
/net/per610a/home/mvp/mvp_db/news7-lv/2001/2001_10_26_19_00/2001_10_26_19_00.mpg;Yasuo FUKUDA.jpg;33729;33733;47861;1687;1688;1
/net/per610a/home/mvp/mvp_db/news7-lv/2001/2001_10_26_19_00/2001_10_26_19_00.mpg;Sadakazu TANIGAKI.jpg;33889;33997;47861;1695;1701;6
/net/per610a/home/mvp/mvp_db/news7-lv/2001/2001_10_26_19_00/2001_10_26_19_00.mpg;Junichiro KOIZUMI.jpg;40253;40777;47861;2014;2040;26
/net/per610a/home/mvp/mvp_db/news7-lv/2001/2001_10_26_19_00/2001_10_26_19_00.mpg;Junichiro KOIZUMI.jpg;41849;41877;47861;2094;2095;1
/net/per610a/home/mvp/mvp_db/news7-lv/2001/2001_10_29_19_00/2001_10_29_19_00.mpg;Junichiro KOIZUMI.jpg;3045;3449;47861;152;172;20
/net/per610a/home/mvp/mvp_db/news7-lv/2001/2001_10_29_19_00/2001_10_29_19_00.mpg;Takenori KANZAKI.jpg;9069;9417;47861;453;471;18
/net/per610a/home/mvp/mvp_db/news7-lv/2001/2001_10_31_19_00/2001_10_31_19_00.mpg;Takenori KANZAKI.jpg;28989;29333;47861;1450;1467;17
/net/per610a/home/mvp/mvp_db/news7-lv/2001/2001_10_31_19_00/2001_10_31_19_00.mpg;Takenori KANZAKI.jpg;29397;29557;47861;1471;1479;8
/net/per610a/home/mvp/mvp_db/news7-lv/2001/2001_10_31_19_00/2001_10_31_19_00.mpg;Takenori KANZAKI.jpg;30809;30861;47861;1541;1544;3
/net/per610a/home/mvp/mvp_db/news7-lv/2001/2001_11_03_19_00/2001_11_03_19_00.mpg;Toranosuke Katayama.jpg;30981;31181;35957;1550;1560;10
/net/per610a/home/mvp/mvp_db/news7-lv/2001/2001_11_04_19_00/2001_11_04_19_00.mpg;Junichiro KOIZUMI.jpg;10697;10817;23969;535;541;6
/net/per610a/home/mvp/mvp_db/news7-lv/2001/2001_11_04_19_00/2001_11_04_19_00.mpg;Junichiro KOIZUMI.jpg;10893;11001;23969;544;550;6
/net/per610a/home/mvp/mvp_db/news7-lv/2001/2001_11_04_19_00/2001_11_04_19_00.mpg;Junichiro KOIZUMI.jpg;11453;11545;23969;572;577;5
/net/per610a/home/mvp/mvp_db/news7-lv/2001/2001_11_04_19_00/2001_11_04_19_00.mpg;Shinzo ABE.jpg;16381;16545;23969;819;827;8
/net/per610a/home/mvp/mvp_db/news7-lv/2001/2001_11_06_19_00/2001_11_06_19_00.mpg;Junichiro KOIZUMI.jpg;401;721;41869;20;36;16
/net/per610a/home/mvp/mvp_db/news7-lv/2001/2001_11_06_19_00/2001_11_06_19_00.mpg;Junichiro KOIZUMI.jpg;21633;22841;41869;1082;1142;60
/net/per610a/home/mvp/mvp_db/news7-lv/2001/2001_11_06_19_00/2001_11_06_19_00.mpg;Junichiro KOIZUMI.jpg;23037;23669;41869;1152;1184;32
/net/per610a/home/mvp/mvp_db/news7-lv/2001/2001_11_07_19_00/2001_11_07_19_00.mpg;Junichiro KOIZUMI.jpg;10873;11117;41881;544;556;12
/net/per610a/home/mvp/mvp_db/news7-lv/2001/2001_11_09_19_00/2001_11_09_19_00.mpg;Naoto KAN.jpg;7393;8301;35961;369;415;46
/net/per610a/home/mvp/mvp_db/news7-lv/2001/2001_11_09_19_00/2001_11_09_19_00.mpg;Takeo Hiranuma.jpeg;31193;31833;35961;1560;1592;32
/net/per610a/home/mvp/mvp_db/news7-lv/2001/2001_11_09_19_00/2001_11_09_19_00.mpg;Shintaro ISHIHARA.jpg;35293;35785;35961;1765;1790;25
/net/per610a/home/mvp/mvp_db/news7-lv/2001/2001_11_10_19_00/2001_11_10_19_00.mpg;Junichiro KOIZUMI.jpg;4089;4769;35957;204;238;34
/net/per610a/home/mvp/mvp_db/news7-lv/2001/2001_11_10_19_00/2001_11_10_19_00.mpg;Yukio HATOYAMA.jpg;22317;23569;35957;1116;1179;63
/net/per610a/home/mvp/mvp_db/news7-lv/2001/2001_11_11_19_00/2001_11_11_19_00.mpg;Ichiro OZAWA.jpg;20673;21401;23969;1034;1070;36
/net/per610a/home/mvp/mvp_db/news7-lv/2001/2001_11_12_19_00/2001_11_12_19_00.mpg;Junichiro KOIZUMI.jpg;26609;26945;35961;1331;1347;16
/net/per610a/home/mvp/mvp_db/news7-lv/2001/2001_11_12_19_00/2001_11_12_19_00.mpg;Junichiro KOIZUMI.jpg;26949;26957;35961;1348;1348;0
/net/per610a/home/mvp/mvp_db/news7-lv/2001/2001_11_12_19_00/2001_11_12_19_00.mpg;Junichiro KOIZUMI.jpg;30721;31201;35961;1536;1560;24
/net/per610a/home/mvp/mvp_db/news7-lv/2001/2001_11_15_19_00/2001_11_15_19_00.mpg;Junichiro KOIZUMI.jpg;29185;29373;41861;1460;1470;10
/net/per610a/home/mvp/mvp_db/news7-lv/2001/2001_11_16_19_00/2001_11_16_19_00.mpg;Junichiro KOIZUMI.jpg;2717;3093;41869;135;154;19
/net/per610a/home/mvp/mvp_db/news7-lv/2001/2001_11_16_19_00/2001_11_16_19_00.mpg;Junichiro KOIZUMI.jpg;29485;30201;41869;1475;1511;36
/net/per610a/home/mvp/mvp_db/news7-lv/2001/2001_11_16_19_00/2001_11_16_19_00.mpg;Yukio HATOYAMA.jpg;31077;31509;41869;1555;1576;21
/net/per610a/home/mvp/mvp_db/news7-lv/2001/2001_11_17_19_00/2001_11_17_19_00.mpg;Junichiro KOIZUMI.jpg;24801;25941;35957;1240;1297;57
/net/per610a/home/mvp/mvp_db/news7-lv/2001/2001_11_18_19_00/2001_11_18_19_00.mpg;Junichiro KOIZUMI.jpg;7753;8149;23969;387;407;20
/net/per610a/home/mvp/mvp_db/news7-lv/2001/2001_11_18_19_00/2001_11_18_19_00.mpg;Junichiro KOIZUMI.jpg;8473;10309;23969;423;515;92
/net/per610a/home/mvp/mvp_db/news7-lv/2001/2001_11_18_19_00/2001_11_18_19_00.mpg;Yukio HATOYAMA.jpg;8925;9229;23969;446;461;15
/net/per610a/home/mvp/mvp_db/news7-lv/2001/2001_11_19_19_00/2001_11_19_19_00.mpg;Junichiro KOIZUMI.jpg;21677;23169;41861;1084;1159;75
/net/per610a/home/mvp/mvp_db/news7-lv/2001/2001_11_19_19_00/2001_11_19_19_00.mpg;Junichiro KOIZUMI.jpg;26261;27093;41861;1314;1355;41
/net/per610a/home/mvp/mvp_db/news7-lv/2001/2001_11_19_19_00/2001_11_19_19_00.mpg;Junichiro KOIZUMI.jpg;29045;29137;41861;1453;1458;5
/net/per610a/home/mvp/mvp_db/news7-lv/2001/2001_11_19_19_00/2001_11_19_19_00.mpg;Junichiro KOIZUMI.jpg;29265;29333;41861;1464;1468;4
/net/per610a/home/mvp/mvp_db/news7-lv/2001/2001_11_22_19_00/2001_11_22_19_00.mpg;Takenori KANZAKI.jpg;221;309;41869;11;15;4
/net/per610a/home/mvp/mvp_db/news7-lv/2001/2001_11_22_19_00/2001_11_22_19_00.mpg;Junichiro KOIZUMI.jpg;405;441;41869;20;22;2
/net/per610a/home/mvp/mvp_db/news7-lv/2001/2001_11_22_19_00/2001_11_22_19_00.mpg;Junichiro KOIZUMI.jpg;5145;5221;41869;257;261;4
/net/per610a/home/mvp/mvp_db/news7-lv/2001/2001_11_22_19_00/2001_11_22_19_00.mpg;Yasuo FUKUDA.jpg;5321;5329;41869;266;266;0
/net/per610a/home/mvp/mvp_db/news7-lv/2001/2001_11_22_19_00/2001_11_22_19_00.mpg;Yasuo FUKUDA.jpg;32557;32909;41869;1629;1646;17
/net/per610a/home/mvp/mvp_db/news7-lv/2001/2001_11_23_19_00/2001_11_23_19_00.mpg;Naoto KAN.jpg;17649;19205;35889;883;961;78
/net/per610a/home/mvp/mvp_db/news7-lv/2001/2001_11_26_19_00/2001_11_26_19_00.mpg;Yukio HATOYAMA.jpg;21685;21813;41869;1085;1091;6
/net/per610a/home/mvp/mvp_db/news7-lv/2001/2001_11_29_19_00/2001_11_29_19_00.mpg;Junichiro KOIZUMI.jpg;3621;3737;41881;181;187;6
/net/per610a/home/mvp/mvp_db/news7-lv/2001/2001_11_29_19_00/2001_11_29_19_00.mpg;Junichiro KOIZUMI.jpg;7261;7365;41881;363;368;5
/net/per610a/home/mvp/mvp_db/news7-lv/2001/2001_11_29_19_00/2001_11_29_19_00.mpg;Yukio HATOYAMA.jpg;26977;27305;41881;1350;1366;16
/net/per610a/home/mvp/mvp_db/news7-lv/2001/2001_11_30_19_00/2001_11_30_19_00.mpg;Junichiro KOIZUMI.jpg;26025;26345;41861;1302;1318;16
/net/per610a/home/mvp/mvp_db/news7-lv/2001/2001_11_30_19_00/2001_11_30_19_00.mpg;Junichiro KOIZUMI.jpg;32313;32705;41861;1617;1636;19
/net/per610a/home/mvp/mvp_db/news7-lv/2001/2001_12_01_19_00/2001_12_01_19_00.mpg;Junichiro KOIZUMI.jpg;4897;5841;35961;244;292;48
/net/per610a/home/mvp/mvp_db/news7-lv/2001/2001_12_01_19_00/2001_12_01_19_00.mpg;Junichiro KOIZUMI.jpg;7721;8565;35961;386;428;42
/net/per610a/home/mvp/mvp_db/news7-lv/2001/2001_12_01_19_00/2001_12_01_19_00.mpg;Shintaro ISHIHARA.jpg;32849;33705;35961;1643;1686;43
/net/per610a/home/mvp/mvp_db/news7-lv/2001/2001_12_04_19_00/2001_12_04_19_00.mpg;Junichiro KOIZUMI.jpg;21149;21249;41869;1058;1063;5
/net/per610a/home/mvp/mvp_db/news7-lv/2001/2001_12_05_19_00/2001_12_05_19_00.mpg;Junichiro KOIZUMI.jpg;28593;28681;41861;1430;1435;5
/net/per610a/home/mvp/mvp_db/news7-lv/2001/2001_12_06_19_00/2001_12_06_19_00.mpg;Junichiro KOIZUMI.jpg;63073;63577;71921;3156;3181;25
/net/per610a/home/mvp/mvp_db/news7-lv/2001/2001_12_06_19_00/2001_12_06_19_00.mpg;Junichiro KOIZUMI.jpg;63657;64361;71921;3185;3220;35
/net/per610a/home/mvp/mvp_db/news7-lv/2001/2001_12_07_19_00/2001_12_07_19_00.mpg;Junichiro KOIZUMI.jpg;27273;28033;41869;1364;1402;38
/net/per610a/home/mvp/mvp_db/news7-lv/2001/2001_12_07_19_00/2001_12_07_19_00.mpg;Junichiro KOIZUMI.jpg;31461;31785;41869;1574;1590;16
/net/per610a/home/mvp/mvp_db/news7-lv/2001/2001_12_10_19_00/2001_12_10_19_00.mpg;Junichiro KOIZUMI.jpg;15465;15945;41861;773;797;24
/net/per610a/home/mvp/mvp_db/news7-lv/2001/2001_12_10_19_00/2001_12_10_19_00.mpg;Junichiro KOIZUMI.jpg;16525;16601;41861;827;830;3
/net/per610a/home/mvp/mvp_db/news7-lv/2001/2001_12_10_19_00/2001_12_10_19_00.mpg;Junichiro KOIZUMI.jpg;18401;19049;41861;920;953;33
/net/per610a/home/mvp/mvp_db/news7-lv/2001/2001_12_10_19_00/2001_12_10_19_00.mpg;Junichiro KOIZUMI.jpg;21761;21881;41861;1089;1095;6
/net/per610a/home/mvp/mvp_db/news7-lv/2001/2001_12_10_19_00/2001_12_10_19_00.mpg;Junichiro KOIZUMI.jpg;23001;23181;41861;1151;1160;9
/net/per610a/home/mvp/mvp_db/news7-lv/2001/2001_12_10_19_00/2001_12_10_19_00.mpg;Takenori KANZAKI.jpg;21937;22197;41861;1097;1110;13
/net/per610a/home/mvp/mvp_db/news7-lv/2001/2001_12_11_19_00/2001_12_11_19_00.mpg;Junichiro KOIZUMI.jpg;32073;32629;41869;1604;1632;28
/net/per610a/home/mvp/mvp_db/news7-lv/2001/2001_12_11_19_00/2001_12_11_19_00.mpg;Junichiro KOIZUMI.jpg;32993;33009;41869;1650;1651;1
/net/per610a/home/mvp/mvp_db/news7-lv/2001/2001_12_12_19_00/2001_12_12_19_00.mpg;Takeo Hiranuma.jpeg;32401;32661;41881;1621;1634;13
/net/per610a/home/mvp/mvp_db/news7-lv/2001/2001_12_12_19_00/2001_12_12_19_00.mpg;Junichiro KOIZUMI.jpg;32821;33057;41881;1642;1654;12
/net/per610a/home/mvp/mvp_db/news7-lv/2001/2001_12_13_19_00/2001_12_13_19_00.mpg;Junichiro KOIZUMI.jpg;13833;13837;41861;692;692;0
/net/per610a/home/mvp/mvp_db/news7-lv/2001/2001_12_13_19_00/2001_12_13_19_00.mpg;Junichiro KOIZUMI.jpg;33949;34221;41861;1699;1712;13
/net/per610a/home/mvp/mvp_db/news7-lv/2001/2001_12_17_19_00/2001_12_17_19_00.mpg;Junichiro KOIZUMI.jpg;25293;25513;41869;1265;1276;11
/net/per610a/home/mvp/mvp_db/news7-lv/2001/2001_12_18_19_00/2001_12_18_19_00.mpg;Junichiro KOIZUMI.jpg;5869;6101;41869;293;305;12
/net/per610a/home/mvp/mvp_db/news7-lv/2001/2001_12_18_19_00/2001_12_18_19_00.mpg;Junichiro KOIZUMI.jpg;6641;6709;41869;332;335;3
/net/per610a/home/mvp/mvp_db/news7-lv/2001/2001_12_18_19_00/2001_12_18_19_00.mpg;Junichiro KOIZUMI.jpg;11241;11813;41869;562;591;29
/net/per610a/home/mvp/mvp_db/news7-lv/2001/2001_12_18_19_00/2001_12_18_19_00.mpg;Junichiro KOIZUMI.jpg;12397;12449;41869;620;622;2
/net/per610a/home/mvp/mvp_db/news7-lv/2001/2001_12_19_19_00/2001_12_19_19_00.mpg;Junichiro KOIZUMI.jpg;10685;10749;41869;534;537;3
/net/per610a/home/mvp/mvp_db/news7-lv/2001/2001_12_19_19_00/2001_12_19_19_00.mpg;Junichiro KOIZUMI.jpg;10937;10993;41869;547;550;3
/net/per610a/home/mvp/mvp_db/news7-lv/2001/2001_12_19_19_00/2001_12_19_19_00.mpg;Junichiro KOIZUMI.jpg;13433;13457;41869;672;673;1
/net/per610a/home/mvp/mvp_db/news7-lv/2001/2001_12_19_19_00/2001_12_19_19_00.mpg;Junichiro KOIZUMI.jpg;13561;13565;41869;678;678;0
/net/per610a/home/mvp/mvp_db/news7-lv/2001/2001_12_20_19_00/2001_12_20_19_00.mpg;Junichiro KOIZUMI.jpg;445;581;41869;22;29;7
/net/per610a/home/mvp/mvp_db/news7-lv/2001/2001_12_20_19_00/2001_12_20_19_00.mpg;Junichiro KOIZUMI.jpg;9321;9793;41869;466;490;24
/net/per610a/home/mvp/mvp_db/news7-lv/2001/2001_12_20_19_00/2001_12_20_19_00.mpg;Junichiro KOIZUMI.jpg;12921;13577;41869;646;679;33
/net/per610a/home/mvp/mvp_db/news7-lv/2001/2001_12_20_19_00/2001_12_20_19_00.mpg;Takeo Hiranuma.jpeg;29529;29661;41869;1477;1484;7
/net/per610a/home/mvp/mvp_db/news7-lv/2001/2001_12_20_19_00/2001_12_20_19_00.mpg;Takeo Hiranuma.jpeg;29709;29813;41869;1486;1491;5
/net/per610a/home/mvp/mvp_db/news7-lv/2001/2001_12_21_19_00/2001_12_21_19_00.mpg;Takeo Hiranuma.jpeg;2097;2149;35869;104;107;3
/net/per610a/home/mvp/mvp_db/news7-lv/2001/2001_12_21_19_00/2001_12_21_19_00.mpg;Takeo Hiranuma.jpeg;2697;2725;35869;134;136;2
/net/per610a/home/mvp/mvp_db/news7-lv/2001/2001_12_21_19_00/2001_12_21_19_00.mpg;Takeo Hiranuma.jpeg;8505;9397;35869;425;470;45
/net/per610a/home/mvp/mvp_db/news7-lv/2001/2001_12_21_19_00/2001_12_21_19_00.mpg;Takeo Hiranuma.jpeg;12349;12449;35869;617;622;5
/net/per610a/home/mvp/mvp_db/news7-lv/2001/2001_12_21_19_00/2001_12_21_19_00.mpg;Takeo Hiranuma.jpeg;12705;13237;35869;635;662;27
/net/per610a/home/mvp/mvp_db/news7-lv/2001/2001_12_21_19_00/2001_12_21_19_00.mpg;Junichiro KOIZUMI.jpg;4169;4281;35869;208;214;6
/net/per610a/home/mvp/mvp_db/news7-lv/2001/2001_12_22_19_00/2001_12_22_19_00.mpg;Shinzo ABE.jpg;9229;9453;35957;461;472;11
/net/per610a/home/mvp/mvp_db/news7-lv/2001/2001_12_23_19_00/2001_12_23_19_00.mpg;Junichiro KOIZUMI.jpg;20361;21893;23973;1018;1094;76
/net/per610a/home/mvp/mvp_db/news7-lv/2001/2001_12_24_19_00/2001_12_24_19_00.mpg;Junichiro KOIZUMI.jpg;749;837;47861;37;41;4
/net/per610a/home/mvp/mvp_db/news7-lv/2001/2001_12_24_19_00/2001_12_24_19_00.mpg;Junichiro KOIZUMI.jpg;36497;36497;47861;1826;1826;0
/net/per610a/home/mvp/mvp_db/news7-lv/2001/2001_12_24_19_00/2001_12_24_19_00.mpg;Junichiro KOIZUMI.jpg;39301;40129;47861;1966;2008;42
/net/per610a/home/mvp/mvp_db/news7-lv/2001/2001_12_24_19_00/2001_12_24_19_00.mpg;Ichiro OZAWA.jpg;29349;29409;47861;1468;1471;3
/net/per610a/home/mvp/mvp_db/news7-lv/2001/2001_12_24_19_00/2001_12_24_19_00.mpg;Ichiro OZAWA.jpg;30905;31085;47861;1546;1555;9
/net/per610a/home/mvp/mvp_db/news7-lv/2001/2001_12_25_19_00/2001_12_25_19_00.mpg;Takeo Hiranuma.jpeg;15997;16745;35869;800;837;37
/net/per610a/home/mvp/mvp_db/news7-lv/2001/2001_12_25_19_00/2001_12_25_19_00.mpg;Junichiro KOIZUMI.jpg;20449;20537;35869;1023;1027;4
/net/per610a/home/mvp/mvp_db/news7-lv/2001/2001_12_25_19_00/2001_12_25_19_00.mpg;Junichiro KOIZUMI.jpg;21157;21181;35869;1058;1059;1
/net/per610a/home/mvp/mvp_db/news7-lv/2001/2001_12_27_19_00/2001_12_27_19_00.mpg;Junichiro KOIZUMI.jpg;25521;26601;35861;1276;1330;54
/net/per610a/home/mvp/mvp_db/news7-lv/2001/2001_12_27_19_00/2001_12_27_19_00.mpg;Junichiro KOIZUMI.jpg;26665;26985;35861;1333;1349;16
/net/per610a/home/mvp/mvp_db/news7-lv/2001/2001_12_28_19_00/2001_12_28_19_00.mpg;Yasuo FUKUDA.jpg;2597;3009;35869;129;150;21
/net/per610a/home/mvp/mvp_db/news7-lv/2001/2001_12_28_19_00/2001_12_28_19_00.mpg;Junichiro KOIZUMI.jpg;7513;10489;35869;375;524;149
/net/per610a/home/mvp/mvp_db/news7-lv/2001/2001_12_28_19_00/2001_12_28_19_00.mpg;Junichiro KOIZUMI.jpg;11093;11249;35869;555;562;7
/net/per610a/home/mvp/mvp_db/news7-lv/2001/2001_12_28_19_00/2001_12_28_19_00.mpg;Junichiro KOIZUMI.jpg;11389;11461;35869;569;573;4
/net/per610a/home/mvp/mvp_db/news7-lv/2001/2001_12_28_19_00/2001_12_28_19_00.mpg;Junichiro KOIZUMI.jpg;11533;11537;35869;577;577;0
/net/per610a/home/mvp/mvp_db/news7-lv/2001/2001_12_29_19_00/2001_12_29_19_00.mpg;Yukio HATOYAMA.jpg;8661;9413;35957;433;470;37
/net/per610a/home/mvp/mvp_db/news7-lv/2002/2002_01_01_19_00/2002_01_01_19_00.mpg;Junichiro KOIZUMI.jpg;26941;26957;35957;1347;1348;1
/net/per610a/home/mvp/mvp_db/news7-lv/2002/2002_01_01_19_00/2002_01_01_19_00.mpg;Junichiro KOIZUMI.jpg;27201;27529;35957;1360;1377;17
/net/per610a/home/mvp/mvp_db/news7-lv/2002/2002_01_01_19_00/2002_01_01_19_00.mpg;Takenori KANZAKI.jpg;27745;27845;35957;1388;1393;5
/net/per610a/home/mvp/mvp_db/news7-lv/2002/2002_01_02_19_00/2002_01_02_19_00.mpg;Yukio HATOYAMA.jpg;20105;20281;35957;1005;1014;9
/net/per610a/home/mvp/mvp_db/news7-lv/2002/2002_01_02_19_00/2002_01_02_19_00.mpg;Kazuo SHII.jpg;20721;20817;35957;1036;1041;5
/net/per610a/home/mvp/mvp_db/news7-lv/2002/2002_01_04_19_00/2002_01_04_19_00.mpg;Junichiro KOIZUMI.jpg;349;597;35957;17;29;12
/net/per610a/home/mvp/mvp_db/news7-lv/2002/2002_01_04_19_00/2002_01_04_19_00.mpg;Junichiro KOIZUMI.jpg;1681;1977;35957;84;98;14
/net/per610a/home/mvp/mvp_db/news7-lv/2002/2002_01_04_19_00/2002_01_04_19_00.mpg;Junichiro KOIZUMI.jpg;2045;6121;35957;102;306;204
/net/per610a/home/mvp/mvp_db/news7-lv/2002/2002_01_04_19_00/2002_01_04_19_00.mpg;Junichiro KOIZUMI.jpg;6201;6341;35957;310;317;7
/net/per610a/home/mvp/mvp_db/news7-lv/2002/2002_01_04_19_00/2002_01_04_19_00.mpg;Junichiro KOIZUMI.jpg;6665;7025;35957;333;351;18
/net/per610a/home/mvp/mvp_db/news7-lv/2002/2002_01_04_19_00/2002_01_04_19_00.mpg;Junichiro KOIZUMI.jpg;22965;23493;35957;1148;1175;27
/net/per610a/home/mvp/mvp_db/news7-lv/2002/2002_01_05_19_00/2002_01_05_19_00.mpg;Yukio HATOYAMA.jpg;13705;14741;35957;685;737;52
/net/per610a/home/mvp/mvp_db/news7-lv/2002/2002_01_07_19_00/2002_01_07_19_00.mpg;Junichiro KOIZUMI.jpg;23625;24777;35957;1182;1239;57
/net/per610a/home/mvp/mvp_db/news7-lv/2002/2002_01_07_19_00/2002_01_07_19_00.mpg;Junichiro KOIZUMI.jpg;25617;26353;35957;1281;1318;37
/net/per610a/home/mvp/mvp_db/news7-lv/2002/2002_01_08_19_00/2002_01_08_19_00.mpg;Junichiro KOIZUMI.jpg;509;613;35957;25;30;5
/net/per610a/home/mvp/mvp_db/news7-lv/2002/2002_01_08_19_00/2002_01_08_19_00.mpg;Junichiro KOIZUMI.jpg;17493;17537;35957;875;877;2
/net/per610a/home/mvp/mvp_db/news7-lv/2002/2002_01_08_19_00/2002_01_08_19_00.mpg;Takako DOI.jpg;18025;18705;35957;901;935;34
/net/per610a/home/mvp/mvp_db/news7-lv/2002/2002_01_08_19_00/2002_01_08_19_00.mpg;Yasuo FUKUDA.jpg;18817;19133;35957;941;957;16
/net/per610a/home/mvp/mvp_db/news7-lv/2002/2002_01_09_19_00/2002_01_09_19_00.mpg;Junichiro KOIZUMI.jpg;13813;13993;35957;691;700;9
/net/per610a/home/mvp/mvp_db/news7-lv/2002/2002_01_09_19_00/2002_01_09_19_00.mpg;Junichiro KOIZUMI.jpg;14097;16297;35957;705;815;110
/net/per610a/home/mvp/mvp_db/news7-lv/2002/2002_01_09_19_00/2002_01_09_19_00.mpg;Junichiro KOIZUMI.jpg;16449;16569;35957;822;828;6
/net/per610a/home/mvp/mvp_db/news7-lv/2002/2002_01_09_19_00/2002_01_09_19_00.mpg;Junichiro KOIZUMI.jpg;16805;17845;35957;840;892;52
/net/per610a/home/mvp/mvp_db/news7-lv/2002/2002_01_11_19_00/2002_01_11_19_00.mpg;Shinzo ABE.jpg;18977;19001;35957;949;950;1
/net/per610a/home/mvp/mvp_db/news7-lv/2002/2002_01_11_19_00/2002_01_11_19_00.mpg;Shinzo ABE.jpg;19113;19285;35957;956;964;8
/net/per610a/home/mvp/mvp_db/news7-lv/2002/2002_01_11_19_00/2002_01_11_19_00.mpg;Naoto KAN.jpg;19369;19721;35957;969;986;17
/net/per610a/home/mvp/mvp_db/news7-lv/2002/2002_01_14_19_00/2002_01_14_19_00.mpg;Junichiro KOIZUMI.jpg;1141;1485;35957;57;74;17
/net/per610a/home/mvp/mvp_db/news7-lv/2002/2002_01_14_19_00/2002_01_14_19_00.mpg;Junichiro KOIZUMI.jpg;4205;4729;35957;210;236;26
/net/per610a/home/mvp/mvp_db/news7-lv/2002/2002_01_14_19_00/2002_01_14_19_00.mpg;Junichiro KOIZUMI.jpg;4813;5625;35957;240;281;41
/net/per610a/home/mvp/mvp_db/news7-lv/2002/2002_01_14_19_00/2002_01_14_19_00.mpg;Junichiro KOIZUMI.jpg;5697;6757;35957;285;338;53
/net/per610a/home/mvp/mvp_db/news7-lv/2002/2002_01_14_19_00/2002_01_14_19_00.mpg;Junichiro KOIZUMI.jpg;6965;8205;35957;348;410;62
/net/per610a/home/mvp/mvp_db/news7-lv/2002/2002_01_14_19_00/2002_01_14_19_00.mpg;Junichiro KOIZUMI.jpg;8621;9033;35957;431;451;20
/net/per610a/home/mvp/mvp_db/news7-lv/2002/2002_01_15_19_00/2002_01_15_19_00.mpg;Yasuo FUKUDA.jpg;10349;10817;35957;517;541;24
/net/per610a/home/mvp/mvp_db/news7-lv/2002/2002_01_15_19_00/2002_01_15_19_00.mpg;Junichiro KOIZUMI.jpg;18017;18217;35957;901;911;10
/net/per610a/home/mvp/mvp_db/news7-lv/2002/2002_01_15_19_00/2002_01_15_19_00.mpg;Junichiro KOIZUMI.jpg;18417;18477;35957;921;924;3
/net/per610a/home/mvp/mvp_db/news7-lv/2002/2002_01_17_19_00/2002_01_17_19_00.mpg;Yasuo FUKUDA.jpg;20729;21209;35957;1037;1061;24
/net/per610a/home/mvp/mvp_db/news7-lv/2002/2002_01_17_19_00/2002_01_17_19_00.mpg;Yasuo FUKUDA.jpg;21289;21429;35957;1065;1072;7
/net/per610a/home/mvp/mvp_db/news7-lv/2002/2002_01_17_19_00/2002_01_17_19_00.mpg;Junichiro KOIZUMI.jpg;25265;25337;35957;1264;1267;3
/net/per610a/home/mvp/mvp_db/news7-lv/2002/2002_01_17_19_00/2002_01_17_19_00.mpg;Junichiro KOIZUMI.jpg;25437;25881;35957;1272;1294;22
/net/per610a/home/mvp/mvp_db/news7-lv/2002/2002_01_21_19_00/2002_01_21_19_00.mpg;Junichiro KOIZUMI.jpg;6525;6541;35957;326;327;1
/net/per610a/home/mvp/mvp_db/news7-lv/2002/2002_01_21_19_00/2002_01_21_19_00.mpg;Junichiro KOIZUMI.jpg;6645;6665;35957;332;333;1
/net/per610a/home/mvp/mvp_db/news7-lv/2002/2002_01_21_19_00/2002_01_21_19_00.mpg;Junichiro KOIZUMI.jpg;6753;6769;35957;337;338;1
/net/per610a/home/mvp/mvp_db/news7-lv/2002/2002_01_21_19_00/2002_01_21_19_00.mpg;Junichiro KOIZUMI.jpg;10685;10697;35957;534;535;1
/net/per610a/home/mvp/mvp_db/news7-lv/2002/2002_01_21_19_00/2002_01_21_19_00.mpg;Junichiro KOIZUMI.jpg;16645;16665;35957;832;833;1
/net/per610a/home/mvp/mvp_db/news7-lv/2002/2002_01_21_19_00/2002_01_21_19_00.mpg;Junichiro KOIZUMI.jpg;16897;17105;35957;845;855;10
/net/per610a/home/mvp/mvp_db/news7-lv/2002/2002_01_21_19_00/2002_01_21_19_00.mpg;Junichiro KOIZUMI.jpg;18393;18445;35957;920;922;2
/net/per610a/home/mvp/mvp_db/news7-lv/2002/2002_01_21_19_00/2002_01_21_19_00.mpg;Junichiro KOIZUMI.jpg;21545;22421;35957;1077;1121;44
/net/per610a/home/mvp/mvp_db/news7-lv/2002/2002_01_22_19_00/2002_01_22_19_00.mpg;Junichiro KOIZUMI.jpg;6049;6509;35957;302;325;23
/net/per610a/home/mvp/mvp_db/news7-lv/2002/2002_01_22_19_00/2002_01_22_19_00.mpg;Junichiro KOIZUMI.jpg;24417;24481;35957;1221;1224;3
/net/per610a/home/mvp/mvp_db/news7-lv/2002/2002_01_23_19_00/2002_01_23_19_00.mpg;Yasuo FUKUDA.jpg;4433;4905;35957;221;245;24
/net/per610a/home/mvp/mvp_db/news7-lv/2002/2002_01_23_19_00/2002_01_23_19_00.mpg;Junichiro KOIZUMI.jpg;15997;16097;35957;800;805;5
/net/per610a/home/mvp/mvp_db/news7-lv/2002/2002_01_24_19_00/2002_01_24_19_00.mpg;Junichiro KOIZUMI.jpg;661;889;35957;33;44;11
/net/per610a/home/mvp/mvp_db/news7-lv/2002/2002_01_24_19_00/2002_01_24_19_00.mpg;Junichiro KOIZUMI.jpg;7809;7889;35957;390;394;4
/net/per610a/home/mvp/mvp_db/news7-lv/2002/2002_01_24_19_00/2002_01_24_19_00.mpg;Junichiro KOIZUMI.jpg;10353;10705;35957;517;535;18
/net/per610a/home/mvp/mvp_db/news7-lv/2002/2002_01_25_19_00/2002_01_25_19_00.mpg;Yasuo FUKUDA.jpg;7037;7401;35957;352;370;18
/net/per610a/home/mvp/mvp_db/news7-lv/2002/2002_01_25_19_00/2002_01_25_19_00.mpg;Yasuo FUKUDA.jpg;7477;8789;35957;374;439;65
/net/per610a/home/mvp/mvp_db/news7-lv/2002/2002_01_25_19_00/2002_01_25_19_00.mpg;YUriko Koike.jpg;19293;19397;35957;965;970;5
/net/per610a/home/mvp/mvp_db/news7-lv/2002/2002_01_26_19_00/2002_01_26_19_00.mpg;Yukio HATOYAMA.jpg;14533;16429;35957;727;821;94
/net/per610a/home/mvp/mvp_db/news7-lv/2002/2002_01_27_19_00/2002_01_27_19_00.mpg;Takenori KANZAKI.jpg;13189;15081;23973;659;754;95
/net/per610a/home/mvp/mvp_db/news7-lv/2002/2002_01_29_19_00/2002_01_29_19_00.mpg;Ichiro OZAWA.jpg;3785;4373;35957;189;218;29
/net/per610a/home/mvp/mvp_db/news7-lv/2002/2002_01_29_19_00/2002_01_29_19_00.mpg;Yukio HATOYAMA.jpg;5057;5561;35957;253;278;25
/net/per610a/home/mvp/mvp_db/news7-lv/2002/2002_01_29_19_00/2002_01_29_19_00.mpg;Yukio HATOYAMA.jpg;19145;20733;35957;957;1037;80
/net/per610a/home/mvp/mvp_db/news7-lv/2002/2002_01_29_19_00/2002_01_29_19_00.mpg;Yasuo FUKUDA.jpg;14433;15017;35957;722;751;29
/net/per610a/home/mvp/mvp_db/news7-lv/2002/2002_01_29_19_00/2002_01_29_19_00.mpg;Yukio HATOYAMA.jpg;16649;16861;35957;832;843;11
/net/per610a/home/mvp/mvp_db/news7-lv/2002/2002_01_29_19_00/2002_01_29_19_00.mpg;Sadakazu TANIGAKI.jpg;18505;18617;35957;925;931;6
/net/per610a/home/mvp/mvp_db/news7-lv/2002/2002_01_30_19_00/2002_01_30_19_00.mpg;Junichiro KOIZUMI.jpg;429;701;35957;21;35;14
/net/per610a/home/mvp/mvp_db/news7-lv/2002/2002_01_30_19_00/2002_01_30_19_00.mpg;Junichiro KOIZUMI.jpg;9857;9897;35957;493;495;2
/net/per610a/home/mvp/mvp_db/news7-lv/2002/2002_01_30_19_00/2002_01_30_19_00.mpg;Junichiro KOIZUMI.jpg;14873;15453;35957;744;773;29
/net/per610a/home/mvp/mvp_db/news7-lv/2002/2002_01_30_19_00/2002_01_30_19_00.mpg;Junichiro KOIZUMI.jpg;15681;15993;35957;784;800;16
/net/per610a/home/mvp/mvp_db/news7-lv/2002/2002_01_30_19_00/2002_01_30_19_00.mpg;Junichiro KOIZUMI.jpg;16189;16629;35957;809;831;22
/net/per610a/home/mvp/mvp_db/news7-lv/2002/2002_01_30_19_00/2002_01_30_19_00.mpg;Junichiro KOIZUMI.jpg;2541;2573;35957;127;128;1
/net/per610a/home/mvp/mvp_db/news7-lv/2002/2002_01_30_19_00/2002_01_30_19_00.mpg;Junichiro KOIZUMI.jpg;9741;9841;35957;487;492;5
/net/per610a/home/mvp/mvp_db/news7-lv/2002/2002_01_31_19_00/2002_01_31_19_00.mpg;Yasuo FUKUDA.jpg;397;573;35957;19;28;9
/net/per610a/home/mvp/mvp_db/news7-lv/2002/2002_01_31_19_00/2002_01_31_19_00.mpg;Yasuo FUKUDA.jpg;3049;3481;35957;152;174;22
/net/per610a/home/mvp/mvp_db/news7-lv/2002/2002_01_31_19_00/2002_01_31_19_00.mpg;Yasuo FUKUDA.jpg;3549;3905;35957;177;195;18
/net/per610a/home/mvp/mvp_db/news7-lv/2002/2002_01_31_19_00/2002_01_31_19_00.mpg;Yasuo FUKUDA.jpg;3969;4393;35957;198;219;21
/net/per610a/home/mvp/mvp_db/news7-lv/2002/2002_01_31_19_00/2002_01_31_19_00.mpg;Junichiro KOIZUMI.jpg;2557;3045;35957;127;152;25
/net/per610a/home/mvp/mvp_db/news7-lv/2002/2002_01_31_19_00/2002_01_31_19_00.mpg;Toranosuke Katayama.jpg;4397;4973;35957;219;248;29
/net/per610a/home/mvp/mvp_db/news7-lv/2002/2002_01_31_19_00/2002_01_31_19_00.mpg;Katsuya OKADA.jpg;7577;9197;35957;379;460;81
/net/per610a/home/mvp/mvp_db/news7-lv/2002/2002_02_01_19_00/2002_02_01_19_00.mpg;Junichiro KOIZUMI.jpg;2293;3725;35957;114;186;72
/net/per610a/home/mvp/mvp_db/news7-lv/2002/2002_02_01_19_00/2002_02_01_19_00.mpg;Junichiro KOIZUMI.jpg;8053;8385;35957;402;419;17
/net/per610a/home/mvp/mvp_db/news7-lv/2002/2002_02_01_19_00/2002_02_01_19_00.mpg;Junichiro KOIZUMI.jpg;12989;13373;35957;649;669;20
/net/per610a/home/mvp/mvp_db/news7-lv/2002/2002_02_01_19_00/2002_02_01_19_00.mpg;Junichiro KOIZUMI.jpg;18029;18185;35957;902;909;7
/net/per610a/home/mvp/mvp_db/news7-lv/2002/2002_02_01_19_00/2002_02_01_19_00.mpg;Junichiro KOIZUMI.jpg;34757;35185;35957;1738;1760;22
/net/per610a/home/mvp/mvp_db/news7-lv/2002/2002_02_01_19_00/2002_02_01_19_00.mpg;Yasuo FUKUDA.jpg;8625;9025;35957;431;451;20
/net/per610a/home/mvp/mvp_db/news7-lv/2002/2002_02_01_19_00/2002_02_01_19_00.mpg;Yasuo FUKUDA.jpg;9749;10033;35957;487;501;14
/net/per610a/home/mvp/mvp_db/news7-lv/2002/2002_02_01_19_00/2002_02_01_19_00.mpg;Yasuo FUKUDA.jpg;11137;12081;35957;557;604;47
/net/per610a/home/mvp/mvp_db/news7-lv/2002/2002_02_01_19_00/2002_02_01_19_00.mpg;Kazuo SHII.jpg;13397;14989;35957;670;749;79
/net/per610a/home/mvp/mvp_db/news7-lv/2002/2002_02_01_19_00/2002_02_01_19_00.mpg;Junichiro KOIZUMI.jpg;14925;15049;35957;746;752;6
/net/per610a/home/mvp/mvp_db/news7-lv/2002/2002_02_02_19_00/2002_02_02_19_00.mpg;Yasuo FUKUDA.jpg;3729;3809;35957;186;190;4
/net/per610a/home/mvp/mvp_db/news7-lv/2002/2002_02_02_19_00/2002_02_02_19_00.mpg;Junichiro KOIZUMI.jpg;30377;31229;35957;1519;1562;43
/net/per610a/home/mvp/mvp_db/news7-lv/2002/2002_02_03_19_00/2002_02_03_19_00.mpg;Naoto KAN.jpg;8697;9261;23969;435;463;28
/net/per610a/home/mvp/mvp_db/news7-lv/2002/2002_02_04_19_00/2002_02_04_19_00.mpg;Junichiro KOIZUMI.jpg;5777;6057;35957;289;303;14
/net/per610a/home/mvp/mvp_db/news7-lv/2002/2002_02_04_19_00/2002_02_04_19_00.mpg;Junichiro KOIZUMI.jpg;10201;10925;35957;510;546;36
/net/per610a/home/mvp/mvp_db/news7-lv/2002/2002_02_04_19_00/2002_02_04_19_00.mpg;Yasuo FUKUDA.jpg;12017;12909;35957;601;645;44
/net/per610a/home/mvp/mvp_db/news7-lv/2002/2002_02_04_19_00/2002_02_04_19_00.mpg;Yasuo FUKUDA.jpg;27353;27457;35957;1368;1373;5
/net/per610a/home/mvp/mvp_db/news7-lv/2002/2002_02_05_19_00/2002_02_05_19_00.mpg;Junichiro KOIZUMI.jpg;8537;8553;35957;427;427;0
/net/per610a/home/mvp/mvp_db/news7-lv/2002/2002_02_05_19_00/2002_02_05_19_00.mpg;Junichiro KOIZUMI.jpg;20889;22213;35957;1045;1111;66
/net/per610a/home/mvp/mvp_db/news7-lv/2002/2002_02_06_19_00/2002_02_06_19_00.mpg;Junichiro KOIZUMI.jpg;2221;2553;35957;111;127;16
/net/per610a/home/mvp/mvp_db/news7-lv/2002/2002_02_06_19_00/2002_02_06_19_00.mpg;Junichiro KOIZUMI.jpg;6389;7221;35957;319;361;42
/net/per610a/home/mvp/mvp_db/news7-lv/2002/2002_02_06_19_00/2002_02_06_19_00.mpg;Takenori KANZAKI.jpg;5649;6341;35957;282;317;35
/net/per610a/home/mvp/mvp_db/news7-lv/2002/2002_02_06_19_00/2002_02_06_19_00.mpg;Takenori KANZAKI.jpg;23177;23789;35957;1159;1190;31
/net/per610a/home/mvp/mvp_db/news7-lv/2002/2002_02_07_19_00/2002_02_07_19_00.mpg;Junichiro KOIZUMI.jpg;7265;7709;35957;363;385;22
/net/per610a/home/mvp/mvp_db/news7-lv/2002/2002_02_07_19_00/2002_02_07_19_00.mpg;Junichiro KOIZUMI.jpg;8321;8737;35957;416;437;21
/net/per610a/home/mvp/mvp_db/news7-lv/2002/2002_02_07_19_00/2002_02_07_19_00.mpg;Junichiro KOIZUMI.jpg;10321;10685;35957;516;534;18
/net/per610a/home/mvp/mvp_db/news7-lv/2002/2002_02_08_19_00/2002_02_08_19_00.mpg;Junichiro KOIZUMI.jpg;24841;25225;35957;1242;1262;20
/net/per610a/home/mvp/mvp_db/news7-lv/2002/2002_02_09_19_00/2002_02_09_19_00.mpg;Yukio HATOYAMA.jpg;22253;23077;35957;1113;1154;41
/net/per610a/home/mvp/mvp_db/news7-lv/2002/2002_02_11_19_00/2002_02_11_19_00.mpg;Junichiro KOIZUMI.jpg;1041;1317;35957;52;65;13
/net/per610a/home/mvp/mvp_db/news7-lv/2002/2002_02_11_19_00/2002_02_11_19_00.mpg;Junichiro KOIZUMI.jpg;5549;5641;35957;277;282;5
/net/per610a/home/mvp/mvp_db/news7-lv/2002/2002_02_11_19_00/2002_02_11_19_00.mpg;Junichiro KOIZUMI.jpg;5709;5725;35957;285;286;1
/net/per610a/home/mvp/mvp_db/news7-lv/2002/2002_02_11_19_00/2002_02_11_19_00.mpg;Junichiro KOIZUMI.jpg;15765;15777;35957;788;789;1
/net/per610a/home/mvp/mvp_db/news7-lv/2002/2002_02_11_19_00/2002_02_11_19_00.mpg;Junichiro KOIZUMI.jpg;15933;16737;35957;797;837;40
/net/per610a/home/mvp/mvp_db/news7-lv/2002/2002_02_12_19_00/2002_02_12_19_00.mpg;Junichiro KOIZUMI.jpg;5869;6209;35957;293;310;17
/net/per610a/home/mvp/mvp_db/news7-lv/2002/2002_02_12_19_00/2002_02_12_19_00.mpg;Junichiro KOIZUMI.jpg;7229;7773;35957;361;388;27
/net/per610a/home/mvp/mvp_db/news7-lv/2002/2002_02_12_19_00/2002_02_12_19_00.mpg;Junichiro KOIZUMI.jpg;7837;8141;35957;392;407;15
/net/per610a/home/mvp/mvp_db/news7-lv/2002/2002_02_12_19_00/2002_02_12_19_00.mpg;Takeo Hiranuma.jpeg;6429;6961;35957;321;348;27
/net/per610a/home/mvp/mvp_db/news7-lv/2002/2002_02_12_19_00/2002_02_12_19_00.mpg;Takenori KANZAKI.jpg;22269;22465;35957;1114;1123;9
/net/per610a/home/mvp/mvp_db/news7-lv/2002/2002_02_13_19_00/2002_02_13_19_00.mpg;Junichiro KOIZUMI.jpg;15641;15717;35957;782;786;4
/net/per610a/home/mvp/mvp_db/news7-lv/2002/2002_02_13_19_00/2002_02_13_19_00.mpg;Junichiro KOIZUMI.jpg;15849;15849;35957;792;792;0
/net/per610a/home/mvp/mvp_db/news7-lv/2002/2002_02_13_19_00/2002_02_13_19_00.mpg;Junichiro KOIZUMI.jpg;16333;16725;35957;817;836;19
/net/per610a/home/mvp/mvp_db/news7-lv/2002/2002_02_13_19_00/2002_02_13_19_00.mpg;Junichiro KOIZUMI.jpg;17977;18945;35957;899;947;48
/net/per610a/home/mvp/mvp_db/news7-lv/2002/2002_02_13_19_00/2002_02_13_19_00.mpg;Junichiro KOIZUMI.jpg;20625;20797;35957;1031;1040;9
/net/per610a/home/mvp/mvp_db/news7-lv/2002/2002_02_13_19_00/2002_02_13_19_00.mpg;Junichiro KOIZUMI.jpg;20925;21113;35957;1046;1056;10
/net/per610a/home/mvp/mvp_db/news7-lv/2002/2002_02_17_19_00/2002_02_17_19_00.mpg;Junichiro KOIZUMI.jpg;3113;4037;23969;155;201;46
/net/per610a/home/mvp/mvp_db/news7-lv/2002/2002_02_18_19_00/2002_02_18_19_00.mpg;Junichiro KOIZUMI.jpg;2089;2841;35957;104;142;38
/net/per610a/home/mvp/mvp_db/news7-lv/2002/2002_02_18_19_00/2002_02_18_19_00.mpg;Junichiro KOIZUMI.jpg;4269;4661;35957;213;233;20
/net/per610a/home/mvp/mvp_db/news7-lv/2002/2002_02_18_19_00/2002_02_18_19_00.mpg;Junichiro KOIZUMI.jpg;4949;5877;35957;247;294;47
/net/per610a/home/mvp/mvp_db/news7-lv/2002/2002_02_18_19_00/2002_02_18_19_00.mpg;Junichiro KOIZUMI.jpg;15785;16641;35957;789;832;43
/net/per610a/home/mvp/mvp_db/news7-lv/2002/2002_02_18_19_00/2002_02_18_19_00.mpg;Junichiro KOIZUMI.jpg;34641;34741;35957;1733;1738;5
/net/per610a/home/mvp/mvp_db/news7-lv/2002/2002_02_19_19_00/2002_02_19_19_00.mpg;Junichiro KOIZUMI.jpg;3349;3453;35957;167;172;5
/net/per610a/home/mvp/mvp_db/news7-lv/2002/2002_02_19_19_00/2002_02_19_19_00.mpg;Junichiro KOIZUMI.jpg;11153;11185;35957;558;559;1
/net/per610a/home/mvp/mvp_db/news7-lv/2002/2002_02_19_19_00/2002_02_19_19_00.mpg;Junichiro KOIZUMI.jpg;11253;11353;35957;563;568;5
/net/per610a/home/mvp/mvp_db/news7-lv/2002/2002_02_19_19_00/2002_02_19_19_00.mpg;Yukio HATOYAMA.jpg;7873;9813;35957;393;490;97
/net/per610a/home/mvp/mvp_db/news7-lv/2002/2002_02_19_19_00/2002_02_19_19_00.mpg;Yukio HATOYAMA.jpg;9957;10229;35957;498;511;13
/net/per610a/home/mvp/mvp_db/news7-lv/2002/2002_02_19_19_00/2002_02_19_19_00.mpg;Yukio HATOYAMA.jpg;11413;11877;35957;571;594;23
/net/per610a/home/mvp/mvp_db/news7-lv/2002/2002_02_20_19_00/2002_02_20_19_00.mpg;Junichiro KOIZUMI.jpg;11357;12805;35961;568;640;72
/net/per610a/home/mvp/mvp_db/news7-lv/2002/2002_02_20_19_00/2002_02_20_19_00.mpg;Yukio HATOYAMA.jpg;17001;19145;35961;850;957;107
/net/per610a/home/mvp/mvp_db/news7-lv/2002/2002_02_21_19_00/2002_02_21_19_00.mpg;Yasuo FUKUDA.jpg;13181;14173;35957;659;709;50
/net/per610a/home/mvp/mvp_db/news7-lv/2002/2002_02_22_19_00/2002_02_22_19_00.mpg;Junichiro KOIZUMI.jpg;1601;1609;35961;80;80;0
/net/per610a/home/mvp/mvp_db/news7-lv/2002/2002_02_22_19_00/2002_02_22_19_00.mpg;Junichiro KOIZUMI.jpg;5137;5261;35961;256;263;7
/net/per610a/home/mvp/mvp_db/news7-lv/2002/2002_02_22_19_00/2002_02_22_19_00.mpg;Junichiro KOIZUMI.jpg;5345;5393;35961;267;269;2
/net/per610a/home/mvp/mvp_db/news7-lv/2002/2002_02_22_19_00/2002_02_22_19_00.mpg;Junichiro KOIZUMI.jpg;8385;9125;35961;419;456;37
/net/per610a/home/mvp/mvp_db/news7-lv/2002/2002_02_22_19_00/2002_02_22_19_00.mpg;Yukio HATOYAMA.jpg;11249;13009;35961;562;650;88
/net/per610a/home/mvp/mvp_db/news7-lv/2002/2002_02_24_19_00/2002_02_24_19_00.mpg;Naoto KAN.jpg;3713;5309;23969;185;265;80
/net/per610a/home/mvp/mvp_db/news7-lv/2002/2002_02_24_19_00/2002_02_24_19_00.mpg;Kazuo SHII.jpg;3981;4301;23969;199;215;16
/net/per610a/home/mvp/mvp_db/news7-lv/2002/2002_02_27_19_00/2002_02_27_19_00.mpg;Ichiro OZAWA.jpg;421;701;35957;21;35;14
/net/per610a/home/mvp/mvp_db/news7-lv/2002/2002_02_27_19_00/2002_02_27_19_00.mpg;Ichiro OZAWA.jpg;5397;5405;35957;270;270;0
/net/per610a/home/mvp/mvp_db/news7-lv/2002/2002_02_27_19_00/2002_02_27_19_00.mpg;Yukio HATOYAMA.jpg;5033;5317;35957;251;266;15
/net/per610a/home/mvp/mvp_db/news7-lv/2002/2002_02_27_19_00/2002_02_27_19_00.mpg;Yukio HATOYAMA.jpg;5529;6057;35957;276;303;27
/net/per610a/home/mvp/mvp_db/news7-lv/2002/2002_02_27_19_00/2002_02_27_19_00.mpg;Yukio HATOYAMA.jpg;6125;7533;35957;306;376;70
/net/per610a/home/mvp/mvp_db/news7-lv/2002/2002_02_27_19_00/2002_02_27_19_00.mpg;Shintaro ISHIHARA.jpg;10613;10749;35957;530;537;7
/net/per610a/home/mvp/mvp_db/news7-lv/2002/2002_02_28_19_00/2002_02_28_19_00.mpg;Yukio HATOYAMA.jpg;3165;4465;35957;158;223;65
/net/per610a/home/mvp/mvp_db/news7-lv/2002/2002_03_01_19_00/2002_03_01_19_00.mpg;Naoto KAN.jpg;2909;3809;35957;145;190;45
/net/per610a/home/mvp/mvp_db/news7-lv/2002/2002_03_01_19_00/2002_03_01_19_00.mpg;Junichiro KOIZUMI.jpg;16517;16621;35957;826;831;5
/net/per610a/home/mvp/mvp_db/news7-lv/2002/2002_03_04_19_00/2002_03_04_19_00.mpg;Yasuo FUKUDA.jpg;7185;8089;35957;359;404;45
/net/per610a/home/mvp/mvp_db/news7-lv/2002/2002_03_05_19_00/2002_03_05_19_00.mpg;Yasuo FUKUDA.jpg;24089;24901;35957;1205;1245;40
/net/per610a/home/mvp/mvp_db/news7-lv/2002/2002_03_06_19_00/2002_03_06_19_00.mpg;Junichiro KOIZUMI.jpg;4257;4961;35957;212;248;36
/net/per610a/home/mvp/mvp_db/news7-lv/2002/2002_03_06_19_00/2002_03_06_19_00.mpg;Takenori KANZAKI.jpg;7441;8669;35957;372;433;61
/net/per610a/home/mvp/mvp_db/news7-lv/2002/2002_03_07_19_00/2002_03_07_19_00.mpg;Junichiro KOIZUMI.jpg;3389;3669;35957;169;183;14
/net/per610a/home/mvp/mvp_db/news7-lv/2002/2002_03_07_19_00/2002_03_07_19_00.mpg;Masashi Nakano.jpg;23781;23933;35957;1189;1197;8
/net/per610a/home/mvp/mvp_db/news7-lv/2002/2002_03_07_19_00/2002_03_07_19_00.mpg;Masashi Nakano.jpg;24025;25321;35957;1202;1266;64
/net/per610a/home/mvp/mvp_db/news7-lv/2002/2002_03_08_19_00/2002_03_08_19_00.mpg;Yasuo FUKUDA.jpg;8629;9521;35957;431;476;45
/net/per610a/home/mvp/mvp_db/news7-lv/2002/2002_03_08_19_00/2002_03_08_19_00.mpg;Yukio HATOYAMA.jpg;10269;10921;35957;513;546;33
/net/per610a/home/mvp/mvp_db/news7-lv/2002/2002_03_08_19_00/2002_03_08_19_00.mpg;Junichiro KOIZUMI.jpg;19665;19997;35957;983;1000;17
/net/per610a/home/mvp/mvp_db/news7-lv/2002/2002_03_11_19_00/2002_03_11_19_00.mpg;Junichiro KOIZUMI.jpg;26069;26225;35961;1304;1311;7
/net/per610a/home/mvp/mvp_db/news7-lv/2002/2002_03_11_19_00/2002_03_11_19_00.mpg;Junichiro KOIZUMI.jpg;27425;27589;35961;1371;1380;9
/net/per610a/home/mvp/mvp_db/news7-lv/2002/2002_03_11_19_00/2002_03_11_19_00.mpg;Junichiro KOIZUMI.jpg;31101;31217;35961;1555;1561;6
/net/per610a/home/mvp/mvp_db/news7-lv/2002/2002_03_11_19_00/2002_03_11_19_00.mpg;Junichiro KOIZUMI.jpg;33245;33269;35961;1663;1664;1
/net/per610a/home/mvp/mvp_db/news7-lv/2002/2002_03_11_19_00/2002_03_11_19_00.mpg;Junichiro KOIZUMI.jpg;28265;28377;35961;1413;1419;6
/net/per610a/home/mvp/mvp_db/news7-lv/2002/2002_03_11_19_00/2002_03_11_19_00.mpg;Junichiro KOIZUMI.jpg;33913;34029;35961;1696;1702;6
/net/per610a/home/mvp/mvp_db/news7-lv/2002/2002_03_12_19_00/2002_03_12_19_00.mpg;Junichiro KOIZUMI.jpg;4581;5045;35957;229;252;23
/net/per610a/home/mvp/mvp_db/news7-lv/2002/2002_03_12_19_00/2002_03_12_19_00.mpg;Yasuo FUKUDA.jpg;25921;26513;35957;1296;1326;30
/net/per610a/home/mvp/mvp_db/news7-lv/2002/2002_03_14_19_00/2002_03_14_19_00.mpg;Yukio HATOYAMA.jpg;13585;13917;35957;679;696;17
/net/per610a/home/mvp/mvp_db/news7-lv/2002/2002_03_15_19_00/2002_03_15_19_00.mpg;Junichiro KOIZUMI.jpg;485;925;35957;24;46;22
/net/per610a/home/mvp/mvp_db/news7-lv/2002/2002_03_15_19_00/2002_03_15_19_00.mpg;Junichiro KOIZUMI.jpg;7181;10457;35957;359;523;164
/net/per610a/home/mvp/mvp_db/news7-lv/2002/2002_03_15_19_00/2002_03_15_19_00.mpg;Junichiro KOIZUMI.jpg;17757;17881;35957;888;894;6
/net/per610a/home/mvp/mvp_db/news7-lv/2002/2002_03_15_19_00/2002_03_15_19_00.mpg;Yasuo FUKUDA.jpg;18297;18421;35957;915;921;6
/net/per610a/home/mvp/mvp_db/news7-lv/2002/2002_03_18_19_00/2002_03_18_19_00.mpg;Yukio HATOYAMA.jpg;8001;9909;35957;400;495;95
/net/per610a/home/mvp/mvp_db/news7-lv/2002/2002_03_19_19_00/2002_03_19_19_00.mpg;Ichiro OZAWA.jpg;501;625;35957;25;31;6
/net/per610a/home/mvp/mvp_db/news7-lv/2002/2002_03_19_19_00/2002_03_19_19_00.mpg;Ichiro OZAWA.jpg;11889;12181;35957;594;609;15
/net/per610a/home/mvp/mvp_db/news7-lv/2002/2002_03_19_19_00/2002_03_19_19_00.mpg;Junichiro KOIZUMI.jpg;3533;3809;35957;176;190;14
/net/per610a/home/mvp/mvp_db/news7-lv/2002/2002_03_19_19_00/2002_03_19_19_00.mpg;Junichiro KOIZUMI.jpg;17921;18557;35957;896;928;32
/net/per610a/home/mvp/mvp_db/news7-lv/2002/2002_03_20_19_00/2002_03_20_19_00.mpg;Yukio HATOYAMA.jpg;3713;6105;35957;185;305;120
/net/per610a/home/mvp/mvp_db/news7-lv/2002/2002_03_20_19_00/2002_03_20_19_00.mpg;Takeo Hiranuma.jpeg;12849;13989;35957;642;699;57
/net/per610a/home/mvp/mvp_db/news7-lv/2002/2002_03_20_19_00/2002_03_20_19_00.mpg;Shinzo ABE.jpg;14133;14565;35957;707;728;21
/net/per610a/home/mvp/mvp_db/news7-lv/2002/2002_03_20_19_00/2002_03_20_19_00.mpg;Yasuo FUKUDA.jpg;17229;17957;35957;862;898;36
/net/per610a/home/mvp/mvp_db/news7-lv/2002/2002_03_21_19_00/2002_03_21_19_00.mpg;Junichiro KOIZUMI.jpg;2885;3201;35961;144;160;16
/net/per610a/home/mvp/mvp_db/news7-lv/2002/2002_03_21_19_00/2002_03_21_19_00.mpg;Junichiro KOIZUMI.jpg;4077;4153;35961;203;207;4
/net/per610a/home/mvp/mvp_db/news7-lv/2002/2002_03_21_19_00/2002_03_21_19_00.mpg;Junichiro KOIZUMI.jpg;4981;5033;35961;249;251;2
/net/per610a/home/mvp/mvp_db/news7-lv/2002/2002_03_21_19_00/2002_03_21_19_00.mpg;Junichiro KOIZUMI.jpg;34561;35065;35961;1728;1754;26
/net/per610a/home/mvp/mvp_db/news7-lv/2002/2002_03_21_19_00/2002_03_21_19_00.mpg;Kazuo SHII.jpg;7401;8401;35961;370;420;50
/net/per610a/home/mvp/mvp_db/news7-lv/2002/2002_03_21_19_00/2002_03_21_19_00.mpg;Kazuo SHII.jpg;8465;8929;35961;423;446;23
/net/per610a/home/mvp/mvp_db/news7-lv/2002/2002_03_23_19_00/2002_03_23_19_00.mpg;Shinzo ABE.jpg;721;1941;35957;36;97;61
/net/per610a/home/mvp/mvp_db/news7-lv/2002/2002_03_23_19_00/2002_03_23_19_00.mpg;Shinzo ABE.jpg;3661;4045;35957;183;202;19
/net/per610a/home/mvp/mvp_db/news7-lv/2002/2002_03_23_19_00/2002_03_23_19_00.mpg;Junichiro KOIZUMI.jpg;3661;4185;35957;183;209;26
/net/per610a/home/mvp/mvp_db/news7-lv/2002/2002_03_23_19_00/2002_03_23_19_00.mpg;Junichiro KOIZUMI.jpg;4273;4345;35957;213;217;4
/net/per610a/home/mvp/mvp_db/news7-lv/2002/2002_03_23_19_00/2002_03_23_19_00.mpg;Junichiro KOIZUMI.jpg;4957;5009;35957;248;250;2
/net/per610a/home/mvp/mvp_db/news7-lv/2002/2002_03_23_19_00/2002_03_23_19_00.mpg;Junichiro KOIZUMI.jpg;5909;5989;35957;295;299;4
/net/per610a/home/mvp/mvp_db/news7-lv/2002/2002_03_23_19_00/2002_03_23_19_00.mpg;Junichiro KOIZUMI.jpg;6085;6345;35957;304;317;13
/net/per610a/home/mvp/mvp_db/news7-lv/2002/2002_03_23_19_00/2002_03_23_19_00.mpg;Junichiro KOIZUMI.jpg;6549;7421;35957;327;371;44
/net/per610a/home/mvp/mvp_db/news7-lv/2002/2002_03_26_19_00/2002_03_26_19_00.mpg;Junichiro KOIZUMI.jpg;14001;18569;35961;700;928;228
/net/per610a/home/mvp/mvp_db/news7-lv/2002/2002_03_26_19_00/2002_03_26_19_00.mpg;Shintaro ISHIHARA.jpg;23417;24461;35961;1171;1223;52
/net/per610a/home/mvp/mvp_db/news7-lv/2002/2002_03_26_19_00/2002_03_26_19_00.mpg;Shintaro ISHIHARA.jpg;26749;26833;35961;1338;1342;4
/net/per610a/home/mvp/mvp_db/news7-lv/2002/2002_03_26_19_00/2002_03_26_19_00.mpg;Shintaro ISHIHARA.jpg;27385;29893;35961;1369;1495;126
/net/per610a/home/mvp/mvp_db/news7-lv/2002/2002_03_27_19_00/2002_03_27_19_00.mpg;Junichiro KOIZUMI.jpg;757;793;35957;37;39;2
/net/per610a/home/mvp/mvp_db/news7-lv/2002/2002_03_27_19_00/2002_03_27_19_00.mpg;Junichiro KOIZUMI.jpg;905;1201;35957;45;60;15
/net/per610a/home/mvp/mvp_db/news7-lv/2002/2002_03_27_19_00/2002_03_27_19_00.mpg;Junichiro KOIZUMI.jpg;4005;4989;35957;200;249;49
/net/per610a/home/mvp/mvp_db/news7-lv/2002/2002_03_27_19_00/2002_03_27_19_00.mpg;Junichiro KOIZUMI.jpg;13557;13621;35957;678;681;3
/net/per610a/home/mvp/mvp_db/news7-lv/2002/2002_03_27_19_00/2002_03_27_19_00.mpg;Junichiro KOIZUMI.jpg;13689;14245;35957;684;712;28
/net/per610a/home/mvp/mvp_db/news7-lv/2002/2002_03_30_19_00/2002_03_30_19_00.mpg;Junichiro KOIZUMI.jpg;2185;3521;35957;109;176;67
/net/per610a/home/mvp/mvp_db/news7-lv/2002/2002_03_30_19_00/2002_03_30_19_00.mpg;Junichiro KOIZUMI.jpg;5233;7213;35957;261;360;99
/net/per610a/home/mvp/mvp_db/news7-lv/2002/2002_04_01_19_00/2002_04_01_19_00.mpg;Yukio HATOYAMA.jpg;7365;7465;35957;368;373;5
/net/per610a/home/mvp/mvp_db/news7-lv/2002/2002_04_01_19_00/2002_04_01_19_00.mpg;Junichiro KOIZUMI.jpg;20105;21057;35957;1005;1053;48
/net/per610a/home/mvp/mvp_db/news7-lv/2002/2002_04_01_19_00/2002_04_01_19_00.mpg;Junichiro KOIZUMI.jpg;22309;22549;35957;1116;1128;12
/net/per610a/home/mvp/mvp_db/news7-lv/2002/2002_04_02_19_00/2002_04_02_19_00.mpg;Junichiro KOIZUMI.jpg;11357;11469;35957;568;573;5
/net/per610a/home/mvp/mvp_db/news7-lv/2002/2002_04_02_19_00/2002_04_02_19_00.mpg;Junichiro KOIZUMI.jpg;15185;15993;35957;759;800;41
/net/per610a/home/mvp/mvp_db/news7-lv/2002/2002_04_02_19_00/2002_04_02_19_00.mpg;Yukio HATOYAMA.jpg;12621;13121;35957;631;656;25
/net/per610a/home/mvp/mvp_db/news7-lv/2002/2002_04_03_19_00/2002_04_03_19_00.mpg;Takenori KANZAKI.jpg;393;637;35957;19;31;12
/net/per610a/home/mvp/mvp_db/news7-lv/2002/2002_04_03_19_00/2002_04_03_19_00.mpg;Takenori KANZAKI.jpg;8181;9117;35957;409;456;47
/net/per610a/home/mvp/mvp_db/news7-lv/2002/2002_04_03_19_00/2002_04_03_19_00.mpg;Takenori KANZAKI.jpg;15121;15241;35957;756;762;6
/net/per610a/home/mvp/mvp_db/news7-lv/2002/2002_04_03_19_00/2002_04_03_19_00.mpg;Takenori KANZAKI.jpg;16753;16985;35957;838;849;11
/net/per610a/home/mvp/mvp_db/news7-lv/2002/2002_04_03_19_00/2002_04_03_19_00.mpg;Yasuo FUKUDA.jpg;4153;5301;35957;207;265;58
/net/per610a/home/mvp/mvp_db/news7-lv/2002/2002_04_03_19_00/2002_04_03_19_00.mpg;Yukio HATOYAMA.jpg;11785;13781;35957;589;689;100
/net/per610a/home/mvp/mvp_db/news7-lv/2002/2002_04_03_19_00/2002_04_03_19_00.mpg;Junichiro KOIZUMI.jpg;27305;28813;35957;1366;1441;75
/net/per610a/home/mvp/mvp_db/news7-lv/2002/2002_04_04_19_00/2002_04_04_19_00.mpg;Yasuo FUKUDA.jpg;14505;15797;35957;725;790;65
/net/per610a/home/mvp/mvp_db/news7-lv/2002/2002_04_04_19_00/2002_04_04_19_00.mpg;Junichiro KOIZUMI.jpg;23749;23881;35957;1188;1194;6
/net/per610a/home/mvp/mvp_db/news7-lv/2002/2002_04_04_19_00/2002_04_04_19_00.mpg;Junichiro KOIZUMI.jpg;23993;24037;35957;1200;1202;2
/net/per610a/home/mvp/mvp_db/news7-lv/2002/2002_04_04_19_00/2002_04_04_19_00.mpg;Junichiro KOIZUMI.jpg;24113;24165;35957;1206;1209;3
/net/per610a/home/mvp/mvp_db/news7-lv/2002/2002_04_05_19_00/2002_04_05_19_00.mpg;Naoto KAN.jpg;19581;20437;35957;979;1022;43
/net/per610a/home/mvp/mvp_db/news7-lv/2002/2002_04_05_19_00/2002_04_05_19_00.mpg;Junichiro KOIZUMI.jpg;26693;27165;35957;1335;1359;24
/net/per610a/home/mvp/mvp_db/news7-lv/2002/2002_04_08_19_00/2002_04_08_19_00.mpg;Junichiro KOIZUMI.jpg;14953;15057;35957;748;753;5
/net/per610a/home/mvp/mvp_db/news7-lv/2002/2002_04_08_19_00/2002_04_08_19_00.mpg;Junichiro KOIZUMI.jpg;27621;27637;35957;1381;1382;1
/net/per610a/home/mvp/mvp_db/news7-lv/2002/2002_04_09_19_00/2002_04_09_19_00.mpg;Yukio EDANO.jpg;14293;15529;35957;715;776;61
/net/per610a/home/mvp/mvp_db/news7-lv/2002/2002_04_10_19_00/2002_04_10_19_00.mpg;Ichiro OZAWA.jpg;5417;6081;35957;271;304;33
/net/per610a/home/mvp/mvp_db/news7-lv/2002/2002_04_11_19_00/2002_04_11_19_00.mpg;Junichiro KOIZUMI.jpg;1917;3013;35957;95;150;55
/net/per610a/home/mvp/mvp_db/news7-lv/2002/2002_04_12_19_00/2002_04_12_19_00.mpg;Junichiro KOIZUMI.jpg;7873;8521;35957;393;426;33
/net/per610a/home/mvp/mvp_db/news7-lv/2002/2002_04_12_19_00/2002_04_12_19_00.mpg;Kazuo SHII.jpg;18465;18553;35957;923;928;5
/net/per610a/home/mvp/mvp_db/news7-lv/2002/2002_04_12_19_00/2002_04_12_19_00.mpg;Kazuo SHII.jpg;20417;20841;35957;1021;1042;21
/net/per610a/home/mvp/mvp_db/news7-lv/2002/2002_04_12_19_00/2002_04_12_19_00.mpg;Naoto KAN.jpg;22169;22965;35957;1109;1148;39
/net/per610a/home/mvp/mvp_db/news7-lv/2002/2002_04_16_19_00/2002_04_16_19_00.mpg;Sadakazu TANIGAKI.jpg;525;525;35957;26;26;0
/net/per610a/home/mvp/mvp_db/news7-lv/2002/2002_04_16_19_00/2002_04_16_19_00.mpg;Sadakazu TANIGAKI.jpg;12989;13065;35957;649;653;4
/net/per610a/home/mvp/mvp_db/news7-lv/2002/2002_04_17_19_00/2002_04_17_19_00.mpg;Junichiro KOIZUMI.jpg;7277;10045;35957;364;502;138
/net/per610a/home/mvp/mvp_db/news7-lv/2002/2002_04_21_19_00/2002_04_21_19_00.mpg;Junichiro KOIZUMI.jpg;721;841;23969;36;42;6
/net/per610a/home/mvp/mvp_db/news7-lv/2002/2002_04_21_19_00/2002_04_21_19_00.mpg;Junichiro KOIZUMI.jpg;1313;1681;23969;65;84;19
/net/per610a/home/mvp/mvp_db/news7-lv/2002/2002_04_21_19_00/2002_04_21_19_00.mpg;Junichiro KOIZUMI.jpg;1781;7701;23969;89;385;296
/net/per610a/home/mvp/mvp_db/news7-lv/2002/2002_04_22_19_00/2002_04_22_19_00.mpg;Junichiro KOIZUMI.jpg;6569;6593;35957;328;329;1
/net/per610a/home/mvp/mvp_db/news7-lv/2002/2002_04_22_19_00/2002_04_22_19_00.mpg;Junichiro KOIZUMI.jpg;6693;6797;35957;334;340;6
/net/per610a/home/mvp/mvp_db/news7-lv/2002/2002_04_22_19_00/2002_04_22_19_00.mpg;Junichiro KOIZUMI.jpg;7025;7053;35957;351;352;1
/net/per610a/home/mvp/mvp_db/news7-lv/2002/2002_04_22_19_00/2002_04_22_19_00.mpg;Junichiro KOIZUMI.jpg;13509;13617;35957;675;681;6
/net/per610a/home/mvp/mvp_db/news7-lv/2002/2002_04_22_19_00/2002_04_22_19_00.mpg;Junichiro KOIZUMI.jpg;13853;14473;35957;693;724;31
/net/per610a/home/mvp/mvp_db/news7-lv/2002/2002_04_22_19_00/2002_04_22_19_00.mpg;Junichiro KOIZUMI.jpg;15461;16941;35957;773;847;74
/net/per610a/home/mvp/mvp_db/news7-lv/2002/2002_04_22_19_00/2002_04_22_19_00.mpg;Junichiro KOIZUMI.jpg;10929;11125;35957;546;556;10
/net/per610a/home/mvp/mvp_db/news7-lv/2002/2002_04_22_19_00/2002_04_22_19_00.mpg;Junichiro KOIZUMI.jpg;11589;11777;35957;579;589;10
/net/per610a/home/mvp/mvp_db/news7-lv/2002/2002_04_22_19_00/2002_04_22_19_00.mpg;Junichiro KOIZUMI.jpg;11873;11877;35957;594;594;0
/net/per610a/home/mvp/mvp_db/news7-lv/2002/2002_04_23_19_00/2002_04_23_19_00.mpg;Junichiro KOIZUMI.jpg;701;745;35957;35;37;2
/net/per610a/home/mvp/mvp_db/news7-lv/2002/2002_04_23_19_00/2002_04_23_19_00.mpg;Junichiro KOIZUMI.jpg;1005;1129;35957;50;56;6
/net/per610a/home/mvp/mvp_db/news7-lv/2002/2002_04_23_19_00/2002_04_23_19_00.mpg;Junichiro KOIZUMI.jpg;4417;5841;35957;220;292;72
/net/per610a/home/mvp/mvp_db/news7-lv/2002/2002_04_23_19_00/2002_04_23_19_00.mpg;Junichiro KOIZUMI.jpg;7177;8125;35957;359;406;47
/net/per610a/home/mvp/mvp_db/news7-lv/2002/2002_04_23_19_00/2002_04_23_19_00.mpg;Junichiro KOIZUMI.jpg;11605;11661;35957;580;583;3
/net/per610a/home/mvp/mvp_db/news7-lv/2002/2002_04_23_19_00/2002_04_23_19_00.mpg;Junichiro KOIZUMI.jpg;11725;11989;35957;586;599;13
/net/per610a/home/mvp/mvp_db/news7-lv/2002/2002_04_23_19_00/2002_04_23_19_00.mpg;Junichiro KOIZUMI.jpg;12273;12989;35957;614;649;35
/net/per610a/home/mvp/mvp_db/news7-lv/2002/2002_04_23_19_00/2002_04_23_19_00.mpg;Junichiro KOIZUMI.jpg;16793;16845;35957;840;842;2
/net/per610a/home/mvp/mvp_db/news7-lv/2002/2002_04_23_19_00/2002_04_23_19_00.mpg;Ichiro OZAWA.jpg;14445;14905;35957;722;745;23
/net/per610a/home/mvp/mvp_db/news7-lv/2002/2002_04_24_19_00/2002_04_24_19_00.mpg;Ichiro OZAWA.jpg;373;517;35957;18;25;7
/net/per610a/home/mvp/mvp_db/news7-lv/2002/2002_04_24_19_00/2002_04_24_19_00.mpg;Junichiro KOIZUMI.jpg;1365;1993;35957;68;99;31
/net/per610a/home/mvp/mvp_db/news7-lv/2002/2002_04_24_19_00/2002_04_24_19_00.mpg;Junichiro KOIZUMI.jpg;2813;2905;35957;140;145;5
/net/per610a/home/mvp/mvp_db/news7-lv/2002/2002_04_24_19_00/2002_04_24_19_00.mpg;Junichiro KOIZUMI.jpg;3281;3497;35957;164;174;10
/net/per610a/home/mvp/mvp_db/news7-lv/2002/2002_04_24_19_00/2002_04_24_19_00.mpg;Junichiro KOIZUMI.jpg;3877;4061;35957;193;203;10
/net/per610a/home/mvp/mvp_db/news7-lv/2002/2002_04_24_19_00/2002_04_24_19_00.mpg;Junichiro KOIZUMI.jpg;4685;4793;35957;234;239;5
/net/per610a/home/mvp/mvp_db/news7-lv/2002/2002_04_24_19_00/2002_04_24_19_00.mpg;Junichiro KOIZUMI.jpg;6485;6633;35957;324;331;7
/net/per610a/home/mvp/mvp_db/news7-lv/2002/2002_04_24_19_00/2002_04_24_19_00.mpg;Junichiro KOIZUMI.jpg;7237;7481;35957;362;374;12
/net/per610a/home/mvp/mvp_db/news7-lv/2002/2002_04_24_19_00/2002_04_24_19_00.mpg;Junichiro KOIZUMI.jpg;9077;9165;35957;454;458;4
/net/per610a/home/mvp/mvp_db/news7-lv/2002/2002_04_24_19_00/2002_04_24_19_00.mpg;Yasuo FUKUDA.jpg;1997;2009;35957;99;100;1
/net/per610a/home/mvp/mvp_db/news7-lv/2002/2002_04_24_19_00/2002_04_24_19_00.mpg;Yasuo FUKUDA.jpg;3501;3873;35957;175;193;18
/net/per610a/home/mvp/mvp_db/news7-lv/2002/2002_04_24_19_00/2002_04_24_19_00.mpg;Junichiro KOIZUMI.jpg;2909;3277;35957;145;163;18
/net/per610a/home/mvp/mvp_db/news7-lv/2002/2002_04_24_19_00/2002_04_24_19_00.mpg;Junichiro KOIZUMI.jpg;6637;7233;35957;332;361;29
/net/per610a/home/mvp/mvp_db/news7-lv/2002/2002_04_24_19_00/2002_04_24_19_00.mpg;Takenori KANZAKI.jpg;4065;4681;35957;203;234;31
/net/per610a/home/mvp/mvp_db/news7-lv/2002/2002_04_24_19_00/2002_04_24_19_00.mpg;Yukio HATOYAMA.jpg;4797;6481;35957;240;324;84
/net/per610a/home/mvp/mvp_db/news7-lv/2002/2002_04_24_19_00/2002_04_24_19_00.mpg;Natsuo YAMAGUCHI.jpg;15681;15869;35957;784;793;9
/net/per610a/home/mvp/mvp_db/news7-lv/2002/2002_04_25_19_00/2002_04_25_19_00.mpg;Junichiro KOIZUMI.jpg;25701;25773;35957;1285;1289;4
/net/per610a/home/mvp/mvp_db/news7-lv/2002/2002_04_25_19_00/2002_04_25_19_00.mpg;Junichiro KOIZUMI.jpg;25893;25949;35957;1295;1298;3
/net/per610a/home/mvp/mvp_db/news7-lv/2002/2002_04_26_19_00/2002_04_26_19_00.mpg;Junichiro KOIZUMI.jpg;393;909;35957;19;45;26
/net/per610a/home/mvp/mvp_db/news7-lv/2002/2002_04_26_19_00/2002_04_26_19_00.mpg;Junichiro KOIZUMI.jpg;997;1073;35957;49;53;4
/net/per610a/home/mvp/mvp_db/news7-lv/2002/2002_04_26_19_00/2002_04_26_19_00.mpg;Junichiro KOIZUMI.jpg;3921;4341;35957;196;217;21
/net/per610a/home/mvp/mvp_db/news7-lv/2002/2002_04_26_19_00/2002_04_26_19_00.mpg;Junichiro KOIZUMI.jpg;4525;4533;35957;226;226;0
/net/per610a/home/mvp/mvp_db/news7-lv/2002/2002_04_26_19_00/2002_04_26_19_00.mpg;Junichiro KOIZUMI.jpg;15785;15857;35957;789;793;4
/net/per610a/home/mvp/mvp_db/news7-lv/2002/2002_04_26_19_00/2002_04_26_19_00.mpg;Junichiro KOIZUMI.jpg;19969;20237;35957;999;1012;13
/net/per610a/home/mvp/mvp_db/news7-lv/2002/2002_04_26_19_00/2002_04_26_19_00.mpg;Junichiro KOIZUMI.jpg;20709;20957;35957;1036;1048;12
/net/per610a/home/mvp/mvp_db/news7-lv/2002/2002_04_26_19_00/2002_04_26_19_00.mpg;Junichiro KOIZUMI.jpg;1117;1381;35957;55;69;14
/net/per610a/home/mvp/mvp_db/news7-lv/2002/2002_04_26_19_00/2002_04_26_19_00.mpg;Junichiro KOIZUMI.jpg;5485;5985;35957;274;299;25
/net/per610a/home/mvp/mvp_db/news7-lv/2002/2002_04_26_19_00/2002_04_26_19_00.mpg;Junichiro KOIZUMI.jpg;21069;21185;35957;1054;1059;5
/net/per610a/home/mvp/mvp_db/news7-lv/2002/2002_04_26_19_00/2002_04_26_19_00.mpg;Junichiro KOIZUMI.jpg;1361;3205;35957;68;160;92
/net/per610a/home/mvp/mvp_db/news7-lv/2002/2002_04_26_19_00/2002_04_26_19_00.mpg;Junichiro KOIZUMI.jpg;3401;3689;35957;170;184;14
/net/per610a/home/mvp/mvp_db/news7-lv/2002/2002_04_26_19_00/2002_04_26_19_00.mpg;Junichiro KOIZUMI.jpg;9105;9341;35957;455;467;12
/net/per610a/home/mvp/mvp_db/news7-lv/2002/2002_04_26_19_00/2002_04_26_19_00.mpg;Junichiro KOIZUMI.jpg;11421;11561;35957;571;578;7
/net/per610a/home/mvp/mvp_db/news7-lv/2002/2002_04_26_19_00/2002_04_26_19_00.mpg;Junichiro KOIZUMI.jpg;4705;4737;35957;235;237;2
/net/per610a/home/mvp/mvp_db/news7-lv/2002/2002_04_26_19_00/2002_04_26_19_00.mpg;Junichiro KOIZUMI.jpg;4901;5985;35957;245;299;54
/net/per610a/home/mvp/mvp_db/news7-lv/2002/2002_04_26_19_00/2002_04_26_19_00.mpg;Junichiro KOIZUMI.jpg;6213;6413;35957;310;320;10
/net/per610a/home/mvp/mvp_db/news7-lv/2002/2002_04_26_19_00/2002_04_26_19_00.mpg;Junichiro KOIZUMI.jpg;6705;7085;35957;335;354;19
/net/per610a/home/mvp/mvp_db/news7-lv/2002/2002_04_26_19_00/2002_04_26_19_00.mpg;Junichiro KOIZUMI.jpg;7345;7537;35957;367;377;10
/net/per610a/home/mvp/mvp_db/news7-lv/2002/2002_04_26_19_00/2002_04_26_19_00.mpg;Junichiro KOIZUMI.jpg;8473;8721;35957;423;436;13
/net/per610a/home/mvp/mvp_db/news7-lv/2002/2002_04_26_19_00/2002_04_26_19_00.mpg;Junichiro KOIZUMI.jpg;15185;15561;35957;759;778;19
/net/per610a/home/mvp/mvp_db/news7-lv/2002/2002_04_26_19_00/2002_04_26_19_00.mpg;Junichiro KOIZUMI.jpg;15917;16225;35957;796;811;15
/net/per610a/home/mvp/mvp_db/news7-lv/2002/2002_04_26_19_00/2002_04_26_19_00.mpg;Junichiro KOIZUMI.jpg;17121;17165;35957;856;858;2
/net/per610a/home/mvp/mvp_db/news7-lv/2002/2002_04_26_19_00/2002_04_26_19_00.mpg;Junichiro KOIZUMI.jpg;23937;24193;35957;1197;1210;13
/net/per610a/home/mvp/mvp_db/news7-lv/2002/2002_04_26_19_00/2002_04_26_19_00.mpg;Junichiro KOIZUMI.jpg;4869;4893;35957;243;244;1
/net/per610a/home/mvp/mvp_db/news7-lv/2002/2002_04_26_19_00/2002_04_26_19_00.mpg;Junichiro KOIZUMI.jpg;9569;9761;35957;478;488;10
/net/per610a/home/mvp/mvp_db/news7-lv/2002/2002_04_26_19_00/2002_04_26_19_00.mpg;Junichiro KOIZUMI.jpg;17269;17301;35957;864;865;1
/net/per610a/home/mvp/mvp_db/news7-lv/2002/2002_04_26_19_00/2002_04_26_19_00.mpg;Junichiro KOIZUMI.jpg;10497;11033;35957;525;552;27
/net/per610a/home/mvp/mvp_db/news7-lv/2002/2002_04_26_19_00/2002_04_26_19_00.mpg;Junichiro KOIZUMI.jpg;11777;12065;35957;589;603;14
/net/per610a/home/mvp/mvp_db/news7-lv/2002/2002_04_26_19_00/2002_04_26_19_00.mpg;Junichiro KOIZUMI.jpg;20521;20705;35957;1026;1035;9
/net/per610a/home/mvp/mvp_db/news7-lv/2002/2002_04_27_19_00/2002_04_27_19_00.mpg;Junichiro KOIZUMI.jpg;4105;4465;35957;205;223;18
/net/per610a/home/mvp/mvp_db/news7-lv/2002/2002_04_27_19_00/2002_04_27_19_00.mpg;Junichiro KOIZUMI.jpg;4569;4757;35957;228;238;10
/net/per610a/home/mvp/mvp_db/news7-lv/2002/2002_04_29_19_00/2002_04_29_19_00.mpg;Takenori KANZAKI.jpg;14493;14721;35957;725;736;11
/net/per610a/home/mvp/mvp_db/news7-lv/2002/2002_05_01_19_00/2002_05_01_19_00.mpg;Junichiro KOIZUMI.jpg;4605;4797;35957;230;240;10
/net/per610a/home/mvp/mvp_db/news7-lv/2002/2002_05_01_19_00/2002_05_01_19_00.mpg;Junichiro KOIZUMI.jpg;8005;8057;35957;400;403;3
/net/per610a/home/mvp/mvp_db/news7-lv/2002/2002_05_01_19_00/2002_05_01_19_00.mpg;Junichiro KOIZUMI.jpg;8221;8261;35957;411;413;2
/net/per610a/home/mvp/mvp_db/news7-lv/2002/2002_05_01_19_00/2002_05_01_19_00.mpg;Junichiro KOIZUMI.jpg;8625;8741;35957;431;437;6
/net/per610a/home/mvp/mvp_db/news7-lv/2002/2002_05_02_19_00/2002_05_02_19_00.mpg;Katsuya OKADA.jpg;12469;14781;35957;623;739;116
/net/per610a/home/mvp/mvp_db/news7-lv/2002/2002_05_03_19_00/2002_05_03_19_00.mpg;Kazuo SHII.jpg;4341;4629;35957;217;231;14
/net/per610a/home/mvp/mvp_db/news7-lv/2002/2002_05_03_19_00/2002_05_03_19_00.mpg;Kazuo SHII.jpg;4753;6761;35957;237;338;101
/net/per610a/home/mvp/mvp_db/news7-lv/2002/2002_05_03_19_00/2002_05_03_19_00.mpg;Kazuo SHII.jpg;14369;14501;35957;718;725;7
/net/per610a/home/mvp/mvp_db/news7-lv/2002/2002_05_07_19_00/2002_05_07_19_00.mpg;Junichiro KOIZUMI.jpg;11505;12353;35957;575;618;43
/net/per610a/home/mvp/mvp_db/news7-lv/2002/2002_05_07_19_00/2002_05_07_19_00.mpg;Junichiro KOIZUMI.jpg;28329;28453;35957;1417;1423;6
/net/per610a/home/mvp/mvp_db/news7-lv/2002/2002_05_08_19_00/2002_05_08_19_00.mpg;Yukio HATOYAMA.jpg;2925;3053;35957;146;152;6
/net/per610a/home/mvp/mvp_db/news7-lv/2002/2002_05_08_19_00/2002_05_08_19_00.mpg;Takenori KANZAKI.jpg;4369;5245;35957;218;262;44
/net/per610a/home/mvp/mvp_db/news7-lv/2002/2002_05_09_19_00/2002_05_09_19_00.mpg;Junichiro KOIZUMI.jpg;1885;2909;35957;94;145;51
/net/per610a/home/mvp/mvp_db/news7-lv/2002/2002_05_09_19_00/2002_05_09_19_00.mpg;Junichiro KOIZUMI.jpg;20277;20821;35957;1014;1041;27
/net/per610a/home/mvp/mvp_db/news7-lv/2002/2002_05_09_19_00/2002_05_09_19_00.mpg;Junichiro KOIZUMI.jpg;20993;21453;35957;1050;1073;23
/net/per610a/home/mvp/mvp_db/news7-lv/2002/2002_05_10_19_00/2002_05_10_19_00.mpg;Yasuo FUKUDA.jpg;8173;8445;35957;408;422;14
/net/per610a/home/mvp/mvp_db/news7-lv/2002/2002_05_12_19_00/2002_05_12_19_00.mpg;Yukio HATOYAMA.jpg;6085;8113;23969;304;405;101
/net/per610a/home/mvp/mvp_db/news7-lv/2002/2002_05_13_19_00/2002_05_13_19_00.mpg;Junichiro KOIZUMI.jpg;22149;22241;35957;1108;1112;4
/net/per610a/home/mvp/mvp_db/news7-lv/2002/2002_05_13_19_00/2002_05_13_19_00.mpg;Junichiro KOIZUMI.jpg;25493;25573;35957;1275;1279;4
/net/per610a/home/mvp/mvp_db/news7-lv/2002/2002_05_13_19_00/2002_05_13_19_00.mpg;Junichiro KOIZUMI.jpg;25713;25781;35957;1286;1289;3
/net/per610a/home/mvp/mvp_db/news7-lv/2002/2002_05_14_19_00/2002_05_14_19_00.mpg;Junichiro KOIZUMI.jpg;9453;9837;35957;472;492;20
/net/per610a/home/mvp/mvp_db/news7-lv/2002/2002_05_14_19_00/2002_05_14_19_00.mpg;Yasuo FUKUDA.jpg;9901;10193;35957;495;509;14
/net/per610a/home/mvp/mvp_db/news7-lv/2002/2002_05_15_19_00/2002_05_15_19_00.mpg;Takenori KANZAKI.jpg;12481;14717;35957;624;736;112
/net/per610a/home/mvp/mvp_db/news7-lv/2002/2002_05_15_19_00/2002_05_15_19_00.mpg;Takenori KANZAKI.jpg;19601;19797;35957;980;990;10
/net/per610a/home/mvp/mvp_db/news7-lv/2002/2002_05_15_19_00/2002_05_15_19_00.mpg;Takenori KANZAKI.jpg;20205;20269;35957;1010;1014;4
/net/per610a/home/mvp/mvp_db/news7-lv/2002/2002_05_15_19_00/2002_05_15_19_00.mpg;Takenori KANZAKI.jpg;20477;20729;35957;1024;1037;13
/net/per610a/home/mvp/mvp_db/news7-lv/2002/2002_05_15_19_00/2002_05_15_19_00.mpg;Junichiro KOIZUMI.jpg;20185;20197;35957;1009;1010;1
/net/per610a/home/mvp/mvp_db/news7-lv/2002/2002_05_15_19_00/2002_05_15_19_00.mpg;Junichiro KOIZUMI.jpg;20273;20281;35957;1014;1014;0
/net/per610a/home/mvp/mvp_db/news7-lv/2002/2002_05_15_19_00/2002_05_15_19_00.mpg;Junichiro KOIZUMI.jpg;20369;20469;35957;1019;1024;5
/net/per610a/home/mvp/mvp_db/news7-lv/2002/2002_05_15_19_00/2002_05_15_19_00.mpg;Junichiro KOIZUMI.jpg;20889;21409;35957;1045;1071;26
/net/per610a/home/mvp/mvp_db/news7-lv/2002/2002_05_15_19_00/2002_05_15_19_00.mpg;Junichiro KOIZUMI.jpg;32293;34697;35957;1615;1735;120
/net/per610a/home/mvp/mvp_db/news7-lv/2002/2002_05_16_19_00/2002_05_16_19_00.mpg;Yasuo FUKUDA.jpg;8569;8821;35957;428;441;13
/net/per610a/home/mvp/mvp_db/news7-lv/2002/2002_05_16_19_00/2002_05_16_19_00.mpg;Yasuo FUKUDA.jpg;9385;9733;35957;469;486;17
/net/per610a/home/mvp/mvp_db/news7-lv/2002/2002_05_16_19_00/2002_05_16_19_00.mpg;Ichiro OZAWA.jpg;21597;21765;35957;1080;1088;8
/net/per610a/home/mvp/mvp_db/news7-lv/2002/2002_05_19_19_00/2002_05_19_19_00.mpg;Shinzo ABE.jpg;1761;2609;23969;88;130;42
/net/per610a/home/mvp/mvp_db/news7-lv/2002/2002_05_20_19_00/2002_05_20_19_00.mpg;Yasuo FUKUDA.jpg;2653;3225;35957;132;161;29
/net/per610a/home/mvp/mvp_db/news7-lv/2002/2002_05_20_19_00/2002_05_20_19_00.mpg;Ichiro OZAWA.jpg;16445;16537;35957;822;827;5
/net/per610a/home/mvp/mvp_db/news7-lv/2002/2002_05_21_19_00/2002_05_21_19_00.mpg;Yasuo FUKUDA.jpg;12249;12269;35957;612;613;1
/net/per610a/home/mvp/mvp_db/news7-lv/2002/2002_05_21_19_00/2002_05_21_19_00.mpg;Yasuo FUKUDA.jpg;12417;12513;35957;621;626;5
/net/per610a/home/mvp/mvp_db/news7-lv/2002/2002_05_22_19_00/2002_05_22_19_00.mpg;Junichiro KOIZUMI.jpg;6033;6265;35957;301;313;12
/net/per610a/home/mvp/mvp_db/news7-lv/2002/2002_05_22_19_00/2002_05_22_19_00.mpg;Junichiro KOIZUMI.jpg;21577;21889;35957;1079;1095;16
/net/per610a/home/mvp/mvp_db/news7-lv/2002/2002_05_22_19_00/2002_05_22_19_00.mpg;Yasuo FUKUDA.jpg;12981;13317;35957;649;666;17
/net/per610a/home/mvp/mvp_db/news7-lv/2002/2002_05_23_19_00/2002_05_23_19_00.mpg;Yasuo FUKUDA.jpg;13529;13865;35957;676;693;17
/net/per610a/home/mvp/mvp_db/news7-lv/2002/2002_05_23_19_00/2002_05_23_19_00.mpg;Yasuo FUKUDA.jpg;17701;18105;35957;885;905;20
/net/per610a/home/mvp/mvp_db/news7-lv/2002/2002_05_23_19_00/2002_05_23_19_00.mpg;Yasuo FUKUDA.jpg;25389;25393;35957;1270;1270;0
/net/per610a/home/mvp/mvp_db/news7-lv/2002/2002_05_23_19_00/2002_05_23_19_00.mpg;Junichiro KOIZUMI.jpg;17053;17177;35957;853;859;6
/net/per610a/home/mvp/mvp_db/news7-lv/2002/2002_05_23_19_00/2002_05_23_19_00.mpg;Junichiro KOIZUMI.jpg;27545;28341;35957;1378;1417;39
/net/per610a/home/mvp/mvp_db/news7-lv/2002/2002_05_23_19_00/2002_05_23_19_00.mpg;Shinzo ABE.jpg;20225;20413;35957;1011;1021;10
/net/per610a/home/mvp/mvp_db/news7-lv/2002/2002_05_24_19_00/2002_05_24_19_00.mpg;Yukio HATOYAMA.jpg;8293;8345;35957;414;417;3
/net/per610a/home/mvp/mvp_db/news7-lv/2002/2002_05_24_19_00/2002_05_24_19_00.mpg;Yukio HATOYAMA.jpg;8441;8541;35957;422;427;5
/net/per610a/home/mvp/mvp_db/news7-lv/2002/2002_05_26_19_00/2002_05_26_19_00.mpg;Junichiro KOIZUMI.jpg;20429;20757;23969;1021;1038;17
/net/per610a/home/mvp/mvp_db/news7-lv/2002/2002_05_26_19_00/2002_05_26_19_00.mpg;Junichiro KOIZUMI.jpg;21121;21353;23969;1056;1068;12
/net/per610a/home/mvp/mvp_db/news7-lv/2002/2002_05_27_19_00/2002_05_27_19_00.mpg;Junichiro KOIZUMI.jpg;12373;12381;35957;619;619;0
/net/per610a/home/mvp/mvp_db/news7-lv/2002/2002_05_27_19_00/2002_05_27_19_00.mpg;Junichiro KOIZUMI.jpg;12489;12645;35957;624;632;8
/net/per610a/home/mvp/mvp_db/news7-lv/2002/2002_05_27_19_00/2002_05_27_19_00.mpg;Junichiro KOIZUMI.jpg;13065;13593;35957;653;680;27
/net/per610a/home/mvp/mvp_db/news7-lv/2002/2002_05_27_19_00/2002_05_27_19_00.mpg;Junichiro KOIZUMI.jpg;15077;15121;35957;754;756;2
/net/per610a/home/mvp/mvp_db/news7-lv/2002/2002_05_27_19_00/2002_05_27_19_00.mpg;Junichiro KOIZUMI.jpg;18509;18913;35957;926;946;20
/net/per610a/home/mvp/mvp_db/news7-lv/2002/2002_05_27_19_00/2002_05_27_19_00.mpg;Akihiro OHTA.jpg;17617;17713;35957;881;886;5
/net/per610a/home/mvp/mvp_db/news7-lv/2002/2002_05_28_19_00/2002_05_28_19_00.mpg;Junichiro KOIZUMI.jpg;17761;17849;35957;888;893;5
/net/per610a/home/mvp/mvp_db/news7-lv/2002/2002_05_28_19_00/2002_05_28_19_00.mpg;Junichiro KOIZUMI.jpg;19941;20653;35957;997;1033;36
/net/per610a/home/mvp/mvp_db/news7-lv/2002/2002_05_29_19_00/2002_05_29_19_00.mpg;Kenji Eda.jpg;3693;3841;35957;184;192;8
/net/per610a/home/mvp/mvp_db/news7-lv/2002/2002_05_29_19_00/2002_05_29_19_00.mpg;Takenori KANZAKI.jpg;4049;6825;35957;202;341;139
/net/per610a/home/mvp/mvp_db/news7-lv/2002/2002_05_29_19_00/2002_05_29_19_00.mpg;Junichiro KOIZUMI.jpg;22473;23617;35957;1124;1181;57
/net/per610a/home/mvp/mvp_db/news7-lv/2002/2002_05_31_19_00/2002_05_31_19_00.mpg;Yasuo FUKUDA.jpg;17465;17557;35957;873;878;5
/net/per610a/home/mvp/mvp_db/news7-lv/2002/2002_05_31_19_00/2002_05_31_19_00.mpg;Junichiro KOIZUMI.jpg;18597;19441;35957;930;972;42
/net/per610a/home/mvp/mvp_db/news7-lv/2002/2002_06_03_19_00/2002_06_03_19_00.mpg;Yasuo FUKUDA.jpg;19597;20373;35957;980;1019;39
/net/per610a/home/mvp/mvp_db/news7-lv/2002/2002_06_03_19_00/2002_06_03_19_00.mpg;Yasuo FUKUDA.jpg;23321;23713;35957;1166;1186;20
/net/per610a/home/mvp/mvp_db/news7-lv/2002/2002_06_03_19_00/2002_06_03_19_00.mpg;Yasuo FUKUDA.jpg;24337;25517;35957;1217;1276;59
/net/per610a/home/mvp/mvp_db/news7-lv/2002/2002_06_03_19_00/2002_06_03_19_00.mpg;Yasuo FUKUDA.jpg;26025;26481;35957;1302;1324;22
/net/per610a/home/mvp/mvp_db/news7-lv/2002/2002_06_05_19_00/2002_06_05_19_00.mpg;Kazuo SHII.jpg;26113;26945;35961;1306;1347;41
/net/per610a/home/mvp/mvp_db/news7-lv/2002/2002_06_07_19_00/2002_06_07_19_00.mpg;Masashi Nakano.jpg;2389;2469;35957;119;123;4
/net/per610a/home/mvp/mvp_db/news7-lv/2002/2002_06_08_19_00/2002_06_08_19_00.mpg;Takeo Hiranuma.jpeg;21585;23301;35957;1079;1165;86
/net/per610a/home/mvp/mvp_db/news7-lv/2002/2002_06_08_19_00/2002_06_08_19_00.mpg;Naoto KAN.jpg;24885;25765;35957;1245;1289;44
/net/per610a/home/mvp/mvp_db/news7-lv/2002/2002_06_10_19_00/2002_06_10_19_00.mpg;Junichiro KOIZUMI.jpg;26125;26209;35957;1307;1311;4
/net/per610a/home/mvp/mvp_db/news7-lv/2002/2002_06_10_19_00/2002_06_10_19_00.mpg;Junichiro KOIZUMI.jpg;26349;26433;35957;1318;1322;4
/net/per610a/home/mvp/mvp_db/news7-lv/2002/2002_06_11_19_00/2002_06_11_19_00.mpg;Junichiro KOIZUMI.jpg;19673;19769;35957;984;989;5
/net/per610a/home/mvp/mvp_db/news7-lv/2002/2002_06_11_19_00/2002_06_11_19_00.mpg;Junichiro KOIZUMI.jpg;20121;20185;35957;1006;1009;3
/net/per610a/home/mvp/mvp_db/news7-lv/2002/2002_06_11_19_00/2002_06_11_19_00.mpg;Junichiro KOIZUMI.jpg;20273;20905;35957;1014;1045;31
/net/per610a/home/mvp/mvp_db/news7-lv/2002/2002_06_11_19_00/2002_06_11_19_00.mpg;Junichiro KOIZUMI.jpg;22409;23325;35957;1121;1166;45
/net/per610a/home/mvp/mvp_db/news7-lv/2002/2002_06_12_19_00/2002_06_12_19_00.mpg;Naoto KAN.jpg;3557;3677;35957;177;183;6
/net/per610a/home/mvp/mvp_db/news7-lv/2002/2002_06_12_19_00/2002_06_12_19_00.mpg;Yasuo FUKUDA.jpg;7909;8509;35957;395;425;30
/net/per610a/home/mvp/mvp_db/news7-lv/2002/2002_06_13_19_00/2002_06_13_19_00.mpg;Naoto KAN.jpg;1341;1397;35957;67;69;2
/net/per610a/home/mvp/mvp_db/news7-lv/2002/2002_06_13_19_00/2002_06_13_19_00.mpg;Naoto KAN.jpg;19157;19169;35957;958;959;1
/net/per610a/home/mvp/mvp_db/news7-lv/2002/2002_06_13_19_00/2002_06_13_19_00.mpg;Naoto KAN.jpg;20577;21093;35957;1029;1055;26
/net/per610a/home/mvp/mvp_db/news7-lv/2002/2002_06_16_19_00/2002_06_16_19_00.mpg;Yukio HATOYAMA.jpg;2353;3829;23969;117;191;74
/net/per610a/home/mvp/mvp_db/news7-lv/2002/2002_06_17_19_00/2002_06_17_19_00.mpg;Yukio HATOYAMA.jpg;24381;26125;35961;1219;1306;87
/net/per610a/home/mvp/mvp_db/news7-lv/2002/2002_06_19_19_00/2002_06_19_19_00.mpg;Junichiro KOIZUMI.jpg;33477;35665;35961;1674;1784;110
/net/per610a/home/mvp/mvp_db/news7-lv/2002/2002_06_21_19_00/2002_06_21_19_00.mpg;Junichiro KOIZUMI.jpg;1565;1781;35957;78;89;11
/net/per610a/home/mvp/mvp_db/news7-lv/2002/2002_06_21_19_00/2002_06_21_19_00.mpg;Junichiro KOIZUMI.jpg;4241;4241;35957;212;212;0
/net/per610a/home/mvp/mvp_db/news7-lv/2002/2002_06_21_19_00/2002_06_21_19_00.mpg;Junichiro KOIZUMI.jpg;6229;6297;35957;311;315;4
/net/per610a/home/mvp/mvp_db/news7-lv/2002/2002_06_21_19_00/2002_06_21_19_00.mpg;Junichiro KOIZUMI.jpg;6645;6657;35957;332;333;1
/net/per610a/home/mvp/mvp_db/news7-lv/2002/2002_06_21_19_00/2002_06_21_19_00.mpg;Yasuo FUKUDA.jpg;1817;3025;35957;90;151;61
/net/per610a/home/mvp/mvp_db/news7-lv/2002/2002_06_21_19_00/2002_06_21_19_00.mpg;Yasuo FUKUDA.jpg;6309;6577;35957;315;329;14
/net/per610a/home/mvp/mvp_db/news7-lv/2002/2002_06_21_19_00/2002_06_21_19_00.mpg;Junichiro KOIZUMI.jpg;3153;3253;35957;157;162;5
/net/per610a/home/mvp/mvp_db/news7-lv/2002/2002_06_21_19_00/2002_06_21_19_00.mpg;Junichiro KOIZUMI.jpg;8669;8805;35957;433;440;7
/net/per610a/home/mvp/mvp_db/news7-lv/2002/2002_06_21_19_00/2002_06_21_19_00.mpg;Junichiro KOIZUMI.jpg;28985;29357;35957;1450;1468;18
/net/per610a/home/mvp/mvp_db/news7-lv/2002/2002_06_21_19_00/2002_06_21_19_00.mpg;Yukio HATOYAMA.jpg;14045;15581;35957;702;779;77
/net/per610a/home/mvp/mvp_db/news7-lv/2002/2002_06_26_19_00/2002_06_26_19_00.mpg;Junichiro KOIZUMI.jpg;9585;10001;35957;479;500;21
/net/per610a/home/mvp/mvp_db/news7-lv/2002/2002_06_27_19_00/2002_06_27_19_00.mpg;Junichiro KOIZUMI.jpg;461;469;35957;23;23;0
/net/per610a/home/mvp/mvp_db/news7-lv/2002/2002_06_27_19_00/2002_06_27_19_00.mpg;Junichiro KOIZUMI.jpg;709;829;35957;35;41;6
/net/per610a/home/mvp/mvp_db/news7-lv/2002/2002_06_27_19_00/2002_06_27_19_00.mpg;Junichiro KOIZUMI.jpg;16981;17029;35957;849;851;2
/net/per610a/home/mvp/mvp_db/news7-lv/2002/2002_06_27_19_00/2002_06_27_19_00.mpg;Junichiro KOIZUMI.jpg;18361;18377;35957;918;919;1
/net/per610a/home/mvp/mvp_db/news7-lv/2002/2002_06_27_19_00/2002_06_27_19_00.mpg;Junichiro KOIZUMI.jpg;18489;18565;35957;925;928;3
/net/per610a/home/mvp/mvp_db/news7-lv/2002/2002_06_28_19_00/2002_06_28_19_00.mpg;Junichiro KOIZUMI.jpg;13941;14465;35957;697;723;26
/net/per610a/home/mvp/mvp_db/news7-lv/2002/2002_06_28_19_00/2002_06_28_19_00.mpg;Junichiro KOIZUMI.jpg;15917;17009;35957;796;850;54
/net/per610a/home/mvp/mvp_db/news7-lv/2002/2002_06_28_19_00/2002_06_28_19_00.mpg;Toranosuke Katayama.jpg;18425;18989;35957;921;950;29
/net/per610a/home/mvp/mvp_db/news7-lv/2002/2002_07_01_19_00/2002_07_01_19_00.mpg;Junichiro KOIZUMI.jpg;1905;2145;35957;95;107;12
/net/per610a/home/mvp/mvp_db/news7-lv/2002/2002_07_01_19_00/2002_07_01_19_00.mpg;Junichiro KOIZUMI.jpg;4665;4673;35957;233;233;0
/net/per610a/home/mvp/mvp_db/news7-lv/2002/2002_07_01_19_00/2002_07_01_19_00.mpg;Junichiro KOIZUMI.jpg;28185;28213;35957;1410;1411;1
/net/per610a/home/mvp/mvp_db/news7-lv/2002/2002_07_02_19_00/2002_07_02_19_00.mpg;Junichiro KOIZUMI.jpg;14241;14349;35957;712;717;5
/net/per610a/home/mvp/mvp_db/news7-lv/2002/2002_07_02_19_00/2002_07_02_19_00.mpg;Junichiro KOIZUMI.jpg;17061;17149;35957;853;857;4
/net/per610a/home/mvp/mvp_db/news7-lv/2002/2002_07_02_19_00/2002_07_02_19_00.mpg;Junichiro KOIZUMI.jpg;23729;23785;35957;1187;1190;3
/net/per610a/home/mvp/mvp_db/news7-lv/2002/2002_07_02_19_00/2002_07_02_19_00.mpg;Junichiro KOIZUMI.jpg;14693;15485;35957;735;774;39
/net/per610a/home/mvp/mvp_db/news7-lv/2002/2002_07_03_19_00/2002_07_03_19_00.mpg;Junichiro KOIZUMI.jpg;21357;23321;35957;1068;1166;98
/net/per610a/home/mvp/mvp_db/news7-lv/2002/2002_07_03_19_00/2002_07_03_19_00.mpg;Yasuo FUKUDA.jpg;26865;27113;35957;1344;1356;12
/net/per610a/home/mvp/mvp_db/news7-lv/2002/2002_07_04_19_00/2002_07_04_19_00.mpg;Junichiro KOIZUMI.jpg;6297;6537;35121;315;327;12
/net/per610a/home/mvp/mvp_db/news7-lv/2002/2002_07_04_19_00/2002_07_04_19_00.mpg;Toranosuke Katayama.jpg;15137;15793;35121;757;790;33
/net/per610a/home/mvp/mvp_db/news7-lv/2002/2002_07_04_19_00/2002_07_04_19_00.mpg;Toranosuke Katayama.jpg;16317;16841;35121;816;842;26
/net/per610a/home/mvp/mvp_db/news7-lv/2002/2002_07_06_19_00/2002_07_06_19_00.mpg;Takenori KANZAKI.jpg;25641;27045;35957;1282;1353;71
/net/per610a/home/mvp/mvp_db/news7-lv/2002/2002_07_06_19_00/2002_07_06_19_00.mpg;Ichiro OZAWA.jpg;27193;27377;35957;1360;1369;9
/net/per610a/home/mvp/mvp_db/news7-lv/2002/2002_07_08_19_00/2002_07_08_19_00.mpg;Junichiro KOIZUMI.jpg;22529;23649;35957;1127;1183;56
/net/per610a/home/mvp/mvp_db/news7-lv/2002/2002_07_08_19_00/2002_07_08_19_00.mpg;Junichiro KOIZUMI.jpg;23913;23981;35957;1196;1199;3
/net/per610a/home/mvp/mvp_db/news7-lv/2002/2002_07_09_19_00/2002_07_09_19_00.mpg;Junichiro KOIZUMI.jpg;10029;10929;35957;501;546;45
/net/per610a/home/mvp/mvp_db/news7-lv/2002/2002_07_12_19_00/2002_07_12_19_00.mpg;Naoto KAN.jpg;18837;19073;35957;942;954;12
/net/per610a/home/mvp/mvp_db/news7-lv/2002/2002_07_16_19_00/2002_07_16_19_00.mpg;Junichiro KOIZUMI.jpg;7917;8057;35957;396;403;7
/net/per610a/home/mvp/mvp_db/news7-lv/2002/2002_07_16_19_00/2002_07_16_19_00.mpg;Junichiro KOIZUMI.jpg;8257;8349;35957;413;417;4
/net/per610a/home/mvp/mvp_db/news7-lv/2002/2002_07_16_19_00/2002_07_16_19_00.mpg;Yasuo FUKUDA.jpg;13381;13853;35957;669;693;24
/net/per610a/home/mvp/mvp_db/news7-lv/2002/2002_07_17_19_00/2002_07_17_19_00.mpg;Kazuo SHII.jpg;4221;4669;35957;211;233;22
/net/per610a/home/mvp/mvp_db/news7-lv/2002/2002_07_17_19_00/2002_07_17_19_00.mpg;Yukio HATOYAMA.jpg;7145;7897;35957;357;395;38
/net/per610a/home/mvp/mvp_db/news7-lv/2002/2002_07_20_19_00/2002_07_20_19_00.mpg;Yukio HATOYAMA.jpg;13185;13445;35957;659;672;13
/net/per610a/home/mvp/mvp_db/news7-lv/2002/2002_07_24_19_00/2002_07_24_19_00.mpg;Junichiro KOIZUMI.jpg;6817;7277;35957;341;364;23
/net/per610a/home/mvp/mvp_db/news7-lv/2002/2002_07_24_19_00/2002_07_24_19_00.mpg;Junichiro KOIZUMI.jpg;25265;25389;35957;1264;1270;6
/net/per610a/home/mvp/mvp_db/news7-lv/2002/2002_07_24_19_00/2002_07_24_19_00.mpg;Yukio HATOYAMA.jpg;8741;10357;35957;437;518;81
/net/per610a/home/mvp/mvp_db/news7-lv/2002/2002_07_25_19_00/2002_07_25_19_00.mpg;Junichiro KOIZUMI.jpg;19113;19661;35957;956;983;27
/net/per610a/home/mvp/mvp_db/news7-lv/2002/2002_07_26_19_00/2002_07_26_19_00.mpg;Junichiro KOIZUMI.jpg;2673;3449;35957;133;172;39
/net/per610a/home/mvp/mvp_db/news7-lv/2002/2002_07_26_19_00/2002_07_26_19_00.mpg;Naoto KAN.jpg;3533;5117;35957;176;256;80
/net/per610a/home/mvp/mvp_db/news7-lv/2002/2002_07_29_19_00/2002_07_29_19_00.mpg;Junichiro KOIZUMI.jpg;16181;16269;35957;809;813;4
/net/per610a/home/mvp/mvp_db/news7-lv/2002/2002_07_29_19_00/2002_07_29_19_00.mpg;Junichiro KOIZUMI.jpg;16465;16561;35957;823;828;5
/net/per610a/home/mvp/mvp_db/news7-lv/2002/2002_07_29_19_00/2002_07_29_19_00.mpg;Junichiro KOIZUMI.jpg;16789;16881;35957;839;844;5
/net/per610a/home/mvp/mvp_db/news7-lv/2002/2002_07_29_19_00/2002_07_29_19_00.mpg;Takenori KANZAKI.jpg;16277;16389;35957;814;819;5
/net/per610a/home/mvp/mvp_db/news7-lv/2002/2002_07_29_19_00/2002_07_29_19_00.mpg;Takenori KANZAKI.jpg;16889;17381;35957;844;869;25
/net/per610a/home/mvp/mvp_db/news7-lv/2002/2002_07_29_19_00/2002_07_29_19_00.mpg;Kazuo SHII.jpg;18009;18205;35957;901;910;9
/net/per610a/home/mvp/mvp_db/news7-lv/2002/2002_07_29_19_00/2002_07_29_19_00.mpg;Yukio HATOYAMA.jpg;18361;19365;35957;918;968;50
/net/per610a/home/mvp/mvp_db/news7-lv/2002/2002_07_29_19_00/2002_07_29_19_00.mpg;Toranosuke Katayama.jpg;26661;27221;35957;1333;1361;28
/net/per610a/home/mvp/mvp_db/news7-lv/2002/2002_07_30_19_00/2002_07_30_19_00.mpg;Yasuo FUKUDA.jpg;4001;5325;35957;200;266;66
/net/per610a/home/mvp/mvp_db/news7-lv/2002/2002_07_30_19_00/2002_07_30_19_00.mpg;Junichiro KOIZUMI.jpg;10317;10397;35957;516;520;4
/net/per610a/home/mvp/mvp_db/news7-lv/2002/2002_07_30_19_00/2002_07_30_19_00.mpg;Junichiro KOIZUMI.jpg;10469;10529;35957;523;526;3
/net/per610a/home/mvp/mvp_db/news7-lv/2002/2002_07_30_19_00/2002_07_30_19_00.mpg;Junichiro KOIZUMI.jpg;11229;11281;35957;561;564;3
/net/per610a/home/mvp/mvp_db/news7-lv/2002/2002_07_30_19_00/2002_07_30_19_00.mpg;Junichiro KOIZUMI.jpg;11789;12017;35957;589;601;12
/net/per610a/home/mvp/mvp_db/news7-lv/2002/2002_07_31_19_00/2002_07_31_19_00.mpg;Junichiro KOIZUMI.jpg;1445;1777;35957;72;88;16
/net/per610a/home/mvp/mvp_db/news7-lv/2002/2002_07_31_19_00/2002_07_31_19_00.mpg;Junichiro KOIZUMI.jpg;2489;2601;35957;124;130;6
/net/per610a/home/mvp/mvp_db/news7-lv/2002/2002_07_31_19_00/2002_07_31_19_00.mpg;Junichiro KOIZUMI.jpg;3949;4009;35957;197;200;3
/net/per610a/home/mvp/mvp_db/news7-lv/2002/2002_07_31_19_00/2002_07_31_19_00.mpg;Junichiro KOIZUMI.jpg;9529;9601;35957;476;480;4
/net/per610a/home/mvp/mvp_db/news7-lv/2002/2002_07_31_19_00/2002_07_31_19_00.mpg;Junichiro KOIZUMI.jpg;10045;10097;35957;502;505;3
/net/per610a/home/mvp/mvp_db/news7-lv/2002/2002_07_31_19_00/2002_07_31_19_00.mpg;Junichiro KOIZUMI.jpg;10829;11145;35957;541;557;16
/net/per610a/home/mvp/mvp_db/news7-lv/2002/2002_07_31_19_00/2002_07_31_19_00.mpg;Junichiro KOIZUMI.jpg;11317;11357;35957;566;568;2
/net/per610a/home/mvp/mvp_db/news7-lv/2002/2002_07_31_19_00/2002_07_31_19_00.mpg;Junichiro KOIZUMI.jpg;14309;14389;35957;715;719;4
/net/per610a/home/mvp/mvp_db/news7-lv/2002/2002_07_31_19_00/2002_07_31_19_00.mpg;Junichiro KOIZUMI.jpg;16865;17189;35957;843;859;16
/net/per610a/home/mvp/mvp_db/news7-lv/2002/2002_07_31_19_00/2002_07_31_19_00.mpg;Naoto KAN.jpg;10597;10633;35957;530;531;1
/net/per610a/home/mvp/mvp_db/news7-lv/2002/2002_07_31_19_00/2002_07_31_19_00.mpg;Naoto KAN.jpg;12509;12689;35957;625;634;9
/net/per610a/home/mvp/mvp_db/news7-lv/2002/2002_07_31_19_00/2002_07_31_19_00.mpg;Yasuo FUKUDA.jpg;13345;13813;35957;667;691;24
/net/per610a/home/mvp/mvp_db/news7-lv/2002/2002_08_01_19_00/2002_08_01_19_00.mpg;Junichiro KOIZUMI.jpg;969;1229;35957;48;61;13
/net/per610a/home/mvp/mvp_db/news7-lv/2002/2002_08_01_19_00/2002_08_01_19_00.mpg;Junichiro KOIZUMI.jpg;9885;10557;35957;494;528;34
/net/per610a/home/mvp/mvp_db/news7-lv/2002/2002_08_01_19_00/2002_08_01_19_00.mpg;Junichiro KOIZUMI.jpg;10625;10853;35957;531;542;11
/net/per610a/home/mvp/mvp_db/news7-lv/2002/2002_08_01_19_00/2002_08_01_19_00.mpg;Junichiro KOIZUMI.jpg;10917;11353;35957;546;568;22
/net/per610a/home/mvp/mvp_db/news7-lv/2002/2002_08_01_19_00/2002_08_01_19_00.mpg;Junichiro KOIZUMI.jpg;11521;11905;35957;576;595;19
/net/per610a/home/mvp/mvp_db/news7-lv/2002/2002_08_01_19_00/2002_08_01_19_00.mpg;Junichiro KOIZUMI.jpg;11989;12341;35957;599;617;18
/net/per610a/home/mvp/mvp_db/news7-lv/2002/2002_08_02_19_00/2002_08_02_19_00.mpg;Toranosuke Katayama.jpg;22921;23345;35957;1146;1167;21
/net/per610a/home/mvp/mvp_db/news7-lv/2002/2002_08_02_19_00/2002_08_02_19_00.mpg;Toranosuke Katayama.jpg;25581;25857;35957;1279;1293;14
/net/per610a/home/mvp/mvp_db/news7-lv/2002/2002_08_05_19_00/2002_08_05_19_00.mpg;Yasuo FUKUDA.jpg;1633;2081;35957;81;104;23
/net/per610a/home/mvp/mvp_db/news7-lv/2002/2002_08_05_19_00/2002_08_05_19_00.mpg;Toranosuke Katayama.jpg;10969;11381;35957;548;569;21
/net/per610a/home/mvp/mvp_db/news7-lv/2002/2002_08_05_19_00/2002_08_05_19_00.mpg;Junichiro KOIZUMI.jpg;11513;12117;35957;576;606;30
/net/per610a/home/mvp/mvp_db/news7-lv/2002/2002_08_05_19_00/2002_08_05_19_00.mpg;Junichiro KOIZUMI.jpg;14293;15445;35957;715;772;57
/net/per610a/home/mvp/mvp_db/news7-lv/2002/2002_08_05_19_00/2002_08_05_19_00.mpg;Naoto KAN.jpg;18565;19477;35957;928;974;46
/net/per610a/home/mvp/mvp_db/news7-lv/2002/2002_08_06_19_00/2002_08_06_19_00.mpg;Yukio EDANO.jpg;5277;6413;35957;264;320;56
/net/per610a/home/mvp/mvp_db/news7-lv/2002/2002_08_06_19_00/2002_08_06_19_00.mpg;Naoto KAN.jpg;19101;19277;35957;955;964;9
/net/per610a/home/mvp/mvp_db/news7-lv/2002/2002_08_07_19_00/2002_08_07_19_00.mpg;Yukio HATOYAMA.jpg;24065;24985;35957;1204;1250;46
/net/per610a/home/mvp/mvp_db/news7-lv/2002/2002_08_07_19_00/2002_08_07_19_00.mpg;Yukio HATOYAMA.jpg;25065;26281;35957;1254;1314;60
/net/per610a/home/mvp/mvp_db/news7-lv/2002/2002_08_08_19_00/2002_08_08_19_00.mpg;Junichiro KOIZUMI.jpg;16881;17201;35957;844;860;16
/net/per610a/home/mvp/mvp_db/news7-lv/2002/2002_08_09_19_00/2002_08_09_19_00.mpg;Yukio HATOYAMA.jpg;15529;17129;35957;776;856;80
/net/per610a/home/mvp/mvp_db/news7-lv/2002/2002_08_10_19_00/2002_08_10_19_00.mpg;Junichiro KOIZUMI.jpg;26761;26865;35957;1338;1344;6
/net/per610a/home/mvp/mvp_db/news7-lv/2002/2002_08_10_19_00/2002_08_10_19_00.mpg;Junichiro KOIZUMI.jpg;27105;27933;35957;1356;1397;41
/net/per610a/home/mvp/mvp_db/news7-lv/2002/2002_08_11_19_00/2002_08_11_19_00.mpg;Junichiro KOIZUMI.jpg;10813;10929;23969;540;546;6
/net/per610a/home/mvp/mvp_db/news7-lv/2002/2002_08_12_19_00/2002_08_12_19_00.mpg;Junichiro KOIZUMI.jpg;13505;13549;35957;675;677;2
/net/per610a/home/mvp/mvp_db/news7-lv/2002/2002_08_12_19_00/2002_08_12_19_00.mpg;Junichiro KOIZUMI.jpg;13889;14077;35957;694;704;10
/net/per610a/home/mvp/mvp_db/news7-lv/2002/2002_08_12_19_00/2002_08_12_19_00.mpg;Junichiro KOIZUMI.jpg;14125;14349;35957;706;717;11
/net/per610a/home/mvp/mvp_db/news7-lv/2002/2002_08_12_19_00/2002_08_12_19_00.mpg;Junichiro KOIZUMI.jpg;15585;15693;35957;779;785;6
/net/per610a/home/mvp/mvp_db/news7-lv/2002/2002_08_28_19_00/2002_08_28_19_00.mpg;Takeo Hiranuma.jpeg;16989;17373;35957;849;869;20
/net/per610a/home/mvp/mvp_db/news7-lv/2002/2002_08_28_19_00/2002_08_28_19_00.mpg;Ichiro OZAWA.jpg;25069;25341;35957;1254;1267;13
/net/per610a/home/mvp/mvp_db/news7-lv/2002/2002_08_29_19_00/2002_08_29_19_00.mpg;Yoshihiko Noda.jpg;22613;22725;35961;1131;1136;5
/net/per610a/home/mvp/mvp_db/news7-lv/2002/2002_08_29_19_00/2002_08_29_19_00.mpg;Seiji MAEHARA.jpg;22621;22681;35961;1131;1134;3
/net/per610a/home/mvp/mvp_db/news7-lv/2002/2002_08_29_19_00/2002_08_29_19_00.mpg;Seiji MAEHARA.jpg;22857;23661;35961;1143;1183;40
/net/per610a/home/mvp/mvp_db/news7-lv/2002/2002_08_30_19_00/2002_08_30_19_00.mpg;Junichiro KOIZUMI.jpg;3481;4265;35961;174;213;39
/net/per610a/home/mvp/mvp_db/news7-lv/2002/2002_08_30_19_00/2002_08_30_19_00.mpg;Junichiro KOIZUMI.jpg;16389;17033;35961;819;852;33
/net/per610a/home/mvp/mvp_db/news7-lv/2002/2002_08_30_19_00/2002_08_30_19_00.mpg;Junichiro KOIZUMI.jpg;32261;32377;35961;1613;1619;6
/net/per610a/home/mvp/mvp_db/news7-lv/2002/2002_08_30_19_00/2002_08_30_19_00.mpg;Junichiro KOIZUMI.jpg;33297;34025;35961;1665;1702;37
/net/per610a/home/mvp/mvp_db/news7-lv/2002/2002_08_30_19_00/2002_08_30_19_00.mpg;Junichiro KOIZUMI.jpg;6553;7125;35961;327;356;29
/net/per610a/home/mvp/mvp_db/news7-lv/2002/2002_08_30_19_00/2002_08_30_19_00.mpg;Junichiro KOIZUMI.jpg;13281;13281;35961;664;664;0
/net/per610a/home/mvp/mvp_db/news7-lv/2002/2002_08_30_19_00/2002_08_30_19_00.mpg;Junichiro KOIZUMI.jpg;13573;13573;35961;679;679;0
/net/per610a/home/mvp/mvp_db/news7-lv/2002/2002_08_30_19_00/2002_08_30_19_00.mpg;Junichiro KOIZUMI.jpg;28941;28941;35961;1447;1447;0
/net/per610a/home/mvp/mvp_db/news7-lv/2002/2002_08_30_19_00/2002_08_30_19_00.mpg;Junichiro KOIZUMI.jpg;31941;32253;35961;1597;1613;16
/net/per610a/home/mvp/mvp_db/news7-lv/2002/2002_08_31_19_00/2002_08_31_19_00.mpg;Junichiro KOIZUMI.jpg;1805;2181;35957;90;109;19
/net/per610a/home/mvp/mvp_db/news7-lv/2002/2002_09_01_19_00/2002_09_01_19_00.mpg;Junichiro KOIZUMI.jpg;8505;8545;23973;425;427;2
/net/per610a/home/mvp/mvp_db/news7-lv/2002/2002_09_01_19_00/2002_09_01_19_00.mpg;Junichiro KOIZUMI.jpg;8617;8637;23973;430;431;1
/net/per610a/home/mvp/mvp_db/news7-lv/2002/2002_09_01_19_00/2002_09_01_19_00.mpg;Junichiro KOIZUMI.jpg;15837;16101;23973;792;805;13
/net/per610a/home/mvp/mvp_db/news7-lv/2002/2002_09_02_19_00/2002_09_02_19_00.mpg;Yoshihiko Noda.jpg;25309;25401;35957;1266;1270;4
/net/per610a/home/mvp/mvp_db/news7-lv/2002/2002_09_02_19_00/2002_09_02_19_00.mpg;Yukio HATOYAMA.jpg;25613;25841;35957;1281;1292;11
/net/per610a/home/mvp/mvp_db/news7-lv/2002/2002_09_02_19_00/2002_09_02_19_00.mpg;Naoto KAN.jpg;25613;26041;35957;1281;1302;21
/net/per610a/home/mvp/mvp_db/news7-lv/2002/2002_09_03_19_00/2002_09_03_19_00.mpg;Junichiro KOIZUMI.jpg;14781;14797;35957;739;740;1
/net/per610a/home/mvp/mvp_db/news7-lv/2002/2002_09_03_19_00/2002_09_03_19_00.mpg;Junichiro KOIZUMI.jpg;14905;14981;35957;745;749;4
/net/per610a/home/mvp/mvp_db/news7-lv/2002/2002_09_03_19_00/2002_09_03_19_00.mpg;Junichiro KOIZUMI.jpg;15385;15385;35957;769;769;0
/net/per610a/home/mvp/mvp_db/news7-lv/2002/2002_09_03_19_00/2002_09_03_19_00.mpg;Junichiro KOIZUMI.jpg;15509;16009;35957;775;800;25
/net/per610a/home/mvp/mvp_db/news7-lv/2002/2002_09_03_19_00/2002_09_03_19_00.mpg;Junichiro KOIZUMI.jpg;18913;19113;35957;946;956;10
/net/per610a/home/mvp/mvp_db/news7-lv/2002/2002_09_03_19_00/2002_09_03_19_00.mpg;Junichiro KOIZUMI.jpg;19225;19433;35957;961;972;11
/net/per610a/home/mvp/mvp_db/news7-lv/2002/2002_09_03_19_00/2002_09_03_19_00.mpg;Taro ASO.jpg;21069;21997;35957;1054;1100;46
/net/per610a/home/mvp/mvp_db/news7-lv/2002/2002_09_04_19_00/2002_09_04_19_00.mpg;Yasuo FUKUDA.jpg;2477;2957;35957;123;147;24
/net/per610a/home/mvp/mvp_db/news7-lv/2002/2002_09_05_19_00/2002_09_05_19_00.mpg;Junichiro KOIZUMI.jpg;4345;4589;35957;217;229;12
/net/per610a/home/mvp/mvp_db/news7-lv/2002/2002_09_05_19_00/2002_09_05_19_00.mpg;Junichiro KOIZUMI.jpg;5505;5669;35957;275;283;8
/net/per610a/home/mvp/mvp_db/news7-lv/2002/2002_09_05_19_00/2002_09_05_19_00.mpg;Junichiro KOIZUMI.jpg;5889;5957;35957;294;298;4
/net/per610a/home/mvp/mvp_db/news7-lv/2002/2002_09_05_19_00/2002_09_05_19_00.mpg;Junichiro KOIZUMI.jpg;22329;22373;35957;1117;1119;2
/net/per610a/home/mvp/mvp_db/news7-lv/2002/2002_09_05_19_00/2002_09_05_19_00.mpg;Yasuo FUKUDA.jpg;4645;5029;35957;232;251;19
/net/per610a/home/mvp/mvp_db/news7-lv/2002/2002_09_05_19_00/2002_09_05_19_00.mpg;Ichiro OZAWA.jpg;7481;8833;35957;374;441;67
/net/per610a/home/mvp/mvp_db/news7-lv/2002/2002_09_06_19_00/2002_09_06_19_00.mpg;Junichiro KOIZUMI.jpg;313;553;35957;15;27;12
/net/per610a/home/mvp/mvp_db/news7-lv/2002/2002_09_06_19_00/2002_09_06_19_00.mpg;Junichiro KOIZUMI.jpg;8401;8469;35957;420;423;3
/net/per610a/home/mvp/mvp_db/news7-lv/2002/2002_09_06_19_00/2002_09_06_19_00.mpg;Yasuo FUKUDA.jpg;5165;5693;35957;258;284;26
/net/per610a/home/mvp/mvp_db/news7-lv/2002/2002_09_06_19_00/2002_09_06_19_00.mpg;Naoto KAN.jpg;7793;7857;35957;389;393;4
/net/per610a/home/mvp/mvp_db/news7-lv/2002/2002_09_06_19_00/2002_09_06_19_00.mpg;Toranosuke Katayama.jpg;10317;10717;35957;516;536;20
/net/per610a/home/mvp/mvp_db/news7-lv/2002/2002_09_06_19_00/2002_09_06_19_00.mpg;Toranosuke Katayama.jpg;10853;11257;35957;542;563;21
/net/per610a/home/mvp/mvp_db/news7-lv/2002/2002_09_07_19_00/2002_09_07_19_00.mpg;Junichiro KOIZUMI.jpg;8625;8901;35957;431;445;14
/net/per610a/home/mvp/mvp_db/news7-lv/2002/2002_09_09_19_00/2002_09_09_19_00.mpg;Junichiro KOIZUMI.jpg;13705;14205;35957;685;710;25
/net/per610a/home/mvp/mvp_db/news7-lv/2002/2002_09_09_19_00/2002_09_09_19_00.mpg;Junichiro KOIZUMI.jpg;17973;18553;35957;899;928;29
/net/per610a/home/mvp/mvp_db/news7-lv/2002/2002_09_10_19_00/2002_09_10_19_00.mpg;Junichiro KOIZUMI.jpg;25561;25925;35957;1278;1297;19
/net/per610a/home/mvp/mvp_db/news7-lv/2002/2002_09_12_19_00/2002_09_12_19_00.mpg;Junichiro KOIZUMI.jpg;13937;14001;35957;697;700;3
/net/per610a/home/mvp/mvp_db/news7-lv/2002/2002_09_12_19_00/2002_09_12_19_00.mpg;Junichiro KOIZUMI.jpg;16873;16937;35957;844;847;3
/net/per610a/home/mvp/mvp_db/news7-lv/2002/2002_09_12_19_00/2002_09_12_19_00.mpg;Takeo Hiranuma.jpeg;22305;22673;35957;1115;1134;19
/net/per610a/home/mvp/mvp_db/news7-lv/2002/2002_09_13_19_00/2002_09_13_19_00.mpg;Yasuo FUKUDA.jpg;6645;7085;35957;332;354;22
/net/per610a/home/mvp/mvp_db/news7-lv/2002/2002_09_15_19_00/2002_09_15_19_00.mpg;Junichiro KOIZUMI.jpg;713;809;23969;35;40;5
/net/per610a/home/mvp/mvp_db/news7-lv/2002/2002_09_15_19_00/2002_09_15_19_00.mpg;Junichiro KOIZUMI.jpg;1629;2581;23969;81;129;48
/net/per610a/home/mvp/mvp_db/news7-lv/2002/2002_09_15_19_00/2002_09_15_19_00.mpg;Junichiro KOIZUMI.jpg;11333;12033;23969;566;601;35
/net/per610a/home/mvp/mvp_db/news7-lv/2002/2002_09_15_19_00/2002_09_15_19_00.mpg;Shinzo ABE.jpg;1177;1393;23969;58;69;11
/net/per610a/home/mvp/mvp_db/news7-lv/2002/2002_09_16_19_00/2002_09_16_19_00.mpg;Junichiro KOIZUMI.jpg;369;409;35957;18;20;2
/net/per610a/home/mvp/mvp_db/news7-lv/2002/2002_09_16_19_00/2002_09_16_19_00.mpg;Junichiro KOIZUMI.jpg;493;549;35957;24;27;3
/net/per610a/home/mvp/mvp_db/news7-lv/2002/2002_09_16_19_00/2002_09_16_19_00.mpg;Junichiro KOIZUMI.jpg;2021;2081;35957;101;104;3
/net/per610a/home/mvp/mvp_db/news7-lv/2002/2002_09_16_19_00/2002_09_16_19_00.mpg;Junichiro KOIZUMI.jpg;2841;3125;35957;142;156;14
/net/per610a/home/mvp/mvp_db/news7-lv/2002/2002_09_16_19_00/2002_09_16_19_00.mpg;Junichiro KOIZUMI.jpg;4937;5321;35957;247;266;19
/net/per610a/home/mvp/mvp_db/news7-lv/2002/2002_09_16_19_00/2002_09_16_19_00.mpg;Junichiro KOIZUMI.jpg;5389;5461;35957;269;273;4
/net/per610a/home/mvp/mvp_db/news7-lv/2002/2002_09_16_19_00/2002_09_16_19_00.mpg;Junichiro KOIZUMI.jpg;6081;6877;35957;304;344;40
/net/per610a/home/mvp/mvp_db/news7-lv/2002/2002_09_16_19_00/2002_09_16_19_00.mpg;Junichiro KOIZUMI.jpg;9205;9513;35957;460;475;15
/net/per610a/home/mvp/mvp_db/news7-lv/2002/2002_09_16_19_00/2002_09_16_19_00.mpg;Junichiro KOIZUMI.jpg;13569;14117;35957;678;706;28
/net/per610a/home/mvp/mvp_db/news7-lv/2002/2002_09_16_19_00/2002_09_16_19_00.mpg;Junichiro KOIZUMI.jpg;18253;18557;35957;913;928;15
/net/per610a/home/mvp/mvp_db/news7-lv/2002/2002_09_16_19_00/2002_09_16_19_00.mpg;Junichiro KOIZUMI.jpg;23001;23297;35957;1150;1165;15
/net/per610a/home/mvp/mvp_db/news7-lv/2002/2002_09_16_19_00/2002_09_16_19_00.mpg;Junichiro KOIZUMI.jpg;23705;24033;35957;1186;1202;16
/net/per610a/home/mvp/mvp_db/news7-lv/2002/2002_09_16_19_00/2002_09_16_19_00.mpg;Junichiro KOIZUMI.jpg;3177;3829;35957;158;191;33
/net/per610a/home/mvp/mvp_db/news7-lv/2002/2002_09_16_19_00/2002_09_16_19_00.mpg;Junichiro KOIZUMI.jpg;23337;23697;35957;1167;1185;18
/net/per610a/home/mvp/mvp_db/news7-lv/2002/2002_09_17_19_00/2002_09_17_19_00.mpg;Junichiro KOIZUMI.jpg;1;1261;35961;0;63;63
/net/per610a/home/mvp/mvp_db/news7-lv/2002/2002_09_17_19_00/2002_09_17_19_00.mpg;Junichiro KOIZUMI.jpg;3713;10841;35961;185;542;357
/net/per610a/home/mvp/mvp_db/news7-lv/2002/2002_09_17_19_00/2002_09_17_19_00.mpg;Junichiro KOIZUMI.jpg;10969;11085;35961;548;554;6
/net/per610a/home/mvp/mvp_db/news7-lv/2002/2002_09_17_19_00/2002_09_17_19_00.mpg;Junichiro KOIZUMI.jpg;33765;33793;35961;1689;1690;1
/net/per610a/home/mvp/mvp_db/news7-lv/2002/2002_09_18_19_00/2002_09_18_19_00.mpg;Junichiro KOIZUMI.jpg;2409;3085;35957;120;154;34
/net/per610a/home/mvp/mvp_db/news7-lv/2002/2002_09_18_19_00/2002_09_18_19_00.mpg;Junichiro KOIZUMI.jpg;3213;3365;35957;160;168;8
/net/per610a/home/mvp/mvp_db/news7-lv/2002/2002_09_18_19_00/2002_09_18_19_00.mpg;Junichiro KOIZUMI.jpg;6401;7317;35957;320;366;46
/net/per610a/home/mvp/mvp_db/news7-lv/2002/2002_09_18_19_00/2002_09_18_19_00.mpg;Junichiro KOIZUMI.jpg;10513;10685;35957;525;534;9
/net/per610a/home/mvp/mvp_db/news7-lv/2002/2002_09_18_19_00/2002_09_18_19_00.mpg;Yasuo FUKUDA.jpg;3577;4277;35957;178;213;35
/net/per610a/home/mvp/mvp_db/news7-lv/2002/2002_09_19_19_00/2002_09_19_19_00.mpg;Shinzo ABE.jpg;473;1201;35961;23;60;37
/net/per610a/home/mvp/mvp_db/news7-lv/2002/2002_09_19_19_00/2002_09_19_19_00.mpg;Shinzo ABE.jpg;9897;11145;35961;495;557;62
/net/per610a/home/mvp/mvp_db/news7-lv/2002/2002_09_19_19_00/2002_09_19_19_00.mpg;Shinzo ABE.jpg;11217;11829;35961;561;591;30
/net/per610a/home/mvp/mvp_db/news7-lv/2002/2002_09_19_19_00/2002_09_19_19_00.mpg;Junichiro KOIZUMI.jpg;6177;7149;35961;309;357;48
/net/per610a/home/mvp/mvp_db/news7-lv/2002/2002_09_19_19_00/2002_09_19_19_00.mpg;Junichiro KOIZUMI.jpg;7289;9381;35961;364;469;105
/net/per610a/home/mvp/mvp_db/news7-lv/2002/2002_09_19_19_00/2002_09_19_19_00.mpg;Junichiro KOIZUMI.jpg;28149;28201;35961;1408;1410;2
/net/per610a/home/mvp/mvp_db/news7-lv/2002/2002_09_19_19_00/2002_09_19_19_00.mpg;Junichiro KOIZUMI.jpg;28761;29405;35961;1438;1471;33
/net/per610a/home/mvp/mvp_db/news7-lv/2002/2002_09_19_19_00/2002_09_19_19_00.mpg;Junichiro KOIZUMI.jpg;29489;30081;35961;1475;1504;29
/net/per610a/home/mvp/mvp_db/news7-lv/2002/2002_09_21_19_00/2002_09_21_19_00.mpg;Junichiro KOIZUMI.jpg;8293;8381;35957;414;419;5
/net/per610a/home/mvp/mvp_db/news7-lv/2002/2002_09_21_19_00/2002_09_21_19_00.mpg;Junichiro KOIZUMI.jpg;10705;10729;35957;535;536;1
/net/per610a/home/mvp/mvp_db/news7-lv/2002/2002_09_21_19_00/2002_09_21_19_00.mpg;Junichiro KOIZUMI.jpg;14861;14981;35957;743;749;6
/net/per610a/home/mvp/mvp_db/news7-lv/2002/2002_09_21_19_00/2002_09_21_19_00.mpg;Junichiro KOIZUMI.jpg;18033;18469;35957;902;924;22
/net/per610a/home/mvp/mvp_db/news7-lv/2002/2002_09_22_19_00/2002_09_22_19_00.mpg;Junichiro KOIZUMI.jpg;5533;5645;23969;276;282;6
/net/per610a/home/mvp/mvp_db/news7-lv/2002/2002_09_22_19_00/2002_09_22_19_00.mpg;Junichiro KOIZUMI.jpg;22993;23057;23969;1150;1153;3
/net/per610a/home/mvp/mvp_db/news7-lv/2002/2002_09_23_19_00/2002_09_23_19_00.mpg;Yukio HATOYAMA.jpg;629;693;35957;31;34;3
/net/per610a/home/mvp/mvp_db/news7-lv/2002/2002_09_23_19_00/2002_09_23_19_00.mpg;Yukio HATOYAMA.jpg;9357;9445;35957;468;472;4
/net/per610a/home/mvp/mvp_db/news7-lv/2002/2002_09_23_19_00/2002_09_23_19_00.mpg;Yukio HATOYAMA.jpg;10721;10893;35957;536;544;8
/net/per610a/home/mvp/mvp_db/news7-lv/2002/2002_09_23_19_00/2002_09_23_19_00.mpg;Yukio HATOYAMA.jpg;11233;12709;35957;562;635;73
/net/per610a/home/mvp/mvp_db/news7-lv/2002/2002_09_23_19_00/2002_09_23_19_00.mpg;Yukio HATOYAMA.jpg;16245;16289;35957;812;814;2
/net/per610a/home/mvp/mvp_db/news7-lv/2002/2002_09_23_19_00/2002_09_23_19_00.mpg;Junichiro KOIZUMI.jpg;5537;5573;35957;277;278;1
/net/per610a/home/mvp/mvp_db/news7-lv/2002/2002_09_23_19_00/2002_09_23_19_00.mpg;Junichiro KOIZUMI.jpg;12825;13101;35957;641;655;14
/net/per610a/home/mvp/mvp_db/news7-lv/2002/2002_09_24_19_00/2002_09_24_19_00.mpg;Seiji MAEHARA.jpg;449;677;35957;22;33;11
/net/per610a/home/mvp/mvp_db/news7-lv/2002/2002_09_24_19_00/2002_09_24_19_00.mpg;Yasuo FUKUDA.jpg;1745;2665;35957;87;133;46
/net/per610a/home/mvp/mvp_db/news7-lv/2002/2002_09_24_19_00/2002_09_24_19_00.mpg;Junichiro KOIZUMI.jpg;9289;9289;35957;464;464;0
/net/per610a/home/mvp/mvp_db/news7-lv/2002/2002_09_24_19_00/2002_09_24_19_00.mpg;Junichiro KOIZUMI.jpg;9357;9357;35957;468;468;0
/net/per610a/home/mvp/mvp_db/news7-lv/2002/2002_09_24_19_00/2002_09_24_19_00.mpg;Junichiro KOIZUMI.jpg;9865;9945;35957;493;497;4
/net/per610a/home/mvp/mvp_db/news7-lv/2002/2002_09_24_19_00/2002_09_24_19_00.mpg;Yukio HATOYAMA.jpg;15005;15045;35957;750;752;2
/net/per610a/home/mvp/mvp_db/news7-lv/2002/2002_09_24_19_00/2002_09_24_19_00.mpg;Yukio HATOYAMA.jpg;15865;16081;35957;793;804;11
/net/per610a/home/mvp/mvp_db/news7-lv/2002/2002_09_24_19_00/2002_09_24_19_00.mpg;Yoshihiko Noda.jpg;16753;16833;35957;838;842;4
/net/per610a/home/mvp/mvp_db/news7-lv/2002/2002_09_25_19_00/2002_09_25_19_00.mpg;Junichiro KOIZUMI.jpg;2985;3593;35957;149;179;30
/net/per610a/home/mvp/mvp_db/news7-lv/2002/2002_09_25_19_00/2002_09_25_19_00.mpg;Junichiro KOIZUMI.jpg;9229;9469;35957;461;473;12
/net/per610a/home/mvp/mvp_db/news7-lv/2002/2002_09_25_19_00/2002_09_25_19_00.mpg;Yukio HATOYAMA.jpg;21213;22101;35957;1061;1105;44
/net/per610a/home/mvp/mvp_db/news7-lv/2002/2002_09_25_19_00/2002_09_25_19_00.mpg;Yukio HATOYAMA.jpg;22817;23341;35957;1141;1167;26
/net/per610a/home/mvp/mvp_db/news7-lv/2002/2002_09_25_19_00/2002_09_25_19_00.mpg;Yukio HATOYAMA.jpg;23249;23753;35957;1163;1188;25
/net/per610a/home/mvp/mvp_db/news7-lv/2002/2002_09_26_19_00/2002_09_26_19_00.mpg;Kyoko Nakayama.jpg;3989;4753;35957;199;237;38
/net/per610a/home/mvp/mvp_db/news7-lv/2002/2002_09_26_19_00/2002_09_26_19_00.mpg;Yasuo FUKUDA.jpg;17577;17957;35957;879;898;19
/net/per610a/home/mvp/mvp_db/news7-lv/2002/2002_09_26_19_00/2002_09_26_19_00.mpg;Yukio HATOYAMA.jpg;20189;20265;35957;1010;1013;3
/net/per610a/home/mvp/mvp_db/news7-lv/2002/2002_09_26_19_00/2002_09_26_19_00.mpg;Toranosuke Katayama.jpg;21813;22749;35957;1091;1138;47
/net/per610a/home/mvp/mvp_db/news7-lv/2002/2002_09_26_19_00/2002_09_26_19_00.mpg;Toranosuke Katayama.jpg;22861;23649;35957;1143;1183;40
/net/per610a/home/mvp/mvp_db/news7-lv/2002/2002_09_27_19_00/2002_09_27_19_00.mpg;Kyoko Nakayama.jpg;15089;16325;35957;754;816;62
/net/per610a/home/mvp/mvp_db/news7-lv/2002/2002_09_27_19_00/2002_09_27_19_00.mpg;Yukio HATOYAMA.jpg;21761;22029;35957;1088;1102;14
/net/per610a/home/mvp/mvp_db/news7-lv/2002/2002_09_27_19_00/2002_09_27_19_00.mpg;Takeo Hiranuma.jpeg;29269;29897;35957;1464;1495;31
/net/per610a/home/mvp/mvp_db/news7-lv/2002/2002_09_27_19_00/2002_09_27_19_00.mpg;Junichiro KOIZUMI.jpg;29905;31309;35957;1496;1566;70
/net/per610a/home/mvp/mvp_db/news7-lv/2002/2002_09_28_19_00/2002_09_28_19_00.mpg;Kyoko Nakayama.jpg;1217;1521;35957;60;76;16
/net/per610a/home/mvp/mvp_db/news7-lv/2002/2002_09_28_19_00/2002_09_28_19_00.mpg;Kyoko Nakayama.jpg;6761;6837;35957;338;342;4
/net/per610a/home/mvp/mvp_db/news7-lv/2002/2002_09_28_19_00/2002_09_28_19_00.mpg;Kyoko Nakayama.jpg;7465;8121;35957;373;406;33
/net/per610a/home/mvp/mvp_db/news7-lv/2002/2002_09_28_19_00/2002_09_28_19_00.mpg;Kyoko Nakayama.jpg;8197;8873;35957;410;443;33
/net/per610a/home/mvp/mvp_db/news7-lv/2002/2002_09_30_19_00/2002_09_30_19_00.mpg;Junichiro KOIZUMI.jpg;2013;2029;35957;100;101;1
/net/per610a/home/mvp/mvp_db/news7-lv/2002/2002_09_30_19_00/2002_09_30_19_00.mpg;Junichiro KOIZUMI.jpg;4817;4993;35957;241;249;8
/net/per610a/home/mvp/mvp_db/news7-lv/2002/2002_09_30_19_00/2002_09_30_19_00.mpg;Junichiro KOIZUMI.jpg;7609;7733;35957;380;386;6
/net/per610a/home/mvp/mvp_db/news7-lv/2002/2002_09_30_19_00/2002_09_30_19_00.mpg;Junichiro KOIZUMI.jpg;12821;12933;35957;641;647;6
/net/per610a/home/mvp/mvp_db/news7-lv/2002/2002_09_30_19_00/2002_09_30_19_00.mpg;Junichiro KOIZUMI.jpg;16321;16321;35957;816;816;0
/net/per610a/home/mvp/mvp_db/news7-lv/2002/2002_09_30_19_00/2002_09_30_19_00.mpg;Junichiro KOIZUMI.jpg;19037;19037;35957;952;952;0
/net/per610a/home/mvp/mvp_db/news7-lv/2002/2002_09_30_19_00/2002_09_30_19_00.mpg;Yasuo FUKUDA.jpg;2105;2185;35957;105;109;4
/net/per610a/home/mvp/mvp_db/news7-lv/2002/2002_09_30_19_00/2002_09_30_19_00.mpg;Yasuo FUKUDA.jpg;7229;7357;35957;361;368;7
/net/per610a/home/mvp/mvp_db/news7-lv/2002/2002_09_30_19_00/2002_09_30_19_00.mpg;Takeo Hiranuma.jpeg;3169;3281;35957;158;164;6
/net/per610a/home/mvp/mvp_db/news7-lv/2002/2002_09_30_19_00/2002_09_30_19_00.mpg;Junichiro KOIZUMI.jpg;5157;5297;35957;258;265;7
/net/per610a/home/mvp/mvp_db/news7-lv/2002/2002_09_30_19_00/2002_09_30_19_00.mpg;Junichiro KOIZUMI.jpg;19717;19829;35957;986;992;6
/net/per610a/home/mvp/mvp_db/news7-lv/2002/2002_10_03_19_00/2002_10_03_19_00.mpg;Junichiro KOIZUMI.jpg;14017;15389;35957;701;769;68
/net/per610a/home/mvp/mvp_db/news7-lv/2002/2002_10_03_19_00/2002_10_03_19_00.mpg;Junichiro KOIZUMI.jpg;22153;22757;35957;1108;1138;30
/net/per610a/home/mvp/mvp_db/news7-lv/2002/2002_10_03_19_00/2002_10_03_19_00.mpg;Kyoko Nakayama.jpg;15645;16013;35957;782;801;19
/net/per610a/home/mvp/mvp_db/news7-lv/2002/2002_10_03_19_00/2002_10_03_19_00.mpg;Yasuo FUKUDA.jpg;19761;20473;35957;988;1024;36
/net/per610a/home/mvp/mvp_db/news7-lv/2002/2002_10_03_19_00/2002_10_03_19_00.mpg;Sadakazu TANIGAKI.jpg;23725;24229;35957;1187;1212;25
/net/per610a/home/mvp/mvp_db/news7-lv/2002/2002_10_03_19_00/2002_10_03_19_00.mpg;Sadakazu TANIGAKI.jpg;24589;25533;35957;1230;1277;47
/net/per610a/home/mvp/mvp_db/news7-lv/2002/2002_10_03_19_00/2002_10_03_19_00.mpg;Sadakazu TANIGAKI.jpg;25677;26821;35957;1284;1341;57
/net/per610a/home/mvp/mvp_db/news7-lv/2002/2002_10_04_19_00/2002_10_04_19_00.mpg;Shinzo ABE.jpg;15625;15909;35957;781;795;14
/net/per610a/home/mvp/mvp_db/news7-lv/2002/2002_10_04_19_00/2002_10_04_19_00.mpg;Junichiro KOIZUMI.jpg;34809;35197;35957;1741;1760;19
/net/per610a/home/mvp/mvp_db/news7-lv/2002/2002_10_07_19_00/2002_10_07_19_00.mpg;Junichiro KOIZUMI.jpg;2097;2913;35957;104;145;41
/net/per610a/home/mvp/mvp_db/news7-lv/2002/2002_10_08_19_00/2002_10_08_19_00.mpg;Ichiro OZAWA.jpg;29625;29713;35957;1482;1486;4
/net/per610a/home/mvp/mvp_db/news7-lv/2002/2002_10_08_19_00/2002_10_08_19_00.mpg;Ichiro OZAWA.jpg;29813;29829;35957;1491;1492;1
/net/per610a/home/mvp/mvp_db/news7-lv/2002/2002_10_08_19_00/2002_10_08_19_00.mpg;Ichiro OZAWA.jpg;29969;30625;35957;1499;1532;33
/net/per610a/home/mvp/mvp_db/news7-lv/2002/2002_10_08_19_00/2002_10_08_19_00.mpg;Ichiro OZAWA.jpg;30829;31093;35957;1542;1555;13
/net/per610a/home/mvp/mvp_db/news7-lv/2002/2002_10_09_19_00/2002_10_09_19_00.mpg;Junichiro KOIZUMI.jpg;27097;28633;35961;1355;1432;77
/net/per610a/home/mvp/mvp_db/news7-lv/2002/2002_10_09_19_00/2002_10_09_19_00.mpg;Junichiro KOIZUMI.jpg;29557;29589;35961;1478;1480;2
/net/per610a/home/mvp/mvp_db/news7-lv/2002/2002_10_11_19_00/2002_10_11_19_00.mpg;Ichiro OZAWA.jpg;909;957;35957;45;47;2
/net/per610a/home/mvp/mvp_db/news7-lv/2002/2002_10_11_19_00/2002_10_11_19_00.mpg;Ichiro OZAWA.jpg;19073;19117;35957;954;956;2
/net/per610a/home/mvp/mvp_db/news7-lv/2002/2002_10_11_19_00/2002_10_11_19_00.mpg;Ichiro OZAWA.jpg;19497;19501;35957;975;975;0
/net/per610a/home/mvp/mvp_db/news7-lv/2002/2002_10_11_19_00/2002_10_11_19_00.mpg;YUriko Koike.jpg;8101;8345;35957;405;417;12
/net/per610a/home/mvp/mvp_db/news7-lv/2002/2002_10_11_19_00/2002_10_11_19_00.mpg;Junichiro KOIZUMI.jpg;19129;19213;35957;957;961;4
/net/per610a/home/mvp/mvp_db/news7-lv/2002/2002_10_11_19_00/2002_10_11_19_00.mpg;Junichiro KOIZUMI.jpg;19341;19381;35957;967;969;2
/net/per610a/home/mvp/mvp_db/news7-lv/2002/2002_10_13_19_00/2002_10_13_19_00.mpg;Junichiro KOIZUMI.jpg;18281;18825;23969;914;941;27
/net/per610a/home/mvp/mvp_db/news7-lv/2002/2002_10_14_19_00/2002_10_14_19_00.mpg;Junichiro KOIZUMI.jpg;18705;19001;35957;935;950;15
/net/per610a/home/mvp/mvp_db/news7-lv/2002/2002_10_14_19_00/2002_10_14_19_00.mpg;Junichiro KOIZUMI.jpg;19337;19717;35957;967;986;19
/net/per610a/home/mvp/mvp_db/news7-lv/2002/2002_10_16_19_00/2002_10_16_19_00.mpg;Junichiro KOIZUMI.jpg;26697;27093;35957;1335;1355;20
/net/per610a/home/mvp/mvp_db/news7-lv/2002/2002_10_18_19_00/2002_10_18_19_00.mpg;Junichiro KOIZUMI.jpg;6861;6921;35957;343;346;3
/net/per610a/home/mvp/mvp_db/news7-lv/2002/2002_10_18_19_00/2002_10_18_19_00.mpg;Junichiro KOIZUMI.jpg;7113;7213;35957;355;360;5
/net/per610a/home/mvp/mvp_db/news7-lv/2002/2002_10_18_19_00/2002_10_18_19_00.mpg;Yasuo FUKUDA.jpg;29097;29289;35957;1455;1465;10
/net/per610a/home/mvp/mvp_db/news7-lv/2002/2002_10_18_19_00/2002_10_18_19_00.mpg;Yasuo FUKUDA.jpg;29421;29681;35957;1471;1484;13
/net/per610a/home/mvp/mvp_db/news7-lv/2002/2002_10_19_19_00/2002_10_19_19_00.mpg;Junichiro KOIZUMI.jpg;4221;5229;35957;211;261;50
/net/per610a/home/mvp/mvp_db/news7-lv/2002/2002_10_20_19_00/2002_10_20_19_00.mpg;Junichiro KOIZUMI.jpg;5965;6109;23969;298;305;7
/net/per610a/home/mvp/mvp_db/news7-lv/2002/2002_10_21_19_00/2002_10_21_19_00.mpg;Shinzo ABE.jpg;6093;7109;35957;304;355;51
/net/per610a/home/mvp/mvp_db/news7-lv/2002/2002_10_22_19_00/2002_10_22_19_00.mpg;Shinzo ABE.jpg;6489;6977;35957;324;349;25
/net/per610a/home/mvp/mvp_db/news7-lv/2002/2002_10_22_19_00/2002_10_22_19_00.mpg;Shinzo ABE.jpg;7045;7525;35957;352;376;24
/net/per610a/home/mvp/mvp_db/news7-lv/2002/2002_10_22_19_00/2002_10_22_19_00.mpg;Junichiro KOIZUMI.jpg;18613;20049;35957;931;1003;72
/net/per610a/home/mvp/mvp_db/news7-lv/2002/2002_10_22_19_00/2002_10_22_19_00.mpg;Junichiro KOIZUMI.jpg;22965;23057;35957;1148;1153;5
/net/per610a/home/mvp/mvp_db/news7-lv/2002/2002_10_22_19_00/2002_10_22_19_00.mpg;Junichiro KOIZUMI.jpg;23133;23153;35957;1157;1158;1
/net/per610a/home/mvp/mvp_db/news7-lv/2002/2002_10_22_19_00/2002_10_22_19_00.mpg;Junichiro KOIZUMI.jpg;23217;23257;35957;1161;1163;2
/net/per610a/home/mvp/mvp_db/news7-lv/2002/2002_10_23_19_00/2002_10_23_19_00.mpg;Junichiro KOIZUMI.jpg;8285;8757;35957;414;438;24
/net/per610a/home/mvp/mvp_db/news7-lv/2002/2002_10_23_19_00/2002_10_23_19_00.mpg;Junichiro KOIZUMI.jpg;18841;19541;35957;942;977;35
/net/per610a/home/mvp/mvp_db/news7-lv/2002/2002_10_24_19_00/2002_10_24_19_00.mpg;Yasuo FUKUDA.jpg;1;285;35957;0;14;14
/net/per610a/home/mvp/mvp_db/news7-lv/2002/2002_10_24_19_00/2002_10_24_19_00.mpg;Yasuo FUKUDA.jpg;2357;3469;35957;117;173;56
/net/per610a/home/mvp/mvp_db/news7-lv/2002/2002_10_24_19_00/2002_10_24_19_00.mpg;Yasuo FUKUDA.jpg;12977;13997;35957;649;700;51
/net/per610a/home/mvp/mvp_db/news7-lv/2002/2002_10_24_19_00/2002_10_24_19_00.mpg;Junichiro KOIZUMI.jpg;26681;27321;35957;1334;1366;32
/net/per610a/home/mvp/mvp_db/news7-lv/2002/2002_10_24_19_00/2002_10_24_19_00.mpg;Junichiro KOIZUMI.jpg;27449;27765;35957;1373;1389;16
/net/per610a/home/mvp/mvp_db/news7-lv/2002/2002_10_25_19_00/2002_10_25_19_00.mpg;Junichiro KOIZUMI.jpg;27913;28045;35957;1396;1403;7
/net/per610a/home/mvp/mvp_db/news7-lv/2002/2002_10_28_19_00/2002_10_28_19_00.mpg;Junichiro KOIZUMI.jpg;825;1061;35957;41;53;12
/net/per610a/home/mvp/mvp_db/news7-lv/2002/2002_10_28_19_00/2002_10_28_19_00.mpg;Kyoko Nakayama.jpg;6905;7085;35957;345;354;9
/net/per610a/home/mvp/mvp_db/news7-lv/2002/2002_10_29_19_00/2002_10_29_19_00.mpg;Yasuo FUKUDA.jpg;19385;19701;35957;969;985;16
/net/per610a/home/mvp/mvp_db/news7-lv/2002/2002_10_30_19_00/2002_10_30_19_00.mpg;Yasuo FUKUDA.jpg;5321;5621;35957;266;281;15
/net/per610a/home/mvp/mvp_db/news7-lv/2002/2002_10_31_19_00/2002_10_31_19_00.mpg;Ichiro OZAWA.jpg;1053;1197;35957;52;59;7
/net/per610a/home/mvp/mvp_db/news7-lv/2002/2002_10_31_19_00/2002_10_31_19_00.mpg;Ichiro OZAWA.jpg;23517;23521;35957;1176;1176;0
/net/per610a/home/mvp/mvp_db/news7-lv/2002/2002_10_31_19_00/2002_10_31_19_00.mpg;Ichiro OZAWA.jpg;24361;24361;35957;1218;1218;0
/net/per610a/home/mvp/mvp_db/news7-lv/2002/2002_10_31_19_00/2002_10_31_19_00.mpg;Ichiro OZAWA.jpg;24425;24597;35957;1222;1230;8
/net/per610a/home/mvp/mvp_db/news7-lv/2002/2002_11_01_19_00/2002_11_01_19_00.mpg;Yasuo FUKUDA.jpg;3185;3681;35957;159;184;25
/net/per610a/home/mvp/mvp_db/news7-lv/2002/2002_11_02_19_00/2002_11_02_19_00.mpg;Takenori KANZAKI.jpg;8933;9001;35957;446;450;4
/net/per610a/home/mvp/mvp_db/news7-lv/2002/2002_11_02_19_00/2002_11_02_19_00.mpg;Takenori KANZAKI.jpg;12349;12477;35957;617;624;7
/net/per610a/home/mvp/mvp_db/news7-lv/2002/2002_11_02_19_00/2002_11_02_19_00.mpg;Takenori KANZAKI.jpg;9109;9661;35957;455;483;28
/net/per610a/home/mvp/mvp_db/news7-lv/2002/2002_11_02_19_00/2002_11_02_19_00.mpg;Takenori KANZAKI.jpg;9761;10437;35957;488;522;34
/net/per610a/home/mvp/mvp_db/news7-lv/2002/2002_11_03_19_00/2002_11_03_19_00.mpg;Shinzo ABE.jpg;1681;1853;23969;84;92;8
/net/per610a/home/mvp/mvp_db/news7-lv/2002/2002_11_03_19_00/2002_11_03_19_00.mpg;Junichiro KOIZUMI.jpg;6305;6577;23969;315;329;14
/net/per610a/home/mvp/mvp_db/news7-lv/2002/2002_11_04_19_00/2002_11_04_19_00.mpg;Junichiro KOIZUMI.jpg;213;281;35957;10;14;4
/net/per610a/home/mvp/mvp_db/news7-lv/2002/2002_11_04_19_00/2002_11_04_19_00.mpg;Junichiro KOIZUMI.jpg;4473;4513;35957;223;225;2
/net/per610a/home/mvp/mvp_db/news7-lv/2002/2002_11_04_19_00/2002_11_04_19_00.mpg;Junichiro KOIZUMI.jpg;1505;1525;35957;75;76;1
/net/per610a/home/mvp/mvp_db/news7-lv/2002/2002_11_04_19_00/2002_11_04_19_00.mpg;Junichiro KOIZUMI.jpg;2953;3165;35957;147;158;11
/net/per610a/home/mvp/mvp_db/news7-lv/2002/2002_11_04_19_00/2002_11_04_19_00.mpg;Junichiro KOIZUMI.jpg;3893;4001;35957;194;200;6
/net/per610a/home/mvp/mvp_db/news7-lv/2002/2002_11_05_19_00/2002_11_05_19_00.mpg;Shinzo ABE.jpg;9313;9341;35957;465;467;2
/net/per610a/home/mvp/mvp_db/news7-lv/2002/2002_11_05_19_00/2002_11_05_19_00.mpg;Shinzo ABE.jpg;13053;13097;35957;653;655;2
/net/per610a/home/mvp/mvp_db/news7-lv/2002/2002_11_05_19_00/2002_11_05_19_00.mpg;Shinzo ABE.jpg;13213;14057;35957;661;703;42
/net/per610a/home/mvp/mvp_db/news7-lv/2002/2002_11_05_19_00/2002_11_05_19_00.mpg;Shinzo ABE.jpg;14357;14525;35957;718;726;8
/net/per610a/home/mvp/mvp_db/news7-lv/2002/2002_11_05_19_00/2002_11_05_19_00.mpg;Junichiro KOIZUMI.jpg;26997;27285;35957;1350;1365;15
/net/per610a/home/mvp/mvp_db/news7-lv/2002/2002_11_06_19_00/2002_11_06_19_00.mpg;Kyoko Nakayama.jpg;653;705;35957;32;35;3
/net/per610a/home/mvp/mvp_db/news7-lv/2002/2002_11_06_19_00/2002_11_06_19_00.mpg;Kyoko Nakayama.jpg;8645;8697;35957;432;435;3
/net/per610a/home/mvp/mvp_db/news7-lv/2002/2002_11_06_19_00/2002_11_06_19_00.mpg;Kyoko Nakayama.jpg;709;981;35957;35;49;14
/net/per610a/home/mvp/mvp_db/news7-lv/2002/2002_11_06_19_00/2002_11_06_19_00.mpg;Kyoko Nakayama.jpg;8505;8521;35957;425;426;1
/net/per610a/home/mvp/mvp_db/news7-lv/2002/2002_11_06_19_00/2002_11_06_19_00.mpg;Shinzo ABE.jpg;7969;7997;35957;398;400;2
/net/per610a/home/mvp/mvp_db/news7-lv/2002/2002_11_06_19_00/2002_11_06_19_00.mpg;Shinzo ABE.jpg;8425;8481;35957;421;424;3
/net/per610a/home/mvp/mvp_db/news7-lv/2002/2002_11_06_19_00/2002_11_06_19_00.mpg;Junichiro KOIZUMI.jpg;11757;12429;35957;588;621;33
/net/per610a/home/mvp/mvp_db/news7-lv/2002/2002_11_06_19_00/2002_11_06_19_00.mpg;Junichiro KOIZUMI.jpg;22673;23477;35957;1134;1174;40
/net/per610a/home/mvp/mvp_db/news7-lv/2002/2002_11_06_19_00/2002_11_06_19_00.mpg;Yukio HATOYAMA.jpg;13805;14549;35957;690;727;37
/net/per610a/home/mvp/mvp_db/news7-lv/2002/2002_11_06_19_00/2002_11_06_19_00.mpg;Kazuo SHII.jpg;14629;14873;35957;731;744;13
/net/per610a/home/mvp/mvp_db/news7-lv/2002/2002_11_07_19_00/2002_11_07_19_00.mpg;Junichiro KOIZUMI.jpg;18041;18513;35957;902;926;24
/net/per610a/home/mvp/mvp_db/news7-lv/2002/2002_11_07_19_00/2002_11_07_19_00.mpg;Junichiro KOIZUMI.jpg;22869;22913;35957;1144;1146;2
/net/per610a/home/mvp/mvp_db/news7-lv/2002/2002_11_07_19_00/2002_11_07_19_00.mpg;Junichiro KOIZUMI.jpg;23861;24313;35957;1193;1216;23
/net/per610a/home/mvp/mvp_db/news7-lv/2002/2002_11_07_19_00/2002_11_07_19_00.mpg;Yasuo FUKUDA.jpg;22089;22753;35957;1105;1138;33
/net/per610a/home/mvp/mvp_db/news7-lv/2002/2002_11_07_19_00/2002_11_07_19_00.mpg;Yasuo FUKUDA.jpg;28489;29057;35957;1425;1453;28
/net/per610a/home/mvp/mvp_db/news7-lv/2002/2002_11_08_19_00/2002_11_08_19_00.mpg;Yasuo FUKUDA.jpg;4501;5681;35957;225;284;59
/net/per610a/home/mvp/mvp_db/news7-lv/2002/2002_11_08_19_00/2002_11_08_19_00.mpg;Yasuo FUKUDA.jpg;11353;12069;35957;568;603;35
/net/per610a/home/mvp/mvp_db/news7-lv/2002/2002_11_12_19_00/2002_11_12_19_00.mpg;Toranosuke Katayama.jpg;12701;13457;35957;635;673;38
/net/per610a/home/mvp/mvp_db/news7-lv/2002/2002_11_12_19_00/2002_11_12_19_00.mpg;Toranosuke Katayama.jpg;23209;23325;35957;1161;1166;5
/net/per610a/home/mvp/mvp_db/news7-lv/2002/2002_11_13_19_00/2002_11_13_19_00.mpg;Junichiro KOIZUMI.jpg;21321;22981;35957;1066;1149;83
/net/per610a/home/mvp/mvp_db/news7-lv/2002/2002_11_14_19_00/2002_11_14_19_00.mpg;Yasuo FUKUDA.jpg;15521;15917;35957;776;796;20
/net/per610a/home/mvp/mvp_db/news7-lv/2002/2002_11_15_19_00/2002_11_15_19_00.mpg;Yasuo FUKUDA.jpg;12317;12689;35957;616;634;18
/net/per610a/home/mvp/mvp_db/news7-lv/2002/2002_11_15_19_00/2002_11_15_19_00.mpg;Junichiro KOIZUMI.jpg;12697;12765;35957;635;638;3
/net/per610a/home/mvp/mvp_db/news7-lv/2002/2002_11_15_19_00/2002_11_15_19_00.mpg;Junichiro KOIZUMI.jpg;13185;13325;35957;659;666;7
/net/per610a/home/mvp/mvp_db/news7-lv/2002/2002_11_15_19_00/2002_11_15_19_00.mpg;Sadakazu TANIGAKI.jpg;24265;24665;35957;1214;1234;20
/net/per610a/home/mvp/mvp_db/news7-lv/2002/2002_11_26_19_00/2002_11_26_19_00.mpg;Junichiro KOIZUMI.jpg;4409;5765;35957;220;288;68
/net/per610a/home/mvp/mvp_db/news7-lv/2002/2002_11_26_19_00/2002_11_26_19_00.mpg;Yasuo FUKUDA.jpg;10489;10833;35957;524;541;17
/net/per610a/home/mvp/mvp_db/news7-lv/2002/2002_11_27_19_00/2002_11_27_19_00.mpg;Shinzo ABE.jpg;1281;1649;35957;64;82;18
/net/per610a/home/mvp/mvp_db/news7-lv/2002/2002_11_27_19_00/2002_11_27_19_00.mpg;Shinzo ABE.jpg;20141;20149;35957;1007;1008;1
/net/per610a/home/mvp/mvp_db/news7-lv/2002/2002_11_27_19_00/2002_11_27_19_00.mpg;Shinzo ABE.jpg;20633;21273;35957;1032;1064;32
/net/per610a/home/mvp/mvp_db/news7-lv/2002/2002_11_27_19_00/2002_11_27_19_00.mpg;Shinzo ABE.jpg;22605;24101;35957;1130;1205;75
/net/per610a/home/mvp/mvp_db/news7-lv/2002/2002_11_28_19_00/2002_11_28_19_00.mpg;Junichiro KOIZUMI.jpg;23385;23929;35957;1169;1197;28
/net/per610a/home/mvp/mvp_db/news7-lv/2002/2002_11_28_19_00/2002_11_28_19_00.mpg;Junichiro KOIZUMI.jpg;24701;24785;35957;1235;1240;5
/net/per610a/home/mvp/mvp_db/news7-lv/2002/2002_11_28_19_00/2002_11_28_19_00.mpg;Junichiro KOIZUMI.jpg;25705;25861;35957;1286;1293;7
/net/per610a/home/mvp/mvp_db/news7-lv/2002/2002_11_28_19_00/2002_11_28_19_00.mpg;Junichiro KOIZUMI.jpg;24093;24161;35957;1205;1208;3
/net/per610a/home/mvp/mvp_db/news7-lv/2002/2002_11_28_19_00/2002_11_28_19_00.mpg;Junichiro KOIZUMI.jpg;24597;24677;35957;1230;1234;4
/net/per610a/home/mvp/mvp_db/news7-lv/2002/2002_11_28_19_00/2002_11_28_19_00.mpg;Junichiro KOIZUMI.jpg;25545;25697;35957;1278;1285;7
/net/per610a/home/mvp/mvp_db/news7-lv/2002/2002_11_28_19_00/2002_11_28_19_00.mpg;Junichiro KOIZUMI.jpg;25901;26709;35957;1295;1336;41
/net/per610a/home/mvp/mvp_db/news7-lv/2002/2002_11_29_19_00/2002_11_29_19_00.mpg;Yukio HATOYAMA.jpg;13233;14069;35957;662;703;41
/net/per610a/home/mvp/mvp_db/news7-lv/2002/2002_11_29_19_00/2002_11_29_19_00.mpg;Yasuo FUKUDA.jpg;16393;17149;35957;820;857;37
/net/per610a/home/mvp/mvp_db/news7-lv/2002/2002_11_29_19_00/2002_11_29_19_00.mpg;Toranosuke Katayama.jpg;31857;32109;35957;1593;1606;13
/net/per610a/home/mvp/mvp_db/news7-lv/2002/2002_11_30_19_00/2002_11_30_19_00.mpg;Yukio HATOYAMA.jpg;12901;13769;35957;645;688;43
/net/per610a/home/mvp/mvp_db/news7-lv/2002/2002_12_01_19_00/2002_12_01_19_00.mpg;Yukio HATOYAMA.jpg;6313;6789;23973;315;339;24
/net/per610a/home/mvp/mvp_db/news7-lv/2002/2002_12_01_19_00/2002_12_01_19_00.mpg;Yukio HATOYAMA.jpg;10061;10481;23973;503;524;21
/net/per610a/home/mvp/mvp_db/news7-lv/2002/2002_12_01_19_00/2002_12_01_19_00.mpg;Yukio HATOYAMA.jpg;10605;12141;23973;530;607;77
/net/per610a/home/mvp/mvp_db/news7-lv/2002/2002_12_02_19_00/2002_12_02_19_00.mpg;Yukio HATOYAMA.jpg;165;537;35957;8;26;18
/net/per610a/home/mvp/mvp_db/news7-lv/2002/2002_12_02_19_00/2002_12_02_19_00.mpg;Yukio HATOYAMA.jpg;2365;2397;35957;118;119;1
/net/per610a/home/mvp/mvp_db/news7-lv/2002/2002_12_02_19_00/2002_12_02_19_00.mpg;Yukio HATOYAMA.jpg;2609;2661;35957;130;133;3
/net/per610a/home/mvp/mvp_db/news7-lv/2002/2002_12_02_19_00/2002_12_02_19_00.mpg;Yukio HATOYAMA.jpg;3005;3141;35957;150;157;7
/net/per610a/home/mvp/mvp_db/news7-lv/2002/2002_12_02_19_00/2002_12_02_19_00.mpg;Yukio HATOYAMA.jpg;7849;7897;35957;392;395;3
/net/per610a/home/mvp/mvp_db/news7-lv/2002/2002_12_02_19_00/2002_12_02_19_00.mpg;Yukio HATOYAMA.jpg;8357;8369;35957;418;418;0
/net/per610a/home/mvp/mvp_db/news7-lv/2002/2002_12_02_19_00/2002_12_02_19_00.mpg;Junichiro KOIZUMI.jpg;857;1045;35957;42;52;10
/net/per610a/home/mvp/mvp_db/news7-lv/2002/2002_12_02_19_00/2002_12_02_19_00.mpg;Yukio HATOYAMA.jpg;6293;6301;35957;314;315;1
/net/per610a/home/mvp/mvp_db/news7-lv/2002/2002_12_02_19_00/2002_12_02_19_00.mpg;Yukio HATOYAMA.jpg;6765;7209;35957;338;360;22
/net/per610a/home/mvp/mvp_db/news7-lv/2002/2002_12_02_19_00/2002_12_02_19_00.mpg;Junichiro KOIZUMI.jpg;10633;10745;35957;531;537;6
/net/per610a/home/mvp/mvp_db/news7-lv/2002/2002_12_02_19_00/2002_12_02_19_00.mpg;Junichiro KOIZUMI.jpg;22293;22717;35957;1115;1136;21
/net/per610a/home/mvp/mvp_db/news7-lv/2002/2002_12_03_19_00/2002_12_03_19_00.mpg;Yukio HATOYAMA.jpg;2425;2489;35957;121;124;3
/net/per610a/home/mvp/mvp_db/news7-lv/2002/2002_12_03_19_00/2002_12_03_19_00.mpg;Yukio HATOYAMA.jpg;3097;5117;35957;154;256;102
/net/per610a/home/mvp/mvp_db/news7-lv/2002/2002_12_03_19_00/2002_12_03_19_00.mpg;Yukio HATOYAMA.jpg;5825;5993;35957;291;299;8
/net/per610a/home/mvp/mvp_db/news7-lv/2002/2002_12_03_19_00/2002_12_03_19_00.mpg;Junichiro KOIZUMI.jpg;5125;5605;35957;256;280;24
/net/per610a/home/mvp/mvp_db/news7-lv/2002/2002_12_03_19_00/2002_12_03_19_00.mpg;Junichiro KOIZUMI.jpg;16625;16989;35957;831;849;18
/net/per610a/home/mvp/mvp_db/news7-lv/2002/2002_12_03_19_00/2002_12_03_19_00.mpg;Yoshihiko Noda.jpg;7849;8305;35957;392;415;23
/net/per610a/home/mvp/mvp_db/news7-lv/2002/2002_12_04_19_00/2002_12_04_19_00.mpg;Yasuo FUKUDA.jpg;2917;4089;35961;145;204;59
/net/per610a/home/mvp/mvp_db/news7-lv/2002/2002_12_04_19_00/2002_12_04_19_00.mpg;Yasuo FUKUDA.jpg;13153;13657;35961;657;683;26
/net/per610a/home/mvp/mvp_db/news7-lv/2002/2002_12_04_19_00/2002_12_04_19_00.mpg;Junichiro KOIZUMI.jpg;4669;4941;35961;233;247;14
/net/per610a/home/mvp/mvp_db/news7-lv/2002/2002_12_04_19_00/2002_12_04_19_00.mpg;Junichiro KOIZUMI.jpg;6169;6293;35961;308;314;6
/net/per610a/home/mvp/mvp_db/news7-lv/2002/2002_12_04_19_00/2002_12_04_19_00.mpg;Junichiro KOIZUMI.jpg;8197;8281;35961;410;414;4
/net/per610a/home/mvp/mvp_db/news7-lv/2002/2002_12_04_19_00/2002_12_04_19_00.mpg;Junichiro KOIZUMI.jpg;10825;11381;35961;541;569;28
/net/per610a/home/mvp/mvp_db/news7-lv/2002/2002_12_04_19_00/2002_12_04_19_00.mpg;Yukio HATOYAMA.jpg;14873;14965;35961;744;748;4
/net/per610a/home/mvp/mvp_db/news7-lv/2002/2002_12_04_19_00/2002_12_04_19_00.mpg;Yukio HATOYAMA.jpg;15437;15569;35961;772;778;6
/net/per610a/home/mvp/mvp_db/news7-lv/2002/2002_12_04_19_00/2002_12_04_19_00.mpg;Yukio HATOYAMA.jpg;15653;15749;35961;783;787;4
/net/per610a/home/mvp/mvp_db/news7-lv/2002/2002_12_04_19_00/2002_12_04_19_00.mpg;Junichiro KOIZUMI.jpg;26645;27225;35961;1332;1361;29
/net/per610a/home/mvp/mvp_db/news7-lv/2002/2002_12_05_19_00/2002_12_05_19_00.mpg;Yasuo FUKUDA.jpg;3869;4173;35961;193;208;15
/net/per610a/home/mvp/mvp_db/news7-lv/2002/2002_12_05_19_00/2002_12_05_19_00.mpg;Yukio HATOYAMA.jpg;9449;9881;35961;472;494;22
/net/per610a/home/mvp/mvp_db/news7-lv/2002/2002_12_05_19_00/2002_12_05_19_00.mpg;Junichiro KOIZUMI.jpg;11265;12137;35961;563;607;44
/net/per610a/home/mvp/mvp_db/news7-lv/2002/2002_12_06_19_00/2002_12_06_19_00.mpg;Naoto KAN.jpg;745;1477;35961;37;73;36
/net/per610a/home/mvp/mvp_db/news7-lv/2002/2002_12_06_19_00/2002_12_06_19_00.mpg;Naoto KAN.jpg;15209;16265;35961;760;813;53
/net/per610a/home/mvp/mvp_db/news7-lv/2002/2002_12_06_19_00/2002_12_06_19_00.mpg;Naoto KAN.jpg;19053;19489;35961;953;974;21
/net/per610a/home/mvp/mvp_db/news7-lv/2002/2002_12_06_19_00/2002_12_06_19_00.mpg;Katsuya OKADA.jpg;1289;1477;35961;64;73;9
/net/per610a/home/mvp/mvp_db/news7-lv/2002/2002_12_06_19_00/2002_12_06_19_00.mpg;Katsuya OKADA.jpg;18105;18429;35961;905;921;16
/net/per610a/home/mvp/mvp_db/news7-lv/2002/2002_12_06_19_00/2002_12_06_19_00.mpg;Katsuya OKADA.jpg;19053;19489;35961;953;974;21
/net/per610a/home/mvp/mvp_db/news7-lv/2002/2002_12_06_19_00/2002_12_06_19_00.mpg;Junichiro KOIZUMI.jpg;6149;8369;35961;307;418;111
/net/per610a/home/mvp/mvp_db/news7-lv/2002/2002_12_06_19_00/2002_12_06_19_00.mpg;Junichiro KOIZUMI.jpg;8737;9081;35961;437;454;17
/net/per610a/home/mvp/mvp_db/news7-lv/2002/2002_12_06_19_00/2002_12_06_19_00.mpg;Junichiro KOIZUMI.jpg;14345;14405;35961;717;720;3
/net/per610a/home/mvp/mvp_db/news7-lv/2002/2002_12_06_19_00/2002_12_06_19_00.mpg;Sadakazu TANIGAKI.jpg;24165;24405;35961;1208;1220;12
/net/per610a/home/mvp/mvp_db/news7-lv/2002/2002_12_09_19_00/2002_12_09_19_00.mpg;Junichiro KOIZUMI.jpg;18945;19069;35957;947;954;7
/net/per610a/home/mvp/mvp_db/news7-lv/2002/2002_12_09_19_00/2002_12_09_19_00.mpg;Junichiro KOIZUMI.jpg;24649;25657;35957;1233;1283;50
/net/per610a/home/mvp/mvp_db/news7-lv/2002/2002_12_09_19_00/2002_12_09_19_00.mpg;Katsuya OKADA.jpg;20333;20385;35957;1017;1019;2
/net/per610a/home/mvp/mvp_db/news7-lv/2002/2002_12_09_19_00/2002_12_09_19_00.mpg;Katsuya OKADA.jpg;22001;22333;35957;1100;1117;17
/net/per610a/home/mvp/mvp_db/news7-lv/2002/2002_12_10_19_00/2002_12_10_19_00.mpg;Naoto KAN.jpg;2581;2625;35961;129;131;2
/net/per610a/home/mvp/mvp_db/news7-lv/2002/2002_12_10_19_00/2002_12_10_19_00.mpg;Naoto KAN.jpg;6829;6881;35961;341;344;3
/net/per610a/home/mvp/mvp_db/news7-lv/2002/2002_12_10_19_00/2002_12_10_19_00.mpg;Naoto KAN.jpg;8989;9677;35961;449;484;35
/net/per610a/home/mvp/mvp_db/news7-lv/2002/2002_12_10_19_00/2002_12_10_19_00.mpg;Naoto KAN.jpg;11281;11913;35961;564;595;31
/net/per610a/home/mvp/mvp_db/news7-lv/2002/2002_12_10_19_00/2002_12_10_19_00.mpg;Yasuo FUKUDA.jpg;30313;31113;35961;1516;1556;40
/net/per610a/home/mvp/mvp_db/news7-lv/2002/2002_12_11_19_00/2002_12_11_19_00.mpg;Yasuo FUKUDA.jpg;17033;17621;35961;852;881;29
/net/per610a/home/mvp/mvp_db/news7-lv/2002/2002_12_11_19_00/2002_12_11_19_00.mpg;Naoto KAN.jpg;23081;23117;35961;1154;1156;2
/net/per610a/home/mvp/mvp_db/news7-lv/2002/2002_12_11_19_00/2002_12_11_19_00.mpg;Naoto KAN.jpg;23853;25177;35961;1193;1259;66
/net/per610a/home/mvp/mvp_db/news7-lv/2002/2002_12_12_19_00/2002_12_12_19_00.mpg;Yukio EDANO.jpg;28005;28637;35961;1400;1432;32
/net/per610a/home/mvp/mvp_db/news7-lv/2002/2002_12_13_19_00/2002_12_13_19_00.mpg;Yasuo FUKUDA.jpg;4453;4865;35957;222;243;21
/net/per610a/home/mvp/mvp_db/news7-lv/2002/2002_12_13_19_00/2002_12_13_19_00.mpg;Naoto KAN.jpg;20793;21265;35957;1040;1063;23
/net/per610a/home/mvp/mvp_db/news7-lv/2002/2002_12_14_19_00/2002_12_14_19_00.mpg;Junichiro KOIZUMI.jpg;10661;11729;35957;533;586;53
/net/per610a/home/mvp/mvp_db/news7-lv/2002/2002_12_16_19_00/2002_12_16_19_00.mpg;Shinzo ABE.jpg;14221;14293;35957;711;715;4
/net/per610a/home/mvp/mvp_db/news7-lv/2002/2002_12_16_19_00/2002_12_16_19_00.mpg;Shinzo ABE.jpg;14437;14469;35957;722;723;1
/net/per610a/home/mvp/mvp_db/news7-lv/2002/2002_12_16_19_00/2002_12_16_19_00.mpg;Shinzo ABE.jpg;14533;14841;35957;727;742;15
/net/per610a/home/mvp/mvp_db/news7-lv/2002/2002_12_16_19_00/2002_12_16_19_00.mpg;Shinzo ABE.jpg;15057;16061;35957;753;803;50
/net/per610a/home/mvp/mvp_db/news7-lv/2002/2002_12_17_19_00/2002_12_17_19_00.mpg;Naoto KAN.jpg;9145;9825;35957;457;491;34
/net/per610a/home/mvp/mvp_db/news7-lv/2002/2002_12_17_19_00/2002_12_17_19_00.mpg;Yasuo FUKUDA.jpg;14437;14765;35957;722;738;16
/net/per610a/home/mvp/mvp_db/news7-lv/2002/2002_12_17_19_00/2002_12_17_19_00.mpg;Yasuo FUKUDA.jpg;14829;15689;35957;741;784;43
/net/per610a/home/mvp/mvp_db/news7-lv/2002/2002_12_17_19_00/2002_12_17_19_00.mpg;Yasuo FUKUDA.jpg;25089;25709;35957;1255;1286;31
/net/per610a/home/mvp/mvp_db/news7-lv/2002/2002_12_18_19_00/2002_12_18_19_00.mpg;Toranosuke Katayama.jpg;15657;15741;35957;783;787;4
/net/per610a/home/mvp/mvp_db/news7-lv/2002/2002_12_18_19_00/2002_12_18_19_00.mpg;Toranosuke Katayama.jpg;16885;16973;35957;844;849;5
/net/per610a/home/mvp/mvp_db/news7-lv/2002/2002_12_18_19_00/2002_12_18_19_00.mpg;Toranosuke Katayama.jpg;21013;21113;35957;1051;1056;5
/net/per610a/home/mvp/mvp_db/news7-lv/2002/2002_12_18_19_00/2002_12_18_19_00.mpg;Nariaki Nakayama.png;15657;15817;35957;783;791;8
/net/per610a/home/mvp/mvp_db/news7-lv/2002/2002_12_18_19_00/2002_12_18_19_00.mpg;Yukio EDANO.jpg;18709;20045;35957;936;1002;66
/net/per610a/home/mvp/mvp_db/news7-lv/2002/2002_12_19_19_00/2002_12_19_19_00.mpg;Yasuo FUKUDA.jpg;12217;12717;35957;611;636;25
/net/per610a/home/mvp/mvp_db/news7-lv/2002/2002_12_19_19_00/2002_12_19_19_00.mpg;Junichiro KOIZUMI.jpg;31013;31145;35957;1551;1558;7
/net/per610a/home/mvp/mvp_db/news7-lv/2002/2002_12_21_19_00/2002_12_21_19_00.mpg;Junichiro KOIZUMI.jpg;13193;13309;35957;660;665;5
/net/per610a/home/mvp/mvp_db/news7-lv/2002/2002_12_24_19_00/2002_12_24_19_00.mpg;Naoto KAN.jpg;15433;15517;35957;772;776;4
/net/per610a/home/mvp/mvp_db/news7-lv/2002/2002_12_24_19_00/2002_12_24_19_00.mpg;Naoto KAN.jpg;15617;15993;35957;781;800;19
/net/per610a/home/mvp/mvp_db/news7-lv/2002/2002_12_24_19_00/2002_12_24_19_00.mpg;Junichiro KOIZUMI.jpg;16345;16469;35957;817;823;6
/net/per610a/home/mvp/mvp_db/news7-lv/2002/2002_12_24_19_00/2002_12_24_19_00.mpg;Junichiro KOIZUMI.jpg;17277;17709;35957;864;886;22
/net/per610a/home/mvp/mvp_db/news7-lv/2002/2002_12_24_19_00/2002_12_24_19_00.mpg;Yasuo FUKUDA.jpg;21425;21449;35957;1071;1073;2
/net/per610a/home/mvp/mvp_db/news7-lv/2002/2002_12_24_19_00/2002_12_24_19_00.mpg;Yasuo FUKUDA.jpg;22193;22985;35957;1110;1149;39
/net/per610a/home/mvp/mvp_db/news7-lv/2002/2002_12_25_19_00/2002_12_25_19_00.mpg;Junichiro KOIZUMI.jpg;1865;3645;35957;93;182;89
/net/per610a/home/mvp/mvp_db/news7-lv/2002/2002_12_26_19_00/2002_12_26_19_00.mpg;Junichiro KOIZUMI.jpg;721;1125;35957;36;56;20
/net/per610a/home/mvp/mvp_db/news7-lv/2002/2002_12_26_19_00/2002_12_26_19_00.mpg;Junichiro KOIZUMI.jpg;18809;18865;35957;941;943;2
/net/per610a/home/mvp/mvp_db/news7-lv/2002/2002_12_26_19_00/2002_12_26_19_00.mpg;Takenori KANZAKI.jpg;18417;18485;35957;921;924;3
/net/per610a/home/mvp/mvp_db/news7-lv/2002/2002_12_26_19_00/2002_12_26_19_00.mpg;Takenori KANZAKI.jpg;18669;18685;35957;934;934;0
/net/per610a/home/mvp/mvp_db/news7-lv/2002/2002_12_27_19_00/2002_12_27_19_00.mpg;Junichiro KOIZUMI.jpg;17833;18393;35957;892;920;28
/net/per610a/home/mvp/mvp_db/news7-lv/2002/2002_12_27_19_00/2002_12_27_19_00.mpg;Junichiro KOIZUMI.jpg;18505;18721;35957;925;936;11
/net/per610a/home/mvp/mvp_db/news7-lv/2002/2002_12_27_19_00/2002_12_27_19_00.mpg;Junichiro KOIZUMI.jpg;18901;19733;35957;945;987;42
/net/per610a/home/mvp/mvp_db/news7-lv/2002/2002_12_27_19_00/2002_12_27_19_00.mpg;Junichiro KOIZUMI.jpg;20013;21201;35957;1001;1060;59
/net/per610a/home/mvp/mvp_db/news7-lv/2003/2003_01_01_19_00/2003_01_01_19_00.mpg;Junichiro KOIZUMI.jpg;15449;15581;23901;773;779;6
/net/per610a/home/mvp/mvp_db/news7-lv/2003/2003_01_03_19_00/2003_01_03_19_00.mpg;Naoto KAN.jpg;6897;6953;23889;345;347;2
/net/per610a/home/mvp/mvp_db/news7-lv/2003/2003_01_03_19_00/2003_01_03_19_00.mpg;Naoto KAN.jpg;7357;7405;23889;368;370;2
/net/per610a/home/mvp/mvp_db/news7-lv/2003/2003_01_04_19_00/2003_01_04_19_00.mpg;Junichiro KOIZUMI.jpg;12057;12417;35957;603;621;18
/net/per610a/home/mvp/mvp_db/news7-lv/2003/2003_01_04_19_00/2003_01_04_19_00.mpg;Junichiro KOIZUMI.jpg;13561;13657;35957;678;683;5
/net/per610a/home/mvp/mvp_db/news7-lv/2003/2003_01_04_19_00/2003_01_04_19_00.mpg;Junichiro KOIZUMI.jpg;14069;14601;35957;703;730;27
/net/per610a/home/mvp/mvp_db/news7-lv/2003/2003_01_04_19_00/2003_01_04_19_00.mpg;Shinzo ABE.jpg;15173;16621;35957;759;831;72
/net/per610a/home/mvp/mvp_db/news7-lv/2003/2003_01_04_19_00/2003_01_04_19_00.mpg;Kazuo SHII.jpg;19557;20609;35957;978;1031;53
/net/per610a/home/mvp/mvp_db/news7-lv/2003/2003_01_06_19_00/2003_01_06_19_00.mpg;Junichiro KOIZUMI.jpg;305;461;35957;15;23;8
/net/per610a/home/mvp/mvp_db/news7-lv/2003/2003_01_06_19_00/2003_01_06_19_00.mpg;Junichiro KOIZUMI.jpg;2481;3285;35957;124;164;40
/net/per610a/home/mvp/mvp_db/news7-lv/2003/2003_01_06_19_00/2003_01_06_19_00.mpg;Junichiro KOIZUMI.jpg;3369;4561;35957;168;228;60
/net/per610a/home/mvp/mvp_db/news7-lv/2003/2003_01_06_19_00/2003_01_06_19_00.mpg;Junichiro KOIZUMI.jpg;5085;5901;35957;254;295;41
/net/per610a/home/mvp/mvp_db/news7-lv/2003/2003_01_07_19_00/2003_01_07_19_00.mpg;Junichiro KOIZUMI.jpg;3209;3569;35957;160;178;18
/net/per610a/home/mvp/mvp_db/news7-lv/2003/2003_01_07_19_00/2003_01_07_19_00.mpg;Junichiro KOIZUMI.jpg;7465;8181;35957;373;409;36
/net/per610a/home/mvp/mvp_db/news7-lv/2003/2003_01_07_19_00/2003_01_07_19_00.mpg;Junichiro KOIZUMI.jpg;14789;15109;35957;739;755;16
/net/per610a/home/mvp/mvp_db/news7-lv/2003/2003_01_07_19_00/2003_01_07_19_00.mpg;Yasuo FUKUDA.jpg;13177;14661;35957;659;733;74
/net/per610a/home/mvp/mvp_db/news7-lv/2003/2003_01_08_19_00/2003_01_08_19_00.mpg;Junichiro KOIZUMI.jpg;10297;11173;35957;515;559;44
/net/per610a/home/mvp/mvp_db/news7-lv/2003/2003_01_08_19_00/2003_01_08_19_00.mpg;Junichiro KOIZUMI.jpg;17241;17713;35957;862;886;24
/net/per610a/home/mvp/mvp_db/news7-lv/2003/2003_01_08_19_00/2003_01_08_19_00.mpg;Yasuo FUKUDA.jpg;28753;28921;35957;1438;1446;8
/net/per610a/home/mvp/mvp_db/news7-lv/2003/2003_01_09_19_00/2003_01_09_19_00.mpg;Yasuo FUKUDA.jpg;8977;9637;35957;449;482;33
/net/per610a/home/mvp/mvp_db/news7-lv/2003/2003_01_11_19_00/2003_01_11_19_00.mpg;Junichiro KOIZUMI.jpg;12881;15613;35957;644;781;137
/net/per610a/home/mvp/mvp_db/news7-lv/2003/2003_01_12_19_00/2003_01_12_19_00.mpg;Junichiro KOIZUMI.jpg;1949;2005;23969;97;100;3
/net/per610a/home/mvp/mvp_db/news7-lv/2003/2003_01_12_19_00/2003_01_12_19_00.mpg;Junichiro KOIZUMI.jpg;2229;2693;23969;111;134;23
/net/per610a/home/mvp/mvp_db/news7-lv/2003/2003_01_12_19_00/2003_01_12_19_00.mpg;Junichiro KOIZUMI.jpg;3073;4865;23969;153;243;90
/net/per610a/home/mvp/mvp_db/news7-lv/2003/2003_01_13_19_00/2003_01_13_19_00.mpg;Ichiro OZAWA.jpg;10765;12005;35957;538;600;62
/net/per610a/home/mvp/mvp_db/news7-lv/2003/2003_01_14_19_00/2003_01_14_19_00.mpg;Kazuo SHII.jpg;9161;10725;35957;458;536;78
/net/per610a/home/mvp/mvp_db/news7-lv/2003/2003_01_14_19_00/2003_01_14_19_00.mpg;Junichiro KOIZUMI.jpg;14357;14653;35957;718;733;15
/net/per610a/home/mvp/mvp_db/news7-lv/2003/2003_01_14_19_00/2003_01_14_19_00.mpg;Junichiro KOIZUMI.jpg;14873;14897;35957;744;745;1
/net/per610a/home/mvp/mvp_db/news7-lv/2003/2003_01_15_19_00/2003_01_15_19_00.mpg;Junichiro KOIZUMI.jpg;4641;5269;35957;232;263;31
/net/per610a/home/mvp/mvp_db/news7-lv/2003/2003_01_15_19_00/2003_01_15_19_00.mpg;Yasuo FUKUDA.jpg;10741;10969;35957;537;548;11
/net/per610a/home/mvp/mvp_db/news7-lv/2003/2003_01_23_19_00/2003_01_23_19_00.mpg;Junichiro KOIZUMI.jpg;14185;14705;35957;709;735;26
/net/per610a/home/mvp/mvp_db/news7-lv/2003/2003_01_25_19_00/2003_01_25_19_00.mpg;Yasuo FUKUDA.jpg;14473;15045;35957;724;752;28
/net/per610a/home/mvp/mvp_db/news7-lv/2003/2003_01_27_19_00/2003_01_27_19_00.mpg;Yasuo FUKUDA.jpg;7677;8517;35957;384;426;42
/net/per610a/home/mvp/mvp_db/news7-lv/2003/2003_01_27_19_00/2003_01_27_19_00.mpg;Junichiro KOIZUMI.jpg;21565;21617;35957;1078;1081;3
/net/per610a/home/mvp/mvp_db/news7-lv/2003/2003_01_27_19_00/2003_01_27_19_00.mpg;Junichiro KOIZUMI.jpg;21681;21769;35957;1084;1089;5
/net/per610a/home/mvp/mvp_db/news7-lv/2003/2003_01_27_19_00/2003_01_27_19_00.mpg;Junichiro KOIZUMI.jpg;22221;22257;35957;1111;1113;2
/net/per610a/home/mvp/mvp_db/news7-lv/2003/2003_01_27_19_00/2003_01_27_19_00.mpg;Junichiro KOIZUMI.jpg;22329;22773;35957;1117;1139;22
/net/per610a/home/mvp/mvp_db/news7-lv/2003/2003_01_27_19_00/2003_01_27_19_00.mpg;Junichiro KOIZUMI.jpg;22941;22945;35957;1147;1147;0
/net/per610a/home/mvp/mvp_db/news7-lv/2003/2003_01_29_19_00/2003_01_29_19_00.mpg;Junichiro KOIZUMI.jpg;6085;6557;35957;304;328;24
/net/per610a/home/mvp/mvp_db/news7-lv/2003/2003_01_30_19_00/2003_01_30_19_00.mpg;Shintaro ISHIHARA.jpg;1073;1541;35957;53;77;24
/net/per610a/home/mvp/mvp_db/news7-lv/2003/2003_01_30_19_00/2003_01_30_19_00.mpg;Shintaro ISHIHARA.jpg;5185;5449;35957;259;272;13
/net/per610a/home/mvp/mvp_db/news7-lv/2003/2003_01_30_19_00/2003_01_30_19_00.mpg;Shintaro ISHIHARA.jpg;5557;6173;35957;278;308;30
/net/per610a/home/mvp/mvp_db/news7-lv/2003/2003_01_30_19_00/2003_01_30_19_00.mpg;Junichiro KOIZUMI.jpg;15781;15861;35957;789;793;4
/net/per610a/home/mvp/mvp_db/news7-lv/2003/2003_01_30_19_00/2003_01_30_19_00.mpg;Junichiro KOIZUMI.jpg;21889;21953;35957;1095;1098;3
/net/per610a/home/mvp/mvp_db/news7-lv/2003/2003_01_31_19_00/2003_01_31_19_00.mpg;Takenori KANZAKI.jpg;10093;10505;35957;504;525;21
/net/per610a/home/mvp/mvp_db/news7-lv/2003/2003_01_31_19_00/2003_01_31_19_00.mpg;Kazuo SHII.jpg;12025;12397;35957;601;620;19
/net/per610a/home/mvp/mvp_db/news7-lv/2003/2003_02_01_19_00/2003_02_01_19_00.mpg;Junichiro KOIZUMI.jpg;21821;21937;35957;1091;1097;6
/net/per610a/home/mvp/mvp_db/news7-lv/2003/2003_02_02_19_00/2003_02_02_19_00.mpg;Naoto KAN.jpg;11749;12597;23969;587;630;43
/net/per610a/home/mvp/mvp_db/news7-lv/2003/2003_02_02_19_00/2003_02_02_19_00.mpg;Naoto KAN.jpg;14101;14701;23969;705;735;30
/net/per610a/home/mvp/mvp_db/news7-lv/2003/2003_02_02_19_00/2003_02_02_19_00.mpg;Naoto KAN.jpg;14909;15929;23969;745;796;51
/net/per610a/home/mvp/mvp_db/news7-lv/2003/2003_02_03_19_00/2003_02_03_19_00.mpg;Junichiro KOIZUMI.jpg;13177;13261;35957;659;663;4
/net/per610a/home/mvp/mvp_db/news7-lv/2003/2003_02_03_19_00/2003_02_03_19_00.mpg;Takenori KANZAKI.jpg;21653;22309;35957;1083;1116;33
/net/per610a/home/mvp/mvp_db/news7-lv/2003/2003_02_04_19_00/2003_02_04_19_00.mpg;Junichiro KOIZUMI.jpg;737;905;35957;36;45;9
/net/per610a/home/mvp/mvp_db/news7-lv/2003/2003_02_04_19_00/2003_02_04_19_00.mpg;Junichiro KOIZUMI.jpg;17777;18325;35957;889;916;27
/net/per610a/home/mvp/mvp_db/news7-lv/2003/2003_02_04_19_00/2003_02_04_19_00.mpg;Junichiro KOIZUMI.jpg;19109;20849;35957;956;1043;87
/net/per610a/home/mvp/mvp_db/news7-lv/2003/2003_02_04_19_00/2003_02_04_19_00.mpg;Junichiro KOIZUMI.jpg;21545;21781;35957;1077;1089;12
/net/per610a/home/mvp/mvp_db/news7-lv/2003/2003_02_04_19_00/2003_02_04_19_00.mpg;Kazuo SHII.jpg;22449;23149;35957;1123;1158;35
/net/per610a/home/mvp/mvp_db/news7-lv/2003/2003_02_04_19_00/2003_02_04_19_00.mpg;Naoto KAN.jpg;22449;22757;35957;1123;1138;15
/net/per610a/home/mvp/mvp_db/news7-lv/2003/2003_02_05_19_00/2003_02_05_19_00.mpg;Taro ASO.jpg;8273;8513;35957;413;425;12
/net/per610a/home/mvp/mvp_db/news7-lv/2003/2003_02_07_19_00/2003_02_07_19_00.mpg;Junichiro KOIZUMI.jpg;16377;16469;35957;819;823;4
/net/per610a/home/mvp/mvp_db/news7-lv/2003/2003_02_08_19_00/2003_02_08_19_00.mpg;Shinzo ABE.jpg;19285;19609;35957;964;981;17
/net/per610a/home/mvp/mvp_db/news7-lv/2003/2003_02_08_19_00/2003_02_08_19_00.mpg;Toranosuke Katayama.jpg;26425;27417;35957;1322;1371;49
/net/per610a/home/mvp/mvp_db/news7-lv/2003/2003_02_09_19_00/2003_02_09_19_00.mpg;Naoto KAN.jpg;10465;10561;23969;523;528;5
/net/per610a/home/mvp/mvp_db/news7-lv/2003/2003_02_09_19_00/2003_02_09_19_00.mpg;Naoto KAN.jpg;10761;11729;23969;538;586;48
/net/per610a/home/mvp/mvp_db/news7-lv/2003/2003_02_10_19_00/2003_02_10_19_00.mpg;Junichiro KOIZUMI.jpg;13265;13313;35957;663;666;3
/net/per610a/home/mvp/mvp_db/news7-lv/2003/2003_02_10_19_00/2003_02_10_19_00.mpg;Junichiro KOIZUMI.jpg;13625;14081;35957;681;704;23
/net/per610a/home/mvp/mvp_db/news7-lv/2003/2003_02_10_19_00/2003_02_10_19_00.mpg;Junichiro KOIZUMI.jpg;22021;22165;35957;1101;1108;7
/net/per610a/home/mvp/mvp_db/news7-lv/2003/2003_02_10_19_00/2003_02_10_19_00.mpg;Junichiro KOIZUMI.jpg;22745;22949;35957;1137;1148;11
/net/per610a/home/mvp/mvp_db/news7-lv/2003/2003_02_10_19_00/2003_02_10_19_00.mpg;Yasuo FUKUDA.jpg;22957;23469;35957;1148;1174;26
/net/per610a/home/mvp/mvp_db/news7-lv/2003/2003_02_11_19_00/2003_02_11_19_00.mpg;Junichiro KOIZUMI.jpg;11453;12605;35957;573;630;57
/net/per610a/home/mvp/mvp_db/news7-lv/2003/2003_02_13_19_00/2003_02_13_19_00.mpg;Yasuo FUKUDA.jpg;11721;12397;35957;586;620;34
/net/per610a/home/mvp/mvp_db/news7-lv/2003/2003_02_14_19_00/2003_02_14_19_00.mpg;Junichiro KOIZUMI.jpg;7501;8613;35957;375;430;55
/net/per610a/home/mvp/mvp_db/news7-lv/2003/2003_02_17_19_00/2003_02_17_19_00.mpg;Junichiro KOIZUMI.jpg;8573;8601;35957;428;430;2
/net/per610a/home/mvp/mvp_db/news7-lv/2003/2003_02_17_19_00/2003_02_17_19_00.mpg;Junichiro KOIZUMI.jpg;8849;8897;35957;442;445;3
/net/per610a/home/mvp/mvp_db/news7-lv/2003/2003_02_17_19_00/2003_02_17_19_00.mpg;Yasuo FUKUDA.jpg;9029;9381;35957;451;469;18
/net/per610a/home/mvp/mvp_db/news7-lv/2003/2003_02_17_19_00/2003_02_17_19_00.mpg;Yasuo FUKUDA.jpg;9469;9729;35957;473;486;13
/net/per610a/home/mvp/mvp_db/news7-lv/2003/2003_02_17_19_00/2003_02_17_19_00.mpg;Yasuo FUKUDA.jpg;15441;16181;35957;772;809;37
/net/per610a/home/mvp/mvp_db/news7-lv/2003/2003_02_19_19_00/2003_02_19_19_00.mpg;Shizuka KAMEI.jpg;19085;19569;35957;954;979;25
/net/per610a/home/mvp/mvp_db/news7-lv/2003/2003_02_19_19_00/2003_02_19_19_00.mpg;Shintaro ISHIHARA.jpg;27705;28009;35957;1386;1401;15
/net/per610a/home/mvp/mvp_db/news7-lv/2003/2003_02_20_19_00/2003_02_20_19_00.mpg;Yasuo FUKUDA.jpg;13517;14617;35957;676;731;55
/net/per610a/home/mvp/mvp_db/news7-lv/2003/2003_02_21_19_00/2003_02_21_19_00.mpg;Yasuo FUKUDA.jpg;17173;17321;35957;859;866;7
/net/per610a/home/mvp/mvp_db/news7-lv/2003/2003_02_21_19_00/2003_02_21_19_00.mpg;Yasuo FUKUDA.jpg;17325;17637;35957;866;882;16
/net/per610a/home/mvp/mvp_db/news7-lv/2003/2003_02_22_19_00/2003_02_22_19_00.mpg;Shinzo ABE.jpg;9105;10733;35957;455;536;81
/net/per610a/home/mvp/mvp_db/news7-lv/2003/2003_02_24_19_00/2003_02_24_19_00.mpg;Junichiro KOIZUMI.jpg;1033;1293;35957;51;64;13
/net/per610a/home/mvp/mvp_db/news7-lv/2003/2003_02_24_19_00/2003_02_24_19_00.mpg;Junichiro KOIZUMI.jpg;4213;4709;35957;210;235;25
/net/per610a/home/mvp/mvp_db/news7-lv/2003/2003_02_24_19_00/2003_02_24_19_00.mpg;Ichiro OZAWA.jpg;22869;23149;35957;1144;1158;14
/net/per610a/home/mvp/mvp_db/news7-lv/2003/2003_02_24_19_00/2003_02_24_19_00.mpg;Ichiro OZAWA.jpg;23445;24117;35957;1172;1206;34
/net/per610a/home/mvp/mvp_db/news7-lv/2003/2003_02_25_19_00/2003_02_25_19_00.mpg;Junichiro KOIZUMI.jpg;345;609;35957;17;30;13
/net/per610a/home/mvp/mvp_db/news7-lv/2003/2003_02_25_19_00/2003_02_25_19_00.mpg;Junichiro KOIZUMI.jpg;845;949;35957;42;47;5
/net/per610a/home/mvp/mvp_db/news7-lv/2003/2003_02_25_19_00/2003_02_25_19_00.mpg;Junichiro KOIZUMI.jpg;2325;2337;35957;116;116;0
/net/per610a/home/mvp/mvp_db/news7-lv/2003/2003_02_25_19_00/2003_02_25_19_00.mpg;Junichiro KOIZUMI.jpg;2889;3345;35957;144;167;23
/net/per610a/home/mvp/mvp_db/news7-lv/2003/2003_02_25_19_00/2003_02_25_19_00.mpg;Junichiro KOIZUMI.jpg;4589;4657;35957;229;232;3
/net/per610a/home/mvp/mvp_db/news7-lv/2003/2003_02_25_19_00/2003_02_25_19_00.mpg;Junichiro KOIZUMI.jpg;5077;6213;35957;254;310;56
/net/per610a/home/mvp/mvp_db/news7-lv/2003/2003_02_25_19_00/2003_02_25_19_00.mpg;Junichiro KOIZUMI.jpg;8245;8637;35957;412;432;20
/net/per610a/home/mvp/mvp_db/news7-lv/2003/2003_02_25_19_00/2003_02_25_19_00.mpg;Junichiro KOIZUMI.jpg;8785;9261;35957;439;463;24
/net/per610a/home/mvp/mvp_db/news7-lv/2003/2003_02_25_19_00/2003_02_25_19_00.mpg;Junichiro KOIZUMI.jpg;18725;19861;35957;936;993;57
/net/per610a/home/mvp/mvp_db/news7-lv/2003/2003_02_25_19_00/2003_02_25_19_00.mpg;Yasuo FUKUDA.jpg;20821;21169;35957;1041;1059;18
/net/per610a/home/mvp/mvp_db/news7-lv/2003/2003_02_26_19_00/2003_02_26_19_00.mpg;Junichiro KOIZUMI.jpg;9049;9185;35957;452;459;7
/net/per610a/home/mvp/mvp_db/news7-lv/2003/2003_02_26_19_00/2003_02_26_19_00.mpg;Yasuo FUKUDA.jpg;9393;10473;35957;469;523;54
/net/per610a/home/mvp/mvp_db/news7-lv/2003/2003_02_28_19_00/2003_02_28_19_00.mpg;Kazuo SHII.jpg;31197;31657;35957;1560;1583;23
/net/per610a/home/mvp/mvp_db/news7-lv/2003/2003_03_03_19_00/2003_03_03_19_00.mpg;Yasuo FUKUDA.jpg;10381;11337;35957;519;567;48
/net/per610a/home/mvp/mvp_db/news7-lv/2003/2003_03_05_19_00/2003_03_05_19_00.mpg;Yasuo FUKUDA.jpg;5113;5845;35957;255;292;37
/net/per610a/home/mvp/mvp_db/news7-lv/2003/2003_03_05_19_00/2003_03_05_19_00.mpg;Yoshihiko Noda.jpg;14981;15273;35957;749;764;15
/net/per610a/home/mvp/mvp_db/news7-lv/2003/2003_03_05_19_00/2003_03_05_19_00.mpg;Junichiro KOIZUMI.jpg;16661;17049;35957;833;852;19
/net/per610a/home/mvp/mvp_db/news7-lv/2003/2003_03_06_19_00/2003_03_06_19_00.mpg;Junichiro KOIZUMI.jpg;17837;18125;35957;892;906;14
/net/per610a/home/mvp/mvp_db/news7-lv/2003/2003_03_06_19_00/2003_03_06_19_00.mpg;Junichiro KOIZUMI.jpg;19333;19813;35957;967;991;24
/net/per610a/home/mvp/mvp_db/news7-lv/2003/2003_03_07_19_00/2003_03_07_19_00.mpg;Junichiro KOIZUMI.jpg;3465;3665;35957;173;183;10
/net/per610a/home/mvp/mvp_db/news7-lv/2003/2003_03_07_19_00/2003_03_07_19_00.mpg;Junichiro KOIZUMI.jpg;4109;4717;35957;205;236;31
/net/per610a/home/mvp/mvp_db/news7-lv/2003/2003_03_07_19_00/2003_03_07_19_00.mpg;Junichiro KOIZUMI.jpg;7233;8233;35957;361;411;50
/net/per610a/home/mvp/mvp_db/news7-lv/2003/2003_03_07_19_00/2003_03_07_19_00.mpg;Junichiro KOIZUMI.jpg;23429;23581;35957;1172;1179;7
/net/per610a/home/mvp/mvp_db/news7-lv/2003/2003_03_07_19_00/2003_03_07_19_00.mpg;Shintaro ISHIHARA.jpg;25705;26633;35957;1286;1332;46
/net/per610a/home/mvp/mvp_db/news7-lv/2003/2003_03_09_19_00/2003_03_09_19_00.mpg;Shinzo ABE.jpg;6429;7133;23969;321;356;35
/net/per610a/home/mvp/mvp_db/news7-lv/2003/2003_03_09_19_00/2003_03_09_19_00.mpg;Shinzo ABE.jpg;7197;7333;23969;360;366;6
/net/per610a/home/mvp/mvp_db/news7-lv/2003/2003_03_10_19_00/2003_03_10_19_00.mpg;Yasuo FUKUDA.jpg;4425;4681;35957;221;234;13
/net/per610a/home/mvp/mvp_db/news7-lv/2003/2003_03_10_19_00/2003_03_10_19_00.mpg;Junichiro KOIZUMI.jpg;10637;11333;35957;532;567;35
/net/per610a/home/mvp/mvp_db/news7-lv/2003/2003_03_10_19_00/2003_03_10_19_00.mpg;Junichiro KOIZUMI.jpg;19249;19265;35957;963;963;0
/net/per610a/home/mvp/mvp_db/news7-lv/2003/2003_03_10_19_00/2003_03_10_19_00.mpg;Junichiro KOIZUMI.jpg;25545;25801;35957;1278;1290;12
/net/per610a/home/mvp/mvp_db/news7-lv/2003/2003_03_11_19_00/2003_03_11_19_00.mpg;Takenori KANZAKI.jpg;11921;12065;35957;596;603;7
/net/per610a/home/mvp/mvp_db/news7-lv/2003/2003_03_12_19_00/2003_03_12_19_00.mpg;Junichiro KOIZUMI.jpg;15305;15845;35957;765;792;27
/net/per610a/home/mvp/mvp_db/news7-lv/2003/2003_03_12_19_00/2003_03_12_19_00.mpg;Yasuo FUKUDA.jpg;16833;17441;35957;842;872;30
/net/per610a/home/mvp/mvp_db/news7-lv/2003/2003_03_13_19_00/2003_03_13_19_00.mpg;Yasuo FUKUDA.jpg;17569;18285;35957;879;914;35
/net/per610a/home/mvp/mvp_db/news7-lv/2003/2003_03_13_19_00/2003_03_13_19_00.mpg;Shinzo ABE.jpg;21009;21025;35957;1051;1051;0
/net/per610a/home/mvp/mvp_db/news7-lv/2003/2003_03_13_19_00/2003_03_13_19_00.mpg;Shinzo ABE.jpg;21213;21449;35957;1061;1073;12
/net/per610a/home/mvp/mvp_db/news7-lv/2003/2003_03_14_19_00/2003_03_14_19_00.mpg;Junichiro KOIZUMI.jpg;16917;16997;35957;846;850;4
/net/per610a/home/mvp/mvp_db/news7-lv/2003/2003_03_14_19_00/2003_03_14_19_00.mpg;Junichiro KOIZUMI.jpg;17125;18093;35957;856;905;49
/net/per610a/home/mvp/mvp_db/news7-lv/2003/2003_03_14_19_00/2003_03_14_19_00.mpg;Junichiro KOIZUMI.jpg;23229;23297;35957;1162;1165;3
/net/per610a/home/mvp/mvp_db/news7-lv/2003/2003_03_15_19_00/2003_03_15_19_00.mpg;Shinzo ABE.jpg;11529;11685;35957;576;584;8
/net/per610a/home/mvp/mvp_db/news7-lv/2003/2003_03_15_19_00/2003_03_15_19_00.mpg;Shinzo ABE.jpg;11785;12841;35957;589;642;53
/net/per610a/home/mvp/mvp_db/news7-lv/2003/2003_03_15_19_00/2003_03_15_19_00.mpg;Ichiro OZAWA.jpg;12845;14241;35957;642;712;70
/net/per610a/home/mvp/mvp_db/news7-lv/2003/2003_03_15_19_00/2003_03_15_19_00.mpg;Naoto KAN.jpg;14245;15261;35957;712;763;51
/net/per610a/home/mvp/mvp_db/news7-lv/2003/2003_03_18_19_00/2003_03_18_19_00.mpg;Junichiro KOIZUMI.jpg;857;1101;35961;42;55;13
/net/per610a/home/mvp/mvp_db/news7-lv/2003/2003_03_18_19_00/2003_03_18_19_00.mpg;Junichiro KOIZUMI.jpg;8797;10301;35961;440;515;75
/net/per610a/home/mvp/mvp_db/news7-lv/2003/2003_03_18_19_00/2003_03_18_19_00.mpg;Junichiro KOIZUMI.jpg;12781;12937;35961;639;647;8
/net/per610a/home/mvp/mvp_db/news7-lv/2003/2003_03_19_19_00/2003_03_19_19_00.mpg;Ichiro OZAWA.jpg;19833;20717;35961;992;1036;44
/net/per610a/home/mvp/mvp_db/news7-lv/2003/2003_03_19_19_00/2003_03_19_19_00.mpg;Yasuo FUKUDA.jpg;28345;29185;35961;1417;1460;43
/net/per610a/home/mvp/mvp_db/news7-lv/2003/2003_03_27_19_00/2003_03_27_19_00.mpg;Yasuo FUKUDA.jpg;34997;35577;68249;1751;1780;29
/net/per610a/home/mvp/mvp_db/news7-lv/2003/2003_03_27_19_00/2003_03_27_19_00.mpg;Junichiro KOIZUMI.jpg;44533;45293;68249;2228;2266;38
/net/per610a/home/mvp/mvp_db/news7-lv/2003/2003_03_28_19_00/2003_03_28_19_00.mpg;Junichiro KOIZUMI.jpg;30957;31057;53941;1548;1553;5
/net/per610a/home/mvp/mvp_db/news7-lv/2003/2003_03_28_19_00/2003_03_28_19_00.mpg;Junichiro KOIZUMI.jpg;31129;32857;53941;1557;1644;87
/net/per610a/home/mvp/mvp_db/news7-lv/2003/2003_03_28_19_00/2003_03_28_19_00.mpg;Junichiro KOIZUMI.jpg;32921;33337;53941;1647;1668;21
/net/per610a/home/mvp/mvp_db/news7-lv/2003/2003_03_28_19_00/2003_03_28_19_00.mpg;Junichiro KOIZUMI.jpg;33761;33845;53941;1689;1693;4
/net/per610a/home/mvp/mvp_db/news7-lv/2003/2003_03_28_19_00/2003_03_28_19_00.mpg;Junichiro KOIZUMI.jpg;34153;34169;53941;1708;1709;1
/net/per610a/home/mvp/mvp_db/news7-lv/2003/2003_03_31_19_00/2003_03_31_19_00.mpg;Naoto KAN.jpg;5961;6249;35961;298;312;14
/net/per610a/home/mvp/mvp_db/news7-lv/2003/2003_03_31_19_00/2003_03_31_19_00.mpg;Junichiro KOIZUMI.jpg;9913;10417;35961;495;521;26
/net/per610a/home/mvp/mvp_db/news7-lv/2003/2003_03_31_19_00/2003_03_31_19_00.mpg;Junichiro KOIZUMI.jpg;30385;30505;35961;1520;1526;6
/net/per610a/home/mvp/mvp_db/news7-lv/2003/2003_04_01_19_00/2003_04_01_19_00.mpg;Toranosuke Katayama.jpg;30497;30709;35961;1525;1536;11
/net/per610a/home/mvp/mvp_db/news7-lv/2003/2003_04_01_19_00/2003_04_01_19_00.mpg;Junichiro KOIZUMI.jpg;32041;32157;35961;1602;1608;6
/net/per610a/home/mvp/mvp_db/news7-lv/2003/2003_04_03_19_00/2003_04_03_19_00.mpg;Yasuo FUKUDA.jpg;15065;15537;35957;753;777;24
/net/per610a/home/mvp/mvp_db/news7-lv/2003/2003_04_04_19_00/2003_04_04_19_00.mpg;Junichiro KOIZUMI.jpg;28113;28261;35957;1406;1413;7
/net/per610a/home/mvp/mvp_db/news7-lv/2003/2003_04_04_19_00/2003_04_04_19_00.mpg;Junichiro KOIZUMI.jpg;28405;28509;35957;1421;1426;5
/net/per610a/home/mvp/mvp_db/news7-lv/2003/2003_04_11_19_00/2003_04_11_19_00.mpg;Junichiro KOIZUMI.jpg;18013;18405;35957;901;920;19
/net/per610a/home/mvp/mvp_db/news7-lv/2003/2003_04_11_19_00/2003_04_11_19_00.mpg;Junichiro KOIZUMI.jpg;27445;27445;35957;1373;1373;0
/net/per610a/home/mvp/mvp_db/news7-lv/2003/2003_04_11_19_00/2003_04_11_19_00.mpg;Junichiro KOIZUMI.jpg;27709;27797;35957;1386;1390;4
/net/per610a/home/mvp/mvp_db/news7-lv/2003/2003_04_11_19_00/2003_04_11_19_00.mpg;Junichiro KOIZUMI.jpg;27917;28009;35957;1396;1401;5
/net/per610a/home/mvp/mvp_db/news7-lv/2003/2003_04_16_19_00/2003_04_16_19_00.mpg;Yasuo FUKUDA.jpg;477;681;35957;23;34;11
/net/per610a/home/mvp/mvp_db/news7-lv/2003/2003_04_16_19_00/2003_04_16_19_00.mpg;Yasuo FUKUDA.jpg;5441;6161;35957;272;308;36
/net/per610a/home/mvp/mvp_db/news7-lv/2003/2003_04_18_19_00/2003_04_18_19_00.mpg;Yasuo FUKUDA.jpg;7949;8665;35957;397;433;36
/net/per610a/home/mvp/mvp_db/news7-lv/2003/2003_04_18_19_00/2003_04_18_19_00.mpg;Toranosuke Katayama.jpg;20129;20209;35957;1007;1011;4
/net/per610a/home/mvp/mvp_db/news7-lv/2003/2003_04_18_19_00/2003_04_18_19_00.mpg;Toranosuke Katayama.jpg;20353;20433;35957;1018;1022;4
/net/per610a/home/mvp/mvp_db/news7-lv/2003/2003_04_18_19_00/2003_04_18_19_00.mpg;Toranosuke Katayama.jpg;20621;20781;35957;1031;1039;8
/net/per610a/home/mvp/mvp_db/news7-lv/2003/2003_04_22_19_00/2003_04_22_19_00.mpg;Junichiro KOIZUMI.jpg;7537;8329;35957;377;416;39
/net/per610a/home/mvp/mvp_db/news7-lv/2003/2003_04_22_19_00/2003_04_22_19_00.mpg;Junichiro KOIZUMI.jpg;23729;23997;35957;1187;1200;13
/net/per610a/home/mvp/mvp_db/news7-lv/2003/2003_04_23_19_00/2003_04_23_19_00.mpg;Taro ASO.jpg;10829;10861;35957;541;543;2
/net/per610a/home/mvp/mvp_db/news7-lv/2003/2003_04_23_19_00/2003_04_23_19_00.mpg;Taro ASO.jpg;10941;11053;35957;547;553;6
/net/per610a/home/mvp/mvp_db/news7-lv/2003/2003_04_23_19_00/2003_04_23_19_00.mpg;Kazuo SHII.jpg;14837;15085;35957;742;754;12
/net/per610a/home/mvp/mvp_db/news7-lv/2003/2003_04_23_19_00/2003_04_23_19_00.mpg;Yoshihiko Noda.jpg;22969;23085;35957;1149;1154;5
/net/per610a/home/mvp/mvp_db/news7-lv/2003/2003_04_25_19_00/2003_04_25_19_00.mpg;Junichiro KOIZUMI.jpg;11853;12265;35957;593;613;20
/net/per610a/home/mvp/mvp_db/news7-lv/2003/2003_04_25_19_00/2003_04_25_19_00.mpg;Junichiro KOIZUMI.jpg;21105;22721;35957;1055;1136;81
/net/per610a/home/mvp/mvp_db/news7-lv/2003/2003_04_26_19_00/2003_04_26_19_00.mpg;Yasuo FUKUDA.jpg;3049;3697;35957;152;184;32
/net/per610a/home/mvp/mvp_db/news7-lv/2003/2003_04_28_19_00/2003_04_28_19_00.mpg;Junichiro KOIZUMI.jpg;5049;5217;35957;252;261;9
/net/per610a/home/mvp/mvp_db/news7-lv/2003/2003_04_28_19_00/2003_04_28_19_00.mpg;Junichiro KOIZUMI.jpg;5373;6097;35957;268;305;37
/net/per610a/home/mvp/mvp_db/news7-lv/2003/2003_04_28_19_00/2003_04_28_19_00.mpg;Junichiro KOIZUMI.jpg;6409;8029;35957;320;401;81
/net/per610a/home/mvp/mvp_db/news7-lv/2003/2003_04_29_19_00/2003_04_29_19_00.mpg;Junichiro KOIZUMI.jpg;16853;16877;35957;843;844;1
/net/per610a/home/mvp/mvp_db/news7-lv/2003/2003_04_29_19_00/2003_04_29_19_00.mpg;Junichiro KOIZUMI.jpg;16949;16949;35957;847;847;0
/net/per610a/home/mvp/mvp_db/news7-lv/2003/2003_04_29_19_00/2003_04_29_19_00.mpg;Junichiro KOIZUMI.jpg;17225;17361;35957;861;868;7
/net/per610a/home/mvp/mvp_db/news7-lv/2003/2003_04_29_19_00/2003_04_29_19_00.mpg;Junichiro KOIZUMI.jpg;17565;17917;35957;878;896;18
/net/per610a/home/mvp/mvp_db/news7-lv/2003/2003_04_29_19_00/2003_04_29_19_00.mpg;Takeo Hiranuma.jpeg;18609;18609;35957;931;931;0
/net/per610a/home/mvp/mvp_db/news7-lv/2003/2003_04_29_19_00/2003_04_29_19_00.mpg;Takeo Hiranuma.jpeg;18681;18897;35957;934;945;11
/net/per610a/home/mvp/mvp_db/news7-lv/2003/2003_04_30_19_00/2003_04_30_19_00.mpg;Naoto KAN.jpg;25957;26077;35957;1298;1304;6
/net/per610a/home/mvp/mvp_db/news7-lv/2003/2003_05_02_19_00/2003_05_02_19_00.mpg;Shinzo ABE.jpg;19197;19237;35957;960;962;2
/net/per610a/home/mvp/mvp_db/news7-lv/2003/2003_05_02_19_00/2003_05_02_19_00.mpg;Shinzo ABE.jpg;19669;19741;35957;984;987;3
/net/per610a/home/mvp/mvp_db/news7-lv/2003/2003_05_02_19_00/2003_05_02_19_00.mpg;Junichiro KOIZUMI.jpg;19645;20261;35957;982;1013;31
/net/per610a/home/mvp/mvp_db/news7-lv/2003/2003_05_06_19_00/2003_05_06_19_00.mpg;Junichiro KOIZUMI.jpg;9949;10673;35957;497;533;36
/net/per610a/home/mvp/mvp_db/news7-lv/2003/2003_05_06_19_00/2003_05_06_19_00.mpg;Junichiro KOIZUMI.jpg;14009;14377;35957;700;719;19
/net/per610a/home/mvp/mvp_db/news7-lv/2003/2003_05_06_19_00/2003_05_06_19_00.mpg;Naoto KAN.jpg;23577;23681;35957;1179;1184;5
/net/per610a/home/mvp/mvp_db/news7-lv/2003/2003_05_06_19_00/2003_05_06_19_00.mpg;Naoto KAN.jpg;24165;24949;35957;1209;1248;39
/net/per610a/home/mvp/mvp_db/news7-lv/2003/2003_05_07_19_00/2003_05_07_19_00.mpg;Naoto KAN.jpg;7789;7945;35957;389;397;8
/net/per610a/home/mvp/mvp_db/news7-lv/2003/2003_05_07_19_00/2003_05_07_19_00.mpg;Ichiro OZAWA.jpg;11621;11817;35957;581;591;10
/net/per610a/home/mvp/mvp_db/news7-lv/2003/2003_05_07_19_00/2003_05_07_19_00.mpg;Ichiro OZAWA.jpg;12241;13025;35957;612;651;39
/net/per610a/home/mvp/mvp_db/news7-lv/2003/2003_05_08_19_00/2003_05_08_19_00.mpg;Junichiro KOIZUMI.jpg;9985;10117;35957;499;506;7
/net/per610a/home/mvp/mvp_db/news7-lv/2003/2003_05_09_19_00/2003_05_09_19_00.mpg;Junichiro KOIZUMI.jpg;21117;21993;35957;1056;1100;44
/net/per610a/home/mvp/mvp_db/news7-lv/2003/2003_05_12_19_00/2003_05_12_19_00.mpg;Junichiro KOIZUMI.jpg;15069;15105;35957;753;755;2
/net/per610a/home/mvp/mvp_db/news7-lv/2003/2003_05_12_19_00/2003_05_12_19_00.mpg;Junichiro KOIZUMI.jpg;16441;16485;35957;822;824;2
/net/per610a/home/mvp/mvp_db/news7-lv/2003/2003_05_14_19_00/2003_05_14_19_00.mpg;Junichiro KOIZUMI.jpg;19461;19961;35957;973;998;25
/net/per610a/home/mvp/mvp_db/news7-lv/2003/2003_05_15_19_00/2003_05_15_19_00.mpg;Junichiro KOIZUMI.jpg;7225;10289;35957;361;514;153
/net/per610a/home/mvp/mvp_db/news7-lv/2003/2003_05_17_19_00/2003_05_17_19_00.mpg;Junichiro KOIZUMI.jpg;1821;2573;35957;91;128;37
/net/per610a/home/mvp/mvp_db/news7-lv/2003/2003_05_20_19_00/2003_05_20_19_00.mpg;Junichiro KOIZUMI.jpg;18657;18849;35957;933;943;10
/net/per610a/home/mvp/mvp_db/news7-lv/2003/2003_05_20_19_00/2003_05_20_19_00.mpg;Junichiro KOIZUMI.jpg;18917;19017;35957;946;951;5
/net/per610a/home/mvp/mvp_db/news7-lv/2003/2003_05_20_19_00/2003_05_20_19_00.mpg;Junichiro KOIZUMI.jpg;19237;19601;35957;962;980;18
/net/per610a/home/mvp/mvp_db/news7-lv/2003/2003_05_21_19_00/2003_05_21_19_00.mpg;Yasuo FUKUDA.jpg;9881;10561;35957;494;528;34
/net/per610a/home/mvp/mvp_db/news7-lv/2003/2003_05_21_19_00/2003_05_21_19_00.mpg;Junichiro KOIZUMI.jpg;17309;17461;35957;866;873;7
/net/per610a/home/mvp/mvp_db/news7-lv/2003/2003_05_22_19_00/2003_05_22_19_00.mpg;Shintaro ISHIHARA.jpg;14189;14761;35957;709;738;29
/net/per610a/home/mvp/mvp_db/news7-lv/2003/2003_05_22_19_00/2003_05_22_19_00.mpg;Shintaro ISHIHARA.jpg;15185;15269;35957;759;763;4
/net/per610a/home/mvp/mvp_db/news7-lv/2003/2003_05_22_19_00/2003_05_22_19_00.mpg;Shintaro ISHIHARA.jpg;16529;16757;35957;826;838;12
/net/per610a/home/mvp/mvp_db/news7-lv/2003/2003_05_23_19_00/2003_05_23_19_00.mpg;Junichiro KOIZUMI.jpg;3421;4133;35957;171;206;35
/net/per610a/home/mvp/mvp_db/news7-lv/2003/2003_05_23_19_00/2003_05_23_19_00.mpg;Junichiro KOIZUMI.jpg;16785;17117;35957;839;856;17
/net/per610a/home/mvp/mvp_db/news7-lv/2003/2003_05_23_19_00/2003_05_23_19_00.mpg;Junichiro KOIZUMI.jpg;20537;21281;35957;1027;1064;37
/net/per610a/home/mvp/mvp_db/news7-lv/2003/2003_05_24_19_00/2003_05_24_19_00.mpg;Junichiro KOIZUMI.jpg;5293;5405;35957;264;270;6
/net/per610a/home/mvp/mvp_db/news7-lv/2003/2003_05_28_19_00/2003_05_28_19_00.mpg;Junichiro KOIZUMI.jpg;8029;10905;35957;401;545;144
/net/per610a/home/mvp/mvp_db/news7-lv/2003/2003_05_28_19_00/2003_05_28_19_00.mpg;Takenori KANZAKI.jpg;11357;11381;35957;568;569;1
/net/per610a/home/mvp/mvp_db/news7-lv/2003/2003_05_28_19_00/2003_05_28_19_00.mpg;Takenori KANZAKI.jpg;11533;14313;35957;577;716;139
/net/per610a/home/mvp/mvp_db/news7-lv/2003/2003_05_28_19_00/2003_05_28_19_00.mpg;Yasuo FUKUDA.jpg;20549;20989;35957;1028;1050;22
/net/per610a/home/mvp/mvp_db/news7-lv/2003/2003_05_28_19_00/2003_05_28_19_00.mpg;Yasuo FUKUDA.jpg;25325;25525;35957;1267;1277;10
/net/per610a/home/mvp/mvp_db/news7-lv/2003/2003_05_30_19_00/2003_05_30_19_00.mpg;Junichiro KOIZUMI.jpg;9085;9617;35957;454;481;27
/net/per610a/home/mvp/mvp_db/news7-lv/2003/2003_05_30_19_00/2003_05_30_19_00.mpg;Junichiro KOIZUMI.jpg;10545;10713;35957;527;535;8
/net/per610a/home/mvp/mvp_db/news7-lv/2003/2003_05_30_19_00/2003_05_30_19_00.mpg;Junichiro KOIZUMI.jpg;11181;11801;35957;559;590;31
/net/per610a/home/mvp/mvp_db/news7-lv/2003/2003_05_30_19_00/2003_05_30_19_00.mpg;Junichiro KOIZUMI.jpg;12313;12389;35957;616;619;3
/net/per610a/home/mvp/mvp_db/news7-lv/2003/2003_05_30_19_00/2003_05_30_19_00.mpg;Junichiro KOIZUMI.jpg;13493;13753;35957;675;688;13
/net/per610a/home/mvp/mvp_db/news7-lv/2003/2003_05_30_19_00/2003_05_30_19_00.mpg;Junichiro KOIZUMI.jpg;10109;10109;35957;505;505;0
/net/per610a/home/mvp/mvp_db/news7-lv/2003/2003_05_30_19_00/2003_05_30_19_00.mpg;Junichiro KOIZUMI.jpg;11009;11133;35957;550;557;7
/net/per610a/home/mvp/mvp_db/news7-lv/2003/2003_05_30_19_00/2003_05_30_19_00.mpg;Junichiro KOIZUMI.jpg;12393;12393;35957;620;620;0
/net/per610a/home/mvp/mvp_db/news7-lv/2003/2003_05_30_19_00/2003_05_30_19_00.mpg;Junichiro KOIZUMI.jpg;14453;14505;35957;723;725;2
/net/per610a/home/mvp/mvp_db/news7-lv/2003/2003_05_31_19_00/2003_05_31_19_00.mpg;Junichiro KOIZUMI.jpg;461;701;35957;23;35;12
/net/per610a/home/mvp/mvp_db/news7-lv/2003/2003_05_31_19_00/2003_05_31_19_00.mpg;Junichiro KOIZUMI.jpg;2453;2993;35957;122;149;27
/net/per610a/home/mvp/mvp_db/news7-lv/2003/2003_05_31_19_00/2003_05_31_19_00.mpg;Junichiro KOIZUMI.jpg;3105;3157;35957;155;157;2
/net/per610a/home/mvp/mvp_db/news7-lv/2003/2003_05_31_19_00/2003_05_31_19_00.mpg;Junichiro KOIZUMI.jpg;3805;4157;35957;190;207;17
/net/per610a/home/mvp/mvp_db/news7-lv/2003/2003_05_31_19_00/2003_05_31_19_00.mpg;Junichiro KOIZUMI.jpg;6545;6685;35957;327;334;7
/net/per610a/home/mvp/mvp_db/news7-lv/2003/2003_05_31_19_00/2003_05_31_19_00.mpg;Junichiro KOIZUMI.jpg;8609;8757;35957;430;438;8
/net/per610a/home/mvp/mvp_db/news7-lv/2003/2003_06_02_19_00/2003_06_02_19_00.mpg;Junichiro KOIZUMI.jpg;957;1009;35957;47;50;3
/net/per610a/home/mvp/mvp_db/news7-lv/2003/2003_06_02_19_00/2003_06_02_19_00.mpg;Junichiro KOIZUMI.jpg;2557;2797;35957;127;139;12
/net/per610a/home/mvp/mvp_db/news7-lv/2003/2003_06_02_19_00/2003_06_02_19_00.mpg;Ichiro OZAWA.jpg;15233;15765;35957;762;788;26
/net/per610a/home/mvp/mvp_db/news7-lv/2003/2003_06_02_19_00/2003_06_02_19_00.mpg;Ichiro OZAWA.jpg;16697;17673;35957;835;884;49
/net/per610a/home/mvp/mvp_db/news7-lv/2003/2003_06_02_19_00/2003_06_02_19_00.mpg;Takako DOI.jpg;16477;16549;35957;824;827;3
/net/per610a/home/mvp/mvp_db/news7-lv/2003/2003_06_06_19_00/2003_06_06_19_00.mpg;Yasuo FUKUDA.jpg;293;317;35961;14;15;1
/net/per610a/home/mvp/mvp_db/news7-lv/2003/2003_06_06_19_00/2003_06_06_19_00.mpg;Yasuo FUKUDA.jpg;2205;2349;35961;110;117;7
/net/per610a/home/mvp/mvp_db/news7-lv/2003/2003_06_06_19_00/2003_06_06_19_00.mpg;Yasuo FUKUDA.jpg;3021;3029;35961;151;151;0
/net/per610a/home/mvp/mvp_db/news7-lv/2003/2003_06_06_19_00/2003_06_06_19_00.mpg;Junichiro KOIZUMI.jpg;1577;2013;35961;78;100;22
/net/per610a/home/mvp/mvp_db/news7-lv/2003/2003_06_06_19_00/2003_06_06_19_00.mpg;Junichiro KOIZUMI.jpg;3137;3529;35961;156;176;20
/net/per610a/home/mvp/mvp_db/news7-lv/2003/2003_06_06_19_00/2003_06_06_19_00.mpg;Junichiro KOIZUMI.jpg;4881;5413;35961;244;270;26
/net/per610a/home/mvp/mvp_db/news7-lv/2003/2003_06_06_19_00/2003_06_06_19_00.mpg;Junichiro KOIZUMI.jpg;6365;6401;35961;318;320;2
/net/per610a/home/mvp/mvp_db/news7-lv/2003/2003_06_06_19_00/2003_06_06_19_00.mpg;Junichiro KOIZUMI.jpg;8069;8149;35961;403;407;4
/net/per610a/home/mvp/mvp_db/news7-lv/2003/2003_06_06_19_00/2003_06_06_19_00.mpg;Shintaro ISHIHARA.jpg;19969;20969;35961;998;1049;51
/net/per610a/home/mvp/mvp_db/news7-lv/2003/2003_06_06_19_00/2003_06_06_19_00.mpg;Takeo Hiranuma.jpeg;21625;22221;35961;1081;1111;30
/net/per610a/home/mvp/mvp_db/news7-lv/2003/2003_06_07_19_00/2003_06_07_19_00.mpg;Junichiro KOIZUMI.jpg;165;165;35957;8;8;0
/net/per610a/home/mvp/mvp_db/news7-lv/2003/2003_06_07_19_00/2003_06_07_19_00.mpg;Junichiro KOIZUMI.jpg;1837;1889;35957;91;94;3
/net/per610a/home/mvp/mvp_db/news7-lv/2003/2003_06_07_19_00/2003_06_07_19_00.mpg;Junichiro KOIZUMI.jpg;1985;2033;35957;99;101;2
/net/per610a/home/mvp/mvp_db/news7-lv/2003/2003_06_07_19_00/2003_06_07_19_00.mpg;Junichiro KOIZUMI.jpg;2233;2297;35957;111;114;3
/net/per610a/home/mvp/mvp_db/news7-lv/2003/2003_06_07_19_00/2003_06_07_19_00.mpg;Junichiro KOIZUMI.jpg;2521;3049;35957;126;152;26
/net/per610a/home/mvp/mvp_db/news7-lv/2003/2003_06_07_19_00/2003_06_07_19_00.mpg;Junichiro KOIZUMI.jpg;3801;4121;35957;190;206;16
/net/per610a/home/mvp/mvp_db/news7-lv/2003/2003_06_07_19_00/2003_06_07_19_00.mpg;Junichiro KOIZUMI.jpg;4913;5589;35957;245;279;34
/net/per610a/home/mvp/mvp_db/news7-lv/2003/2003_06_07_19_00/2003_06_07_19_00.mpg;Junichiro KOIZUMI.jpg;4165;4241;35957;208;212;4
/net/per610a/home/mvp/mvp_db/news7-lv/2003/2003_06_07_19_00/2003_06_07_19_00.mpg;Junichiro KOIZUMI.jpg;5021;5101;35957;251;255;4
/net/per610a/home/mvp/mvp_db/news7-lv/2003/2003_06_07_19_00/2003_06_07_19_00.mpg;Junichiro KOIZUMI.jpg;7673;7697;35957;383;385;2
/net/per610a/home/mvp/mvp_db/news7-lv/2003/2003_06_07_19_00/2003_06_07_19_00.mpg;Junichiro KOIZUMI.jpg;34501;34557;35957;1726;1728;2
/net/per610a/home/mvp/mvp_db/news7-lv/2003/2003_06_07_19_00/2003_06_07_19_00.mpg;Shinzo ABE.jpg;7845;8125;35957;392;406;14
/net/per610a/home/mvp/mvp_db/news7-lv/2003/2003_06_09_19_00/2003_06_09_19_00.mpg;Junichiro KOIZUMI.jpg;3685;3965;35957;184;198;14
/net/per610a/home/mvp/mvp_db/news7-lv/2003/2003_06_10_19_00/2003_06_10_19_00.mpg;Takenori KANZAKI.jpg;2113;2205;35957;105;110;5
/net/per610a/home/mvp/mvp_db/news7-lv/2003/2003_06_10_19_00/2003_06_10_19_00.mpg;Yasuo FUKUDA.jpg;12025;12461;35957;601;623;22
/net/per610a/home/mvp/mvp_db/news7-lv/2003/2003_06_10_19_00/2003_06_10_19_00.mpg;Ichiro OZAWA.jpg;12889;13889;35957;644;694;50
/net/per610a/home/mvp/mvp_db/news7-lv/2003/2003_06_11_19_00/2003_06_11_19_00.mpg;Toranosuke Katayama.jpg;15405;15469;35957;770;773;3
/net/per610a/home/mvp/mvp_db/news7-lv/2003/2003_06_11_19_00/2003_06_11_19_00.mpg;Toranosuke Katayama.jpg;15533;15701;35957;777;785;8
/net/per610a/home/mvp/mvp_db/news7-lv/2003/2003_06_12_19_00/2003_06_12_19_00.mpg;Takenori KANZAKI.jpg;10841;10933;35957;542;546;4
/net/per610a/home/mvp/mvp_db/news7-lv/2003/2003_06_12_19_00/2003_06_12_19_00.mpg;Junichiro KOIZUMI.jpg;11337;12093;35957;567;605;38
/net/per610a/home/mvp/mvp_db/news7-lv/2003/2003_06_13_19_00/2003_06_13_19_00.mpg;Junichiro KOIZUMI.jpg;11113;11509;35957;556;575;19
/net/per610a/home/mvp/mvp_db/news7-lv/2003/2003_06_13_19_00/2003_06_13_19_00.mpg;Junichiro KOIZUMI.jpg;14853;15045;35957;743;752;9
/net/per610a/home/mvp/mvp_db/news7-lv/2003/2003_06_13_19_00/2003_06_13_19_00.mpg;Katsuya OKADA.jpg;14509;14773;35957;725;739;14
/net/per610a/home/mvp/mvp_db/news7-lv/2003/2003_06_15_19_00/2003_06_15_19_00.mpg;Shinzo ABE.jpg;7949;9057;23969;397;453;56
/net/per610a/home/mvp/mvp_db/news7-lv/2003/2003_06_16_19_00/2003_06_16_19_00.mpg;Yasuo FUKUDA.jpg;2629;2641;35957;131;132;1
/net/per610a/home/mvp/mvp_db/news7-lv/2003/2003_06_16_19_00/2003_06_16_19_00.mpg;Yasuo FUKUDA.jpg;7949;8589;35957;397;429;32
/net/per610a/home/mvp/mvp_db/news7-lv/2003/2003_06_16_19_00/2003_06_16_19_00.mpg;Junichiro KOIZUMI.jpg;3045;3081;35957;152;154;2
/net/per610a/home/mvp/mvp_db/news7-lv/2003/2003_06_16_19_00/2003_06_16_19_00.mpg;Junichiro KOIZUMI.jpg;3249;3321;35957;162;166;4
/net/per610a/home/mvp/mvp_db/news7-lv/2003/2003_06_16_19_00/2003_06_16_19_00.mpg;Junichiro KOIZUMI.jpg;5449;5525;35957;272;276;4
/net/per610a/home/mvp/mvp_db/news7-lv/2003/2003_06_16_19_00/2003_06_16_19_00.mpg;Takenori KANZAKI.jpg;3333;3425;35957;166;171;5
/net/per610a/home/mvp/mvp_db/news7-lv/2003/2003_06_16_19_00/2003_06_16_19_00.mpg;Katsuya OKADA.jpg;6101;6201;35957;305;310;5
/net/per610a/home/mvp/mvp_db/news7-lv/2003/2003_06_17_19_00/2003_06_17_19_00.mpg;Yasuo FUKUDA.jpg;5365;6085;35957;268;304;36
/net/per610a/home/mvp/mvp_db/news7-lv/2003/2003_06_19_19_00/2003_06_19_19_00.mpg;Junichiro KOIZUMI.jpg;19349;19957;35957;968;998;30
/net/per610a/home/mvp/mvp_db/news7-lv/2003/2003_06_19_19_00/2003_06_19_19_00.mpg;Junichiro KOIZUMI.jpg;20665;21049;35957;1033;1053;20
/net/per610a/home/mvp/mvp_db/news7-lv/2003/2003_06_21_19_00/2003_06_21_19_00.mpg;Kazuo SHII.jpg;23129;23241;35957;1157;1162;5
/net/per610a/home/mvp/mvp_db/news7-lv/2003/2003_06_23_19_00/2003_06_23_19_00.mpg;Junichiro KOIZUMI.jpg;24005;24113;35957;1201;1206;5
/net/per610a/home/mvp/mvp_db/news7-lv/2003/2003_06_23_19_00/2003_06_23_19_00.mpg;Junichiro KOIZUMI.jpg;24193;24201;35957;1210;1210;0
/net/per610a/home/mvp/mvp_db/news7-lv/2003/2003_06_23_19_00/2003_06_23_19_00.mpg;Junichiro KOIZUMI.jpg;24285;24653;35957;1215;1233;18
/net/per610a/home/mvp/mvp_db/news7-lv/2003/2003_06_23_19_00/2003_06_23_19_00.mpg;Junichiro KOIZUMI.jpg;24721;25273;35957;1236;1264;28
/net/per610a/home/mvp/mvp_db/news7-lv/2003/2003_06_24_19_00/2003_06_24_19_00.mpg;Kazuo SHII.jpg;5717;6993;35957;286;349;63
/net/per610a/home/mvp/mvp_db/news7-lv/2003/2003_06_24_19_00/2003_06_24_19_00.mpg;Yasuo FUKUDA.jpg;11549;11633;35957;577;582;5
/net/per610a/home/mvp/mvp_db/news7-lv/2003/2003_06_24_19_00/2003_06_24_19_00.mpg;Shintaro ISHIHARA.jpg;12185;12509;35957;609;625;16
/net/per610a/home/mvp/mvp_db/news7-lv/2003/2003_06_24_19_00/2003_06_24_19_00.mpg;Shintaro ISHIHARA.jpg;13453;13641;35957;673;682;9
/net/per610a/home/mvp/mvp_db/news7-lv/2003/2003_06_25_19_00/2003_06_25_19_00.mpg;Yasuo FUKUDA.jpg;20033;21641;35957;1002;1082;80
/net/per610a/home/mvp/mvp_db/news7-lv/2003/2003_06_27_19_00/2003_06_27_19_00.mpg;Shintaro ISHIHARA.jpg;26533;27061;35957;1327;1353;26
/net/per610a/home/mvp/mvp_db/news7-lv/2003/2003_07_02_19_00/2003_07_02_19_00.mpg;Ichiro OZAWA.jpg;689;809;35961;34;40;6
/net/per610a/home/mvp/mvp_db/news7-lv/2003/2003_07_02_19_00/2003_07_02_19_00.mpg;Ichiro OZAWA.jpg;7497;7749;35961;375;387;12
/net/per610a/home/mvp/mvp_db/news7-lv/2003/2003_07_02_19_00/2003_07_02_19_00.mpg;Junichiro KOIZUMI.jpg;26265;26321;35961;1313;1316;3
/net/per610a/home/mvp/mvp_db/news7-lv/2003/2003_07_02_19_00/2003_07_02_19_00.mpg;Junichiro KOIZUMI.jpg;26433;26857;35961;1322;1343;21
/net/per610a/home/mvp/mvp_db/news7-lv/2003/2003_07_04_19_00/2003_07_04_19_00.mpg;Junichiro KOIZUMI.jpg;16253;16793;35957;813;840;27
/net/per610a/home/mvp/mvp_db/news7-lv/2003/2003_07_04_19_00/2003_07_04_19_00.mpg;Junichiro KOIZUMI.jpg;19545;20065;35957;977;1003;26
/net/per610a/home/mvp/mvp_db/news7-lv/2003/2003_07_06_19_00/2003_07_06_19_00.mpg;Naoto KAN.jpg;8713;9113;23973;435;455;20
/net/per610a/home/mvp/mvp_db/news7-lv/2003/2003_07_06_19_00/2003_07_06_19_00.mpg;Naoto KAN.jpg;9181;10901;23973;459;545;86
/net/per610a/home/mvp/mvp_db/news7-lv/2003/2003_07_07_19_00/2003_07_07_19_00.mpg;Junichiro KOIZUMI.jpg;4549;4593;35957;227;229;2
/net/per610a/home/mvp/mvp_db/news7-lv/2003/2003_07_07_19_00/2003_07_07_19_00.mpg;Junichiro KOIZUMI.jpg;4689;4861;35957;234;243;9
/net/per610a/home/mvp/mvp_db/news7-lv/2003/2003_07_07_19_00/2003_07_07_19_00.mpg;Junichiro KOIZUMI.jpg;6325;6701;35957;316;335;19
/net/per610a/home/mvp/mvp_db/news7-lv/2003/2003_07_07_19_00/2003_07_07_19_00.mpg;Junichiro KOIZUMI.jpg;6777;6869;35957;339;343;4
/net/per610a/home/mvp/mvp_db/news7-lv/2003/2003_07_07_19_00/2003_07_07_19_00.mpg;Junichiro KOIZUMI.jpg;7397;8029;35957;370;401;31
/net/per610a/home/mvp/mvp_db/news7-lv/2003/2003_07_07_19_00/2003_07_07_19_00.mpg;Katsuya OKADA.jpg;8157;8245;35957;408;412;4
/net/per610a/home/mvp/mvp_db/news7-lv/2003/2003_07_08_19_00/2003_07_08_19_00.mpg;Junichiro KOIZUMI.jpg;15433;15761;35957;772;788;16
/net/per610a/home/mvp/mvp_db/news7-lv/2003/2003_07_08_19_00/2003_07_08_19_00.mpg;Junichiro KOIZUMI.jpg;16833;17177;35957;842;859;17
/net/per610a/home/mvp/mvp_db/news7-lv/2003/2003_07_08_19_00/2003_07_08_19_00.mpg;Junichiro KOIZUMI.jpg;20229;20233;35957;1012;1012;0
/net/per610a/home/mvp/mvp_db/news7-lv/2003/2003_07_09_19_00/2003_07_09_19_00.mpg;Junichiro KOIZUMI.jpg;18769;19393;35961;938;970;32
/net/per610a/home/mvp/mvp_db/news7-lv/2003/2003_07_09_19_00/2003_07_09_19_00.mpg;Takeo Hiranuma.jpeg;27329;27449;35961;1367;1373;6
/net/per610a/home/mvp/mvp_db/news7-lv/2003/2003_07_09_19_00/2003_07_09_19_00.mpg;Takeo Hiranuma.jpeg;27557;27725;35961;1378;1386;8
/net/per610a/home/mvp/mvp_db/news7-lv/2003/2003_07_11_19_00/2003_07_11_19_00.mpg;Junichiro KOIZUMI.jpg;17397;17925;35957;870;896;26
/net/per610a/home/mvp/mvp_db/news7-lv/2003/2003_07_11_19_00/2003_07_11_19_00.mpg;Junichiro KOIZUMI.jpg;18341;19297;35957;917;965;48
/net/per610a/home/mvp/mvp_db/news7-lv/2003/2003_07_12_19_00/2003_07_12_19_00.mpg;Naoto KAN.jpg;18061;19501;35957;903;975;72
/net/per610a/home/mvp/mvp_db/news7-lv/2003/2003_07_13_19_00/2003_07_13_19_00.mpg;Ichiro OZAWA.jpg;9685;9881;23973;484;494;10
/net/per610a/home/mvp/mvp_db/news7-lv/2003/2003_07_14_19_00/2003_07_14_19_00.mpg;Junichiro KOIZUMI.jpg;14501;14685;35957;725;734;9
/net/per610a/home/mvp/mvp_db/news7-lv/2003/2003_07_15_19_00/2003_07_15_19_00.mpg;Junichiro KOIZUMI.jpg;13129;13545;35957;656;677;21
/net/per610a/home/mvp/mvp_db/news7-lv/2003/2003_07_16_19_00/2003_07_16_19_00.mpg;Junichiro KOIZUMI.jpg;18149;19425;35957;908;971;63
/net/per610a/home/mvp/mvp_db/news7-lv/2003/2003_07_17_19_00/2003_07_17_19_00.mpg;Yasuo FUKUDA.jpg;19197;19749;35957;960;988;28
/net/per610a/home/mvp/mvp_db/news7-lv/2003/2003_07_18_19_00/2003_07_18_19_00.mpg;Junichiro KOIZUMI.jpg;14397;14553;35957;720;728;8
/net/per610a/home/mvp/mvp_db/news7-lv/2003/2003_07_18_19_00/2003_07_18_19_00.mpg;Junichiro KOIZUMI.jpg;15873;16353;35957;794;818;24
/net/per610a/home/mvp/mvp_db/news7-lv/2003/2003_07_19_19_00/2003_07_19_19_00.mpg;Junichiro KOIZUMI.jpg;9085;9177;35957;454;459;5
/net/per610a/home/mvp/mvp_db/news7-lv/2003/2003_07_19_19_00/2003_07_19_19_00.mpg;Junichiro KOIZUMI.jpg;9517;9661;35957;476;483;7
/net/per610a/home/mvp/mvp_db/news7-lv/2003/2003_07_22_19_00/2003_07_22_18_56.mpg;Ichiro OZAWA.jpg;6513;6893;71929;325;344;19
/net/per610a/home/mvp/mvp_db/news7-lv/2003/2003_07_22_19_00/2003_07_22_18_56.mpg;Naoto KAN.jpg;6569;6893;71929;328;344;16
/net/per610a/home/mvp/mvp_db/news7-lv/2003/2003_07_22_19_00/2003_07_22_18_56.mpg;Naoto KAN.jpg;7505;7661;71929;375;383;8
/net/per610a/home/mvp/mvp_db/news7-lv/2003/2003_07_22_19_00/2003_07_22_18_56.mpg;Ichiro OZAWA.jpg;7101;7185;71929;355;359;4
/net/per610a/home/mvp/mvp_db/news7-lv/2003/2003_07_22_19_00/2003_07_22_18_56.mpg;Ichiro OZAWA.jpg;7349;7349;71929;367;367;0
/net/per610a/home/mvp/mvp_db/news7-lv/2003/2003_07_22_19_00/2003_07_22_18_56.mpg;Ichiro OZAWA.jpg;7677;8441;71929;384;422;38
/net/per610a/home/mvp/mvp_db/news7-lv/2003/2003_07_22_19_00/2003_07_22_18_56.mpg;Yoshihiko Noda.jpg;33153;33261;71929;1659;1664;5
/net/per610a/home/mvp/mvp_db/news7-lv/2003/2003_07_22_19_00/2003_07_22_19_00.mpg;Ichiro OZAWA.jpg;2081;2461;36097;104;123;19
/net/per610a/home/mvp/mvp_db/news7-lv/2003/2003_07_22_19_00/2003_07_22_19_00.mpg;Naoto KAN.jpg;2093;2461;36097;104;123;19
/net/per610a/home/mvp/mvp_db/news7-lv/2003/2003_07_22_19_00/2003_07_22_19_00.mpg;Naoto KAN.jpg;2561;2653;36097;128;132;4
/net/per610a/home/mvp/mvp_db/news7-lv/2003/2003_07_22_19_00/2003_07_22_19_00.mpg;Yasuo FUKUDA.jpg;26249;26637;36097;1313;1332;19
/net/per610a/home/mvp/mvp_db/news7-lv/2003/2003_07_23_19_00/2003_07_23_18_56.mpg;Ichiro OZAWA.jpg;19801;20237;71929;991;1012;21
/net/per610a/home/mvp/mvp_db/news7-lv/2003/2003_07_23_19_00/2003_07_23_18_56.mpg;Naoto KAN.jpg;22461;22653;71929;1124;1133;9
/net/per610a/home/mvp/mvp_db/news7-lv/2003/2003_07_23_19_00/2003_07_23_19_00.mpg;Naoto KAN.jpg;697;793;35969;34;39;5
/net/per610a/home/mvp/mvp_db/news7-lv/2003/2003_07_23_19_00/2003_07_23_19_00.mpg;Naoto KAN.jpg;925;1085;35969;46;54;8
/net/per610a/home/mvp/mvp_db/news7-lv/2003/2003_07_23_19_00/2003_07_23_19_00.mpg;Naoto KAN.jpg;14045;14929;35969;702;747;45
/net/per610a/home/mvp/mvp_db/news7-lv/2003/2003_07_23_19_00/2003_07_23_19_00.mpg;Naoto KAN.jpg;15065;15137;35969;753;757;4
/net/per610a/home/mvp/mvp_db/news7-lv/2003/2003_07_23_19_00/2003_07_23_19_00.mpg;Naoto KAN.jpg;16389;16617;35969;820;831;11
/net/per610a/home/mvp/mvp_db/news7-lv/2003/2003_07_23_19_00/2003_07_23_19_00.mpg;Naoto KAN.jpg;17913;18053;35969;896;903;7
/net/per610a/home/mvp/mvp_db/news7-lv/2003/2003_07_23_19_00/2003_07_23_19_00.mpg;Ichiro OZAWA.jpg;15249;15705;35969;763;785;22
/net/per610a/home/mvp/mvp_db/news7-lv/2003/2003_07_24_19_00/2003_07_24_18_56.mpg;Yoshihiko Noda.jpg;17065;17209;71929;854;861;7
/net/per610a/home/mvp/mvp_db/news7-lv/2003/2003_07_24_19_00/2003_07_24_18_56.mpg;Naoto KAN.jpg;23217;23677;71929;1161;1185;24
/net/per610a/home/mvp/mvp_db/news7-lv/2003/2003_07_24_19_00/2003_07_24_18_56.mpg;Ichiro OZAWA.jpg;24173;24297;71929;1209;1216;7
/net/per610a/home/mvp/mvp_db/news7-lv/2003/2003_07_24_19_00/2003_07_24_19_00.mpg;Yoshihiko Noda.jpg;12525;12669;35977;626;633;7
/net/per610a/home/mvp/mvp_db/news7-lv/2003/2003_07_24_19_00/2003_07_24_19_00.mpg;Naoto KAN.jpg;18677;19125;35977;934;956;22
/net/per610a/home/mvp/mvp_db/news7-lv/2003/2003_07_25_19_00/2003_07_25_18_56.mpg;Junichiro KOIZUMI.jpg;5721;5749;71929;286;287;1
/net/per610a/home/mvp/mvp_db/news7-lv/2003/2003_07_25_19_00/2003_07_25_18_56.mpg;Junichiro KOIZUMI.jpg;6409;6441;71929;320;322;2
/net/per610a/home/mvp/mvp_db/news7-lv/2003/2003_07_25_19_00/2003_07_25_18_56.mpg;Junichiro KOIZUMI.jpg;6705;6957;71929;335;348;13
/net/per610a/home/mvp/mvp_db/news7-lv/2003/2003_07_25_19_00/2003_07_25_18_56.mpg;Junichiro KOIZUMI.jpg;17069;17177;71929;854;859;5
/net/per610a/home/mvp/mvp_db/news7-lv/2003/2003_07_25_19_00/2003_07_25_18_56.mpg;Junichiro KOIZUMI.jpg;17697;18377;71929;885;919;34
/net/per610a/home/mvp/mvp_db/news7-lv/2003/2003_07_25_19_00/2003_07_25_19_00.mpg;Junichiro KOIZUMI.jpg;1177;1205;35969;58;60;2
/net/per610a/home/mvp/mvp_db/news7-lv/2003/2003_07_25_19_00/2003_07_25_19_00.mpg;Junichiro KOIZUMI.jpg;1869;1905;35969;93;95;2
/net/per610a/home/mvp/mvp_db/news7-lv/2003/2003_07_25_19_00/2003_07_25_19_00.mpg;Junichiro KOIZUMI.jpg;2161;2417;35969;108;120;12
/net/per610a/home/mvp/mvp_db/news7-lv/2003/2003_07_25_19_00/2003_07_25_19_00.mpg;Junichiro KOIZUMI.jpg;12529;12637;35969;626;632;6
/net/per610a/home/mvp/mvp_db/news7-lv/2003/2003_07_25_19_00/2003_07_25_19_00.mpg;Junichiro KOIZUMI.jpg;13153;13833;35969;658;692;34
/net/per610a/home/mvp/mvp_db/news7-lv/2003/2003_07_28_19_00/2003_07_28_18_56.mpg;Junichiro KOIZUMI.jpg;5257;5257;71929;263;263;0
/net/per610a/home/mvp/mvp_db/news7-lv/2003/2003_07_28_19_00/2003_07_28_18_56.mpg;Junichiro KOIZUMI.jpg;5429;5565;71929;271;278;7
/net/per610a/home/mvp/mvp_db/news7-lv/2003/2003_07_28_19_00/2003_07_28_18_56.mpg;Junichiro KOIZUMI.jpg;17529;17573;71929;877;879;2
/net/per610a/home/mvp/mvp_db/news7-lv/2003/2003_07_28_19_00/2003_07_28_18_56.mpg;Junichiro KOIZUMI.jpg;18149;18153;71929;908;908;0
/net/per610a/home/mvp/mvp_db/news7-lv/2003/2003_07_28_19_00/2003_07_28_18_56.mpg;Junichiro KOIZUMI.jpg;18381;18709;71929;919;936;17
/net/per610a/home/mvp/mvp_db/news7-lv/2003/2003_07_28_19_00/2003_07_28_18_56.mpg;Junichiro KOIZUMI.jpg;23513;23937;71929;1176;1198;22
/net/per610a/home/mvp/mvp_db/news7-lv/2003/2003_07_28_19_00/2003_07_28_18_56.mpg;Takenori KANZAKI.jpg;20753;23133;71929;1038;1157;119
/net/per610a/home/mvp/mvp_db/news7-lv/2003/2003_07_28_19_00/2003_07_28_19_00.mpg;Junichiro KOIZUMI.jpg;869;1005;35969;43;50;7
/net/per610a/home/mvp/mvp_db/news7-lv/2003/2003_07_28_19_00/2003_07_28_19_00.mpg;Junichiro KOIZUMI.jpg;12969;13009;35969;649;651;2
/net/per610a/home/mvp/mvp_db/news7-lv/2003/2003_07_28_19_00/2003_07_28_19_00.mpg;Junichiro KOIZUMI.jpg;13565;13601;35969;678;680;2
/net/per610a/home/mvp/mvp_db/news7-lv/2003/2003_07_28_19_00/2003_07_28_19_00.mpg;Junichiro KOIZUMI.jpg;13821;14149;35969;691;708;17
/net/per610a/home/mvp/mvp_db/news7-lv/2003/2003_07_28_19_00/2003_07_28_19_00.mpg;Junichiro KOIZUMI.jpg;18949;19377;35969;948;969;21
/net/per610a/home/mvp/mvp_db/news7-lv/2003/2003_07_28_19_00/2003_07_28_19_00.mpg;Takenori KANZAKI.jpg;16189;18569;35969;810;929;119
/net/per610a/home/mvp/mvp_db/news7-lv/2003/2003_07_29_19_00/2003_07_29_19_00.mpg;Junichiro KOIZUMI.jpg;349;477;35957;17;23;6
/net/per610a/home/mvp/mvp_db/news7-lv/2003/2003_07_29_19_00/2003_07_29_19_00.mpg;Junichiro KOIZUMI.jpg;3461;4165;35957;173;208;35
/net/per610a/home/mvp/mvp_db/news7-lv/2003/2003_07_29_19_00/2003_07_29_19_00.mpg;Junichiro KOIZUMI.jpg;1581;2401;35957;79;120;41
/net/per610a/home/mvp/mvp_db/news7-lv/2003/2003_07_29_19_00/2003_07_29_19_00.mpg;Junichiro KOIZUMI.jpg;2497;3333;35957;124;166;42
/net/per610a/home/mvp/mvp_db/news7-lv/2003/2003_07_29_19_00/2003_07_29_19_00.mpg;Naoto KAN.jpg;5597;6137;35957;280;307;27
/net/per610a/home/mvp/mvp_db/news7-lv/2003/2003_07_29_19_00/2003_07_29_19_00.mpg;Ichiro OZAWA.jpg;10221;10801;35957;511;540;29
/net/per610a/home/mvp/mvp_db/news7-lv/2003/2003_07_30_19_00/2003_07_30_19_00.mpg;Junichiro KOIZUMI.jpg;6625;6957;35957;331;348;17
/net/per610a/home/mvp/mvp_db/news7-lv/2003/2003_07_30_19_00/2003_07_30_19_00.mpg;Junichiro KOIZUMI.jpg;8757;9741;35957;438;487;49
/net/per610a/home/mvp/mvp_db/news7-lv/2003/2003_07_31_19_00/2003_07_31_19_00.mpg;Yasuo FUKUDA.jpg;4949;5725;35957;247;286;39
/net/per610a/home/mvp/mvp_db/news7-lv/2003/2003_07_31_19_00/2003_07_31_19_00.mpg;Yasuo FUKUDA.jpg;23037;23397;35957;1152;1170;18
/net/per610a/home/mvp/mvp_db/news7-lv/2003/2003_07_31_19_00/2003_07_31_19_00.mpg;Junichiro KOIZUMI.jpg;7833;8497;35957;391;425;34
/net/per610a/home/mvp/mvp_db/news7-lv/2003/2003_07_31_19_00/2003_07_31_19_00.mpg;Katsuya OKADA.jpg;10697;10777;35957;535;539;4
/net/per610a/home/mvp/mvp_db/news7-lv/2003/2003_07_31_19_00/2003_07_31_19_00.mpg;Katsuya OKADA.jpg;11649;12357;35957;582;618;36
/net/per610a/home/mvp/mvp_db/news7-lv/2003/2003_08_01_19_00/2003_08_01_19_00.mpg;Yasuo FUKUDA.jpg;2981;3537;35957;149;176;27
/net/per610a/home/mvp/mvp_db/news7-lv/2003/2003_08_01_19_00/2003_08_01_19_00.mpg;Kyoko Nakayama.jpg;15337;16201;35957;767;810;43
/net/per610a/home/mvp/mvp_db/news7-lv/2003/2003_08_02_19_00/2003_08_02_19_00.mpg;Kyoko Nakayama.jpg;12433;13149;35957;622;657;35
/net/per610a/home/mvp/mvp_db/news7-lv/2003/2003_08_04_19_00/2003_08_04_19_00.mpg;Yasuo FUKUDA.jpg;3821;4389;35957;191;219;28
/net/per610a/home/mvp/mvp_db/news7-lv/2003/2003_08_06_19_00/2003_08_06_19_00.mpg;Ichiro OZAWA.jpg;23629;24237;35957;1182;1212;30
/net/per610a/home/mvp/mvp_db/news7-lv/2003/2003_08_07_19_00/2003_08_07_19_00.mpg;Yasuo FUKUDA.jpg;19313;19693;35957;966;985;19
/net/per610a/home/mvp/mvp_db/news7-lv/2003/2003_08_09_19_00/2003_08_09_19_00.mpg;Yasuo FUKUDA.jpg;27077;27181;35957;1354;1359;5
/net/per610a/home/mvp/mvp_db/news7-lv/2003/2003_08_09_19_00/2003_08_09_19_00.mpg;Yasuo FUKUDA.jpg;27313;27517;35957;1366;1376;10
/net/per610a/home/mvp/mvp_db/news7-lv/2003/2003_08_09_19_00/2003_08_09_19_00.mpg;Yasuo FUKUDA.jpg;27981;28033;35957;1399;1402;3
/net/per610a/home/mvp/mvp_db/news7-lv/2003/2003_08_11_19_00/2003_08_11_19_00.mpg;Junichiro KOIZUMI.jpg;15105;15385;35957;755;769;14
/net/per610a/home/mvp/mvp_db/news7-lv/2003/2003_08_11_19_00/2003_08_11_19_00.mpg;Yasuo FUKUDA.jpg;16393;16429;35957;820;821;1
/net/per610a/home/mvp/mvp_db/news7-lv/2003/2003_08_11_19_00/2003_08_11_19_00.mpg;Yasuo FUKUDA.jpg;22273;22325;35957;1114;1116;2
/net/per610a/home/mvp/mvp_db/news7-lv/2003/2003_08_11_19_00/2003_08_11_19_00.mpg;Naoto KAN.jpg;17873;17933;35957;894;897;3
/net/per610a/home/mvp/mvp_db/news7-lv/2003/2003_08_11_19_00/2003_08_11_19_00.mpg;Naoto KAN.jpg;18289;18649;35957;915;933;18
/net/per610a/home/mvp/mvp_db/news7-lv/2003/2003_08_13_19_00/2003_08_13_19_00.mpg;Masashi Nakano.jpg;12201;12373;35957;610;619;9
/net/per610a/home/mvp/mvp_db/news7-lv/2003/2003_08_15_19_00/2003_08_15_19_00.mpg;Sadakazu TANIGAKI.jpg;19157;19973;35957;958;999;41
/net/per610a/home/mvp/mvp_db/news7-lv/2003/2003_08_18_19_00/2003_08_18_19_00.mpg;Junichiro KOIZUMI.jpg;12073;12081;35957;604;604;0
/net/per610a/home/mvp/mvp_db/news7-lv/2003/2003_08_18_19_00/2003_08_18_19_00.mpg;Junichiro KOIZUMI.jpg;12429;12441;35957;621;622;1
/net/per610a/home/mvp/mvp_db/news7-lv/2003/2003_08_18_19_00/2003_08_18_19_00.mpg;Junichiro KOIZUMI.jpg;13289;13873;35957;664;694;30
/net/per610a/home/mvp/mvp_db/news7-lv/2003/2003_08_18_19_00/2003_08_18_19_00.mpg;Shintaro ISHIHARA.jpg;15145;15529;35957;757;776;19
/net/per610a/home/mvp/mvp_db/news7-lv/2003/2003_08_20_19_00/2003_08_20_19_00.mpg;Yasuo FUKUDA.jpg;13589;15013;35957;679;751;72
/net/per610a/home/mvp/mvp_db/news7-lv/2003/2003_08_20_19_00/2003_08_20_19_00.mpg;Junichiro KOIZUMI.jpg;17633;17989;35957;882;900;18
/net/per610a/home/mvp/mvp_db/news7-lv/2003/2003_08_21_19_00/2003_08_21_19_00.mpg;Yasuo FUKUDA.jpg;8813;9309;35957;440;465;25
/net/per610a/home/mvp/mvp_db/news7-lv/2003/2003_08_23_19_00/2003_08_23_19_00.mpg;Shinzo ABE.jpg;12857;13577;35957;643;679;36
/net/per610a/home/mvp/mvp_db/news7-lv/2003/2003_08_25_19_00/2003_08_25_19_00.mpg;Yasuo FUKUDA.jpg;9297;9597;35961;465;480;15
/net/per610a/home/mvp/mvp_db/news7-lv/2003/2003_08_26_19_00/2003_08_26_19_00.mpg;Junichiro KOIZUMI.jpg;23877;24009;35957;1194;1201;7
/net/per610a/home/mvp/mvp_db/news7-lv/2003/2003_08_26_19_00/2003_08_26_19_00.mpg;Junichiro KOIZUMI.jpg;24129;24129;35957;1207;1207;0
/net/per610a/home/mvp/mvp_db/news7-lv/2003/2003_08_26_19_00/2003_08_26_19_00.mpg;Junichiro KOIZUMI.jpg;24305;24397;35957;1216;1220;4
/net/per610a/home/mvp/mvp_db/news7-lv/2003/2003_08_30_19_00/2003_08_30_19_00.mpg;Shizuka KAMEI.jpg;12477;14501;35957;624;725;101
/net/per610a/home/mvp/mvp_db/news7-lv/2003/2003_09_01_19_00/2003_09_01_19_00.mpg;Junichiro KOIZUMI.jpg;581;689;35957;29;34;5
/net/per610a/home/mvp/mvp_db/news7-lv/2003/2003_09_01_19_00/2003_09_01_19_00.mpg;Junichiro KOIZUMI.jpg;3313;3389;35957;165;169;4
/net/per610a/home/mvp/mvp_db/news7-lv/2003/2003_09_01_19_00/2003_09_01_19_00.mpg;Junichiro KOIZUMI.jpg;18865;19069;35957;943;954;11
/net/per610a/home/mvp/mvp_db/news7-lv/2003/2003_09_02_19_00/2003_09_02_19_00.mpg;Junichiro KOIZUMI.jpg;13817;14817;35957;691;741;50
/net/per610a/home/mvp/mvp_db/news7-lv/2003/2003_09_03_19_00/2003_09_03_19_00.mpg;Shizuka KAMEI.jpg;4733;4785;35957;236;239;3
/net/per610a/home/mvp/mvp_db/news7-lv/2003/2003_09_03_19_00/2003_09_03_19_00.mpg;Shizuka KAMEI.jpg;4885;5933;35957;244;296;52
/net/per610a/home/mvp/mvp_db/news7-lv/2003/2003_09_03_19_00/2003_09_03_19_00.mpg;Shizuka KAMEI.jpg;6313;6553;35957;315;327;12
/net/per610a/home/mvp/mvp_db/news7-lv/2003/2003_09_04_19_00/2003_09_04_19_00.mpg;Yasuo FUKUDA.jpg;10305;10961;35957;515;548;33
/net/per610a/home/mvp/mvp_db/news7-lv/2003/2003_09_05_19_00/2003_09_05_19_00.mpg;Shizuka KAMEI.jpg;473;529;35957;23;26;3
/net/per610a/home/mvp/mvp_db/news7-lv/2003/2003_09_05_19_00/2003_09_05_19_00.mpg;Shizuka KAMEI.jpg;5397;5633;35957;270;281;11
/net/per610a/home/mvp/mvp_db/news7-lv/2003/2003_09_05_19_00/2003_09_05_19_00.mpg;Shizuka KAMEI.jpg;5753;5805;35957;287;290;3
/net/per610a/home/mvp/mvp_db/news7-lv/2003/2003_09_05_19_00/2003_09_05_19_00.mpg;Shizuka KAMEI.jpg;5913;6169;35957;295;308;13
/net/per610a/home/mvp/mvp_db/news7-lv/2003/2003_09_05_19_00/2003_09_05_19_00.mpg;Shizuka KAMEI.jpg;6537;6605;35957;327;330;3
/net/per610a/home/mvp/mvp_db/news7-lv/2003/2003_09_05_19_00/2003_09_05_19_00.mpg;Junichiro KOIZUMI.jpg;5389;5633;35957;269;281;12
/net/per610a/home/mvp/mvp_db/news7-lv/2003/2003_09_05_19_00/2003_09_05_19_00.mpg;Junichiro KOIZUMI.jpg;8653;8921;35957;432;446;14
/net/per610a/home/mvp/mvp_db/news7-lv/2003/2003_09_05_19_00/2003_09_05_19_00.mpg;Shintaro ISHIHARA.jpg;14249;14589;35957;712;729;17
/net/per610a/home/mvp/mvp_db/news7-lv/2003/2003_09_07_19_00/2003_09_07_19_00.mpg;Junichiro KOIZUMI.jpg;489;637;23969;24;31;7
/net/per610a/home/mvp/mvp_db/news7-lv/2003/2003_09_07_19_00/2003_09_07_19_00.mpg;Shinzo ABE.jpg;4885;5745;23969;244;287;43
/net/per610a/home/mvp/mvp_db/news7-lv/2003/2003_09_07_19_00/2003_09_07_19_00.mpg;Ichiro OZAWA.jpg;8833;9065;23969;441;453;12
/net/per610a/home/mvp/mvp_db/news7-lv/2003/2003_09_07_19_00/2003_09_07_19_00.mpg;Ichiro OZAWA.jpg;9461;9869;23969;473;493;20
/net/per610a/home/mvp/mvp_db/news7-lv/2003/2003_09_07_19_00/2003_09_07_19_00.mpg;Ichiro OZAWA.jpg;10297;10581;23969;515;529;14
/net/per610a/home/mvp/mvp_db/news7-lv/2003/2003_09_08_19_00/2003_09_08_19_00.mpg;Junichiro KOIZUMI.jpg;6993;7429;35961;349;371;22
/net/per610a/home/mvp/mvp_db/news7-lv/2003/2003_09_08_19_00/2003_09_08_19_00.mpg;Junichiro KOIZUMI.jpg;8601;9049;35961;430;452;22
/net/per610a/home/mvp/mvp_db/news7-lv/2003/2003_09_08_19_00/2003_09_08_19_00.mpg;Junichiro KOIZUMI.jpg;15917;16477;35961;796;824;28
/net/per610a/home/mvp/mvp_db/news7-lv/2003/2003_09_08_19_00/2003_09_08_19_00.mpg;Junichiro KOIZUMI.jpg;17229;17613;35961;861;881;20
/net/per610a/home/mvp/mvp_db/news7-lv/2003/2003_09_08_19_00/2003_09_08_19_00.mpg;Junichiro KOIZUMI.jpg;18685;20605;35961;934;1030;96
/net/per610a/home/mvp/mvp_db/news7-lv/2003/2003_09_08_19_00/2003_09_08_19_00.mpg;Junichiro KOIZUMI.jpg;23289;23661;35961;1165;1183;18
/net/per610a/home/mvp/mvp_db/news7-lv/2003/2003_09_08_19_00/2003_09_08_19_00.mpg;Junichiro KOIZUMI.jpg;25001;25729;35961;1250;1287;37
/net/per610a/home/mvp/mvp_db/news7-lv/2003/2003_09_08_19_00/2003_09_08_19_00.mpg;Junichiro KOIZUMI.jpg;26189;28313;35961;1310;1416;106
/net/per610a/home/mvp/mvp_db/news7-lv/2003/2003_09_08_19_00/2003_09_08_19_00.mpg;Junichiro KOIZUMI.jpg;28657;29257;35961;1433;1463;30
/net/per610a/home/mvp/mvp_db/news7-lv/2003/2003_09_09_19_00/2003_09_09_19_00.mpg;Junichiro KOIZUMI.jpg;3697;5069;35957;184;253;69
/net/per610a/home/mvp/mvp_db/news7-lv/2003/2003_09_09_19_00/2003_09_09_19_00.mpg;Junichiro KOIZUMI.jpg;10209;10921;35957;510;546;36
/net/per610a/home/mvp/mvp_db/news7-lv/2003/2003_09_09_19_00/2003_09_09_19_00.mpg;Yasuo FUKUDA.jpg;21905;23337;35957;1095;1167;72
/net/per610a/home/mvp/mvp_db/news7-lv/2003/2003_09_10_19_00/2003_09_10_19_00.mpg;Junichiro KOIZUMI.jpg;269;413;35957;13;20;7
/net/per610a/home/mvp/mvp_db/news7-lv/2003/2003_09_10_19_00/2003_09_10_19_00.mpg;Junichiro KOIZUMI.jpg;2457;3253;35957;122;162;40
/net/per610a/home/mvp/mvp_db/news7-lv/2003/2003_09_10_19_00/2003_09_10_19_00.mpg;Junichiro KOIZUMI.jpg;5117;5705;35957;256;285;29
/net/per610a/home/mvp/mvp_db/news7-lv/2003/2003_09_10_19_00/2003_09_10_19_00.mpg;Junichiro KOIZUMI.jpg;15081;16241;35957;754;812;58
/net/per610a/home/mvp/mvp_db/news7-lv/2003/2003_09_11_19_00/2003_09_11_19_00.mpg;Junichiro KOIZUMI.jpg;6493;7645;35957;324;382;58
/net/per610a/home/mvp/mvp_db/news7-lv/2003/2003_09_11_19_00/2003_09_11_19_00.mpg;Junichiro KOIZUMI.jpg;8141;8465;35957;407;423;16
/net/per610a/home/mvp/mvp_db/news7-lv/2003/2003_09_11_19_00/2003_09_11_19_00.mpg;Junichiro KOIZUMI.jpg;13905;14745;35957;695;737;42
/net/per610a/home/mvp/mvp_db/news7-lv/2003/2003_09_12_19_00/2003_09_12_19_00.mpg;Junichiro KOIZUMI.jpg;10949;11493;35957;547;575;28
/net/per610a/home/mvp/mvp_db/news7-lv/2003/2003_09_12_19_00/2003_09_12_19_00.mpg;Shintaro ISHIHARA.jpg;15561;15889;35957;778;794;16
/net/per610a/home/mvp/mvp_db/news7-lv/2003/2003_09_12_19_00/2003_09_12_19_00.mpg;Shintaro ISHIHARA.jpg;17109;17969;35957;855;899;44
/net/per610a/home/mvp/mvp_db/news7-lv/2003/2003_09_12_19_00/2003_09_12_19_00.mpg;Yasuo FUKUDA.jpg;15945;17053;35957;797;853;56
/net/per610a/home/mvp/mvp_db/news7-lv/2003/2003_09_13_19_00/2003_09_13_19_00.mpg;Yukio HATOYAMA.jpg;14245;14425;35957;712;721;9
/net/per610a/home/mvp/mvp_db/news7-lv/2003/2003_09_15_19_00/2003_09_15_19_00.mpg;Junichiro KOIZUMI.jpg;16389;16525;35957;819;826;7
/net/per610a/home/mvp/mvp_db/news7-lv/2003/2003_09_15_19_00/2003_09_15_19_00.mpg;Junichiro KOIZUMI.jpg;16637;16693;35957;832;835;3
/net/per610a/home/mvp/mvp_db/news7-lv/2003/2003_09_16_19_00/2003_09_16_19_00.mpg;Junichiro KOIZUMI.jpg;26837;28241;35961;1342;1412;70
/net/per610a/home/mvp/mvp_db/news7-lv/2003/2003_09_16_19_00/2003_09_16_19_00.mpg;Junichiro KOIZUMI.jpg;28353;28397;35961;1418;1420;2
/net/per610a/home/mvp/mvp_db/news7-lv/2003/2003_09_17_19_00/2003_09_17_19_00.mpg;Junichiro KOIZUMI.jpg;1493;1849;35957;74;92;18
/net/per610a/home/mvp/mvp_db/news7-lv/2003/2003_09_17_19_00/2003_09_17_19_00.mpg;Junichiro KOIZUMI.jpg;4321;4445;35957;216;222;6
/net/per610a/home/mvp/mvp_db/news7-lv/2003/2003_09_17_19_00/2003_09_17_19_00.mpg;Yukio HATOYAMA.jpg;2993;3293;35957;149;164;15
/net/per610a/home/mvp/mvp_db/news7-lv/2003/2003_09_17_19_00/2003_09_17_19_00.mpg;Yukio HATOYAMA.jpg;3925;3965;35957;196;198;2
/net/per610a/home/mvp/mvp_db/news7-lv/2003/2003_09_17_19_00/2003_09_17_19_00.mpg;Junichiro KOIZUMI.jpg;8717;9581;35957;436;479;43
/net/per610a/home/mvp/mvp_db/news7-lv/2003/2003_09_17_19_00/2003_09_17_19_00.mpg;Yasuo FUKUDA.jpg;24681;25053;35957;1234;1253;19
/net/per610a/home/mvp/mvp_db/news7-lv/2003/2003_09_18_19_00/2003_09_18_19_00.mpg;Junichiro KOIZUMI.jpg;2361;2457;35957;118;122;4
/net/per610a/home/mvp/mvp_db/news7-lv/2003/2003_09_19_19_00/2003_09_19_19_00.mpg;Junichiro KOIZUMI.jpg;2073;2217;35957;103;110;7
/net/per610a/home/mvp/mvp_db/news7-lv/2003/2003_09_20_19_00/2003_09_20_19_00.mpg;Junichiro KOIZUMI.jpg;4101;4469;35957;205;223;18
/net/per610a/home/mvp/mvp_db/news7-lv/2003/2003_09_20_19_00/2003_09_20_19_00.mpg;Junichiro KOIZUMI.jpg;6397;6469;35957;320;323;3
/net/per610a/home/mvp/mvp_db/news7-lv/2003/2003_09_20_19_00/2003_09_20_19_00.mpg;Takenori KANZAKI.jpg;11249;13369;35957;562;668;106
/net/per610a/home/mvp/mvp_db/news7-lv/2003/2003_09_20_19_00/2003_09_20_19_00.mpg;Junichiro KOIZUMI.jpg;13725;15837;35957;686;792;106
/net/per610a/home/mvp/mvp_db/news7-lv/2003/2003_09_20_19_00/2003_09_20_19_00.mpg;Junichiro KOIZUMI.jpg;15901;16033;35957;795;802;7
/net/per610a/home/mvp/mvp_db/news7-lv/2003/2003_09_20_19_00/2003_09_20_19_00.mpg;Junichiro KOIZUMI.jpg;18709;19213;35957;936;961;25
/net/per610a/home/mvp/mvp_db/news7-lv/2003/2003_09_20_19_00/2003_09_20_19_00.mpg;Naoto KAN.jpg;19969;20257;35957;999;1013;14
/net/per610a/home/mvp/mvp_db/news7-lv/2003/2003_09_20_19_00/2003_09_20_19_00.mpg;Ichiro OZAWA.jpg;19969;20257;35957;999;1013;14
/net/per610a/home/mvp/mvp_db/news7-lv/2003/2003_09_21_19_00/2003_09_21_19_00.mpg;Junichiro KOIZUMI.jpg;733;797;23969;36;39;3
/net/per610a/home/mvp/mvp_db/news7-lv/2003/2003_09_21_19_00/2003_09_21_19_00.mpg;Junichiro KOIZUMI.jpg;1093;1173;23969;54;58;4
/net/per610a/home/mvp/mvp_db/news7-lv/2003/2003_09_21_19_00/2003_09_21_19_00.mpg;Junichiro KOIZUMI.jpg;3525;3573;23969;176;178;2
/net/per610a/home/mvp/mvp_db/news7-lv/2003/2003_09_21_19_00/2003_09_21_19_00.mpg;Junichiro KOIZUMI.jpg;4233;5477;23969;211;273;62
/net/per610a/home/mvp/mvp_db/news7-lv/2003/2003_09_21_19_00/2003_09_21_19_00.mpg;Junichiro KOIZUMI.jpg;13649;14049;23969;682;702;20
/net/per610a/home/mvp/mvp_db/news7-lv/2003/2003_09_21_19_00/2003_09_21_19_00.mpg;Junichiro KOIZUMI.jpg;23421;23777;23969;1171;1189;18
/net/per610a/home/mvp/mvp_db/news7-lv/2003/2003_09_21_19_00/2003_09_21_19_00.mpg;Shinzo ABE.jpg;1133;1133;23969;56;56;0
/net/per610a/home/mvp/mvp_db/news7-lv/2003/2003_09_21_19_00/2003_09_21_19_00.mpg;Shinzo ABE.jpg;1225;1865;23969;61;93;32
/net/per610a/home/mvp/mvp_db/news7-lv/2003/2003_09_21_19_00/2003_09_21_19_00.mpg;Shinzo ABE.jpg;5581;5757;23969;279;287;8
/net/per610a/home/mvp/mvp_db/news7-lv/2003/2003_09_21_19_00/2003_09_21_19_00.mpg;Shinzo ABE.jpg;6965;7057;23969;348;353;5
/net/per610a/home/mvp/mvp_db/news7-lv/2003/2003_09_21_19_00/2003_09_21_19_00.mpg;Shinzo ABE.jpg;12349;12373;23969;617;618;1
/net/per610a/home/mvp/mvp_db/news7-lv/2003/2003_09_21_19_00/2003_09_21_19_00.mpg;Shinzo ABE.jpg;3581;3665;23969;179;183;4
/net/per610a/home/mvp/mvp_db/news7-lv/2003/2003_09_21_19_00/2003_09_21_19_00.mpg;Shinzo ABE.jpg;12873;12913;23969;643;645;2
/net/per610a/home/mvp/mvp_db/news7-lv/2003/2003_09_21_19_00/2003_09_21_19_00.mpg;Takenori KANZAKI.jpg;14173;14573;23969;708;728;20
/net/per610a/home/mvp/mvp_db/news7-lv/2003/2003_09_22_19_00/2003_09_22_19_00.mpg;Yasuo FUKUDA.jpg;1377;1561;35961;68;78;10
/net/per610a/home/mvp/mvp_db/news7-lv/2003/2003_09_22_19_00/2003_09_22_19_00.mpg;Yasuo FUKUDA.jpg;9865;9953;35961;493;497;4
/net/per610a/home/mvp/mvp_db/news7-lv/2003/2003_09_22_19_00/2003_09_22_19_00.mpg;Junichiro KOIZUMI.jpg;4837;4945;35961;241;247;6
/net/per610a/home/mvp/mvp_db/news7-lv/2003/2003_09_22_19_00/2003_09_22_19_00.mpg;Shinzo ABE.jpg;6417;6573;35961;321;328;7
/net/per610a/home/mvp/mvp_db/news7-lv/2003/2003_09_22_19_00/2003_09_22_19_00.mpg;Shinzo ABE.jpg;30473;31173;35961;1524;1559;35
/net/per610a/home/mvp/mvp_db/news7-lv/2003/2003_09_22_19_00/2003_09_22_19_00.mpg;YUriko Koike.jpg;19689;19861;35961;984;993;9
/net/per610a/home/mvp/mvp_db/news7-lv/2003/2003_09_22_19_00/2003_09_22_19_00.mpg;YUriko Koike.jpg;20825;20977;35961;1041;1049;8
/net/per610a/home/mvp/mvp_db/news7-lv/2003/2003_09_22_19_00/2003_09_22_19_00.mpg;YUriko Koike.jpg;21045;22601;35961;1052;1130;78
/net/per610a/home/mvp/mvp_db/news7-lv/2003/2003_09_22_19_00/2003_09_22_19_00.mpg;Sadakazu TANIGAKI.jpg;22693;22793;35961;1135;1140;5
/net/per610a/home/mvp/mvp_db/news7-lv/2003/2003_09_22_19_00/2003_09_22_19_00.mpg;Sadakazu TANIGAKI.jpg;24185;24625;35961;1209;1231;22
/net/per610a/home/mvp/mvp_db/news7-lv/2003/2003_09_22_19_00/2003_09_22_19_00.mpg;Takenori KANZAKI.jpg;32305;34713;35961;1616;1736;120
/net/per610a/home/mvp/mvp_db/news7-lv/2003/2003_09_22_19_00/2003_09_22_19_00.mpg;Taro ASO.jpg;34853;34885;35961;1743;1745;2
/net/per610a/home/mvp/mvp_db/news7-lv/2003/2003_09_22_19_00/2003_09_22_19_00.mpg;Taro ASO.jpg;35081;35133;35961;1754;1757;3
/net/per610a/home/mvp/mvp_db/news7-lv/2003/2003_09_22_19_00/2003_09_22_19_00.mpg;Taro ASO.jpg;35329;35957;35961;1767;1798;31
/net/per610a/home/mvp/mvp_db/news7-lv/2003/2003_09_23_19_00/2003_09_23_19_00.mpg;Takenori KANZAKI.jpg;3393;3973;35957;169;198;29
/net/per610a/home/mvp/mvp_db/news7-lv/2003/2003_09_24_19_00/2003_09_24_19_00.mpg;Naoto KAN.jpg;249;669;35957;12;33;21
/net/per610a/home/mvp/mvp_db/news7-lv/2003/2003_09_24_19_00/2003_09_24_19_00.mpg;Naoto KAN.jpg;2285;2385;35957;114;119;5
/net/per610a/home/mvp/mvp_db/news7-lv/2003/2003_09_24_19_00/2003_09_24_19_00.mpg;Naoto KAN.jpg;2693;4657;35957;134;232;98
/net/per610a/home/mvp/mvp_db/news7-lv/2003/2003_09_24_19_00/2003_09_24_19_00.mpg;Naoto KAN.jpg;6761;6945;35957;338;347;9
/net/per610a/home/mvp/mvp_db/news7-lv/2003/2003_09_24_19_00/2003_09_24_19_00.mpg;Naoto KAN.jpg;8377;8517;35957;419;426;7
/net/per610a/home/mvp/mvp_db/news7-lv/2003/2003_09_24_19_00/2003_09_24_19_00.mpg;Junichiro KOIZUMI.jpg;4921;5541;35957;246;277;31
/net/per610a/home/mvp/mvp_db/news7-lv/2003/2003_09_24_19_00/2003_09_24_19_00.mpg;Junichiro KOIZUMI.jpg;6761;6945;35957;338;347;9
/net/per610a/home/mvp/mvp_db/news7-lv/2003/2003_09_25_19_00/2003_09_25_19_00.mpg;YUriko Koike.jpg;21281;23273;35957;1064;1164;100
/net/per610a/home/mvp/mvp_db/news7-lv/2003/2003_09_25_19_00/2003_09_25_19_00.mpg;YUriko Koike.jpg;23653;25149;35957;1183;1258;75
/net/per610a/home/mvp/mvp_db/news7-lv/2003/2003_09_26_19_00/2003_09_26_19_00.mpg;Ichiro OZAWA.jpg;877;973;35961;43;48;5
/net/per610a/home/mvp/mvp_db/news7-lv/2003/2003_09_29_19_00/2003_09_29_19_00.mpg;Junichiro KOIZUMI.jpg;9713;10217;35957;485;511;26
/net/per610a/home/mvp/mvp_db/news7-lv/2003/2003_09_29_19_00/2003_09_29_19_00.mpg;Junichiro KOIZUMI.jpg;14657;14669;35957;733;733;0
/net/per610a/home/mvp/mvp_db/news7-lv/2003/2003_10_01_19_00/2003_10_01_19_00.mpg;Yoshihiko Noda.jpg;16825;16961;35957;841;848;7
/net/per610a/home/mvp/mvp_db/news7-lv/2003/2003_10_01_19_00/2003_10_01_19_00.mpg;Seiji MAEHARA.jpg;16997;17117;35957;850;856;6
/net/per610a/home/mvp/mvp_db/news7-lv/2003/2003_10_01_19_00/2003_10_01_19_00.mpg;Shinzo ABE.jpg;17369;18077;35957;869;904;35
/net/per610a/home/mvp/mvp_db/news7-lv/2003/2003_10_01_19_00/2003_10_01_19_00.mpg;Ichiro OZAWA.jpg;28045;28617;35957;1403;1431;28
/net/per610a/home/mvp/mvp_db/news7-lv/2003/2003_10_03_19_00/2003_10_03_19_00.mpg;Kazuo SHII.jpg;6953;7521;35957;347;376;29
/net/per610a/home/mvp/mvp_db/news7-lv/2003/2003_10_05_19_00/2003_10_05_19_00.mpg;Naoto KAN.jpg;601;749;23973;30;37;7
/net/per610a/home/mvp/mvp_db/news7-lv/2003/2003_10_05_19_00/2003_10_05_19_00.mpg;Naoto KAN.jpg;11577;12253;23973;579;612;33
/net/per610a/home/mvp/mvp_db/news7-lv/2003/2003_10_05_19_00/2003_10_05_19_00.mpg;Naoto KAN.jpg;12785;12865;23973;639;643;4
/net/per610a/home/mvp/mvp_db/news7-lv/2003/2003_10_05_19_00/2003_10_05_19_00.mpg;Naoto KAN.jpg;13245;14121;23973;662;706;44
/net/per610a/home/mvp/mvp_db/news7-lv/2003/2003_10_05_19_00/2003_10_05_19_00.mpg;Naoto KAN.jpg;14281;15401;23973;714;770;56
/net/per610a/home/mvp/mvp_db/news7-lv/2003/2003_10_06_19_00/2003_10_06_19_00.mpg;Junichiro KOIZUMI.jpg;17729;18017;35957;887;901;14
/net/per610a/home/mvp/mvp_db/news7-lv/2003/2003_10_07_19_00/2003_10_07_19_00.mpg;Taro ASO.jpg;24065;24629;35957;1204;1232;28
/net/per610a/home/mvp/mvp_db/news7-lv/2003/2003_10_08_19_00/2003_10_08_19_00.mpg;Sadakazu TANIGAKI.jpg;13553;13749;35957;678;687;9
/net/per610a/home/mvp/mvp_db/news7-lv/2003/2003_10_08_19_00/2003_10_08_19_00.mpg;Junichiro KOIZUMI.jpg;21361;21525;35957;1068;1076;8
/net/per610a/home/mvp/mvp_db/news7-lv/2003/2003_10_08_19_00/2003_10_08_19_00.mpg;Junichiro KOIZUMI.jpg;21873;22237;35957;1094;1112;18
/net/per610a/home/mvp/mvp_db/news7-lv/2003/2003_10_08_19_00/2003_10_08_19_00.mpg;Shintaro ISHIHARA.jpg;23525;23877;35957;1177;1194;17
/net/per610a/home/mvp/mvp_db/news7-lv/2003/2003_10_09_19_00/2003_10_09_19_00.mpg;Kazuo SHII.jpg;449;529;35957;22;26;4
/net/per610a/home/mvp/mvp_db/news7-lv/2003/2003_10_09_19_00/2003_10_09_19_00.mpg;Junichiro KOIZUMI.jpg;3977;4025;35957;198;201;3
/net/per610a/home/mvp/mvp_db/news7-lv/2003/2003_10_09_19_00/2003_10_09_19_00.mpg;Junichiro KOIZUMI.jpg;5185;5249;35957;259;262;3
/net/per610a/home/mvp/mvp_db/news7-lv/2003/2003_10_09_19_00/2003_10_09_19_00.mpg;Natsuo YAMAGUCHI.jpg;5705;5837;35957;285;292;7
/net/per610a/home/mvp/mvp_db/news7-lv/2003/2003_10_10_19_00/2003_10_10_19_00.mpg;Junichiro KOIZUMI.jpg;421;441;35961;21;22;1
/net/per610a/home/mvp/mvp_db/news7-lv/2003/2003_10_10_19_00/2003_10_10_19_00.mpg;Junichiro KOIZUMI.jpg;4177;4229;35961;208;211;3
/net/per610a/home/mvp/mvp_db/news7-lv/2003/2003_10_10_19_00/2003_10_10_19_00.mpg;Junichiro KOIZUMI.jpg;5545;5573;35961;277;278;1
/net/per610a/home/mvp/mvp_db/news7-lv/2003/2003_10_10_19_00/2003_10_10_19_00.mpg;Junichiro KOIZUMI.jpg;5805;6061;35961;290;303;13
/net/per610a/home/mvp/mvp_db/news7-lv/2003/2003_10_10_19_00/2003_10_10_19_00.mpg;Junichiro KOIZUMI.jpg;8085;8153;35961;404;407;3
/net/per610a/home/mvp/mvp_db/news7-lv/2003/2003_10_10_19_00/2003_10_10_19_00.mpg;Shinzo ABE.jpg;2333;3217;35961;116;160;44
/net/per610a/home/mvp/mvp_db/news7-lv/2003/2003_10_10_19_00/2003_10_10_19_00.mpg;Shinzo ABE.jpg;13405;13777;35961;670;689;19
/net/per610a/home/mvp/mvp_db/news7-lv/2003/2003_10_10_19_00/2003_10_10_19_00.mpg;Shinzo ABE.jpg;22645;22933;35961;1132;1147;15
/net/per610a/home/mvp/mvp_db/news7-lv/2003/2003_10_10_19_00/2003_10_10_19_00.mpg;Shinzo ABE.jpg;25441;25501;35961;1272;1275;3
/net/per610a/home/mvp/mvp_db/news7-lv/2003/2003_10_10_19_00/2003_10_10_19_00.mpg;Shinzo ABE.jpg;28289;28461;35961;1415;1423;8
/net/per610a/home/mvp/mvp_db/news7-lv/2003/2003_10_10_19_00/2003_10_10_19_00.mpg;Shinzo ABE.jpg;28781;29537;35961;1439;1477;38
/net/per610a/home/mvp/mvp_db/news7-lv/2003/2003_10_10_19_00/2003_10_10_19_00.mpg;Junichiro KOIZUMI.jpg;6133;6225;35961;306;311;5
/net/per610a/home/mvp/mvp_db/news7-lv/2003/2003_10_10_19_00/2003_10_10_19_00.mpg;Naoto KAN.jpg;6273;6597;35961;313;330;17
/net/per610a/home/mvp/mvp_db/news7-lv/2003/2003_10_10_19_00/2003_10_10_19_00.mpg;Takenori KANZAKI.jpg;7029;7301;35961;351;365;14
/net/per610a/home/mvp/mvp_db/news7-lv/2003/2003_10_10_19_00/2003_10_10_19_00.mpg;Katsuya OKADA.jpg;13849;15337;35961;692;767;75
/net/per610a/home/mvp/mvp_db/news7-lv/2003/2003_10_10_19_00/2003_10_10_19_00.mpg;Katsuya OKADA.jpg;20201;21805;35961;1010;1090;80
/net/per610a/home/mvp/mvp_db/news7-lv/2003/2003_10_10_19_00/2003_10_10_19_00.mpg;Katsuya OKADA.jpg;22645;22933;35961;1132;1147;15
/net/per610a/home/mvp/mvp_db/news7-lv/2003/2003_10_10_19_00/2003_10_10_19_00.mpg;Katsuya OKADA.jpg;25469;25501;35961;1274;1275;1
/net/per610a/home/mvp/mvp_db/news7-lv/2003/2003_10_10_19_00/2003_10_10_19_00.mpg;Katsuya OKADA.jpg;27981;28733;35961;1399;1437;38
/net/per610a/home/mvp/mvp_db/news7-lv/2003/2003_10_10_19_00/2003_10_10_19_00.mpg;Katsuya OKADA.jpg;29069;29537;35961;1454;1477;23
/net/per610a/home/mvp/mvp_db/news7-lv/2003/2003_10_10_19_00/2003_10_10_19_00.mpg;Katsuya OKADA.jpg;30161;30861;35961;1508;1543;35
/net/per610a/home/mvp/mvp_db/news7-lv/2003/2003_10_10_19_00/2003_10_10_19_00.mpg;Katsuya OKADA.jpg;31585;32669;35961;1580;1634;54
/net/per610a/home/mvp/mvp_db/news7-lv/2003/2003_10_10_19_00/2003_10_10_19_00.mpg;Katsuya OKADA.jpg;32865;33061;35961;1644;1653;9
/net/per610a/home/mvp/mvp_db/news7-lv/2003/2003_10_11_19_00/2003_10_11_19_00.mpg;Shinzo ABE.jpg;8857;10621;35957;443;531;88
/net/per610a/home/mvp/mvp_db/news7-lv/2003/2003_10_11_19_00/2003_10_11_19_00.mpg;Naoto KAN.jpg;26437;26621;35957;1322;1331;9
/net/per610a/home/mvp/mvp_db/news7-lv/2003/2003_10_11_19_00/2003_10_11_19_00.mpg;Naoto KAN.jpg;26969;27277;35957;1349;1364;15
/net/per610a/home/mvp/mvp_db/news7-lv/2003/2003_10_12_19_00/2003_10_12_19_00.mpg;Junichiro KOIZUMI.jpg;4749;4761;23973;237;238;1
/net/per610a/home/mvp/mvp_db/news7-lv/2003/2003_10_12_19_00/2003_10_12_19_00.mpg;Junichiro KOIZUMI.jpg;4989;6049;23973;249;302;53
/net/per610a/home/mvp/mvp_db/news7-lv/2003/2003_10_12_19_00/2003_10_12_19_00.mpg;Takenori KANZAKI.jpg;7569;9629;23973;378;481;103
/net/per610a/home/mvp/mvp_db/news7-lv/2003/2003_10_13_19_00/2003_10_13_19_00.mpg;Taro ASO.jpg;15529;16989;35957;776;849;73
/net/per610a/home/mvp/mvp_db/news7-lv/2003/2003_10_13_19_00/2003_10_13_19_00.mpg;Ichiro OZAWA.jpg;18169;18909;35957;909;946;37
/net/per610a/home/mvp/mvp_db/news7-lv/2003/2003_10_14_19_00/2003_10_14_19_00.mpg;Kyoko Nakayama.jpg;6925;7785;35957;346;389;43
/net/per610a/home/mvp/mvp_db/news7-lv/2003/2003_10_14_19_00/2003_10_14_19_00.mpg;Junichiro KOIZUMI.jpg;9837;10213;35957;492;510;18
/net/per610a/home/mvp/mvp_db/news7-lv/2003/2003_10_14_19_00/2003_10_14_19_00.mpg;Junichiro KOIZUMI.jpg;15429;15481;35957;771;774;3
/net/per610a/home/mvp/mvp_db/news7-lv/2003/2003_10_14_19_00/2003_10_14_19_00.mpg;Shinzo ABE.jpg;11629;12041;35957;581;602;21
/net/per610a/home/mvp/mvp_db/news7-lv/2003/2003_10_14_19_00/2003_10_14_19_00.mpg;Shinzo ABE.jpg;16425;16433;35957;821;822;1
/net/per610a/home/mvp/mvp_db/news7-lv/2003/2003_10_14_19_00/2003_10_14_19_00.mpg;Katsuya OKADA.jpg;12545;14685;35957;627;734;107
/net/per610a/home/mvp/mvp_db/news7-lv/2003/2003_10_15_19_00/2003_10_15_19_00.mpg;Yasuo FUKUDA.jpg;22533;23349;35957;1127;1168;41
/net/per610a/home/mvp/mvp_db/news7-lv/2003/2003_10_15_19_00/2003_10_15_19_00.mpg;Junichiro KOIZUMI.jpg;23389;24045;35957;1170;1203;33
/net/per610a/home/mvp/mvp_db/news7-lv/2003/2003_10_17_19_00/2003_10_17_19_00.mpg;Junichiro KOIZUMI.jpg;15553;16041;35957;778;802;24
/net/per610a/home/mvp/mvp_db/news7-lv/2003/2003_10_17_19_00/2003_10_17_19_00.mpg;Junichiro KOIZUMI.jpg;17953;18093;35957;898;905;7
/net/per610a/home/mvp/mvp_db/news7-lv/2003/2003_10_18_19_00/2003_10_18_19_00.mpg;Takenori KANZAKI.jpg;12101;13101;35957;605;655;50
/net/per610a/home/mvp/mvp_db/news7-lv/2003/2003_10_18_19_00/2003_10_18_19_00.mpg;Takako DOI.jpg;13161;13701;35957;658;685;27
/net/per610a/home/mvp/mvp_db/news7-lv/2003/2003_10_20_19_00/2003_10_20_19_00.mpg;Junichiro KOIZUMI.jpg;881;1017;35957;44;50;6
/net/per610a/home/mvp/mvp_db/news7-lv/2003/2003_10_20_19_00/2003_10_20_19_00.mpg;Junichiro KOIZUMI.jpg;6345;6537;35957;317;327;10
/net/per610a/home/mvp/mvp_db/news7-lv/2003/2003_10_20_19_00/2003_10_20_19_00.mpg;Junichiro KOIZUMI.jpg;7069;7129;35957;353;356;3
/net/per610a/home/mvp/mvp_db/news7-lv/2003/2003_10_20_19_00/2003_10_20_19_00.mpg;Junichiro KOIZUMI.jpg;1037;1069;35957;51;53;2
/net/per610a/home/mvp/mvp_db/news7-lv/2003/2003_10_20_19_00/2003_10_20_19_00.mpg;Junichiro KOIZUMI.jpg;2493;2665;35957;124;133;9
/net/per610a/home/mvp/mvp_db/news7-lv/2003/2003_10_20_19_00/2003_10_20_19_00.mpg;Junichiro KOIZUMI.jpg;3489;3489;35957;174;174;0
/net/per610a/home/mvp/mvp_db/news7-lv/2003/2003_10_20_19_00/2003_10_20_19_00.mpg;Junichiro KOIZUMI.jpg;14465;14849;35957;723;742;19
/net/per610a/home/mvp/mvp_db/news7-lv/2003/2003_10_20_19_00/2003_10_20_19_00.mpg;Junichiro KOIZUMI.jpg;22853;23385;35957;1143;1169;26
/net/per610a/home/mvp/mvp_db/news7-lv/2003/2003_10_21_19_00/2003_10_21_19_00.mpg;Junichiro KOIZUMI.jpg;289;365;35957;14;18;4
/net/per610a/home/mvp/mvp_db/news7-lv/2003/2003_10_21_19_00/2003_10_21_19_00.mpg;Junichiro KOIZUMI.jpg;5009;5277;35957;250;264;14
/net/per610a/home/mvp/mvp_db/news7-lv/2003/2003_10_21_19_00/2003_10_21_19_00.mpg;Junichiro KOIZUMI.jpg;6109;6189;35957;305;309;4
/net/per610a/home/mvp/mvp_db/news7-lv/2003/2003_10_21_19_00/2003_10_21_19_00.mpg;Junichiro KOIZUMI.jpg;4545;4709;35957;227;235;8
/net/per610a/home/mvp/mvp_db/news7-lv/2003/2003_10_21_19_00/2003_10_21_19_00.mpg;Ichiro OZAWA.jpg;22745;22825;35957;1137;1141;4
/net/per610a/home/mvp/mvp_db/news7-lv/2003/2003_10_21_19_00/2003_10_21_19_00.mpg;Ichiro OZAWA.jpg;23125;23289;35957;1156;1165;9
/net/per610a/home/mvp/mvp_db/news7-lv/2003/2003_10_23_19_00/2003_10_23_19_00.mpg;Junichiro KOIZUMI.jpg;2629;2645;35957;131;132;1
/net/per610a/home/mvp/mvp_db/news7-lv/2003/2003_10_23_19_00/2003_10_23_19_00.mpg;Junichiro KOIZUMI.jpg;6549;9625;35957;327;481;154
/net/per610a/home/mvp/mvp_db/news7-lv/2003/2003_10_23_19_00/2003_10_23_19_00.mpg;Junichiro KOIZUMI.jpg;13757;13837;35957;688;692;4
/net/per610a/home/mvp/mvp_db/news7-lv/2003/2003_10_24_19_00/2003_10_24_19_00.mpg;Junichiro KOIZUMI.jpg;12313;12345;35957;616;617;1
/net/per610a/home/mvp/mvp_db/news7-lv/2003/2003_10_24_19_00/2003_10_24_19_00.mpg;Junichiro KOIZUMI.jpg;12801;13569;35957;640;678;38
/net/per610a/home/mvp/mvp_db/news7-lv/2003/2003_10_24_19_00/2003_10_24_19_00.mpg;Junichiro KOIZUMI.jpg;15449;15481;35957;772;774;2
/net/per610a/home/mvp/mvp_db/news7-lv/2003/2003_10_24_19_00/2003_10_24_19_00.mpg;Junichiro KOIZUMI.jpg;15821;15837;35957;791;792;1
/net/per610a/home/mvp/mvp_db/news7-lv/2003/2003_10_24_19_00/2003_10_24_19_00.mpg;Takenori KANZAKI.jpg;13669;14437;35957;683;722;39
/net/per610a/home/mvp/mvp_db/news7-lv/2003/2003_10_25_19_00/2003_10_25_19_00.mpg;Junichiro KOIZUMI.jpg;249;373;35957;12;18;6
/net/per610a/home/mvp/mvp_db/news7-lv/2003/2003_10_25_19_00/2003_10_25_19_00.mpg;Junichiro KOIZUMI.jpg;1361;2713;35957;68;135;67
/net/per610a/home/mvp/mvp_db/news7-lv/2003/2003_10_27_19_00/2003_10_27_19_00.mpg;Junichiro KOIZUMI.jpg;9469;10253;35957;473;512;39
/net/per610a/home/mvp/mvp_db/news7-lv/2003/2003_10_27_19_00/2003_10_27_19_00.mpg;Naoto KAN.jpg;10317;10461;35957;516;523;7
/net/per610a/home/mvp/mvp_db/news7-lv/2003/2003_10_27_19_00/2003_10_27_19_00.mpg;Naoto KAN.jpg;10529;14325;35957;526;716;190
/net/per610a/home/mvp/mvp_db/news7-lv/2003/2003_10_28_19_00/2003_10_28_19_00.mpg;Takenori KANZAKI.jpg;501;629;35961;25;31;6
/net/per610a/home/mvp/mvp_db/news7-lv/2003/2003_10_31_19_00/2003_10_31_19_00.mpg;Junichiro KOIZUMI.jpg;15409;16361;35957;770;818;48
/net/per610a/home/mvp/mvp_db/news7-lv/2003/2003_11_01_19_00/2003_11_01_19_00.mpg;Takenori KANZAKI.jpg;301;341;35957;15;17;2
/net/per610a/home/mvp/mvp_db/news7-lv/2003/2003_11_01_19_00/2003_11_01_19_00.mpg;Takenori KANZAKI.jpg;3561;6485;35957;178;324;146
/net/per610a/home/mvp/mvp_db/news7-lv/2003/2003_11_01_19_00/2003_11_01_19_00.mpg;Junichiro KOIZUMI.jpg;1869;2501;35957;93;125;32
/net/per610a/home/mvp/mvp_db/news7-lv/2003/2003_11_03_19_00/2003_11_03_19_00.mpg;Natsuo YAMAGUCHI.jpg;25977;26705;35957;1299;1336;37
/net/per610a/home/mvp/mvp_db/news7-lv/2003/2003_11_08_19_00/2003_11_08_19_00.mpg;Junichiro KOIZUMI.jpg;1721;1861;35957;86;93;7
/net/per610a/home/mvp/mvp_db/news7-lv/2003/2003_11_08_19_00/2003_11_08_19_00.mpg;Junichiro KOIZUMI.jpg;1949;2121;35957;97;106;9
/net/per610a/home/mvp/mvp_db/news7-lv/2003/2003_11_08_19_00/2003_11_08_19_00.mpg;Junichiro KOIZUMI.jpg;2341;3309;35957;117;165;48
/net/per610a/home/mvp/mvp_db/news7-lv/2003/2003_11_08_19_00/2003_11_08_19_00.mpg;Naoto KAN.jpg;3569;3785;35957;178;189;11
/net/per610a/home/mvp/mvp_db/news7-lv/2003/2003_11_10_19_00/2003_11_10_19_00.mpg;Takenori KANZAKI.jpg;793;1109;35957;39;55;16
/net/per610a/home/mvp/mvp_db/news7-lv/2003/2003_11_10_19_00/2003_11_10_19_00.mpg;Shinzo ABE.jpg;5373;5373;35957;268;268;0
/net/per610a/home/mvp/mvp_db/news7-lv/2003/2003_11_10_19_00/2003_11_10_19_00.mpg;Shinzo ABE.jpg;5525;5545;35957;276;277;1
/net/per610a/home/mvp/mvp_db/news7-lv/2003/2003_11_10_19_00/2003_11_10_19_00.mpg;Shinzo ABE.jpg;6097;6225;35957;305;311;6
/net/per610a/home/mvp/mvp_db/news7-lv/2003/2003_11_10_19_00/2003_11_10_19_00.mpg;Junichiro KOIZUMI.jpg;5461;5473;35957;273;273;0
/net/per610a/home/mvp/mvp_db/news7-lv/2003/2003_11_10_19_00/2003_11_10_19_00.mpg;Junichiro KOIZUMI.jpg;5665;6009;35957;283;300;17
/net/per610a/home/mvp/mvp_db/news7-lv/2003/2003_11_10_19_00/2003_11_10_19_00.mpg;Junichiro KOIZUMI.jpg;13065;13117;35957;653;656;3
/net/per610a/home/mvp/mvp_db/news7-lv/2003/2003_11_10_19_00/2003_11_10_19_00.mpg;Naoto KAN.jpg;7637;7685;35957;382;384;2
/net/per610a/home/mvp/mvp_db/news7-lv/2003/2003_11_10_19_00/2003_11_10_19_00.mpg;Naoto KAN.jpg;13525;13613;35957;676;681;5
/net/per610a/home/mvp/mvp_db/news7-lv/2003/2003_11_10_19_00/2003_11_10_19_00.mpg;Kazuo SHII.jpg;8309;11441;35957;415;572;157
/net/per610a/home/mvp/mvp_db/news7-lv/2003/2003_11_10_19_00/2003_11_10_19_00.mpg;Junichiro KOIZUMI.jpg;14573;14953;35957;729;748;19
/net/per610a/home/mvp/mvp_db/news7-lv/2003/2003_11_10_19_00/2003_11_10_19_00.mpg;Junichiro KOIZUMI.jpg;15617;16465;35957;781;823;42
/net/per610a/home/mvp/mvp_db/news7-lv/2003/2003_11_11_19_00/2003_11_11_19_00.mpg;Yasuo FUKUDA.jpg;3425;4133;35957;171;206;35
/net/per610a/home/mvp/mvp_db/news7-lv/2003/2003_11_11_19_00/2003_11_11_19_00.mpg;Junichiro KOIZUMI.jpg;4809;5061;35957;240;253;13
/net/per610a/home/mvp/mvp_db/news7-lv/2003/2003_11_12_19_00/2003_11_12_19_00.mpg;Yasuo FUKUDA.jpg;21269;21689;35957;1064;1085;21
/net/per610a/home/mvp/mvp_db/news7-lv/2003/2003_11_13_19_00/2003_11_13_19_00.mpg;Junichiro KOIZUMI.jpg;14057;14221;35957;703;711;8
/net/per610a/home/mvp/mvp_db/news7-lv/2003/2003_11_13_19_00/2003_11_13_19_00.mpg;Yasuo FUKUDA.jpg;18569;21045;35957;929;1052;123
/net/per610a/home/mvp/mvp_db/news7-lv/2003/2003_11_14_19_00/2003_11_14_19_00.mpg;Yasuo FUKUDA.jpg;5637;6913;35957;282;345;63
/net/per610a/home/mvp/mvp_db/news7-lv/2003/2003_11_17_19_00/2003_11_17_19_00.mpg;Junichiro KOIZUMI.jpg;1265;1357;35957;63;67;4
/net/per610a/home/mvp/mvp_db/news7-lv/2003/2003_11_17_19_00/2003_11_17_19_00.mpg;Junichiro KOIZUMI.jpg;16825;17217;35957;841;861;20
/net/per610a/home/mvp/mvp_db/news7-lv/2003/2003_11_17_19_00/2003_11_17_19_00.mpg;Junichiro KOIZUMI.jpg;18185;18433;35957;909;922;13
/net/per610a/home/mvp/mvp_db/news7-lv/2003/2003_11_17_19_00/2003_11_17_19_00.mpg;Junichiro KOIZUMI.jpg;19481;19569;35957;974;979;5
/net/per610a/home/mvp/mvp_db/news7-lv/2003/2003_11_17_19_00/2003_11_17_19_00.mpg;Shinzo ABE.jpg;19577;19665;35957;979;983;4
/net/per610a/home/mvp/mvp_db/news7-lv/2003/2003_11_19_19_00/2003_11_19_19_00.mpg;Junichiro KOIZUMI.jpg;1405;1657;35957;70;82;12
/net/per610a/home/mvp/mvp_db/news7-lv/2003/2003_11_19_19_00/2003_11_19_19_00.mpg;Junichiro KOIZUMI.jpg;9085;9413;35957;454;470;16
/net/per610a/home/mvp/mvp_db/news7-lv/2003/2003_11_19_19_00/2003_11_19_19_00.mpg;Junichiro KOIZUMI.jpg;15177;15325;35957;759;766;7
/net/per610a/home/mvp/mvp_db/news7-lv/2003/2003_11_19_19_00/2003_11_19_19_00.mpg;Naoto KAN.jpg;4273;4805;35957;213;240;27
/net/per610a/home/mvp/mvp_db/news7-lv/2003/2003_11_19_19_00/2003_11_19_19_00.mpg;Junichiro KOIZUMI.jpg;6961;6985;35957;348;349;1
/net/per610a/home/mvp/mvp_db/news7-lv/2003/2003_11_19_19_00/2003_11_19_19_00.mpg;Junichiro KOIZUMI.jpg;8629;8653;35957;431;432;1
/net/per610a/home/mvp/mvp_db/news7-lv/2003/2003_11_19_19_00/2003_11_19_19_00.mpg;Junichiro KOIZUMI.jpg;9505;10005;35957;475;500;25
/net/per610a/home/mvp/mvp_db/news7-lv/2003/2003_11_19_19_00/2003_11_19_19_00.mpg;Junichiro KOIZUMI.jpg;10161;10529;35957;508;526;18
/net/per610a/home/mvp/mvp_db/news7-lv/2003/2003_11_19_19_00/2003_11_19_19_00.mpg;Junichiro KOIZUMI.jpg;10789;12397;35957;539;620;81
/net/per610a/home/mvp/mvp_db/news7-lv/2003/2003_11_19_19_00/2003_11_19_19_00.mpg;Junichiro KOIZUMI.jpg;12753;12805;35957;638;640;2
/net/per610a/home/mvp/mvp_db/news7-lv/2003/2003_11_19_19_00/2003_11_19_19_00.mpg;Shinzo ABE.jpg;7117;8605;35957;356;430;74
/net/per610a/home/mvp/mvp_db/news7-lv/2003/2003_11_19_19_00/2003_11_19_19_00.mpg;Shinzo ABE.jpg;12437;12517;35957;622;626;4
/net/per610a/home/mvp/mvp_db/news7-lv/2003/2003_11_25_19_00/2003_11_25_19_00.mpg;Junichiro KOIZUMI.jpg;917;1145;35957;45;57;12
/net/per610a/home/mvp/mvp_db/news7-lv/2003/2003_11_25_19_00/2003_11_25_19_00.mpg;Junichiro KOIZUMI.jpg;11289;11793;35957;564;590;26
/net/per610a/home/mvp/mvp_db/news7-lv/2003/2003_11_25_19_00/2003_11_25_19_00.mpg;Junichiro KOIZUMI.jpg;12005;12149;35957;600;607;7
/net/per610a/home/mvp/mvp_db/news7-lv/2003/2003_11_25_19_00/2003_11_25_19_00.mpg;Junichiro KOIZUMI.jpg;12213;13001;35957;611;650;39
/net/per610a/home/mvp/mvp_db/news7-lv/2003/2003_11_25_19_00/2003_11_25_19_00.mpg;Junichiro KOIZUMI.jpg;13173;13921;35957;659;696;37
/net/per610a/home/mvp/mvp_db/news7-lv/2003/2003_11_26_19_00/2003_11_26_19_00.mpg;Junichiro KOIZUMI.jpg;12393;12817;35957;620;641;21
/net/per610a/home/mvp/mvp_db/news7-lv/2003/2003_11_26_19_00/2003_11_26_19_00.mpg;Junichiro KOIZUMI.jpg;13037;13421;35957;652;671;19
/net/per610a/home/mvp/mvp_db/news7-lv/2003/2003_11_26_19_00/2003_11_26_19_00.mpg;Junichiro KOIZUMI.jpg;13553;13997;35957;678;700;22
/net/per610a/home/mvp/mvp_db/news7-lv/2003/2003_11_26_19_00/2003_11_26_19_00.mpg;Junichiro KOIZUMI.jpg;14145;14509;35957;707;725;18
/net/per610a/home/mvp/mvp_db/news7-lv/2003/2003_11_26_19_00/2003_11_26_19_00.mpg;Junichiro KOIZUMI.jpg;14729;15121;35957;736;756;20
/net/per610a/home/mvp/mvp_db/news7-lv/2003/2003_11_27_19_00/2003_11_27_19_00.mpg;Ichiro OZAWA.jpg;22177;22713;35957;1109;1136;27
/net/per610a/home/mvp/mvp_db/news7-lv/2003/2003_11_28_19_00/2003_11_28_19_00.mpg;Shinzo ABE.jpg;15373;16401;35957;769;820;51
/net/per610a/home/mvp/mvp_db/news7-lv/2003/2003_11_29_19_00/2003_11_29_19_00.mpg;Junichiro KOIZUMI.jpg;24961;25093;35957;1248;1255;7
/net/per610a/home/mvp/mvp_db/news7-lv/2003/2003_11_29_19_00/2003_11_29_19_00.mpg;Junichiro KOIZUMI.jpg;25381;25477;35957;1269;1274;5
/net/per610a/home/mvp/mvp_db/news7-lv/2003/2003_11_30_19_00/2003_11_30_19_00.mpg;Yasuo FUKUDA.jpg;785;901;23973;39;45;6
/net/per610a/home/mvp/mvp_db/news7-lv/2003/2003_11_30_19_00/2003_11_30_19_00.mpg;Yasuo FUKUDA.jpg;9857;9925;23973;492;496;4
/net/per610a/home/mvp/mvp_db/news7-lv/2003/2003_11_30_19_00/2003_11_30_19_00.mpg;Yasuo FUKUDA.jpg;10025;10193;23973;501;509;8
/net/per610a/home/mvp/mvp_db/news7-lv/2003/2003_11_30_19_00/2003_11_30_19_00.mpg;Junichiro KOIZUMI.jpg;10661;10761;23973;533;538;5
/net/per610a/home/mvp/mvp_db/news7-lv/2003/2003_12_01_19_00/2003_12_01_19_00.mpg;Yasuo FUKUDA.jpg;6217;7057;35957;311;353;42
/net/per610a/home/mvp/mvp_db/news7-lv/2003/2003_12_01_19_00/2003_12_01_19_00.mpg;Taro ASO.jpg;7425;8177;35957;371;409;38
/net/per610a/home/mvp/mvp_db/news7-lv/2003/2003_12_01_19_00/2003_12_01_19_00.mpg;Taro ASO.jpg;19125;19297;35957;956;965;9
/net/per610a/home/mvp/mvp_db/news7-lv/2003/2003_12_01_19_00/2003_12_01_19_00.mpg;Naoto KAN.jpg;9621;10545;35957;481;527;46
/net/per610a/home/mvp/mvp_db/news7-lv/2003/2003_12_01_19_00/2003_12_01_19_00.mpg;Junichiro KOIZUMI.jpg;26349;26541;35957;1318;1327;9
/net/per610a/home/mvp/mvp_db/news7-lv/2003/2003_12_02_19_00/2003_12_02_19_00.mpg;Shintaro ISHIHARA.jpg;1417;1421;35957;70;71;1
/net/per610a/home/mvp/mvp_db/news7-lv/2003/2003_12_02_19_00/2003_12_02_19_00.mpg;Shintaro ISHIHARA.jpg;1629;1629;35957;81;81;0
/net/per610a/home/mvp/mvp_db/news7-lv/2003/2003_12_02_19_00/2003_12_02_19_00.mpg;Shintaro ISHIHARA.jpg;1701;1889;35957;85;94;9
/net/per610a/home/mvp/mvp_db/news7-lv/2003/2003_12_02_19_00/2003_12_02_19_00.mpg;Shintaro ISHIHARA.jpg;2573;2945;35957;128;147;19
/net/per610a/home/mvp/mvp_db/news7-lv/2003/2003_12_02_19_00/2003_12_02_19_00.mpg;Shintaro ISHIHARA.jpg;3289;3365;35957;164;168;4
/net/per610a/home/mvp/mvp_db/news7-lv/2003/2003_12_02_19_00/2003_12_02_19_00.mpg;Shintaro ISHIHARA.jpg;4737;4889;35957;237;244;7
/net/per610a/home/mvp/mvp_db/news7-lv/2003/2003_12_02_19_00/2003_12_02_19_00.mpg;Shintaro ISHIHARA.jpg;7077;7589;35957;354;379;25
/net/per610a/home/mvp/mvp_db/news7-lv/2003/2003_12_02_19_00/2003_12_02_19_00.mpg;Shintaro ISHIHARA.jpg;10473;10553;35957;523;527;4
/net/per610a/home/mvp/mvp_db/news7-lv/2003/2003_12_02_19_00/2003_12_02_19_00.mpg;Shintaro ISHIHARA.jpg;11281;11849;35957;564;592;28
/net/per610a/home/mvp/mvp_db/news7-lv/2003/2003_12_02_19_00/2003_12_02_19_00.mpg;Junichiro KOIZUMI.jpg;17993;19217;35957;900;961;61
/net/per610a/home/mvp/mvp_db/news7-lv/2003/2003_12_03_19_00/2003_12_03_19_00.mpg;Yasuo FUKUDA.jpg;1925;2157;35957;96;107;11
/net/per610a/home/mvp/mvp_db/news7-lv/2003/2003_12_03_19_00/2003_12_03_19_00.mpg;Junichiro KOIZUMI.jpg;2785;3397;35957;139;169;30
/net/per610a/home/mvp/mvp_db/news7-lv/2003/2003_12_03_19_00/2003_12_03_19_00.mpg;Junichiro KOIZUMI.jpg;9889;10009;35957;494;500;6
/net/per610a/home/mvp/mvp_db/news7-lv/2003/2003_12_04_19_00/2003_12_04_19_00.mpg;Yasuo FUKUDA.jpg;4041;4197;35957;202;209;7
/net/per610a/home/mvp/mvp_db/news7-lv/2003/2003_12_04_19_00/2003_12_04_19_00.mpg;Junichiro KOIZUMI.jpg;4341;4621;35957;217;231;14
/net/per610a/home/mvp/mvp_db/news7-lv/2003/2003_12_05_19_00/2003_12_05_19_00.mpg;Shintaro ISHIHARA.jpg;17093;17397;35957;855;870;15
/net/per610a/home/mvp/mvp_db/news7-lv/2003/2003_12_05_19_00/2003_12_05_19_00.mpg;Junichiro KOIZUMI.jpg;23989;24093;35957;1200;1205;5
/net/per610a/home/mvp/mvp_db/news7-lv/2003/2003_12_05_19_00/2003_12_05_19_00.mpg;Junichiro KOIZUMI.jpg;24401;24477;35957;1220;1224;4
/net/per610a/home/mvp/mvp_db/news7-lv/2003/2003_12_06_19_00/2003_12_06_19_00.mpg;Shinzo ABE.jpg;9017;9377;35957;451;469;18
/net/per610a/home/mvp/mvp_db/news7-lv/2003/2003_12_06_19_00/2003_12_06_19_00.mpg;Junichiro KOIZUMI.jpg;18285;19005;35957;914;950;36
/net/per610a/home/mvp/mvp_db/news7-lv/2003/2003_12_08_19_00/2003_12_08_19_00.mpg;Shinzo ABE.jpg;3509;3617;35957;175;180;5
/net/per610a/home/mvp/mvp_db/news7-lv/2003/2003_12_08_19_00/2003_12_08_19_00.mpg;Junichiro KOIZUMI.jpg;10373;10941;35957;518;547;29
/net/per610a/home/mvp/mvp_db/news7-lv/2003/2003_12_08_19_00/2003_12_08_19_00.mpg;Naoto KAN.jpg;11129;11969;35957;556;598;42
/net/per610a/home/mvp/mvp_db/news7-lv/2003/2003_12_09_19_00/2003_12_09_19_00.mpg;Junichiro KOIZUMI.jpg;1;465;35961;0;23;23
/net/per610a/home/mvp/mvp_db/news7-lv/2003/2003_12_09_19_00/2003_12_09_19_00.mpg;Junichiro KOIZUMI.jpg;1485;4637;35961;74;231;157
/net/per610a/home/mvp/mvp_db/news7-lv/2003/2003_12_09_19_00/2003_12_09_19_00.mpg;Junichiro KOIZUMI.jpg;4709;5413;35961;235;270;35
/net/per610a/home/mvp/mvp_db/news7-lv/2003/2003_12_09_19_00/2003_12_09_19_00.mpg;Junichiro KOIZUMI.jpg;5477;7593;35961;273;379;106
/net/per610a/home/mvp/mvp_db/news7-lv/2003/2003_12_09_19_00/2003_12_09_19_00.mpg;Junichiro KOIZUMI.jpg;7665;9257;35961;383;463;80
/net/per610a/home/mvp/mvp_db/news7-lv/2003/2003_12_09_19_00/2003_12_09_19_00.mpg;Junichiro KOIZUMI.jpg;10693;10729;35961;534;536;2
/net/per610a/home/mvp/mvp_db/news7-lv/2003/2003_12_09_19_00/2003_12_09_19_00.mpg;Junichiro KOIZUMI.jpg;957;1425;35961;47;71;24
/net/per610a/home/mvp/mvp_db/news7-lv/2003/2003_12_09_19_00/2003_12_09_19_00.mpg;Junichiro KOIZUMI.jpg;12977;13117;35961;649;656;7
/net/per610a/home/mvp/mvp_db/news7-lv/2003/2003_12_09_19_00/2003_12_09_19_00.mpg;Junichiro KOIZUMI.jpg;21549;21805;35961;1078;1090;12
/net/per610a/home/mvp/mvp_db/news7-lv/2003/2003_12_09_19_00/2003_12_09_19_00.mpg;Yasuo FUKUDA.jpg;9589;9925;35961;479;496;17
/net/per610a/home/mvp/mvp_db/news7-lv/2003/2003_12_09_19_00/2003_12_09_19_00.mpg;Junichiro KOIZUMI.jpg;12793;12969;35961;639;648;9
/net/per610a/home/mvp/mvp_db/news7-lv/2003/2003_12_09_19_00/2003_12_09_19_00.mpg;Junichiro KOIZUMI.jpg;33201;33349;35961;1660;1668;8
/net/per610a/home/mvp/mvp_db/news7-lv/2003/2003_12_10_19_00/2003_12_10_19_00.mpg;Yasuo FUKUDA.jpg;421;561;35957;21;28;7
/net/per610a/home/mvp/mvp_db/news7-lv/2003/2003_12_10_19_00/2003_12_10_19_00.mpg;Yasuo FUKUDA.jpg;2381;3105;35957;119;155;36
/net/per610a/home/mvp/mvp_db/news7-lv/2003/2003_12_10_19_00/2003_12_10_19_00.mpg;Yasuo FUKUDA.jpg;3265;3813;35957;163;190;27
/net/per610a/home/mvp/mvp_db/news7-lv/2003/2003_12_10_19_00/2003_12_10_19_00.mpg;Junichiro KOIZUMI.jpg;1957;2361;35957;97;118;21
/net/per610a/home/mvp/mvp_db/news7-lv/2003/2003_12_11_19_00/2003_12_11_19_00.mpg;Yasuo FUKUDA.jpg;5617;6425;35957;281;321;40
/net/per610a/home/mvp/mvp_db/news7-lv/2003/2003_12_11_19_00/2003_12_11_19_00.mpg;Junichiro KOIZUMI.jpg;12241;12385;35957;612;619;7
/net/per610a/home/mvp/mvp_db/news7-lv/2003/2003_12_12_19_00/2003_12_12_19_00.mpg;Yasuo FUKUDA.jpg;13793;14125;35957;690;706;16
/net/per610a/home/mvp/mvp_db/news7-lv/2003/2003_12_15_19_00/2003_12_15_19_00.mpg;Junichiro KOIZUMI.jpg;24585;24833;35957;1230;1242;12
/net/per610a/home/mvp/mvp_db/news7-lv/2003/2003_12_15_19_00/2003_12_15_19_00.mpg;Junichiro KOIZUMI.jpg;25209;25741;35957;1261;1287;26
/net/per610a/home/mvp/mvp_db/news7-lv/2003/2003_12_15_19_00/2003_12_15_19_00.mpg;Junichiro KOIZUMI.jpg;28421;28821;35957;1421;1441;20
/net/per610a/home/mvp/mvp_db/news7-lv/2003/2003_12_16_19_00/2003_12_16_19_00.mpg;Junichiro KOIZUMI.jpg;17317;17369;35957;866;869;3
/net/per610a/home/mvp/mvp_db/news7-lv/2003/2003_12_16_19_00/2003_12_16_19_00.mpg;Junichiro KOIZUMI.jpg;17477;17869;35957;874;894;20
/net/per610a/home/mvp/mvp_db/news7-lv/2003/2003_12_16_19_00/2003_12_16_19_00.mpg;Shinzo ABE.jpg;28589;29645;35957;1430;1483;53
/net/per610a/home/mvp/mvp_db/news7-lv/2003/2003_12_22_19_00/2003_12_22_19_00.mpg;Takenori KANZAKI.jpg;637;1277;35957;31;63;32
/net/per610a/home/mvp/mvp_db/news7-lv/2003/2003_12_22_19_00/2003_12_22_19_00.mpg;Takenori KANZAKI.jpg;13633;15313;35957;682;766;84
/net/per610a/home/mvp/mvp_db/news7-lv/2003/2003_12_22_19_00/2003_12_22_19_00.mpg;Shinzo ABE.jpg;3261;3409;35957;163;170;7
/net/per610a/home/mvp/mvp_db/news7-lv/2003/2003_12_22_19_00/2003_12_22_19_00.mpg;Yasuo FUKUDA.jpg;6081;7121;35957;304;356;52
/net/per610a/home/mvp/mvp_db/news7-lv/2003/2003_12_22_19_00/2003_12_22_19_00.mpg;Sadakazu TANIGAKI.jpg;20973;21069;35957;1049;1054;5
/net/per610a/home/mvp/mvp_db/news7-lv/2003/2003_12_22_19_00/2003_12_22_19_00.mpg;Sadakazu TANIGAKI.jpg;21781;22001;35957;1089;1100;11
/net/per610a/home/mvp/mvp_db/news7-lv/2003/2003_12_22_19_00/2003_12_22_19_00.mpg;Sadakazu TANIGAKI.jpg;22065;22157;35957;1103;1108;5
/net/per610a/home/mvp/mvp_db/news7-lv/2003/2003_12_24_19_00/2003_12_24_19_00.mpg;Junichiro KOIZUMI.jpg;25925;26069;35957;1297;1304;7
/net/per610a/home/mvp/mvp_db/news7-lv/2003/2003_12_25_19_00/2003_12_25_19_00.mpg;Yasuo FUKUDA.jpg;8561;9321;35957;428;466;38
/net/per610a/home/mvp/mvp_db/news7-lv/2003/2003_12_25_19_00/2003_12_25_19_00.mpg;Yasuo FUKUDA.jpg;21005;21349;35957;1050;1068;18
/net/per610a/home/mvp/mvp_db/news7-lv/2003/2003_12_26_19_00/2003_12_26_19_00.mpg;Junichiro KOIZUMI.jpg;3217;4221;35957;160;211;51
/net/per610a/home/mvp/mvp_db/news7-lv/2003/2003_12_26_19_00/2003_12_26_19_00.mpg;Junichiro KOIZUMI.jpg;4453;4929;35957;222;246;24
/net/per610a/home/mvp/mvp_db/news7-lv/2003/2003_12_29_19_00/2003_12_29_19_00.mpg;Junichiro KOIZUMI.jpg;26641;26745;35957;1332;1338;6
/net/per610a/home/mvp/mvp_db/news7-lv/2003/2003_12_29_19_00/2003_12_29_19_00.mpg;Junichiro KOIZUMI.jpg;26973;27053;35957;1349;1353;4
/net/per610a/home/mvp/mvp_db/news7-lv/2004/2004_01_01_19_00/2004_01_01_19_00.mpg;Junichiro KOIZUMI.jpg;525;837;23901;26;41;15
/net/per610a/home/mvp/mvp_db/news7-lv/2004/2004_01_01_19_00/2004_01_01_19_00.mpg;Junichiro KOIZUMI.jpg;4721;4845;23901;236;242;6
/net/per610a/home/mvp/mvp_db/news7-lv/2004/2004_01_01_19_00/2004_01_01_19_00.mpg;Takenori KANZAKI.jpg;17361;17469;23901;868;874;6
/net/per610a/home/mvp/mvp_db/news7-lv/2004/2004_01_05_19_00/2004_01_05_19_00.mpg;Junichiro KOIZUMI.jpg;9013;9317;35957;450;466;16
/net/per610a/home/mvp/mvp_db/news7-lv/2004/2004_01_05_19_00/2004_01_05_19_00.mpg;Junichiro KOIZUMI.jpg;9661;9833;35957;483;491;8
/net/per610a/home/mvp/mvp_db/news7-lv/2004/2004_01_05_19_00/2004_01_05_19_00.mpg;Junichiro KOIZUMI.jpg;14665;14825;35957;733;741;8
/net/per610a/home/mvp/mvp_db/news7-lv/2004/2004_01_05_19_00/2004_01_05_19_00.mpg;Naoto KAN.jpg;11109;11109;35957;555;555;0
/net/per610a/home/mvp/mvp_db/news7-lv/2004/2004_01_05_19_00/2004_01_05_19_00.mpg;Naoto KAN.jpg;11177;11857;35957;559;593;34
/net/per610a/home/mvp/mvp_db/news7-lv/2004/2004_01_05_19_00/2004_01_05_19_00.mpg;Kazuo SHII.jpg;11933;12337;35957;597;617;20
/net/per610a/home/mvp/mvp_db/news7-lv/2004/2004_01_05_19_00/2004_01_05_19_00.mpg;Shintaro ISHIHARA.jpg;13277;13521;35957;664;676;12
/net/per610a/home/mvp/mvp_db/news7-lv/2004/2004_01_07_19_00/2004_01_07_19_00.mpg;Junichiro KOIZUMI.jpg;19937;20293;35957;997;1015;18
/net/per610a/home/mvp/mvp_db/news7-lv/2004/2004_01_08_19_00/2004_01_08_19_00.mpg;Takenori KANZAKI.jpg;4377;4473;35957;218;223;5
/net/per610a/home/mvp/mvp_db/news7-lv/2004/2004_01_09_19_00/2004_01_09_19_00.mpg;Takenori KANZAKI.jpg;6241;7141;35957;312;357;45
/net/per610a/home/mvp/mvp_db/news7-lv/2004/2004_01_09_19_00/2004_01_09_19_00.mpg;Junichiro KOIZUMI.jpg;7281;7745;35957;364;387;23
/net/per610a/home/mvp/mvp_db/news7-lv/2004/2004_01_09_19_00/2004_01_09_19_00.mpg;Junichiro KOIZUMI.jpg;10789;10993;35957;539;550;11
/net/per610a/home/mvp/mvp_db/news7-lv/2004/2004_01_13_19_00/2004_01_13_19_00.mpg;Junichiro KOIZUMI.jpg;16997;17245;35957;850;862;12
/net/per610a/home/mvp/mvp_db/news7-lv/2004/2004_01_13_19_00/2004_01_13_19_00.mpg;Junichiro KOIZUMI.jpg;17541;17593;35957;877;880;3
/net/per610a/home/mvp/mvp_db/news7-lv/2004/2004_01_13_19_00/2004_01_13_19_00.mpg;Ichiro OZAWA.jpg;22945;23057;35957;1147;1153;6
/net/per610a/home/mvp/mvp_db/news7-lv/2004/2004_01_14_19_00/2004_01_14_19_00.mpg;Junichiro KOIZUMI.jpg;8905;10325;35957;445;516;71
/net/per610a/home/mvp/mvp_db/news7-lv/2004/2004_01_15_19_00/2004_01_15_19_00.mpg;Yasuo FUKUDA.jpg;16817;18421;35957;841;921;80
/net/per610a/home/mvp/mvp_db/news7-lv/2004/2004_01_16_19_00/2004_01_16_19_00.mpg;Junichiro KOIZUMI.jpg;3977;4493;35957;198;224;26
/net/per610a/home/mvp/mvp_db/news7-lv/2004/2004_01_16_19_00/2004_01_16_19_00.mpg;Shinzo ABE.jpg;12077;14833;35957;604;742;138
/net/per610a/home/mvp/mvp_db/news7-lv/2004/2004_01_17_19_00/2004_01_17_19_00.mpg;Kazuo SHII.jpg;26553;26609;35957;1328;1331;3
/net/per610a/home/mvp/mvp_db/news7-lv/2004/2004_01_17_19_00/2004_01_17_19_00.mpg;Kazuo SHII.jpg;27925;28073;35957;1397;1404;7
/net/per610a/home/mvp/mvp_db/news7-lv/2004/2004_01_17_19_00/2004_01_17_19_00.mpg;Kazuo SHII.jpg;28161;28257;35957;1408;1413;5
/net/per610a/home/mvp/mvp_db/news7-lv/2004/2004_01_19_19_00/2004_01_19_19_00.mpg;Junichiro KOIZUMI.jpg;6881;7137;35957;344;357;13
/net/per610a/home/mvp/mvp_db/news7-lv/2004/2004_01_19_19_00/2004_01_19_19_00.mpg;Junichiro KOIZUMI.jpg;11525;12389;35957;576;619;43
/net/per610a/home/mvp/mvp_db/news7-lv/2004/2004_01_19_19_00/2004_01_19_19_00.mpg;Junichiro KOIZUMI.jpg;9225;9865;35957;461;493;32
/net/per610a/home/mvp/mvp_db/news7-lv/2004/2004_01_19_19_00/2004_01_19_19_00.mpg;Junichiro KOIZUMI.jpg;10745;11285;35957;537;564;27
/net/per610a/home/mvp/mvp_db/news7-lv/2004/2004_01_21_19_00/2004_01_21_19_00.mpg;Junichiro KOIZUMI.jpg;3101;3441;35957;155;172;17
/net/per610a/home/mvp/mvp_db/news7-lv/2004/2004_01_21_19_00/2004_01_21_19_00.mpg;Naoto KAN.jpg;3485;4965;35957;174;248;74
/net/per610a/home/mvp/mvp_db/news7-lv/2004/2004_01_22_19_00/2004_01_22_19_00.mpg;Junichiro KOIZUMI.jpg;9253;9637;35957;462;482;20
/net/per610a/home/mvp/mvp_db/news7-lv/2004/2004_01_24_19_00/2004_01_24_19_00.mpg;Junichiro KOIZUMI.jpg;10869;10977;35957;543;549;6
/net/per610a/home/mvp/mvp_db/news7-lv/2004/2004_01_24_19_00/2004_01_24_19_00.mpg;Naoto KAN.jpg;12705;14001;35957;635;700;65
/net/per610a/home/mvp/mvp_db/news7-lv/2004/2004_01_26_19_00/2004_01_26_19_00.mpg;Junichiro KOIZUMI.jpg;3105;3445;35957;155;172;17
/net/per610a/home/mvp/mvp_db/news7-lv/2004/2004_01_26_19_00/2004_01_26_19_00.mpg;Junichiro KOIZUMI.jpg;11617;12185;35957;581;609;28
/net/per610a/home/mvp/mvp_db/news7-lv/2004/2004_01_26_19_00/2004_01_26_19_00.mpg;Junichiro KOIZUMI.jpg;12493;12905;35957;625;645;20
/net/per610a/home/mvp/mvp_db/news7-lv/2004/2004_01_26_19_00/2004_01_26_19_00.mpg;Junichiro KOIZUMI.jpg;3589;3589;35957;179;179;0
/net/per610a/home/mvp/mvp_db/news7-lv/2004/2004_01_26_19_00/2004_01_26_19_00.mpg;Junichiro KOIZUMI.jpg;10981;11385;35957;549;569;20
/net/per610a/home/mvp/mvp_db/news7-lv/2004/2004_01_26_19_00/2004_01_26_19_00.mpg;Junichiro KOIZUMI.jpg;13089;13577;35957;654;679;25
/net/per610a/home/mvp/mvp_db/news7-lv/2004/2004_01_27_19_00/2004_01_27_19_00.mpg;Yasuo FUKUDA.jpg;2713;2997;35957;135;149;14
/net/per610a/home/mvp/mvp_db/news7-lv/2004/2004_01_28_19_00/2004_01_28_19_00.mpg;Kyoko Nakayama.jpg;21881;22621;35957;1094;1131;37
/net/per610a/home/mvp/mvp_db/news7-lv/2004/2004_01_29_19_00/2004_01_29_19_00.mpg;Naoto KAN.jpg;8697;9053;35957;435;452;17
/net/per610a/home/mvp/mvp_db/news7-lv/2004/2004_01_29_19_00/2004_01_29_19_00.mpg;Junichiro KOIZUMI.jpg;18801;20213;35957;940;1011;71
/net/per610a/home/mvp/mvp_db/news7-lv/2004/2004_01_31_19_00/2004_01_31_19_00.mpg;Shinzo ABE.jpg;5425;6413;35957;271;320;49
/net/per610a/home/mvp/mvp_db/news7-lv/2004/2004_01_31_19_00/2004_01_31_19_00.mpg;Naoto KAN.jpg;6617;8173;35957;331;408;77
/net/per610a/home/mvp/mvp_db/news7-lv/2004/2004_01_31_19_00/2004_01_31_19_00.mpg;Yukio EDANO.jpg;12301;12889;35957;615;644;29
/net/per610a/home/mvp/mvp_db/news7-lv/2004/2004_02_03_19_00/2004_02_03_19_00.mpg;Junichiro KOIZUMI.jpg;12341;12493;35957;617;625;8
/net/per610a/home/mvp/mvp_db/news7-lv/2004/2004_02_03_19_00/2004_02_03_19_00.mpg;Junichiro KOIZUMI.jpg;12557;12757;35957;628;638;10
/net/per610a/home/mvp/mvp_db/news7-lv/2004/2004_02_03_19_00/2004_02_03_19_00.mpg;Junichiro KOIZUMI.jpg;13197;13465;35957;660;673;13
/net/per610a/home/mvp/mvp_db/news7-lv/2004/2004_02_03_19_00/2004_02_03_19_00.mpg;Junichiro KOIZUMI.jpg;13557;13677;35957;678;684;6
/net/per610a/home/mvp/mvp_db/news7-lv/2004/2004_02_03_19_00/2004_02_03_19_00.mpg;Junichiro KOIZUMI.jpg;14753;15253;35957;738;763;25
/net/per610a/home/mvp/mvp_db/news7-lv/2004/2004_02_04_19_00/2004_02_04_19_00.mpg;Junichiro KOIZUMI.jpg;24437;24773;35957;1222;1239;17
/net/per610a/home/mvp/mvp_db/news7-lv/2004/2004_02_04_19_00/2004_02_04_19_00.mpg;Junichiro KOIZUMI.jpg;25037;25341;35957;1252;1267;15
/net/per610a/home/mvp/mvp_db/news7-lv/2004/2004_02_06_19_00/2004_02_06_19_00.mpg;Yasuo FUKUDA.jpg;16857;16965;35957;843;848;5
/net/per610a/home/mvp/mvp_db/news7-lv/2004/2004_02_06_19_00/2004_02_06_19_00.mpg;Yasuo FUKUDA.jpg;17037;17037;35957;852;852;0
/net/per610a/home/mvp/mvp_db/news7-lv/2004/2004_02_06_19_00/2004_02_06_19_00.mpg;Yasuo FUKUDA.jpg;17137;17153;35957;857;858;1
/net/per610a/home/mvp/mvp_db/news7-lv/2004/2004_02_06_19_00/2004_02_06_19_00.mpg;Yasuo FUKUDA.jpg;17241;17277;35957;862;864;2
/net/per610a/home/mvp/mvp_db/news7-lv/2004/2004_02_06_19_00/2004_02_06_19_00.mpg;Yasuo FUKUDA.jpg;17345;18333;35957;867;917;50
/net/per610a/home/mvp/mvp_db/news7-lv/2004/2004_02_07_19_00/2004_02_07_19_00.mpg;Shinzo ABE.jpg;16277;16313;35957;814;816;2
/net/per610a/home/mvp/mvp_db/news7-lv/2004/2004_02_07_19_00/2004_02_07_19_00.mpg;Shinzo ABE.jpg;16721;16825;35957;836;841;5
/net/per610a/home/mvp/mvp_db/news7-lv/2004/2004_02_07_19_00/2004_02_07_19_00.mpg;Shinzo ABE.jpg;17405;18817;35957;870;941;71
/net/per610a/home/mvp/mvp_db/news7-lv/2004/2004_02_08_19_00/2004_02_08_19_00.mpg;Shinzo ABE.jpg;14005;14093;23969;700;704;4
/net/per610a/home/mvp/mvp_db/news7-lv/2004/2004_02_08_19_00/2004_02_08_19_00.mpg;Shinzo ABE.jpg;14973;15609;23969;748;780;32
/net/per610a/home/mvp/mvp_db/news7-lv/2004/2004_02_09_19_00/2004_02_09_19_00.mpg;Junichiro KOIZUMI.jpg;22081;22129;35957;1104;1107;3
/net/per610a/home/mvp/mvp_db/news7-lv/2004/2004_02_09_19_00/2004_02_09_19_00.mpg;Junichiro KOIZUMI.jpg;22397;22621;35957;1120;1131;11
/net/per610a/home/mvp/mvp_db/news7-lv/2004/2004_02_10_19_00/2004_02_10_19_00.mpg;Junichiro KOIZUMI.jpg;22461;22777;35957;1123;1139;16
/net/per610a/home/mvp/mvp_db/news7-lv/2004/2004_02_10_19_00/2004_02_10_19_00.mpg;Junichiro KOIZUMI.jpg;22905;23341;35957;1145;1167;22
/net/per610a/home/mvp/mvp_db/news7-lv/2004/2004_02_12_19_00/2004_02_12_19_00.mpg;Junichiro KOIZUMI.jpg;4073;5173;35957;203;258;55
/net/per610a/home/mvp/mvp_db/news7-lv/2004/2004_02_12_19_00/2004_02_12_19_00.mpg;Junichiro KOIZUMI.jpg;22621;22865;35957;1131;1143;12
/net/per610a/home/mvp/mvp_db/news7-lv/2004/2004_02_12_19_00/2004_02_12_19_00.mpg;Junichiro KOIZUMI.jpg;22973;23065;35957;1149;1153;4
/net/per610a/home/mvp/mvp_db/news7-lv/2004/2004_02_12_19_00/2004_02_12_19_00.mpg;Shinzo ABE.jpg;23645;23973;35957;1183;1199;16
/net/per610a/home/mvp/mvp_db/news7-lv/2004/2004_02_13_19_00/2004_02_13_19_00.mpg;Shinzo ABE.jpg;4377;5937;35957;218;297;79
/net/per610a/home/mvp/mvp_db/news7-lv/2004/2004_02_15_19_00/2004_02_15_19_00.mpg;Junichiro KOIZUMI.jpg;1361;1797;23973;68;89;21
/net/per610a/home/mvp/mvp_db/news7-lv/2004/2004_02_15_19_00/2004_02_15_19_00.mpg;Junichiro KOIZUMI.jpg;2365;2901;23973;118;145;27
/net/per610a/home/mvp/mvp_db/news7-lv/2004/2004_02_15_19_00/2004_02_15_19_00.mpg;Junichiro KOIZUMI.jpg;4237;4445;23973;211;222;11
/net/per610a/home/mvp/mvp_db/news7-lv/2004/2004_02_15_19_00/2004_02_15_19_00.mpg;Yasuo FUKUDA.jpg;3141;4233;23973;157;211;54
/net/per610a/home/mvp/mvp_db/news7-lv/2004/2004_02_17_19_00/2004_02_17_19_00.mpg;Junichiro KOIZUMI.jpg;421;601;35957;21;30;9
/net/per610a/home/mvp/mvp_db/news7-lv/2004/2004_02_17_19_00/2004_02_17_19_00.mpg;Junichiro KOIZUMI.jpg;16765;17177;35957;838;859;21
/net/per610a/home/mvp/mvp_db/news7-lv/2004/2004_02_17_19_00/2004_02_17_19_00.mpg;Yoshimi WATANABE.jpg;14277;14361;35957;714;718;4
/net/per610a/home/mvp/mvp_db/news7-lv/2004/2004_02_17_19_00/2004_02_17_19_00.mpg;Takeo Hiranuma.jpeg;15717;16105;35957;786;805;19
/net/per610a/home/mvp/mvp_db/news7-lv/2004/2004_02_24_19_00/2004_02_24_19_00.mpg;Yasuo FUKUDA.jpg;20573;20725;35957;1029;1036;7
/net/per610a/home/mvp/mvp_db/news7-lv/2004/2004_02_24_19_00/2004_02_24_19_00.mpg;Yasuo FUKUDA.jpg;21181;21877;35957;1059;1094;35
/net/per610a/home/mvp/mvp_db/news7-lv/2004/2004_02_27_19_00/2004_02_27_19_00.mpg;Shintaro ISHIHARA.jpg;28833;29137;35957;1442;1457;15
/net/per610a/home/mvp/mvp_db/news7-lv/2004/2004_03_02_19_00/2004_03_02_19_00.mpg;Naoto KAN.jpg;17045;18413;35957;852;921;69
/net/per610a/home/mvp/mvp_db/news7-lv/2004/2004_03_02_19_00/2004_03_02_19_00.mpg;Shinzo ABE.jpg;18457;18849;35957;923;943;20
/net/per610a/home/mvp/mvp_db/news7-lv/2004/2004_03_03_19_00/2004_03_03_19_00.mpg;Junichiro KOIZUMI.jpg;4357;5029;35957;217;251;34
/net/per610a/home/mvp/mvp_db/news7-lv/2004/2004_03_03_19_00/2004_03_03_19_00.mpg;Junichiro KOIZUMI.jpg;26981;27661;35957;1349;1383;34
/net/per610a/home/mvp/mvp_db/news7-lv/2004/2004_03_04_19_00/2004_03_04_19_00.mpg;Katsuya OKADA.jpg;2705;5697;35957;135;285;150
/net/per610a/home/mvp/mvp_db/news7-lv/2004/2004_03_05_19_00/2004_03_05_19_00.mpg;Junichiro KOIZUMI.jpg;20877;20933;35949;1044;1047;3
/net/per610a/home/mvp/mvp_db/news7-lv/2004/2004_03_05_19_00/2004_03_05_19_00.mpg;Junichiro KOIZUMI.jpg;21929;22201;35949;1097;1111;14
/net/per610a/home/mvp/mvp_db/news7-lv/2004/2004_03_05_19_00/2004_03_05_19_00.mpg;Junichiro KOIZUMI.jpg;22513;22725;35949;1126;1137;11
/net/per610a/home/mvp/mvp_db/news7-lv/2004/2004_03_06_19_00/2004_03_06_19_00.mpg;Naoto KAN.jpg;12841;13605;35957;642;680;38
/net/per610a/home/mvp/mvp_db/news7-lv/2004/2004_03_07_19_00/2004_03_07_19_00.mpg;Natsuo YAMAGUCHI.jpg;15185;15389;23973;759;769;10
/net/per610a/home/mvp/mvp_db/news7-lv/2004/2004_03_08_19_00/2004_03_08_19_00.mpg;Natsuo YAMAGUCHI.jpg;5349;5557;35957;267;278;11
/net/per610a/home/mvp/mvp_db/news7-lv/2004/2004_03_08_19_00/2004_03_08_19_00.mpg;Natsuo YAMAGUCHI.jpg;5693;5785;35957;284;289;5
/net/per610a/home/mvp/mvp_db/news7-lv/2004/2004_03_09_19_00/2004_03_09_19_00.mpg;Junichiro KOIZUMI.jpg;20605;21069;35957;1030;1054;24
/net/per610a/home/mvp/mvp_db/news7-lv/2004/2004_03_09_19_00/2004_03_09_19_00.mpg;Junichiro KOIZUMI.jpg;21977;22473;35957;1099;1124;25
/net/per610a/home/mvp/mvp_db/news7-lv/2004/2004_03_09_19_00/2004_03_09_19_00.mpg;Junichiro KOIZUMI.jpg;23109;23513;35957;1156;1176;20
/net/per610a/home/mvp/mvp_db/news7-lv/2004/2004_03_11_19_00/2004_03_11_19_00.mpg;Shintaro ISHIHARA.jpg;6985;7861;35957;349;393;44
/net/per610a/home/mvp/mvp_db/news7-lv/2004/2004_03_15_19_00/2004_03_15_19_00.mpg;Yasuo FUKUDA.jpg;6641;7101;35957;332;355;23
/net/per610a/home/mvp/mvp_db/news7-lv/2004/2004_03_16_19_00/2004_03_16_19_00.mpg;Junichiro KOIZUMI.jpg;21433;22085;35957;1072;1104;32
/net/per610a/home/mvp/mvp_db/news7-lv/2004/2004_03_16_19_00/2004_03_16_19_00.mpg;Junichiro KOIZUMI.jpg;23309;23581;35957;1166;1179;13
/net/per610a/home/mvp/mvp_db/news7-lv/2004/2004_03_17_19_00/2004_03_17_19_00.mpg;Yasuo FUKUDA.jpg;6533;7009;35953;326;350;24
/net/per610a/home/mvp/mvp_db/news7-lv/2004/2004_03_18_19_00/2004_03_18_19_00.mpg;Junichiro KOIZUMI.jpg;9917;10317;35957;496;516;20
/net/per610a/home/mvp/mvp_db/news7-lv/2004/2004_03_18_19_00/2004_03_18_19_00.mpg;Yasuo FUKUDA.jpg;10641;11177;35957;532;559;27
/net/per610a/home/mvp/mvp_db/news7-lv/2004/2004_03_18_19_00/2004_03_18_19_00.mpg;Yukio HATOYAMA.jpg;18361;19301;35957;918;965;47
/net/per610a/home/mvp/mvp_db/news7-lv/2004/2004_03_23_19_00/2004_03_23_19_00.mpg;Yasuo FUKUDA.jpg;6365;7721;35957;318;386;68
/net/per610a/home/mvp/mvp_db/news7-lv/2004/2004_03_24_19_00/2004_03_24_19_00.mpg;Yasuo FUKUDA.jpg;3621;4085;35957;181;204;23
/net/per610a/home/mvp/mvp_db/news7-lv/2004/2004_03_24_19_00/2004_03_24_19_00.mpg;Yasuo FUKUDA.jpg;16025;16921;35957;801;846;45
/net/per610a/home/mvp/mvp_db/news7-lv/2004/2004_03_24_19_00/2004_03_24_19_00.mpg;Junichiro KOIZUMI.jpg;4565;5249;35957;228;262;34
/net/per610a/home/mvp/mvp_db/news7-lv/2004/2004_03_25_19_00/2004_03_25_19_00.mpg;Yasuo FUKUDA.jpg;397;497;35957;19;24;5
/net/per610a/home/mvp/mvp_db/news7-lv/2004/2004_03_25_19_00/2004_03_25_19_00.mpg;Yasuo FUKUDA.jpg;9145;10505;35957;457;525;68
/net/per610a/home/mvp/mvp_db/news7-lv/2004/2004_03_25_19_00/2004_03_25_19_00.mpg;Takeo Hiranuma.jpeg;13429;14893;35957;671;745;74
/net/per610a/home/mvp/mvp_db/news7-lv/2004/2004_03_26_19_00/2004_03_26_19_00.mpg;Junichiro KOIZUMI.jpg;9541;11469;35957;477;573;96
/net/per610a/home/mvp/mvp_db/news7-lv/2004/2004_03_29_19_00/2004_03_29_19_00.mpg;Sadakazu TANIGAKI.jpg;12709;13553;35957;635;678;43
/net/per610a/home/mvp/mvp_db/news7-lv/2004/2004_03_31_19_00/2004_03_31_19_00.mpg;Yasuo FUKUDA.jpg;8289;8425;35957;414;421;7
/net/per610a/home/mvp/mvp_db/news7-lv/2004/2004_04_01_19_00/2004_04_01_19_00.mpg;Junichiro KOIZUMI.jpg;1477;2005;35957;73;100;27
/net/per610a/home/mvp/mvp_db/news7-lv/2004/2004_04_01_19_00/2004_04_01_19_00.mpg;Yasuo FUKUDA.jpg;5861;6245;35957;293;312;19
/net/per610a/home/mvp/mvp_db/news7-lv/2004/2004_04_02_19_00/2004_04_02_19_00.mpg;Naoto KAN.jpg;277;509;35957;13;25;12
/net/per610a/home/mvp/mvp_db/news7-lv/2004/2004_04_02_19_00/2004_04_02_19_00.mpg;Naoto KAN.jpg;3137;3289;35957;156;164;8
/net/per610a/home/mvp/mvp_db/news7-lv/2004/2004_04_02_19_00/2004_04_02_19_00.mpg;Naoto KAN.jpg;3461;4373;35957;173;218;45
/net/per610a/home/mvp/mvp_db/news7-lv/2004/2004_04_02_19_00/2004_04_02_19_00.mpg;Junichiro KOIZUMI.jpg;4425;5445;35957;221;272;51
/net/per610a/home/mvp/mvp_db/news7-lv/2004/2004_04_02_19_00/2004_04_02_19_00.mpg;Junichiro KOIZUMI.jpg;9833;11397;35957;491;570;79
/net/per610a/home/mvp/mvp_db/news7-lv/2004/2004_04_02_19_00/2004_04_02_19_00.mpg;Yoshihiko Noda.jpg;8245;8765;35957;412;438;26
/net/per610a/home/mvp/mvp_db/news7-lv/2004/2004_04_04_19_00/2004_04_04_19_00.mpg;Shinzo ABE.jpg;4777;5945;23973;238;297;59
/net/per610a/home/mvp/mvp_db/news7-lv/2004/2004_04_05_19_00/2004_04_05_19_00.mpg;Shinzo ABE.jpg;23229;23265;35957;1162;1163;1
/net/per610a/home/mvp/mvp_db/news7-lv/2004/2004_04_05_19_00/2004_04_05_19_00.mpg;Shinzo ABE.jpg;23537;24897;35957;1177;1245;68
/net/per610a/home/mvp/mvp_db/news7-lv/2004/2004_04_05_19_00/2004_04_05_19_00.mpg;Junichiro KOIZUMI.jpg;27089;27357;35957;1355;1368;13
/net/per610a/home/mvp/mvp_db/news7-lv/2004/2004_04_06_19_00/2004_04_06_19_00.mpg;Shinzo ABE.jpg;689;925;35957;34;46;12
/net/per610a/home/mvp/mvp_db/news7-lv/2004/2004_04_06_19_00/2004_04_06_19_00.mpg;Shinzo ABE.jpg;15433;15917;35957;772;796;24
/net/per610a/home/mvp/mvp_db/news7-lv/2004/2004_04_06_19_00/2004_04_06_19_00.mpg;Junichiro KOIZUMI.jpg;17765;18097;35957;888;905;17
/net/per610a/home/mvp/mvp_db/news7-lv/2004/2004_04_06_19_00/2004_04_06_19_00.mpg;Yasuo FUKUDA.jpg;26465;27001;35957;1324;1350;26
/net/per610a/home/mvp/mvp_db/news7-lv/2004/2004_04_07_19_00/2004_04_07_19_00.mpg;Yoshihiko Noda.jpg;24837;24905;35957;1242;1246;4
/net/per610a/home/mvp/mvp_db/news7-lv/2004/2004_04_07_19_00/2004_04_07_19_00.mpg;Yoshihiko Noda.jpg;25225;25281;35957;1262;1264;2
/net/per610a/home/mvp/mvp_db/news7-lv/2004/2004_04_07_19_00/2004_04_07_19_00.mpg;Yoshihiko Noda.jpg;26181;26201;35957;1309;1310;1
/net/per610a/home/mvp/mvp_db/news7-lv/2004/2004_04_07_19_00/2004_04_07_19_00.mpg;Yoshihiko Noda.jpg;27717;27825;35957;1386;1392;6
/net/per610a/home/mvp/mvp_db/news7-lv/2004/2004_04_07_19_00/2004_04_07_19_00.mpg;Naoto KAN.jpg;26593;27153;35957;1330;1358;28
/net/per610a/home/mvp/mvp_db/news7-lv/2004/2004_04_08_19_00/2004_04_08_19_00.mpg;Junichiro KOIZUMI.jpg;8969;9513;35957;448;475;27
/net/per610a/home/mvp/mvp_db/news7-lv/2004/2004_04_09_19_00/2004_04_09_19_00.mpg;Junichiro KOIZUMI.jpg;1869;1933;35961;93;96;3
/net/per610a/home/mvp/mvp_db/news7-lv/2004/2004_04_09_19_00/2004_04_09_19_00.mpg;Junichiro KOIZUMI.jpg;3485;5065;35961;174;253;79
/net/per610a/home/mvp/mvp_db/news7-lv/2004/2004_04_09_19_00/2004_04_09_19_00.mpg;Yasuo FUKUDA.jpg;2457;2805;35961;122;140;18
/net/per610a/home/mvp/mvp_db/news7-lv/2004/2004_04_09_19_00/2004_04_09_19_00.mpg;Yasuo FUKUDA.jpg;5773;6429;35961;288;321;33
/net/per610a/home/mvp/mvp_db/news7-lv/2004/2004_04_09_19_00/2004_04_09_19_00.mpg;Katsuya OKADA.jpg;6753;7137;35961;337;357;20
/net/per610a/home/mvp/mvp_db/news7-lv/2004/2004_04_10_19_00/2004_04_10_19_00.mpg;Junichiro KOIZUMI.jpg;7413;7505;35957;370;375;5
/net/per610a/home/mvp/mvp_db/news7-lv/2004/2004_04_10_19_00/2004_04_10_19_00.mpg;Yasuo FUKUDA.jpg;7573;7621;35957;378;381;3
/net/per610a/home/mvp/mvp_db/news7-lv/2004/2004_04_10_19_00/2004_04_10_19_00.mpg;Yasuo FUKUDA.jpg;13977;14273;35957;699;714;15
/net/per610a/home/mvp/mvp_db/news7-lv/2004/2004_04_12_19_00/2004_04_12_19_00.mpg;Junichiro KOIZUMI.jpg;401;533;35957;20;26;6
/net/per610a/home/mvp/mvp_db/news7-lv/2004/2004_04_12_19_00/2004_04_12_19_00.mpg;Junichiro KOIZUMI.jpg;1469;1921;35957;73;96;23
/net/per610a/home/mvp/mvp_db/news7-lv/2004/2004_04_12_19_00/2004_04_12_19_00.mpg;Junichiro KOIZUMI.jpg;2129;2417;35957;106;120;14
/net/per610a/home/mvp/mvp_db/news7-lv/2004/2004_04_12_19_00/2004_04_12_19_00.mpg;Junichiro KOIZUMI.jpg;22001;22013;35957;1100;1101;1
/net/per610a/home/mvp/mvp_db/news7-lv/2004/2004_04_12_19_00/2004_04_12_19_00.mpg;Junichiro KOIZUMI.jpg;22445;22685;35957;1122;1134;12
/net/per610a/home/mvp/mvp_db/news7-lv/2004/2004_04_13_19_00/2004_04_13_19_00.mpg;Yasuo FUKUDA.jpg;12629;13205;35957;631;660;29
/net/per610a/home/mvp/mvp_db/news7-lv/2004/2004_04_13_19_00/2004_04_13_19_00.mpg;Ichiro OZAWA.jpg;24005;24581;35957;1201;1229;28
/net/per610a/home/mvp/mvp_db/news7-lv/2004/2004_04_14_19_00/2004_04_14_19_00.mpg;Taro ASO.jpg;27953;28317;35957;1398;1416;18
/net/per610a/home/mvp/mvp_db/news7-lv/2004/2004_04_15_19_00/2004_04_15_19_00.mpg;Junichiro KOIZUMI.jpg;24849;25189;35957;1243;1260;17
/net/per610a/home/mvp/mvp_db/news7-lv/2004/2004_04_16_19_00/2004_04_16_19_00.mpg;Yasuo FUKUDA.jpg;18785;19101;35957;939;955;16
/net/per610a/home/mvp/mvp_db/news7-lv/2004/2004_04_16_19_00/2004_04_16_19_00.mpg;Junichiro KOIZUMI.jpg;20513;20621;35957;1026;1031;5
/net/per610a/home/mvp/mvp_db/news7-lv/2004/2004_04_19_19_00/2004_04_19_19_00.mpg;Yoshihiko Noda.jpg;28041;28461;35957;1402;1423;21
/net/per610a/home/mvp/mvp_db/news7-lv/2004/2004_04_20_19_00/2004_04_20_19_00.mpg;Junichiro KOIZUMI.jpg;28337;28861;35957;1417;1443;26
/net/per610a/home/mvp/mvp_db/news7-lv/2004/2004_04_22_19_00/2004_04_22_19_00.mpg;Junichiro KOIZUMI.jpg;9861;10177;35957;493;509;16
/net/per610a/home/mvp/mvp_db/news7-lv/2004/2004_04_23_19_00/2004_04_23_19_00.mpg;Junichiro KOIZUMI.jpg;12209;12609;35957;610;630;20
/net/per610a/home/mvp/mvp_db/news7-lv/2004/2004_04_26_19_00/2004_04_26_19_00.mpg;Junichiro KOIZUMI.jpg;16177;16509;35957;809;825;16
/net/per610a/home/mvp/mvp_db/news7-lv/2004/2004_04_26_19_00/2004_04_26_19_00.mpg;Junichiro KOIZUMI.jpg;22513;22729;35957;1126;1137;11
/net/per610a/home/mvp/mvp_db/news7-lv/2004/2004_04_26_19_00/2004_04_26_19_00.mpg;Junichiro KOIZUMI.jpg;17493;17801;35957;875;890;15
/net/per610a/home/mvp/mvp_db/news7-lv/2004/2004_04_26_19_00/2004_04_26_19_00.mpg;Junichiro KOIZUMI.jpg;18437;18873;35957;922;944;22
/net/per610a/home/mvp/mvp_db/news7-lv/2004/2004_04_27_19_00/2004_04_27_19_00.mpg;Yasuo FUKUDA.jpg;8237;8921;35953;412;446;34
/net/per610a/home/mvp/mvp_db/news7-lv/2004/2004_04_27_19_00/2004_04_27_19_00.mpg;Naoto KAN.jpg;8965;9421;35953;448;471;23
/net/per610a/home/mvp/mvp_db/news7-lv/2004/2004_04_28_19_00/2004_04_28_19_00.mpg;Naoto KAN.jpg;149;449;35957;7;22;15
/net/per610a/home/mvp/mvp_db/news7-lv/2004/2004_04_28_19_00/2004_04_28_19_00.mpg;Naoto KAN.jpg;8985;10005;35957;449;500;51
/net/per610a/home/mvp/mvp_db/news7-lv/2004/2004_04_28_19_00/2004_04_28_19_00.mpg;Yukio EDANO.jpg;4333;4629;35957;216;231;15
/net/per610a/home/mvp/mvp_db/news7-lv/2004/2004_04_28_19_00/2004_04_28_19_00.mpg;Yukio EDANO.jpg;5081;5621;35957;254;281;27
/net/per610a/home/mvp/mvp_db/news7-lv/2004/2004_04_30_19_00/2004_04_30_19_00.mpg;Yukio HATOYAMA.jpg;645;1017;35957;32;50;18
/net/per610a/home/mvp/mvp_db/news7-lv/2004/2004_04_30_19_00/2004_04_30_19_00.mpg;Yukio HATOYAMA.jpg;15801;16117;35957;790;806;16
/net/per610a/home/mvp/mvp_db/news7-lv/2004/2004_04_30_19_00/2004_04_30_19_00.mpg;Yukio HATOYAMA.jpg;16193;16413;35957;810;821;11
/net/per610a/home/mvp/mvp_db/news7-lv/2004/2004_04_30_19_00/2004_04_30_19_00.mpg;Yukio HATOYAMA.jpg;16685;17369;35957;834;869;35
/net/per610a/home/mvp/mvp_db/news7-lv/2004/2004_04_30_19_00/2004_04_30_19_00.mpg;Katsuya OKADA.jpg;17733;18093;35957;887;905;18
/net/per610a/home/mvp/mvp_db/news7-lv/2004/2004_05_06_19_00/2004_05_06_19_00.mpg;Junichiro KOIZUMI.jpg;10205;10369;35957;510;518;8
/net/per610a/home/mvp/mvp_db/news7-lv/2004/2004_05_06_19_00/2004_05_06_19_00.mpg;Junichiro KOIZUMI.jpg;10441;10857;35957;522;543;21
/net/per610a/home/mvp/mvp_db/news7-lv/2004/2004_05_06_19_00/2004_05_06_19_00.mpg;Junichiro KOIZUMI.jpg;12069;12957;35957;603;648;45
/net/per610a/home/mvp/mvp_db/news7-lv/2004/2004_05_06_19_00/2004_05_06_19_00.mpg;Naoto KAN.jpg;19961;21461;35957;998;1073;75
/net/per610a/home/mvp/mvp_db/news7-lv/2004/2004_05_07_19_00/2004_05_07_19_00.mpg;Yasuo FUKUDA.jpg;161;445;35957;8;22;14
/net/per610a/home/mvp/mvp_db/news7-lv/2004/2004_05_07_19_00/2004_05_07_19_00.mpg;Yasuo FUKUDA.jpg;1381;3717;35957;69;185;116
/net/per610a/home/mvp/mvp_db/news7-lv/2004/2004_05_07_19_00/2004_05_07_19_00.mpg;Yasuo FUKUDA.jpg;753;1249;35957;37;62;25
/net/per610a/home/mvp/mvp_db/news7-lv/2004/2004_05_07_19_00/2004_05_07_19_00.mpg;Yasuo FUKUDA.jpg;20381;20437;35957;1019;1022;3
/net/per610a/home/mvp/mvp_db/news7-lv/2004/2004_05_07_19_00/2004_05_07_19_00.mpg;Junichiro KOIZUMI.jpg;10457;15149;35957;523;757;234
/net/per610a/home/mvp/mvp_db/news7-lv/2004/2004_05_08_19_00/2004_05_08_19_00.mpg;Junichiro KOIZUMI.jpg;5641;6201;35957;282;310;28
/net/per610a/home/mvp/mvp_db/news7-lv/2004/2004_05_08_19_00/2004_05_08_19_00.mpg;Junichiro KOIZUMI.jpg;25445;25473;35957;1273;1274;1
/net/per610a/home/mvp/mvp_db/news7-lv/2004/2004_05_08_19_00/2004_05_08_19_00.mpg;Taro ASO.jpg;8501;9529;35957;425;476;51
/net/per610a/home/mvp/mvp_db/news7-lv/2004/2004_05_08_19_00/2004_05_08_19_00.mpg;Takenori KANZAKI.jpg;10169;12061;35957;508;603;95
/net/per610a/home/mvp/mvp_db/news7-lv/2004/2004_05_08_19_00/2004_05_08_19_00.mpg;Junichiro KOIZUMI.jpg;25025;25381;35957;1252;1269;17
/net/per610a/home/mvp/mvp_db/news7-lv/2004/2004_05_09_19_00/2004_05_09_19_00.mpg;Yoshihiko Noda.jpg;221;485;23973;11;24;13
/net/per610a/home/mvp/mvp_db/news7-lv/2004/2004_05_09_19_00/2004_05_09_19_00.mpg;Yoshihiko Noda.jpg;5673;7049;23973;283;352;69
/net/per610a/home/mvp/mvp_db/news7-lv/2004/2004_05_09_19_00/2004_05_09_19_00.mpg;Naoto KAN.jpg;8765;8913;23973;438;445;7
/net/per610a/home/mvp/mvp_db/news7-lv/2004/2004_05_09_19_00/2004_05_09_19_00.mpg;Naoto KAN.jpg;9185;9189;23973;459;459;0
/net/per610a/home/mvp/mvp_db/news7-lv/2004/2004_05_09_19_00/2004_05_09_19_00.mpg;Naoto KAN.jpg;10885;10965;23973;544;548;4
/net/per610a/home/mvp/mvp_db/news7-lv/2004/2004_05_09_19_00/2004_05_09_19_00.mpg;Naoto KAN.jpg;11045;11169;23973;552;558;6
/net/per610a/home/mvp/mvp_db/news7-lv/2004/2004_05_09_19_00/2004_05_09_19_00.mpg;Naoto KAN.jpg;11237;11421;23973;562;571;9
/net/per610a/home/mvp/mvp_db/news7-lv/2004/2004_05_09_19_00/2004_05_09_19_00.mpg;Yasuo FUKUDA.jpg;11825;11917;23973;591;596;5
/net/per610a/home/mvp/mvp_db/news7-lv/2004/2004_05_10_19_00/2004_05_10_19_00.mpg;Naoto KAN.jpg;153;729;35961;7;36;29
/net/per610a/home/mvp/mvp_db/news7-lv/2004/2004_05_10_19_00/2004_05_10_19_00.mpg;Naoto KAN.jpg;1201;2401;35961;60;120;60
/net/per610a/home/mvp/mvp_db/news7-lv/2004/2004_05_10_19_00/2004_05_10_19_00.mpg;Naoto KAN.jpg;3525;3625;35961;176;181;5
/net/per610a/home/mvp/mvp_db/news7-lv/2004/2004_05_10_19_00/2004_05_10_19_00.mpg;Naoto KAN.jpg;7197;7289;35961;360;364;4
/net/per610a/home/mvp/mvp_db/news7-lv/2004/2004_05_10_19_00/2004_05_10_19_00.mpg;Naoto KAN.jpg;10201;10337;35961;510;517;7
/net/per610a/home/mvp/mvp_db/news7-lv/2004/2004_05_10_19_00/2004_05_10_19_00.mpg;Naoto KAN.jpg;10597;10861;35961;530;543;13
/net/per610a/home/mvp/mvp_db/news7-lv/2004/2004_05_10_19_00/2004_05_10_19_00.mpg;Naoto KAN.jpg;12965;13085;35961;648;654;6
/net/per610a/home/mvp/mvp_db/news7-lv/2004/2004_05_10_19_00/2004_05_10_19_00.mpg;Naoto KAN.jpg;15097;15109;35961;755;755;0
/net/per610a/home/mvp/mvp_db/news7-lv/2004/2004_05_10_19_00/2004_05_10_19_00.mpg;Junichiro KOIZUMI.jpg;7657;8069;35961;383;403;20
/net/per610a/home/mvp/mvp_db/news7-lv/2004/2004_05_10_19_00/2004_05_10_19_00.mpg;Junichiro KOIZUMI.jpg;17293;17545;35961;865;877;12
/net/per610a/home/mvp/mvp_db/news7-lv/2004/2004_05_10_19_00/2004_05_10_19_00.mpg;Naoto KAN.jpg;15285;15697;35961;764;785;21
/net/per610a/home/mvp/mvp_db/news7-lv/2004/2004_05_10_19_00/2004_05_10_19_00.mpg;Naoto KAN.jpg;16201;16337;35961;810;817;7
/net/per610a/home/mvp/mvp_db/news7-lv/2004/2004_05_11_19_00/2004_05_11_19_00.mpg;Yoshihiko Noda.jpg;4817;4901;35957;241;245;4
/net/per610a/home/mvp/mvp_db/news7-lv/2004/2004_05_11_19_00/2004_05_11_19_00.mpg;Junichiro KOIZUMI.jpg;23441;24101;35957;1172;1205;33
/net/per610a/home/mvp/mvp_db/news7-lv/2004/2004_05_12_19_00/2004_05_12_19_00.mpg;Takenori KANZAKI.jpg;3649;3889;35957;182;194;12
/net/per610a/home/mvp/mvp_db/news7-lv/2004/2004_05_12_19_00/2004_05_12_19_00.mpg;Takenori KANZAKI.jpg;5769;6609;35957;288;330;42
/net/per610a/home/mvp/mvp_db/news7-lv/2004/2004_05_12_19_00/2004_05_12_19_00.mpg;Junichiro KOIZUMI.jpg;6637;7049;35957;332;352;20
/net/per610a/home/mvp/mvp_db/news7-lv/2004/2004_05_12_19_00/2004_05_12_19_00.mpg;Ichiro OZAWA.jpg;8081;8117;35957;404;406;2
/net/per610a/home/mvp/mvp_db/news7-lv/2004/2004_05_12_19_00/2004_05_12_19_00.mpg;Ichiro OZAWA.jpg;12921;13437;35957;646;672;26
/net/per610a/home/mvp/mvp_db/news7-lv/2004/2004_05_12_19_00/2004_05_12_19_00.mpg;Takeo Hiranuma.jpeg;27029;27285;35957;1352;1365;13
/net/per610a/home/mvp/mvp_db/news7-lv/2004/2004_05_13_19_00/2004_05_13_19_00.mpg;Katsuya OKADA.jpg;469;565;35957;23;28;5
/net/per610a/home/mvp/mvp_db/news7-lv/2004/2004_05_13_19_00/2004_05_13_19_00.mpg;Katsuya OKADA.jpg;12681;12993;35957;634;650;16
/net/per610a/home/mvp/mvp_db/news7-lv/2004/2004_05_13_19_00/2004_05_13_19_00.mpg;Takeo Hiranuma.jpeg;8129;8305;35957;406;415;9
/net/per610a/home/mvp/mvp_db/news7-lv/2004/2004_05_13_19_00/2004_05_13_19_00.mpg;Takenori KANZAKI.jpg;10457;10589;35957;523;529;6
/net/per610a/home/mvp/mvp_db/news7-lv/2004/2004_05_13_19_00/2004_05_13_19_00.mpg;Ichiro OZAWA.jpg;11085;11489;35957;554;574;20
/net/per610a/home/mvp/mvp_db/news7-lv/2004/2004_05_13_19_00/2004_05_13_19_00.mpg;Ichiro OZAWA.jpg;13369;13601;35957;668;680;12
/net/per610a/home/mvp/mvp_db/news7-lv/2004/2004_05_13_19_00/2004_05_13_19_00.mpg;Junichiro KOIZUMI.jpg;21093;21281;35957;1055;1064;9
/net/per610a/home/mvp/mvp_db/news7-lv/2004/2004_05_14_19_00/2004_05_14_19_00.mpg;Junichiro KOIZUMI.jpg;145;369;35957;7;18;11
/net/per610a/home/mvp/mvp_db/news7-lv/2004/2004_05_14_19_00/2004_05_14_19_00.mpg;Junichiro KOIZUMI.jpg;1057;6497;35957;52;325;273
/net/per610a/home/mvp/mvp_db/news7-lv/2004/2004_05_14_19_00/2004_05_14_19_00.mpg;Junichiro KOIZUMI.jpg;9469;9609;35957;473;480;7
/net/per610a/home/mvp/mvp_db/news7-lv/2004/2004_05_14_19_00/2004_05_14_19_00.mpg;Shinzo ABE.jpg;9561;9589;35957;478;479;1
/net/per610a/home/mvp/mvp_db/news7-lv/2004/2004_05_14_19_00/2004_05_14_19_00.mpg;Shinzo ABE.jpg;10749;12449;35957;537;622;85
/net/per610a/home/mvp/mvp_db/news7-lv/2004/2004_05_14_19_00/2004_05_14_19_00.mpg;Kenji Eda.jpg;23361;23445;35957;1168;1172;4
/net/per610a/home/mvp/mvp_db/news7-lv/2004/2004_05_14_19_00/2004_05_14_19_00.mpg;Shintaro ISHIHARA.jpg;26173;26549;35957;1309;1328;19
/net/per610a/home/mvp/mvp_db/news7-lv/2004/2004_05_15_19_00/2004_05_15_19_00.mpg;Shinzo ABE.jpg;7117;9045;35957;356;452;96
/net/per610a/home/mvp/mvp_db/news7-lv/2004/2004_05_16_19_00/2004_05_16_19_00.mpg;Junichiro KOIZUMI.jpg;8733;9065;23973;436;453;17
/net/per610a/home/mvp/mvp_db/news7-lv/2004/2004_05_16_19_00/2004_05_16_19_00.mpg;Junichiro KOIZUMI.jpg;10501;10833;23973;525;541;16
/net/per610a/home/mvp/mvp_db/news7-lv/2004/2004_05_16_19_00/2004_05_16_19_00.mpg;Junichiro KOIZUMI.jpg;9509;10133;23973;475;506;31
/net/per610a/home/mvp/mvp_db/news7-lv/2004/2004_05_16_19_00/2004_05_16_19_00.mpg;Junichiro KOIZUMI.jpg;13861;14153;23973;693;707;14
/net/per610a/home/mvp/mvp_db/news7-lv/2004/2004_05_17_19_00/2004_05_17_19_00.mpg;Junichiro KOIZUMI.jpg;3977;4365;35957;198;218;20
/net/per610a/home/mvp/mvp_db/news7-lv/2004/2004_05_17_19_00/2004_05_17_19_00.mpg;Junichiro KOIZUMI.jpg;5337;6377;35957;267;319;52
/net/per610a/home/mvp/mvp_db/news7-lv/2004/2004_05_17_19_00/2004_05_17_19_00.mpg;Shinzo ABE.jpg;6381;7173;35957;319;358;39
/net/per610a/home/mvp/mvp_db/news7-lv/2004/2004_05_18_19_00/2004_05_18_19_00.mpg;Junichiro KOIZUMI.jpg;665;993;35957;33;49;16
/net/per610a/home/mvp/mvp_db/news7-lv/2004/2004_05_18_19_00/2004_05_18_19_00.mpg;Junichiro KOIZUMI.jpg;4533;4933;35957;226;246;20
/net/per610a/home/mvp/mvp_db/news7-lv/2004/2004_05_18_19_00/2004_05_18_19_00.mpg;Junichiro KOIZUMI.jpg;10513;10725;35957;525;536;11
/net/per610a/home/mvp/mvp_db/news7-lv/2004/2004_05_18_19_00/2004_05_18_19_00.mpg;Junichiro KOIZUMI.jpg;11225;11837;35957;561;592;31
/net/per610a/home/mvp/mvp_db/news7-lv/2004/2004_05_18_19_00/2004_05_18_19_00.mpg;Junichiro KOIZUMI.jpg;12001;12809;35957;600;640;40
/net/per610a/home/mvp/mvp_db/news7-lv/2004/2004_05_18_19_00/2004_05_18_19_00.mpg;Junichiro KOIZUMI.jpg;17385;17637;35957;869;882;13
/net/per610a/home/mvp/mvp_db/news7-lv/2004/2004_05_19_19_00/2004_05_19_19_00.mpg;Junichiro KOIZUMI.jpg;13833;14217;35957;692;711;19
/net/per610a/home/mvp/mvp_db/news7-lv/2004/2004_05_20_19_00/2004_05_20_19_00.mpg;Shinzo ABE.jpg;14905;15129;35957;745;756;11
/net/per610a/home/mvp/mvp_db/news7-lv/2004/2004_05_20_19_00/2004_05_20_19_00.mpg;Junichiro KOIZUMI.jpg;16369;17093;35957;818;855;37
/net/per610a/home/mvp/mvp_db/news7-lv/2004/2004_05_21_19_00/2004_05_21_19_00.mpg;Junichiro KOIZUMI.jpg;761;881;35957;38;44;6
/net/per610a/home/mvp/mvp_db/news7-lv/2004/2004_05_21_19_00/2004_05_21_19_00.mpg;Junichiro KOIZUMI.jpg;1101;1141;35957;55;57;2
/net/per610a/home/mvp/mvp_db/news7-lv/2004/2004_05_21_19_00/2004_05_21_19_00.mpg;Junichiro KOIZUMI.jpg;1213;1353;35957;60;67;7
/net/per610a/home/mvp/mvp_db/news7-lv/2004/2004_05_21_19_00/2004_05_21_19_00.mpg;Junichiro KOIZUMI.jpg;1489;1489;35957;74;74;0
/net/per610a/home/mvp/mvp_db/news7-lv/2004/2004_05_21_19_00/2004_05_21_19_00.mpg;Junichiro KOIZUMI.jpg;15429;16317;35957;771;816;45
/net/per610a/home/mvp/mvp_db/news7-lv/2004/2004_05_21_19_00/2004_05_21_19_00.mpg;Junichiro KOIZUMI.jpg;17413;17413;35957;871;871;0
/net/per610a/home/mvp/mvp_db/news7-lv/2004/2004_05_21_19_00/2004_05_21_19_00.mpg;Junichiro KOIZUMI.jpg;19989;19989;35957;1000;1000;0
/net/per610a/home/mvp/mvp_db/news7-lv/2004/2004_05_21_19_00/2004_05_21_19_00.mpg;Junichiro KOIZUMI.jpg;20345;20385;35957;1017;1019;2
/net/per610a/home/mvp/mvp_db/news7-lv/2004/2004_05_22_19_00/2004_05_22_19_00.mpg;Yukio HATOYAMA.jpg;8321;9457;35957;416;473;57
/net/per610a/home/mvp/mvp_db/news7-lv/2004/2004_05_24_19_00/2004_05_24_19_00.mpg;Kyoko Nakayama.jpg;15465;16257;35957;773;813;40
/net/per610a/home/mvp/mvp_db/news7-lv/2004/2004_05_24_19_00/2004_05_24_19_00.mpg;Junichiro KOIZUMI.jpg;21601;21705;35957;1080;1085;5
/net/per610a/home/mvp/mvp_db/news7-lv/2004/2004_05_25_19_00/2004_05_25_19_00.mpg;Junichiro KOIZUMI.jpg;17565;17957;35957;878;898;20
/net/per610a/home/mvp/mvp_db/news7-lv/2004/2004_05_25_19_00/2004_05_25_19_00.mpg;Junichiro KOIZUMI.jpg;21249;21605;35957;1063;1080;17
/net/per610a/home/mvp/mvp_db/news7-lv/2004/2004_05_26_19_00/2004_05_26_19_00.mpg;Kyoko Nakayama.jpg;8473;10313;35957;423;515;92
/net/per610a/home/mvp/mvp_db/news7-lv/2004/2004_05_27_19_00/2004_05_27_19_00.mpg;Kyoko Nakayama.jpg;5505;6685;35957;275;334;59
/net/per610a/home/mvp/mvp_db/news7-lv/2004/2004_05_31_19_00/2004_05_31_19_00.mpg;Kyoko Nakayama.jpg;7045;7965;35957;352;398;46
/net/per610a/home/mvp/mvp_db/news7-lv/2004/2004_05_31_19_00/2004_05_31_19_00.mpg;Junichiro KOIZUMI.jpg;9485;9753;35957;474;487;13
/net/per610a/home/mvp/mvp_db/news7-lv/2004/2004_06_01_19_00/2004_06_01_19_00.mpg;Shinzo ABE.jpg;1181;1345;35957;59;67;8
/net/per610a/home/mvp/mvp_db/news7-lv/2004/2004_06_01_19_00/2004_06_01_19_00.mpg;Shinzo ABE.jpg;16069;17193;35957;803;860;57
/net/per610a/home/mvp/mvp_db/news7-lv/2004/2004_06_01_19_00/2004_06_01_19_00.mpg;Junichiro KOIZUMI.jpg;23445;23673;35957;1172;1184;12
/net/per610a/home/mvp/mvp_db/news7-lv/2004/2004_06_02_19_00/2004_06_02_19_00.mpg;Junichiro KOIZUMI.jpg;18485;20105;35957;924;1005;81
/net/per610a/home/mvp/mvp_db/news7-lv/2004/2004_06_02_19_00/2004_06_02_19_00.mpg;Junichiro KOIZUMI.jpg;20185;21045;35957;1009;1052;43
/net/per610a/home/mvp/mvp_db/news7-lv/2004/2004_06_02_19_00/2004_06_02_19_00.mpg;Junichiro KOIZUMI.jpg;21161;21985;35957;1058;1099;41
/net/per610a/home/mvp/mvp_db/news7-lv/2004/2004_06_02_19_00/2004_06_02_19_00.mpg;Junichiro KOIZUMI.jpg;22645;22765;35957;1132;1138;6
/net/per610a/home/mvp/mvp_db/news7-lv/2004/2004_06_03_19_00/2004_06_03_19_00.mpg;Junichiro KOIZUMI.jpg;18981;19061;35957;949;953;4
/net/per610a/home/mvp/mvp_db/news7-lv/2004/2004_06_04_19_00/2004_06_04_19_00.mpg;Shinzo ABE.jpg;4269;4721;35957;213;236;23
/net/per610a/home/mvp/mvp_db/news7-lv/2004/2004_06_05_19_00/2004_06_05_19_00.mpg;Shinzo ABE.jpg;449;665;35957;22;33;11
/net/per610a/home/mvp/mvp_db/news7-lv/2004/2004_06_05_19_00/2004_06_05_19_00.mpg;Junichiro KOIZUMI.jpg;4901;5081;35957;245;254;9
/net/per610a/home/mvp/mvp_db/news7-lv/2004/2004_06_05_19_00/2004_06_05_19_00.mpg;Katsuya OKADA.jpg;5113;5273;35957;255;263;8
/net/per610a/home/mvp/mvp_db/news7-lv/2004/2004_06_05_19_00/2004_06_05_19_00.mpg;Kyoko Nakayama.jpg;18153;19125;35957;908;956;48
/net/per610a/home/mvp/mvp_db/news7-lv/2004/2004_06_05_19_00/2004_06_05_19_00.mpg;YUriko Koike.jpg;26141;26277;35957;1307;1314;7
/net/per610a/home/mvp/mvp_db/news7-lv/2004/2004_06_07_19_00/2004_06_07_19_00.mpg;Junichiro KOIZUMI.jpg;13541;13541;35957;677;677;0
/net/per610a/home/mvp/mvp_db/news7-lv/2004/2004_06_07_19_00/2004_06_07_19_00.mpg;Junichiro KOIZUMI.jpg;13729;13729;35957;686;686;0
/net/per610a/home/mvp/mvp_db/news7-lv/2004/2004_06_07_19_00/2004_06_07_19_00.mpg;Junichiro KOIZUMI.jpg;13801;14373;35957;690;719;29
/net/per610a/home/mvp/mvp_db/news7-lv/2004/2004_06_07_19_00/2004_06_07_19_00.mpg;Junichiro KOIZUMI.jpg;16309;16449;35957;815;822;7
/net/per610a/home/mvp/mvp_db/news7-lv/2004/2004_06_07_19_00/2004_06_07_19_00.mpg;Junichiro KOIZUMI.jpg;16617;16645;35957;831;832;1
/net/per610a/home/mvp/mvp_db/news7-lv/2004/2004_06_07_19_00/2004_06_07_19_00.mpg;Katsuya OKADA.jpg;14829;16033;35957;741;802;61
/net/per610a/home/mvp/mvp_db/news7-lv/2004/2004_06_07_19_00/2004_06_07_19_00.mpg;Katsuya OKADA.jpg;16093;16177;35957;805;809;4
/net/per610a/home/mvp/mvp_db/news7-lv/2004/2004_06_07_19_00/2004_06_07_19_00.mpg;Shinzo ABE.jpg;16897;17125;35957;845;856;11
/net/per610a/home/mvp/mvp_db/news7-lv/2004/2004_06_08_19_00/2004_06_08_19_00.mpg;Junichiro KOIZUMI.jpg;15389;15525;35957;769;776;7
/net/per610a/home/mvp/mvp_db/news7-lv/2004/2004_06_10_19_00/2004_06_10_19_00.mpg;Junichiro KOIZUMI.jpg;23545;23669;35957;1178;1184;6
/net/per610a/home/mvp/mvp_db/news7-lv/2004/2004_06_10_19_00/2004_06_10_19_00.mpg;Junichiro KOIZUMI.jpg;23753;24121;35957;1188;1206;18
/net/per610a/home/mvp/mvp_db/news7-lv/2004/2004_06_11_19_00/2004_06_11_19_00.mpg;Junichiro KOIZUMI.jpg;18089;18097;35957;905;905;0
/net/per610a/home/mvp/mvp_db/news7-lv/2004/2004_06_11_19_00/2004_06_11_19_00.mpg;Junichiro KOIZUMI.jpg;18181;19465;35957;909;973;64
/net/per610a/home/mvp/mvp_db/news7-lv/2004/2004_06_12_19_00/2004_06_12_19_00.mpg;Junichiro KOIZUMI.jpg;26993;27157;35957;1350;1358;8
/net/per610a/home/mvp/mvp_db/news7-lv/2004/2004_06_12_19_00/2004_06_12_19_00.mpg;Junichiro KOIZUMI.jpg;27305;27697;35957;1366;1385;19
/net/per610a/home/mvp/mvp_db/news7-lv/2004/2004_06_14_19_00/2004_06_14_19_00.mpg;Junichiro KOIZUMI.jpg;12933;13425;35957;647;671;24
/net/per610a/home/mvp/mvp_db/news7-lv/2004/2004_06_14_19_00/2004_06_14_19_00.mpg;Junichiro KOIZUMI.jpg;18613;18761;35957;931;938;7
/net/per610a/home/mvp/mvp_db/news7-lv/2004/2004_06_15_19_00/2004_06_15_19_00.mpg;Shinzo ABE.jpg;3041;3089;35957;152;154;2
/net/per610a/home/mvp/mvp_db/news7-lv/2004/2004_06_15_19_00/2004_06_15_19_00.mpg;Shinzo ABE.jpg;4213;6109;35957;210;305;95
/net/per610a/home/mvp/mvp_db/news7-lv/2004/2004_06_15_19_00/2004_06_15_19_00.mpg;Katsuya OKADA.jpg;9825;9969;35957;491;498;7
/net/per610a/home/mvp/mvp_db/news7-lv/2004/2004_06_15_19_00/2004_06_15_19_00.mpg;Katsuya OKADA.jpg;10945;11185;35957;547;559;12
/net/per610a/home/mvp/mvp_db/news7-lv/2004/2004_06_15_19_00/2004_06_15_19_00.mpg;Junichiro KOIZUMI.jpg;12361;12505;35957;618;625;7
/net/per610a/home/mvp/mvp_db/news7-lv/2004/2004_06_16_19_00/2004_06_16_19_00.mpg;Kazuo SHII.jpg;2481;2937;35957;124;146;22
/net/per610a/home/mvp/mvp_db/news7-lv/2004/2004_06_16_19_00/2004_06_16_19_00.mpg;Kazuo SHII.jpg;4765;4973;35957;238;248;10
/net/per610a/home/mvp/mvp_db/news7-lv/2004/2004_06_16_19_00/2004_06_16_19_00.mpg;Kazuo SHII.jpg;7837;8981;35957;392;449;57
/net/per610a/home/mvp/mvp_db/news7-lv/2004/2004_06_16_19_00/2004_06_16_19_00.mpg;Junichiro KOIZUMI.jpg;4085;4237;35957;204;211;7
/net/per610a/home/mvp/mvp_db/news7-lv/2004/2004_06_16_19_00/2004_06_16_19_00.mpg;Junichiro KOIZUMI.jpg;12281;14853;35957;614;743;129
/net/per610a/home/mvp/mvp_db/news7-lv/2004/2004_06_16_19_00/2004_06_16_19_00.mpg;Shinzo ABE.jpg;5925;7829;35957;296;391;95
/net/per610a/home/mvp/mvp_db/news7-lv/2004/2004_06_17_19_00/2004_06_17_19_00.mpg;Junichiro KOIZUMI.jpg;9937;12957;35957;497;648;151
/net/per610a/home/mvp/mvp_db/news7-lv/2004/2004_06_17_19_00/2004_06_17_19_00.mpg;Junichiro KOIZUMI.jpg;13069;13201;35957;653;660;7
/net/per610a/home/mvp/mvp_db/news7-lv/2004/2004_06_19_19_00/2004_06_19_19_00.mpg;Junichiro KOIZUMI.jpg;17701;17949;35957;885;898;13
/net/per610a/home/mvp/mvp_db/news7-lv/2004/2004_06_19_19_00/2004_06_19_19_00.mpg;Junichiro KOIZUMI.jpg;19053;19221;35957;953;961;8
/net/per610a/home/mvp/mvp_db/news7-lv/2004/2004_06_19_19_00/2004_06_19_19_00.mpg;Takenori KANZAKI.jpg;17989;18509;35957;900;926;26
/net/per610a/home/mvp/mvp_db/news7-lv/2004/2004_06_19_19_00/2004_06_19_19_00.mpg;Takenori KANZAKI.jpg;19833;19885;35957;992;994;2
/net/per610a/home/mvp/mvp_db/news7-lv/2004/2004_06_19_19_00/2004_06_19_19_00.mpg;Kazuo SHII.jpg;18533;18761;35957;927;938;11
/net/per610a/home/mvp/mvp_db/news7-lv/2004/2004_06_19_19_00/2004_06_19_19_00.mpg;Kazuo SHII.jpg;20493;20717;35957;1025;1036;11
/net/per610a/home/mvp/mvp_db/news7-lv/2004/2004_06_19_19_00/2004_06_19_19_00.mpg;Kazuo SHII.jpg;21257;21361;35957;1063;1068;5
/net/per610a/home/mvp/mvp_db/news7-lv/2004/2004_06_19_19_00/2004_06_19_19_00.mpg;Katsuya OKADA.jpg;19225;19825;35957;961;991;30
/net/per610a/home/mvp/mvp_db/news7-lv/2004/2004_06_24_19_00/2004_06_24_19_00.mpg;Junichiro KOIZUMI.jpg;20437;21485;35961;1022;1074;52
/net/per610a/home/mvp/mvp_db/news7-lv/2004/2004_06_24_19_00/2004_06_24_19_00.mpg;Katsuya OKADA.jpg;22037;22745;35961;1102;1137;35
/net/per610a/home/mvp/mvp_db/news7-lv/2004/2004_06_26_19_00/2004_06_26_19_00.mpg;Kazuo SHII.jpg;10677;11221;35957;534;561;27
/net/per610a/home/mvp/mvp_db/news7-lv/2004/2004_07_02_19_00/2004_07_02_19_00.mpg;Kyoko Nakayama.jpg;2485;3133;35957;124;156;32
/net/per610a/home/mvp/mvp_db/news7-lv/2004/2004_07_03_19_00/2004_07_03_19_00.mpg;Junichiro KOIZUMI.jpg;2305;2753;35957;115;137;22
/net/per610a/home/mvp/mvp_db/news7-lv/2004/2004_07_03_19_00/2004_07_03_19_00.mpg;Takenori KANZAKI.jpg;4529;4637;35957;226;231;5
/net/per610a/home/mvp/mvp_db/news7-lv/2004/2004_07_03_19_00/2004_07_03_19_00.mpg;Kazuo SHII.jpg;5933;6977;35957;296;349;53
/net/per610a/home/mvp/mvp_db/news7-lv/2004/2004_07_06_19_00/2004_07_06_19_00.mpg;Kyoko Nakayama.jpg;12893;13257;35957;645;663;18
/net/per610a/home/mvp/mvp_db/news7-lv/2004/2004_07_07_19_00/2004_07_07_19_00.mpg;Ichiro OZAWA.jpg;7545;8121;35957;377;406;29
/net/per610a/home/mvp/mvp_db/news7-lv/2004/2004_07_10_19_00/2004_07_10_19_00.mpg;Junichiro KOIZUMI.jpg;433;629;35957;21;31;10
/net/per610a/home/mvp/mvp_db/news7-lv/2004/2004_07_10_19_00/2004_07_10_19_00.mpg;Junichiro KOIZUMI.jpg;8881;9949;35957;444;497;53
/net/per610a/home/mvp/mvp_db/news7-lv/2004/2004_07_10_19_00/2004_07_10_19_00.mpg;Kyoko Nakayama.jpg;16765;16765;35957;838;838;0
/net/per610a/home/mvp/mvp_db/news7-lv/2004/2004_07_10_19_00/2004_07_10_19_00.mpg;Kyoko Nakayama.jpg;16869;17065;35957;843;853;10
/net/per610a/home/mvp/mvp_db/news7-lv/2004/2004_07_12_19_00/2004_07_12_19_00.mpg;Junichiro KOIZUMI.jpg;1;245;35957;0;12;12
/net/per610a/home/mvp/mvp_db/news7-lv/2004/2004_07_12_19_00/2004_07_12_19_00.mpg;Junichiro KOIZUMI.jpg;4349;4661;35957;217;233;16
/net/per610a/home/mvp/mvp_db/news7-lv/2004/2004_07_12_19_00/2004_07_12_19_00.mpg;Junichiro KOIZUMI.jpg;8697;9397;35957;435;470;35
/net/per610a/home/mvp/mvp_db/news7-lv/2004/2004_07_12_19_00/2004_07_12_19_00.mpg;Junichiro KOIZUMI.jpg;9669;11409;35957;483;570;87
/net/per610a/home/mvp/mvp_db/news7-lv/2004/2004_07_12_19_00/2004_07_12_19_00.mpg;Kyoko Nakayama.jpg;521;729;35957;26;36;10
/net/per610a/home/mvp/mvp_db/news7-lv/2004/2004_07_12_19_00/2004_07_12_19_00.mpg;Kyoko Nakayama.jpg;15773;16041;35957;789;802;13
/net/per610a/home/mvp/mvp_db/news7-lv/2004/2004_07_12_19_00/2004_07_12_19_00.mpg;Kyoko Nakayama.jpg;16161;16281;35957;808;814;6
/net/per610a/home/mvp/mvp_db/news7-lv/2004/2004_07_12_19_00/2004_07_12_19_00.mpg;Takenori KANZAKI.jpg;2589;3405;35957;129;170;41
/net/per610a/home/mvp/mvp_db/news7-lv/2004/2004_07_12_19_00/2004_07_12_19_00.mpg;Takenori KANZAKI.jpg;4349;4537;35957;217;226;9
/net/per610a/home/mvp/mvp_db/news7-lv/2004/2004_07_13_19_00/2004_07_13_19_00.mpg;Taro ASO.jpg;27277;27333;35957;1364;1367;3
/net/per610a/home/mvp/mvp_db/news7-lv/2004/2004_07_13_19_00/2004_07_13_19_00.mpg;Taro ASO.jpg;27713;27757;35957;1386;1388;2
/net/per610a/home/mvp/mvp_db/news7-lv/2004/2004_07_15_19_00/2004_07_15_19_00.mpg;Junichiro KOIZUMI.jpg;18669;18953;35957;934;948;14
/net/per610a/home/mvp/mvp_db/news7-lv/2004/2004_07_19_19_00/2004_07_19_19_00.mpg;Junichiro KOIZUMI.jpg;13397;13457;35957;670;673;3
/net/per610a/home/mvp/mvp_db/news7-lv/2004/2004_07_19_19_00/2004_07_19_19_00.mpg;Junichiro KOIZUMI.jpg;14569;14765;35957;728;738;10
/net/per610a/home/mvp/mvp_db/news7-lv/2004/2004_07_19_19_00/2004_07_19_19_00.mpg;Junichiro KOIZUMI.jpg;18769;19821;35957;939;991;52
/net/per610a/home/mvp/mvp_db/news7-lv/2004/2004_07_20_19_00/2004_07_20_19_00.mpg;Junichiro KOIZUMI.jpg;21317;21713;35957;1066;1086;20
/net/per610a/home/mvp/mvp_db/news7-lv/2004/2004_07_20_19_00/2004_07_20_19_00.mpg;Junichiro KOIZUMI.jpg;22033;22305;35957;1102;1115;13
/net/per610a/home/mvp/mvp_db/news7-lv/2004/2004_07_24_19_00/2004_07_24_19_00.mpg;Junichiro KOIZUMI.jpg;13813;14397;35957;691;720;29
/net/per610a/home/mvp/mvp_db/news7-lv/2004/2004_07_26_19_00/2004_07_26_19_00.mpg;Shinzo ABE.jpg;5769;5813;35957;288;290;2
/net/per610a/home/mvp/mvp_db/news7-lv/2004/2004_07_26_19_00/2004_07_26_19_00.mpg;Shinzo ABE.jpg;5893;6801;35957;294;340;46
/net/per610a/home/mvp/mvp_db/news7-lv/2004/2004_07_26_19_00/2004_07_26_19_00.mpg;Junichiro KOIZUMI.jpg;20433;20761;35957;1022;1038;16
/net/per610a/home/mvp/mvp_db/news7-lv/2004/2004_08_02_19_00/2004_08_02_19_00.mpg;Junichiro KOIZUMI.jpg;15441;15877;35957;772;794;22
/net/per610a/home/mvp/mvp_db/news7-lv/2004/2004_08_03_19_00/2004_08_03_19_00.mpg;Junichiro KOIZUMI.jpg;21177;21989;35957;1059;1100;41
/net/per610a/home/mvp/mvp_db/news7-lv/2004/2004_08_04_19_00/2004_08_04_19_00.mpg;Katsuya OKADA.jpg;21305;21449;35957;1065;1073;8
/net/per610a/home/mvp/mvp_db/news7-lv/2004/2004_08_05_19_00/2004_08_05_19_00.mpg;Junichiro KOIZUMI.jpg;4593;4837;35957;229;242;13
/net/per610a/home/mvp/mvp_db/news7-lv/2004/2004_08_09_19_00/2004_08_09_19_00.mpg;Junichiro KOIZUMI.jpg;13929;14317;35961;696;716;20
/net/per610a/home/mvp/mvp_db/news7-lv/2004/2004_08_09_19_00/2004_08_09_19_00.mpg;Junichiro KOIZUMI.jpg;17229;17657;35961;861;883;22
/net/per610a/home/mvp/mvp_db/news7-lv/2004/2004_08_09_19_00/2004_08_09_19_00.mpg;Junichiro KOIZUMI.jpg;16133;16473;35961;807;824;17
/net/per610a/home/mvp/mvp_db/news7-lv/2004/2004_08_09_19_00/2004_08_09_19_00.mpg;Takenori KANZAKI.jpg;29089;29209;35961;1455;1461;6
/net/per610a/home/mvp/mvp_db/news7-lv/2004/2004_08_25_19_00/2004_08_25_19_00.mpg;Junichiro KOIZUMI.jpg;28053;28485;35961;1403;1425;22
/net/per610a/home/mvp/mvp_db/news7-lv/2004/2004_08_31_19_00/2004_08_31_19_00.mpg;Toru Hashimoto.jpg;26057;26625;35957;1303;1332;29
/net/per610a/home/mvp/mvp_db/news7-lv/2004/2004_09_02_19_00/2004_09_02_19_00.mpg;Junichiro KOIZUMI.jpg;19193;19213;35957;960;961;1
/net/per610a/home/mvp/mvp_db/news7-lv/2004/2004_09_02_19_00/2004_09_02_19_00.mpg;Junichiro KOIZUMI.jpg;20201;20297;35957;1010;1015;5
/net/per610a/home/mvp/mvp_db/news7-lv/2004/2004_09_02_19_00/2004_09_02_19_00.mpg;Junichiro KOIZUMI.jpg;20665;21525;35957;1033;1076;43
/net/per610a/home/mvp/mvp_db/news7-lv/2004/2004_09_09_19_00/2004_09_09_19_00.mpg;Shizuka KAMEI.jpg;17113;17297;35957;856;865;9
/net/per610a/home/mvp/mvp_db/news7-lv/2004/2004_09_09_19_00/2004_09_09_19_00.mpg;Taro ASO.jpg;24341;24769;35957;1217;1239;22
/net/per610a/home/mvp/mvp_db/news7-lv/2004/2004_09_10_19_00/2004_09_10_19_00.mpg;Junichiro KOIZUMI.jpg;17529;17605;35961;876;880;4
/net/per610a/home/mvp/mvp_db/news7-lv/2004/2004_09_10_19_00/2004_09_10_19_00.mpg;Junichiro KOIZUMI.jpg;19965;20449;35961;998;1022;24
/net/per610a/home/mvp/mvp_db/news7-lv/2004/2004_09_10_19_00/2004_09_10_19_00.mpg;Shinzo ABE.jpg;18493;19929;35961;925;996;71
/net/per610a/home/mvp/mvp_db/news7-lv/2004/2004_09_13_19_00/2004_09_13_19_00.mpg;Junichiro KOIZUMI.jpg;18073;18509;35957;904;926;22
/net/per610a/home/mvp/mvp_db/news7-lv/2004/2004_09_13_19_00/2004_09_13_19_00.mpg;Shinzo ABE.jpg;25889;26069;35957;1295;1304;9
/net/per610a/home/mvp/mvp_db/news7-lv/2004/2004_09_21_19_00/2004_09_21_19_00.mpg;Shinzo ABE.jpg;14105;15069;35961;705;753;48
/net/per610a/home/mvp/mvp_db/news7-lv/2004/2004_09_24_19_00/2004_09_24_19_00.mpg;Shinzo ABE.jpg;149;393;35961;7;19;12
/net/per610a/home/mvp/mvp_db/news7-lv/2004/2004_09_24_19_00/2004_09_24_19_00.mpg;Shinzo ABE.jpg;2457;2557;35961;122;127;5
/net/per610a/home/mvp/mvp_db/news7-lv/2004/2004_09_24_19_00/2004_09_24_19_00.mpg;Shinzo ABE.jpg;3449;3809;35961;172;190;18
/net/per610a/home/mvp/mvp_db/news7-lv/2004/2004_09_24_19_00/2004_09_24_19_00.mpg;Junichiro KOIZUMI.jpg;24377;24457;35961;1219;1223;4
/net/per610a/home/mvp/mvp_db/news7-lv/2004/2004_09_25_19_00/2004_09_25_19_00.mpg;Ichiro OZAWA.jpg;317;365;35961;15;18;3
/net/per610a/home/mvp/mvp_db/news7-lv/2004/2004_09_25_19_00/2004_09_25_19_00.mpg;Ichiro OZAWA.jpg;2345;2425;35961;117;121;4
/net/per610a/home/mvp/mvp_db/news7-lv/2004/2004_09_25_19_00/2004_09_25_19_00.mpg;Ichiro OZAWA.jpg;3821;4401;35961;191;220;29
/net/per610a/home/mvp/mvp_db/news7-lv/2004/2004_09_25_19_00/2004_09_25_19_00.mpg;Ichiro OZAWA.jpg;5365;5617;35961;268;280;12
/net/per610a/home/mvp/mvp_db/news7-lv/2004/2004_09_26_19_00/2004_09_26_19_00.mpg;Junichiro KOIZUMI.jpg;3225;3541;23973;161;177;16
/net/per610a/home/mvp/mvp_db/news7-lv/2004/2004_09_26_19_00/2004_09_26_19_00.mpg;Shinzo ABE.jpg;16741;17101;23973;837;855;18
/net/per610a/home/mvp/mvp_db/news7-lv/2004/2004_09_27_19_00/2004_09_27_19_00.mpg;Taro ASO.jpg;6613;7241;35961;330;362;32
/net/per610a/home/mvp/mvp_db/news7-lv/2004/2004_09_27_19_00/2004_09_27_19_00.mpg;Nariaki Nakayama.png;17309;17361;35961;865;868;3
/net/per610a/home/mvp/mvp_db/news7-lv/2004/2004_09_27_19_00/2004_09_27_19_00.mpg;Shinzo ABE.jpg;25761;25829;35961;1288;1292;4
/net/per610a/home/mvp/mvp_db/news7-lv/2004/2004_09_27_19_00/2004_09_27_19_00.mpg;Shinzo ABE.jpg;34569;34685;35961;1729;1735;6
/net/per610a/home/mvp/mvp_db/news7-lv/2004/2004_09_27_19_00/2004_09_27_19_00.mpg;Junichiro KOIZUMI.jpg;34933;35041;35961;1747;1752;5
/net/per610a/home/mvp/mvp_db/news7-lv/2004/2004_09_29_19_00/2004_09_29_19_00.mpg;Kyoko Nakayama.jpg;845;865;35961;42;43;1
/net/per610a/home/mvp/mvp_db/news7-lv/2004/2004_09_29_19_00/2004_09_29_19_00.mpg;Kyoko Nakayama.jpg;13301;13633;35961;665;682;17
/net/per610a/home/mvp/mvp_db/news7-lv/2004/2004_09_29_19_00/2004_09_29_19_00.mpg;Kyoko Nakayama.jpg;13813;14185;35961;691;709;18
/net/per610a/home/mvp/mvp_db/news7-lv/2004/2004_09_29_19_00/2004_09_29_19_00.mpg;Junichiro KOIZUMI.jpg;14381;14385;35961;719;719;0
/net/per610a/home/mvp/mvp_db/news7-lv/2004/2004_09_29_19_00/2004_09_29_19_00.mpg;Junichiro KOIZUMI.jpg;16561;17333;35961;828;867;39
/net/per610a/home/mvp/mvp_db/news7-lv/2004/2004_09_29_19_00/2004_09_29_19_00.mpg;Shinzo ABE.jpg;15377;16477;35961;769;824;55
/net/per610a/home/mvp/mvp_db/news7-lv/2004/2004_10_01_19_00/2004_10_01_19_00.mpg;Junichiro KOIZUMI.jpg;25629;26281;35961;1282;1314;32
/net/per610a/home/mvp/mvp_db/news7-lv/2004/2004_10_02_19_00/2004_10_02_19_00.mpg;Junichiro KOIZUMI.jpg;15713;16565;35961;786;828;42
/net/per610a/home/mvp/mvp_db/news7-lv/2004/2004_10_04_19_00/2004_10_04_19_00.mpg;Junichiro KOIZUMI.jpg;15697;16865;35961;785;843;58
/net/per610a/home/mvp/mvp_db/news7-lv/2004/2004_10_07_19_00/2004_10_07_19_00.mpg;Junichiro KOIZUMI.jpg;17097;17497;35961;855;875;20
/net/per610a/home/mvp/mvp_db/news7-lv/2004/2004_10_07_19_00/2004_10_07_19_00.mpg;Junichiro KOIZUMI.jpg;18925;19353;35961;946;968;22
/net/per610a/home/mvp/mvp_db/news7-lv/2004/2004_10_12_19_00/2004_10_12_19_00.mpg;Junichiro KOIZUMI.jpg;14461;14813;35961;723;741;18
/net/per610a/home/mvp/mvp_db/news7-lv/2004/2004_10_12_19_00/2004_10_12_19_00.mpg;Junichiro KOIZUMI.jpg;15769;15825;35961;788;791;3
/net/per610a/home/mvp/mvp_db/news7-lv/2004/2004_10_12_19_00/2004_10_12_19_00.mpg;Junichiro KOIZUMI.jpg;16345;16449;35961;817;822;5
/net/per610a/home/mvp/mvp_db/news7-lv/2004/2004_10_12_19_00/2004_10_12_19_00.mpg;Junichiro KOIZUMI.jpg;18413;18481;35961;921;924;3
/net/per610a/home/mvp/mvp_db/news7-lv/2004/2004_10_12_19_00/2004_10_12_19_00.mpg;Junichiro KOIZUMI.jpg;18573;18637;35961;929;932;3
/net/per610a/home/mvp/mvp_db/news7-lv/2004/2004_10_12_19_00/2004_10_12_19_00.mpg;Junichiro KOIZUMI.jpg;26681;27125;35961;1334;1356;22
/net/per610a/home/mvp/mvp_db/news7-lv/2004/2004_10_12_19_00/2004_10_12_19_00.mpg;Kyoko Nakayama.jpg;30485;30749;35961;1525;1538;13
/net/per610a/home/mvp/mvp_db/news7-lv/2004/2004_10_13_19_00/2004_10_13_19_00.mpg;Junichiro KOIZUMI.jpg;21577;21709;35957;1079;1086;7
/net/per610a/home/mvp/mvp_db/news7-lv/2004/2004_10_13_19_00/2004_10_13_19_00.mpg;Katsuya OKADA.jpg;21789;21937;35957;1090;1097;7
/net/per610a/home/mvp/mvp_db/news7-lv/2004/2004_10_13_19_00/2004_10_13_19_00.mpg;Katsuya OKADA.jpg;22685;23553;35957;1134;1178;44
/net/per610a/home/mvp/mvp_db/news7-lv/2004/2004_10_13_19_00/2004_10_13_19_00.mpg;Katsuya OKADA.jpg;25217;25409;35957;1261;1271;10
/net/per610a/home/mvp/mvp_db/news7-lv/2004/2004_10_13_19_00/2004_10_13_19_00.mpg;Junichiro KOIZUMI.jpg;26069;26501;35957;1304;1325;21
/net/per610a/home/mvp/mvp_db/news7-lv/2004/2004_10_14_19_00/2004_10_14_19_00.mpg;Junichiro KOIZUMI.jpg;24653;25629;35961;1233;1282;49
/net/per610a/home/mvp/mvp_db/news7-lv/2004/2004_10_16_19_00/2004_10_16_19_00.mpg;Ichiro OZAWA.jpg;28741;29361;35961;1437;1468;31
/net/per610a/home/mvp/mvp_db/news7-lv/2004/2004_10_19_19_00/2004_10_19_19_00.mpg;Kenji Eda.jpg;26201;26417;35961;1310;1321;11
/net/per610a/home/mvp/mvp_db/news7-lv/2004/2004_10_21_19_00/2004_10_21_19_00.mpg;Akihiro OHTA.jpg;28517;28629;35961;1426;1432;6
/net/per610a/home/mvp/mvp_db/news7-lv/2004/2004_10_31_19_00/2004_10_31_19_00.mpg;Junichiro KOIZUMI.jpg;3357;3969;23973;167;198;31
/net/per610a/home/mvp/mvp_db/news7-lv/2004/2004_10_31_19_00/2004_10_31_19_00.mpg;Junichiro KOIZUMI.jpg;13145;13813;23973;657;690;33
/net/per610a/home/mvp/mvp_db/news7-lv/2004/2004_11_08_19_00/2004_11_08_19_00.mpg;Junichiro KOIZUMI.jpg;20081;20625;35961;1004;1031;27
/net/per610a/home/mvp/mvp_db/news7-lv/2004/2004_11_08_19_00/2004_11_08_19_00.mpg;Junichiro KOIZUMI.jpg;21377;21409;35961;1069;1071;2
/net/per610a/home/mvp/mvp_db/news7-lv/2004/2004_11_08_19_00/2004_11_08_19_00.mpg;Junichiro KOIZUMI.jpg;22265;22637;35961;1113;1132;19
/net/per610a/home/mvp/mvp_db/news7-lv/2004/2004_11_10_19_00/2004_11_10_19_00.mpg;Junichiro KOIZUMI.jpg;10077;10549;35961;504;527;23
/net/per610a/home/mvp/mvp_db/news7-lv/2004/2004_11_11_19_00/2004_11_11_19_00.mpg;Junichiro KOIZUMI.jpg;4669;5153;35961;233;257;24
/net/per610a/home/mvp/mvp_db/news7-lv/2004/2004_11_11_19_00/2004_11_11_19_00.mpg;Junichiro KOIZUMI.jpg;32421;32857;35961;1621;1643;22
/net/per610a/home/mvp/mvp_db/news7-lv/2004/2004_11_12_19_00/2004_11_12_19_00.mpg;Junichiro KOIZUMI.jpg;5925;6141;35961;296;307;11
/net/per610a/home/mvp/mvp_db/news7-lv/2004/2004_11_15_19_00/2004_11_15_19_00.mpg;Junichiro KOIZUMI.jpg;3141;3305;35961;157;165;8
/net/per610a/home/mvp/mvp_db/news7-lv/2004/2004_11_15_19_00/2004_11_15_19_00.mpg;Junichiro KOIZUMI.jpg;15009;15017;35961;750;751;1
/net/per610a/home/mvp/mvp_db/news7-lv/2004/2004_11_15_19_00/2004_11_15_19_00.mpg;Junichiro KOIZUMI.jpg;15317;15349;35961;766;767;1
/net/per610a/home/mvp/mvp_db/news7-lv/2004/2004_11_16_19_00/2004_11_16_19_00.mpg;Takeo Hiranuma.jpeg;14721;15001;35961;736;750;14
/net/per610a/home/mvp/mvp_db/news7-lv/2004/2004_11_16_19_00/2004_11_16_19_00.mpg;Junichiro KOIZUMI.jpg;17373;18217;35961;869;911;42
/net/per610a/home/mvp/mvp_db/news7-lv/2004/2004_11_17_19_00/2004_11_17_19_00.mpg;Kyoko Nakayama.jpg;877;1097;35961;43;54;11
/net/per610a/home/mvp/mvp_db/news7-lv/2004/2004_11_17_19_00/2004_11_17_19_00.mpg;Kyoko Nakayama.jpg;20525;21405;35961;1026;1070;44
/net/per610a/home/mvp/mvp_db/news7-lv/2004/2004_11_17_19_00/2004_11_17_19_00.mpg;Shinzo ABE.jpg;1105;1249;35961;55;62;7
/net/per610a/home/mvp/mvp_db/news7-lv/2004/2004_11_17_19_00/2004_11_17_19_00.mpg;Shinzo ABE.jpg;20217;20269;35961;1011;1013;2
/net/per610a/home/mvp/mvp_db/news7-lv/2004/2004_11_17_19_00/2004_11_17_19_00.mpg;Shinzo ABE.jpg;20493;20493;35961;1025;1025;0
/net/per610a/home/mvp/mvp_db/news7-lv/2004/2004_11_17_19_00/2004_11_17_19_00.mpg;Shinzo ABE.jpg;21485;22273;35961;1074;1114;40
/net/per610a/home/mvp/mvp_db/news7-lv/2004/2004_11_17_19_00/2004_11_17_19_00.mpg;Katsuya OKADA.jpg;18149;18253;35961;907;913;6
/net/per610a/home/mvp/mvp_db/news7-lv/2004/2004_11_17_19_00/2004_11_17_19_00.mpg;Katsuya OKADA.jpg;18373;18641;35961;919;932;13
/net/per610a/home/mvp/mvp_db/news7-lv/2004/2004_11_17_19_00/2004_11_17_19_00.mpg;Katsuya OKADA.jpg;18969;19213;35961;948;961;13
/net/per610a/home/mvp/mvp_db/news7-lv/2004/2004_11_18_19_00/2004_11_18_19_00.mpg;Taro ASO.jpg;24349;24573;35961;1218;1229;11
/net/per610a/home/mvp/mvp_db/news7-lv/2004/2004_11_18_19_00/2004_11_18_19_00.mpg;Junichiro KOIZUMI.jpg;25441;26725;35961;1272;1336;64
/net/per610a/home/mvp/mvp_db/news7-lv/2004/2004_11_19_19_00/2004_11_19_19_00.mpg;Takeo Hiranuma.jpeg;12397;12949;35961;620;647;27
/net/per610a/home/mvp/mvp_db/news7-lv/2004/2004_11_20_19_00/2004_11_20_19_00.mpg;Junichiro KOIZUMI.jpg;15413;15413;35961;771;771;0
/net/per610a/home/mvp/mvp_db/news7-lv/2004/2004_11_20_19_00/2004_11_20_19_00.mpg;Junichiro KOIZUMI.jpg;15549;15549;35961;777;777;0
/net/per610a/home/mvp/mvp_db/news7-lv/2004/2004_11_20_19_00/2004_11_20_19_00.mpg;Junichiro KOIZUMI.jpg;15673;15797;35961;784;790;6
/net/per610a/home/mvp/mvp_db/news7-lv/2004/2004_11_20_19_00/2004_11_20_19_00.mpg;Junichiro KOIZUMI.jpg;16101;16265;35961;805;813;8
/net/per610a/home/mvp/mvp_db/news7-lv/2004/2004_11_22_19_00/2004_11_22_19_00.mpg;Shintaro ISHIHARA.jpg;25445;25609;35961;1272;1281;9
/net/per610a/home/mvp/mvp_db/news7-lv/2004/2004_11_22_19_00/2004_11_22_19_00.mpg;Shintaro ISHIHARA.jpg;25809;26021;35961;1291;1301;10
/net/per610a/home/mvp/mvp_db/news7-lv/2004/2004_11_26_19_00/2004_11_26_19_00.mpg;Junichiro KOIZUMI.jpg;3409;3569;35961;170;178;8
/net/per610a/home/mvp/mvp_db/news7-lv/2004/2004_11_28_19_00/2004_11_28_19_00.mpg;Junichiro KOIZUMI.jpg;5677;7261;23973;283;363;80
/net/per610a/home/mvp/mvp_db/news7-lv/2004/2004_11_29_19_00/2004_11_29_19_00.mpg;Junichiro KOIZUMI.jpg;19537;20005;35961;977;1000;23
/net/per610a/home/mvp/mvp_db/news7-lv/2004/2004_12_01_19_00/2004_12_01_19_00.mpg;Taro ASO.jpg;27361;27537;35961;1368;1377;9
/net/per610a/home/mvp/mvp_db/news7-lv/2004/2004_12_01_19_00/2004_12_01_19_00.mpg;Taro ASO.jpg;27605;27861;35961;1380;1393;13
/net/per610a/home/mvp/mvp_db/news7-lv/2004/2004_12_01_19_00/2004_12_01_19_00.mpg;Shinzo ABE.jpg;29261;29413;35961;1463;1471;8
/net/per610a/home/mvp/mvp_db/news7-lv/2004/2004_12_05_19_00/2004_12_05_19_00.mpg;Junichiro KOIZUMI.jpg;23249;23341;23973;1162;1167;5
/net/per610a/home/mvp/mvp_db/news7-lv/2004/2004_12_06_19_00/2004_12_06_19_00.mpg;Junichiro KOIZUMI.jpg;20661;22173;35961;1033;1109;76
/net/per610a/home/mvp/mvp_db/news7-lv/2004/2004_12_07_19_00/2004_12_07_19_00.mpg;Nariaki Nakayama.png;24765;25041;35961;1238;1252;14
/net/per610a/home/mvp/mvp_db/news7-lv/2004/2004_12_08_19_00/2004_12_08_19_00.mpg;Junichiro KOIZUMI.jpg;34569;35705;35961;1729;1786;57
/net/per610a/home/mvp/mvp_db/news7-lv/2004/2004_12_09_19_00/2004_12_09_19_00.mpg;Takeo Hiranuma.jpeg;6957;7029;35961;348;351;3
/net/per610a/home/mvp/mvp_db/news7-lv/2004/2004_12_09_19_00/2004_12_09_19_00.mpg;Takeo Hiranuma.jpeg;7265;7773;35961;363;388;25
/net/per610a/home/mvp/mvp_db/news7-lv/2004/2004_12_12_19_00/2004_12_12_19_00.mpg;Nariaki Nakayama.png;4565;4673;23973;228;233;5
/net/per610a/home/mvp/mvp_db/news7-lv/2004/2004_12_13_19_00/2004_12_13_19_00.mpg;Sadakazu TANIGAKI.jpg;7989;8053;35957;399;402;3
/net/per610a/home/mvp/mvp_db/news7-lv/2004/2004_12_13_19_00/2004_12_13_19_00.mpg;Sadakazu TANIGAKI.jpg;8325;8369;35957;416;418;2
/net/per610a/home/mvp/mvp_db/news7-lv/2004/2004_12_13_19_00/2004_12_13_19_00.mpg;Junichiro KOIZUMI.jpg;8337;8369;35957;417;418;1
/net/per610a/home/mvp/mvp_db/news7-lv/2004/2004_12_13_19_00/2004_12_13_19_00.mpg;Junichiro KOIZUMI.jpg;9165;9849;35957;458;492;34
/net/per610a/home/mvp/mvp_db/news7-lv/2004/2004_12_13_19_00/2004_12_13_19_00.mpg;Junichiro KOIZUMI.jpg;21333;21873;35957;1067;1094;27
/net/per610a/home/mvp/mvp_db/news7-lv/2004/2004_12_13_19_00/2004_12_13_19_00.mpg;Yukio HATOYAMA.jpg;10077;10189;35957;504;509;5
/net/per610a/home/mvp/mvp_db/news7-lv/2004/2004_12_13_19_00/2004_12_13_19_00.mpg;Junichiro KOIZUMI.jpg;18069;18417;35957;904;921;17
/net/per610a/home/mvp/mvp_db/news7-lv/2004/2004_12_13_19_00/2004_12_13_19_00.mpg;Junichiro KOIZUMI.jpg;18889;18985;35957;945;949;4
/net/per610a/home/mvp/mvp_db/news7-lv/2004/2004_12_14_19_00/2004_12_14_19_00.mpg;Shintaro ISHIHARA.jpg;25469;25881;35961;1274;1294;20
/net/per610a/home/mvp/mvp_db/news7-lv/2004/2004_12_14_19_00/2004_12_14_19_00.mpg;Shintaro ISHIHARA.jpg;26465;26801;35961;1323;1340;17
/net/per610a/home/mvp/mvp_db/news7-lv/2004/2004_12_15_19_00/2004_12_15_19_00.mpg;Shinzo ABE.jpg;14753;15281;35961;738;764;26
/net/per610a/home/mvp/mvp_db/news7-lv/2004/2004_12_15_19_00/2004_12_15_19_00.mpg;Shinzo ABE.jpg;15781;16773;35961;789;839;50
/net/per610a/home/mvp/mvp_db/news7-lv/2004/2004_12_17_19_00/2004_12_17_19_00.mpg;Junichiro KOIZUMI.jpg;2597;4489;35961;129;224;95
/net/per610a/home/mvp/mvp_db/news7-lv/2004/2004_12_17_19_00/2004_12_17_19_00.mpg;Shintaro ISHIHARA.jpg;24301;24829;35961;1215;1242;27
/net/per610a/home/mvp/mvp_db/news7-lv/2004/2004_12_18_19_00/2004_12_18_19_00.mpg;Taro ASO.jpg;23173;23213;35961;1159;1161;2
/net/per610a/home/mvp/mvp_db/news7-lv/2004/2004_12_18_19_00/2004_12_18_19_00.mpg;Taro ASO.jpg;23441;23521;35961;1172;1176;4
/net/per610a/home/mvp/mvp_db/news7-lv/2004/2004_12_18_19_00/2004_12_18_19_00.mpg;Taro ASO.jpg;23693;23869;35961;1185;1194;9
/net/per610a/home/mvp/mvp_db/news7-lv/2004/2004_12_18_19_00/2004_12_18_19_00.mpg;Sadakazu TANIGAKI.jpg;24229;24309;35961;1212;1216;4
/net/per610a/home/mvp/mvp_db/news7-lv/2004/2004_12_18_19_00/2004_12_18_19_00.mpg;Sadakazu TANIGAKI.jpg;25245;25281;35961;1262;1264;2
/net/per610a/home/mvp/mvp_db/news7-lv/2004/2004_12_18_19_00/2004_12_18_19_00.mpg;Takenori KANZAKI.jpg;29509;29769;35961;1476;1489;13
/net/per610a/home/mvp/mvp_db/news7-lv/2004/2004_12_19_19_00/2004_12_19_19_00.mpg;Sadakazu TANIGAKI.jpg;8101;8173;23969;405;408;3
/net/per610a/home/mvp/mvp_db/news7-lv/2004/2004_12_19_19_00/2004_12_19_19_00.mpg;Sadakazu TANIGAKI.jpg;9629;10045;23969;481;502;21
/net/per610a/home/mvp/mvp_db/news7-lv/2004/2004_12_21_19_00/2004_12_21_19_00.mpg;Junichiro KOIZUMI.jpg;6757;7369;35961;338;368;30
/net/per610a/home/mvp/mvp_db/news7-lv/2004/2004_12_21_19_00/2004_12_21_19_00.mpg;Kenji Eda.jpg;14385;15137;35961;719;757;38
/net/per610a/home/mvp/mvp_db/news7-lv/2004/2004_12_24_19_00/2004_12_24_19_00.mpg;Junichiro KOIZUMI.jpg;11869;12525;35961;593;626;33
/net/per610a/home/mvp/mvp_db/news7-lv/2005/2005_01_01_19_00/2005_01_01_19_00.mpg;Junichiro KOIZUMI.jpg;13357;13785;23901;668;689;21
/net/per610a/home/mvp/mvp_db/news7-lv/2005/2005_01_01_19_00/2005_01_01_19_00.mpg;Junichiro KOIZUMI.jpg;14037;14297;23901;702;715;13
/net/per610a/home/mvp/mvp_db/news7-lv/2005/2005_01_01_19_00/2005_01_01_19_00.mpg;Takenori KANZAKI.jpg;14037;14301;23901;702;715;13
/net/per610a/home/mvp/mvp_db/news7-lv/2005/2005_01_01_19_00/2005_01_01_19_00.mpg;Kazuo SHII.jpg;15077;15301;23901;754;765;11
/net/per610a/home/mvp/mvp_db/news7-lv/2005/2005_01_02_19_00/2005_01_02_19_00.mpg;Junichiro KOIZUMI.jpg;16029;16085;23973;801;804;3
/net/per610a/home/mvp/mvp_db/news7-lv/2005/2005_01_04_19_00/2005_01_04_19_00.mpg;Junichiro KOIZUMI.jpg;21665;21781;35961;1083;1089;6
/net/per610a/home/mvp/mvp_db/news7-lv/2005/2005_01_04_19_00/2005_01_04_19_00.mpg;Katsuya OKADA.jpg;22785;23073;35961;1139;1154;15
/net/per610a/home/mvp/mvp_db/news7-lv/2005/2005_01_04_19_00/2005_01_04_19_00.mpg;Kazuo SHII.jpg;23617;24009;35961;1181;1201;20
/net/per610a/home/mvp/mvp_db/news7-lv/2005/2005_01_05_19_00/2005_01_05_19_00.mpg;Junichiro KOIZUMI.jpg;8789;9121;35961;439;456;17
/net/per610a/home/mvp/mvp_db/news7-lv/2005/2005_01_06_19_00/2005_01_06_19_00.mpg;Junichiro KOIZUMI.jpg;489;541;35961;24;27;3
/net/per610a/home/mvp/mvp_db/news7-lv/2005/2005_01_06_19_00/2005_01_06_19_00.mpg;Junichiro KOIZUMI.jpg;15069;15369;35961;753;768;15
/net/per610a/home/mvp/mvp_db/news7-lv/2005/2005_01_11_19_00/2005_01_11_19_00.mpg;Junichiro KOIZUMI.jpg;21573;21945;35961;1079;1097;18
/net/per610a/home/mvp/mvp_db/news7-lv/2005/2005_01_11_19_00/2005_01_11_19_00.mpg;Junichiro KOIZUMI.jpg;22213;22329;35961;1111;1117;6
/net/per610a/home/mvp/mvp_db/news7-lv/2005/2005_01_11_19_00/2005_01_11_19_00.mpg;Junichiro KOIZUMI.jpg;22737;22821;35961;1137;1141;4
/net/per610a/home/mvp/mvp_db/news7-lv/2005/2005_01_11_19_00/2005_01_11_19_00.mpg;Junichiro KOIZUMI.jpg;22993;23101;35961;1150;1155;5
/net/per610a/home/mvp/mvp_db/news7-lv/2005/2005_01_14_19_00/2005_01_14_19_00.mpg;Shinzo ABE.jpg;15857;16357;35961;793;818;25
/net/per610a/home/mvp/mvp_db/news7-lv/2005/2005_01_16_19_00/2005_01_16_19_00.mpg;Kyoko Nakayama.jpg;21813;23793;23973;1090;1189;99
/net/per610a/home/mvp/mvp_db/news7-lv/2005/2005_01_18_19_00/2005_01_18_19_00.mpg;Junichiro KOIZUMI.jpg;12677;13053;35961;634;652;18
/net/per610a/home/mvp/mvp_db/news7-lv/2005/2005_01_18_19_00/2005_01_18_19_00.mpg;Junichiro KOIZUMI.jpg;17253;17469;35961;863;873;10
/net/per610a/home/mvp/mvp_db/news7-lv/2005/2005_01_18_19_00/2005_01_18_19_00.mpg;Kyoko Nakayama.jpg;14745;15105;35961;737;755;18
/net/per610a/home/mvp/mvp_db/news7-lv/2005/2005_01_18_19_00/2005_01_18_19_00.mpg;Kyoko Nakayama.jpg;15221;15997;35961;761;800;39
/net/per610a/home/mvp/mvp_db/news7-lv/2005/2005_01_21_19_00/2005_01_21_19_00.mpg;Junichiro KOIZUMI.jpg;1837;2189;35961;91;109;18
/net/per610a/home/mvp/mvp_db/news7-lv/2005/2005_01_21_19_00/2005_01_21_19_00.mpg;Junichiro KOIZUMI.jpg;3265;3289;35961;163;164;1
/net/per610a/home/mvp/mvp_db/news7-lv/2005/2005_01_21_19_00/2005_01_21_19_00.mpg;Junichiro KOIZUMI.jpg;5193;5365;35961;259;268;9
/net/per610a/home/mvp/mvp_db/news7-lv/2005/2005_01_21_19_00/2005_01_21_19_00.mpg;Junichiro KOIZUMI.jpg;5429;6141;35961;271;307;36
/net/per610a/home/mvp/mvp_db/news7-lv/2005/2005_01_21_19_00/2005_01_21_19_00.mpg;Junichiro KOIZUMI.jpg;9889;9985;35961;494;499;5
/net/per610a/home/mvp/mvp_db/news7-lv/2005/2005_01_21_19_00/2005_01_21_19_00.mpg;Katsuya OKADA.jpg;4181;4897;35961;209;244;35
/net/per610a/home/mvp/mvp_db/news7-lv/2005/2005_01_21_19_00/2005_01_21_19_00.mpg;Junichiro KOIZUMI.jpg;4977;5013;35961;248;250;2
/net/per610a/home/mvp/mvp_db/news7-lv/2005/2005_01_21_19_00/2005_01_21_19_00.mpg;Junichiro KOIZUMI.jpg;10149;10233;35961;507;511;4
/net/per610a/home/mvp/mvp_db/news7-lv/2005/2005_01_24_19_00/2005_01_24_19_00.mpg;Junichiro KOIZUMI.jpg;15393;15533;35961;770;777;7
/net/per610a/home/mvp/mvp_db/news7-lv/2005/2005_01_24_19_00/2005_01_24_19_00.mpg;Junichiro KOIZUMI.jpg;16313;16557;35961;816;828;12
/net/per610a/home/mvp/mvp_db/news7-lv/2005/2005_01_24_19_00/2005_01_24_19_00.mpg;Junichiro KOIZUMI.jpg;16621;16657;35961;831;833;2
/net/per610a/home/mvp/mvp_db/news7-lv/2005/2005_01_24_19_00/2005_01_24_19_00.mpg;Junichiro KOIZUMI.jpg;17609;17813;35961;880;891;11
/net/per610a/home/mvp/mvp_db/news7-lv/2005/2005_01_25_19_00/2005_01_25_19_00.mpg;Junichiro KOIZUMI.jpg;4293;5017;35961;214;250;36
/net/per610a/home/mvp/mvp_db/news7-lv/2005/2005_01_25_19_00/2005_01_25_19_00.mpg;Junichiro KOIZUMI.jpg;11301;11497;35961;565;575;10
/net/per610a/home/mvp/mvp_db/news7-lv/2005/2005_01_25_19_00/2005_01_25_19_00.mpg;Junichiro KOIZUMI.jpg;25145;25361;35961;1257;1268;11
/net/per610a/home/mvp/mvp_db/news7-lv/2005/2005_01_25_19_00/2005_01_25_19_00.mpg;Junichiro KOIZUMI.jpg;13521;13865;35961;676;693;17
/net/per610a/home/mvp/mvp_db/news7-lv/2005/2005_01_28_19_00/2005_01_28_19_00.mpg;Shinzo ABE.jpg;19937;20333;35961;997;1017;20
/net/per610a/home/mvp/mvp_db/news7-lv/2005/2005_02_01_19_00/2005_02_01_19_00.mpg;Shinzo ABE.jpg;24417;24657;35961;1221;1233;12
/net/per610a/home/mvp/mvp_db/news7-lv/2005/2005_02_02_19_00/2005_02_02_19_00.mpg;Junichiro KOIZUMI.jpg;24041;24629;35961;1202;1232;30
/net/per610a/home/mvp/mvp_db/news7-lv/2005/2005_02_02_19_00/2005_02_02_19_00.mpg;Junichiro KOIZUMI.jpg;25749;25889;35961;1288;1295;7
/net/per610a/home/mvp/mvp_db/news7-lv/2005/2005_02_02_19_00/2005_02_02_19_00.mpg;Junichiro KOIZUMI.jpg;26013;26505;35961;1301;1325;24
/net/per610a/home/mvp/mvp_db/news7-lv/2005/2005_02_03_19_00/2005_02_03_19_00.mpg;Junichiro KOIZUMI.jpg;21957;22021;35957;1098;1101;3
/net/per610a/home/mvp/mvp_db/news7-lv/2005/2005_02_03_19_00/2005_02_03_19_00.mpg;Junichiro KOIZUMI.jpg;22133;22133;35957;1107;1107;0
/net/per610a/home/mvp/mvp_db/news7-lv/2005/2005_02_03_19_00/2005_02_03_19_00.mpg;Junichiro KOIZUMI.jpg;22221;22273;35957;1111;1114;3
/net/per610a/home/mvp/mvp_db/news7-lv/2005/2005_02_03_19_00/2005_02_03_19_00.mpg;Junichiro KOIZUMI.jpg;22705;23129;35957;1135;1157;22
/net/per610a/home/mvp/mvp_db/news7-lv/2005/2005_02_04_19_00/2005_02_04_19_00.mpg;Sadakazu TANIGAKI.jpg;14757;15361;35961;738;768;30
/net/per610a/home/mvp/mvp_db/news7-lv/2005/2005_02_08_19_00/2005_02_08_19_00.mpg;Nariaki Nakayama.png;11765;13465;35961;588;673;85
/net/per610a/home/mvp/mvp_db/news7-lv/2005/2005_02_09_19_00/2005_02_09_19_00.mpg;Junichiro KOIZUMI.jpg;3733;4069;35961;186;203;17
/net/per610a/home/mvp/mvp_db/news7-lv/2005/2005_02_10_19_00/2005_02_10_19_00.mpg;Junichiro KOIZUMI.jpg;881;1153;35957;44;57;13
/net/per610a/home/mvp/mvp_db/news7-lv/2005/2005_02_10_19_00/2005_02_10_19_00.mpg;Taro ASO.jpg;21593;22169;35957;1080;1109;29
/net/per610a/home/mvp/mvp_db/news7-lv/2005/2005_02_11_19_00/2005_02_11_19_00.mpg;Junichiro KOIZUMI.jpg;23029;23745;35961;1152;1187;35
/net/per610a/home/mvp/mvp_db/news7-lv/2005/2005_02_12_19_00/2005_02_12_19_00.mpg;Katsuya OKADA.jpg;5537;5537;35961;276;276;0
/net/per610a/home/mvp/mvp_db/news7-lv/2005/2005_02_12_19_00/2005_02_12_19_00.mpg;Katsuya OKADA.jpg;8629;9821;35961;431;491;60
/net/per610a/home/mvp/mvp_db/news7-lv/2005/2005_02_13_19_00/2005_02_13_19_00.mpg;Shinzo ABE.jpg;19361;20025;23973;968;1001;33
/net/per610a/home/mvp/mvp_db/news7-lv/2005/2005_02_14_19_00/2005_02_14_19_00.mpg;Junichiro KOIZUMI.jpg;20805;20989;35961;1040;1050;10
/net/per610a/home/mvp/mvp_db/news7-lv/2005/2005_02_14_19_00/2005_02_14_19_00.mpg;Junichiro KOIZUMI.jpg;22765;23485;35961;1138;1174;36
/net/per610a/home/mvp/mvp_db/news7-lv/2005/2005_02_15_19_00/2005_02_15_19_00.mpg;Shinzo ABE.jpg;28873;29045;35961;1444;1453;9
/net/per610a/home/mvp/mvp_db/news7-lv/2005/2005_02_17_19_00/2005_02_17_19_00.mpg;Junichiro KOIZUMI.jpg;10793;11293;35961;539;564;25
/net/per610a/home/mvp/mvp_db/news7-lv/2005/2005_02_22_19_00/2005_02_22_19_00.mpg;Taro ASO.jpg;6325;7057;35961;316;353;37
/net/per610a/home/mvp/mvp_db/news7-lv/2005/2005_02_24_19_00/2005_02_24_19_00.mpg;Junichiro KOIZUMI.jpg;18165;18589;35961;908;929;21
/net/per610a/home/mvp/mvp_db/news7-lv/2005/2005_02_26_19_00/2005_02_26_19_00.mpg;YUriko Koike.jpg;25801;26037;35957;1290;1302;12
/net/per610a/home/mvp/mvp_db/news7-lv/2005/2005_03_03_19_00/2005_03_03_19_00.mpg;Junichiro KOIZUMI.jpg;22293;23465;35961;1115;1173;58
/net/per610a/home/mvp/mvp_db/news7-lv/2005/2005_03_04_19_00/2005_03_04_19_00.mpg;Junichiro KOIZUMI.jpg;22381;22941;35961;1119;1147;28
/net/per610a/home/mvp/mvp_db/news7-lv/2005/2005_03_04_19_00/2005_03_04_19_00.mpg;Junichiro KOIZUMI.jpg;23249;23729;35961;1163;1187;24
/net/per610a/home/mvp/mvp_db/news7-lv/2005/2005_03_07_19_00/2005_03_07_19_00.mpg;Junichiro KOIZUMI.jpg;28705;28749;35961;1436;1438;2
/net/per610a/home/mvp/mvp_db/news7-lv/2005/2005_03_07_19_00/2005_03_07_19_00.mpg;Junichiro KOIZUMI.jpg;28833;28881;35961;1442;1444;2
/net/per610a/home/mvp/mvp_db/news7-lv/2005/2005_03_09_19_00/2005_03_09_19_00.mpg;Junichiro KOIZUMI.jpg;29601;30241;35961;1480;1512;32
/net/per610a/home/mvp/mvp_db/news7-lv/2005/2005_03_10_19_00/2005_03_10_19_00.mpg;Junichiro KOIZUMI.jpg;19017;19237;35961;951;962;11
/net/per610a/home/mvp/mvp_db/news7-lv/2005/2005_03_10_19_00/2005_03_10_19_00.mpg;Junichiro KOIZUMI.jpg;27277;27617;35961;1364;1381;17
/net/per610a/home/mvp/mvp_db/news7-lv/2005/2005_03_10_19_00/2005_03_10_19_00.mpg;Junichiro KOIZUMI.jpg;27681;28105;35961;1384;1405;21
/net/per610a/home/mvp/mvp_db/news7-lv/2005/2005_03_15_19_00/2005_03_15_19_00.mpg;Taro ASO.jpg;23837;23921;35961;1192;1196;4
/net/per610a/home/mvp/mvp_db/news7-lv/2005/2005_03_16_19_00/2005_03_16_19_00.mpg;Junichiro KOIZUMI.jpg;23333;24093;35961;1167;1205;38
/net/per610a/home/mvp/mvp_db/news7-lv/2005/2005_03_17_19_00/2005_03_17_19_00.mpg;Junichiro KOIZUMI.jpg;8997;9613;35961;450;480;30
/net/per610a/home/mvp/mvp_db/news7-lv/2005/2005_03_17_19_00/2005_03_17_19_00.mpg;Yukio EDANO.jpg;9873;9981;35961;493;499;6
/net/per610a/home/mvp/mvp_db/news7-lv/2005/2005_03_23_19_00/2005_03_23_19_00.mpg;Junichiro KOIZUMI.jpg;905;1093;35961;45;54;9
/net/per610a/home/mvp/mvp_db/news7-lv/2005/2005_03_23_19_00/2005_03_23_19_00.mpg;Junichiro KOIZUMI.jpg;13405;14333;35961;670;717;47
/net/per610a/home/mvp/mvp_db/news7-lv/2005/2005_03_27_19_00/2005_03_27_19_00.mpg;Junichiro KOIZUMI.jpg;19289;19613;23973;964;980;16
/net/per610a/home/mvp/mvp_db/news7-lv/2005/2005_03_27_19_00/2005_03_27_19_00.mpg;Junichiro KOIZUMI.jpg;19833;19921;23973;991;996;5
/net/per610a/home/mvp/mvp_db/news7-lv/2005/2005_03_31_19_00/2005_03_31_19_00.mpg;Junichiro KOIZUMI.jpg;18397;19033;35961;920;952;32
/net/per610a/home/mvp/mvp_db/news7-lv/2005/2005_03_31_19_00/2005_03_31_19_00.mpg;Taro ASO.jpg;22441;22473;35961;1122;1124;2
/net/per610a/home/mvp/mvp_db/news7-lv/2005/2005_03_31_19_00/2005_03_31_19_00.mpg;Taro ASO.jpg;24133;24133;35961;1207;1207;0
/net/per610a/home/mvp/mvp_db/news7-lv/2005/2005_03_31_19_00/2005_03_31_19_00.mpg;Taro ASO.jpg;25193;25237;35961;1260;1262;2
/net/per610a/home/mvp/mvp_db/news7-lv/2005/2005_04_01_19_00/2005_04_01_19_00.mpg;Junichiro KOIZUMI.jpg;16965;17385;35961;848;869;21
/net/per610a/home/mvp/mvp_db/news7-lv/2005/2005_04_04_19_00/2005_04_04_19_00.mpg;Junichiro KOIZUMI.jpg;301;417;35961;15;20;5
/net/per610a/home/mvp/mvp_db/news7-lv/2005/2005_04_04_19_00/2005_04_04_19_00.mpg;Junichiro KOIZUMI.jpg;4161;4505;35961;208;225;17
/net/per610a/home/mvp/mvp_db/news7-lv/2005/2005_04_04_19_00/2005_04_04_19_00.mpg;Junichiro KOIZUMI.jpg;10721;11137;35961;536;557;21
/net/per610a/home/mvp/mvp_db/news7-lv/2005/2005_04_04_19_00/2005_04_04_19_00.mpg;Junichiro KOIZUMI.jpg;4509;4877;35961;225;243;18
/net/per610a/home/mvp/mvp_db/news7-lv/2005/2005_04_04_19_00/2005_04_04_19_00.mpg;Junichiro KOIZUMI.jpg;8997;9073;35961;450;453;3
/net/per610a/home/mvp/mvp_db/news7-lv/2005/2005_04_05_19_00/2005_04_05_19_00.mpg;Nariaki Nakayama.png;11881;13221;35961;594;661;67
/net/per610a/home/mvp/mvp_db/news7-lv/2005/2005_04_06_19_00/2005_04_06_19_00.mpg;Junichiro KOIZUMI.jpg;20597;20909;35961;1030;1046;16
/net/per610a/home/mvp/mvp_db/news7-lv/2005/2005_04_07_19_00/2005_04_07_19_00.mpg;Junichiro KOIZUMI.jpg;2749;2997;35957;137;149;12
/net/per610a/home/mvp/mvp_db/news7-lv/2005/2005_04_07_19_00/2005_04_07_19_00.mpg;Junichiro KOIZUMI.jpg;22649;23269;35957;1133;1164;31
/net/per610a/home/mvp/mvp_db/news7-lv/2005/2005_04_08_19_00/2005_04_08_19_00.mpg;Junichiro KOIZUMI.jpg;17469;18289;35961;873;914;41
/net/per610a/home/mvp/mvp_db/news7-lv/2005/2005_04_09_19_00/2005_04_09_19_00.mpg;Junichiro KOIZUMI.jpg;933;961;35961;46;48;2
/net/per610a/home/mvp/mvp_db/news7-lv/2005/2005_04_09_19_00/2005_04_09_19_00.mpg;Junichiro KOIZUMI.jpg;21809;22041;35961;1091;1102;11
/net/per610a/home/mvp/mvp_db/news7-lv/2005/2005_04_11_19_00/2005_04_11_19_00.mpg;Junichiro KOIZUMI.jpg;20221;20501;35961;1011;1025;14
/net/per610a/home/mvp/mvp_db/news7-lv/2005/2005_04_12_19_00/2005_04_12_19_00.mpg;Junichiro KOIZUMI.jpg;497;661;35961;24;33;9
/net/per610a/home/mvp/mvp_db/news7-lv/2005/2005_04_12_19_00/2005_04_12_19_00.mpg;Junichiro KOIZUMI.jpg;4065;4941;35961;203;247;44
/net/per610a/home/mvp/mvp_db/news7-lv/2005/2005_04_13_19_00/2005_04_13_19_00.mpg;Junichiro KOIZUMI.jpg;22025;22413;35961;1101;1121;20
/net/per610a/home/mvp/mvp_db/news7-lv/2005/2005_04_18_19_00/2005_04_18_19_00.mpg;Junichiro KOIZUMI.jpg;9853;10061;35957;492;503;11
/net/per610a/home/mvp/mvp_db/news7-lv/2005/2005_04_18_19_00/2005_04_18_19_00.mpg;Junichiro KOIZUMI.jpg;11537;12721;35957;577;636;59
/net/per610a/home/mvp/mvp_db/news7-lv/2005/2005_04_19_19_00/2005_04_19_19_00.mpg;Katsuya OKADA.jpg;8345;8469;35961;417;423;6
/net/per610a/home/mvp/mvp_db/news7-lv/2005/2005_04_21_19_00/2005_04_21_19_00.mpg;Junichiro KOIZUMI.jpg;18637;19061;35961;932;953;21
/net/per610a/home/mvp/mvp_db/news7-lv/2005/2005_04_22_19_00/2005_04_22_19_00.mpg;Junichiro KOIZUMI.jpg;241;289;35961;12;14;2
/net/per610a/home/mvp/mvp_db/news7-lv/2005/2005_04_22_19_00/2005_04_22_19_00.mpg;Junichiro KOIZUMI.jpg;3073;3177;35961;153;158;5
/net/per610a/home/mvp/mvp_db/news7-lv/2005/2005_04_22_19_00/2005_04_22_19_00.mpg;Junichiro KOIZUMI.jpg;3429;3657;35961;171;182;11
/net/per610a/home/mvp/mvp_db/news7-lv/2005/2005_04_22_19_00/2005_04_22_19_00.mpg;Junichiro KOIZUMI.jpg;4257;4341;35961;212;217;5
/net/per610a/home/mvp/mvp_db/news7-lv/2005/2005_04_22_19_00/2005_04_22_19_00.mpg;Junichiro KOIZUMI.jpg;4713;4897;35961;235;244;9
/net/per610a/home/mvp/mvp_db/news7-lv/2005/2005_04_22_19_00/2005_04_22_19_00.mpg;Junichiro KOIZUMI.jpg;4985;5193;35961;249;259;10
/net/per610a/home/mvp/mvp_db/news7-lv/2005/2005_04_23_19_00/2005_04_23_19_00.mpg;Junichiro KOIZUMI.jpg;4989;5033;35961;249;251;2
/net/per610a/home/mvp/mvp_db/news7-lv/2005/2005_04_23_19_00/2005_04_23_19_00.mpg;Junichiro KOIZUMI.jpg;5529;6349;35961;276;317;41
/net/per610a/home/mvp/mvp_db/news7-lv/2005/2005_04_23_19_00/2005_04_23_19_00.mpg;Junichiro KOIZUMI.jpg;6865;6877;35961;343;344;1
/net/per610a/home/mvp/mvp_db/news7-lv/2005/2005_04_24_19_00/2005_04_24_19_00.mpg;Junichiro KOIZUMI.jpg;3549;3569;23973;177;178;1
/net/per610a/home/mvp/mvp_db/news7-lv/2005/2005_04_24_19_00/2005_04_24_19_00.mpg;Junichiro KOIZUMI.jpg;4801;5317;23973;240;265;25
/net/per610a/home/mvp/mvp_db/news7-lv/2005/2005_04_25_19_00/2005_04_25_19_00.mpg;Junichiro KOIZUMI.jpg;34485;35241;35961;1725;1762;37
/net/per610a/home/mvp/mvp_db/news7-lv/2005/2005_04_27_19_00/2005_04_27_19_00.mpg;Junichiro KOIZUMI.jpg;22625;22705;35961;1131;1135;4
/net/per610a/home/mvp/mvp_db/news7-lv/2005/2005_04_27_19_00/2005_04_27_19_00.mpg;Shizuka KAMEI.jpg;22921;22973;35961;1146;1149;3
/net/per610a/home/mvp/mvp_db/news7-lv/2005/2005_04_27_19_00/2005_04_27_19_00.mpg;Shizuka KAMEI.jpg;23161;23229;35961;1158;1162;4
/net/per610a/home/mvp/mvp_db/news7-lv/2005/2005_05_10_19_00/2005_05_10_19_00.mpg;Junichiro KOIZUMI.jpg;21733;21829;35961;1087;1092;5
/net/per610a/home/mvp/mvp_db/news7-lv/2005/2005_05_10_19_00/2005_05_10_19_00.mpg;Junichiro KOIZUMI.jpg;22085;22881;35961;1104;1144;40
/net/per610a/home/mvp/mvp_db/news7-lv/2005/2005_05_12_19_00/2005_05_12_19_00.mpg;Junichiro KOIZUMI.jpg;12593;13153;35961;629;657;28
/net/per610a/home/mvp/mvp_db/news7-lv/2005/2005_05_12_19_00/2005_05_12_19_00.mpg;Shizuka KAMEI.jpg;24801;25137;35961;1240;1257;17
/net/per610a/home/mvp/mvp_db/news7-lv/2005/2005_05_12_19_00/2005_05_12_19_00.mpg;Shizuka KAMEI.jpg;25273;25365;35961;1264;1268;4
/net/per610a/home/mvp/mvp_db/news7-lv/2005/2005_05_13_19_00/2005_05_13_19_00.mpg;Junichiro KOIZUMI.jpg;15477;16013;35961;774;801;27
/net/per610a/home/mvp/mvp_db/news7-lv/2005/2005_05_16_19_00/2005_05_16_19_00.mpg;Junichiro KOIZUMI.jpg;765;1017;35961;38;50;12
/net/per610a/home/mvp/mvp_db/news7-lv/2005/2005_05_16_19_00/2005_05_16_19_00.mpg;Junichiro KOIZUMI.jpg;11561;12025;35961;578;601;23
/net/per610a/home/mvp/mvp_db/news7-lv/2005/2005_05_16_19_00/2005_05_16_19_00.mpg;Junichiro KOIZUMI.jpg;21245;22141;35961;1062;1107;45
/net/per610a/home/mvp/mvp_db/news7-lv/2005/2005_05_23_19_00/2005_05_23_19_00.mpg;Shinzo ABE.jpg;5345;5581;35957;267;279;12
/net/per610a/home/mvp/mvp_db/news7-lv/2005/2005_05_23_19_00/2005_05_23_19_00.mpg;Junichiro KOIZUMI.jpg;9241;9241;35957;462;462;0
/net/per610a/home/mvp/mvp_db/news7-lv/2005/2005_05_23_19_00/2005_05_23_19_00.mpg;Junichiro KOIZUMI.jpg;11029;11033;35957;551;552;1
/net/per610a/home/mvp/mvp_db/news7-lv/2005/2005_05_23_19_00/2005_05_23_19_00.mpg;Junichiro KOIZUMI.jpg;11649;11717;35957;582;586;4
/net/per610a/home/mvp/mvp_db/news7-lv/2005/2005_05_24_19_00/2005_05_24_19_00.mpg;Junichiro KOIZUMI.jpg;6381;7253;35961;319;362;43
/net/per610a/home/mvp/mvp_db/news7-lv/2005/2005_05_25_19_00/2005_05_25_19_00.mpg;Junichiro KOIZUMI.jpg;19941;20065;35957;997;1003;6
/net/per610a/home/mvp/mvp_db/news7-lv/2005/2005_05_25_19_00/2005_05_25_19_00.mpg;Junichiro KOIZUMI.jpg;20561;20609;35957;1028;1031;3
/net/per610a/home/mvp/mvp_db/news7-lv/2005/2005_05_25_19_00/2005_05_25_19_00.mpg;YUriko Koike.jpg;29889;30193;35957;1495;1510;15
/net/per610a/home/mvp/mvp_db/news7-lv/2005/2005_05_26_19_00/2005_05_26_19_00.mpg;Junichiro KOIZUMI.jpg;7061;7413;35961;353;370;17
/net/per610a/home/mvp/mvp_db/news7-lv/2005/2005_05_26_19_00/2005_05_26_19_00.mpg;Junichiro KOIZUMI.jpg;10117;10457;35961;506;523;17
/net/per610a/home/mvp/mvp_db/news7-lv/2005/2005_05_26_19_00/2005_05_26_19_00.mpg;Junichiro KOIZUMI.jpg;11693;11897;35961;584;595;11
/net/per610a/home/mvp/mvp_db/news7-lv/2005/2005_05_26_19_00/2005_05_26_19_00.mpg;Junichiro KOIZUMI.jpg;19921;19961;35961;996;998;2
/net/per610a/home/mvp/mvp_db/news7-lv/2005/2005_05_26_19_00/2005_05_26_19_00.mpg;Junichiro KOIZUMI.jpg;7417;7513;35961;371;375;4
/net/per610a/home/mvp/mvp_db/news7-lv/2005/2005_05_26_19_00/2005_05_26_19_00.mpg;Junichiro KOIZUMI.jpg;16941;17261;35961;847;863;16
/net/per610a/home/mvp/mvp_db/news7-lv/2005/2005_05_26_19_00/2005_05_26_19_00.mpg;Natsuo YAMAGUCHI.jpg;8541;8837;35961;427;442;15
/net/per610a/home/mvp/mvp_db/news7-lv/2005/2005_05_27_19_00/2005_05_27_19_00.mpg;Shintaro ISHIHARA.jpg;901;1001;35961;45;50;5
/net/per610a/home/mvp/mvp_db/news7-lv/2005/2005_05_27_19_00/2005_05_27_19_00.mpg;Shintaro ISHIHARA.jpg;15969;16501;35961;798;825;27
/net/per610a/home/mvp/mvp_db/news7-lv/2005/2005_05_27_19_00/2005_05_27_19_00.mpg;Shintaro ISHIHARA.jpg;21165;21557;35961;1058;1078;20
/net/per610a/home/mvp/mvp_db/news7-lv/2005/2005_05_27_19_00/2005_05_27_19_00.mpg;Shintaro ISHIHARA.jpg;24329;24369;35961;1217;1219;2
/net/per610a/home/mvp/mvp_db/news7-lv/2005/2005_05_27_19_00/2005_05_27_19_00.mpg;Shintaro ISHIHARA.jpg;24829;25905;35961;1242;1295;53
/net/per610a/home/mvp/mvp_db/news7-lv/2005/2005_05_27_19_00/2005_05_27_19_00.mpg;Junichiro KOIZUMI.jpg;7701;8461;35961;385;423;38
/net/per610a/home/mvp/mvp_db/news7-lv/2005/2005_05_28_19_00/2005_05_28_19_00.mpg;Junichiro KOIZUMI.jpg;5105;5597;35961;255;279;24
/net/per610a/home/mvp/mvp_db/news7-lv/2005/2005_05_28_19_00/2005_05_28_19_00.mpg;Shinzo ABE.jpg;22421;24049;35961;1121;1203;82
/net/per610a/home/mvp/mvp_db/news7-lv/2005/2005_05_30_19_00/2005_05_30_19_00.mpg;Junichiro KOIZUMI.jpg;3297;3749;35961;164;187;23
/net/per610a/home/mvp/mvp_db/news7-lv/2005/2005_05_30_19_00/2005_05_30_19_00.mpg;Junichiro KOIZUMI.jpg;4361;4513;35961;218;225;7
/net/per610a/home/mvp/mvp_db/news7-lv/2005/2005_05_30_19_00/2005_05_30_19_00.mpg;Junichiro KOIZUMI.jpg;28893;28945;35961;1445;1448;3
/net/per610a/home/mvp/mvp_db/news7-lv/2005/2005_05_31_19_00/2005_05_31_19_00.mpg;Nariaki Nakayama.png;17157;17653;35961;858;883;25
/net/per610a/home/mvp/mvp_db/news7-lv/2005/2005_06_02_19_00/2005_06_02_19_00.mpg;Junichiro KOIZUMI.jpg;17841;18717;35961;892;936;44
/net/per610a/home/mvp/mvp_db/news7-lv/2005/2005_06_02_19_00/2005_06_02_19_00.mpg;Junichiro KOIZUMI.jpg;19121;19701;35961;956;985;29
/net/per610a/home/mvp/mvp_db/news7-lv/2005/2005_06_03_19_00/2005_06_03_19_00.mpg;Junichiro KOIZUMI.jpg;21329;21841;35961;1067;1092;25
/net/per610a/home/mvp/mvp_db/news7-lv/2005/2005_06_03_19_00/2005_06_03_19_00.mpg;Junichiro KOIZUMI.jpg;23217;23993;35961;1161;1200;39
/net/per610a/home/mvp/mvp_db/news7-lv/2005/2005_06_03_19_00/2005_06_03_19_00.mpg;Junichiro KOIZUMI.jpg;24181;24353;35961;1209;1218;9
/net/per610a/home/mvp/mvp_db/news7-lv/2005/2005_06_03_19_00/2005_06_03_19_00.mpg;Junichiro KOIZUMI.jpg;24461;24609;35961;1223;1231;8
/net/per610a/home/mvp/mvp_db/news7-lv/2005/2005_06_03_19_00/2005_06_03_19_00.mpg;Shintaro ISHIHARA.jpg;25909;26217;35961;1296;1311;15
/net/per610a/home/mvp/mvp_db/news7-lv/2005/2005_06_07_19_00/2005_06_07_19_00.mpg;Junichiro KOIZUMI.jpg;153;169;35961;7;8;1
/net/per610a/home/mvp/mvp_db/news7-lv/2005/2005_06_07_19_00/2005_06_07_19_00.mpg;Junichiro KOIZUMI.jpg;3669;4421;35961;183;221;38
/net/per610a/home/mvp/mvp_db/news7-lv/2005/2005_06_07_19_00/2005_06_07_19_00.mpg;Junichiro KOIZUMI.jpg;5729;6789;35961;286;339;53
/net/per610a/home/mvp/mvp_db/news7-lv/2005/2005_06_07_19_00/2005_06_07_19_00.mpg;Shinzo ABE.jpg;5285;5581;35961;264;279;15
/net/per610a/home/mvp/mvp_db/news7-lv/2005/2005_06_09_19_00/2005_06_09_19_00.mpg;Junichiro KOIZUMI.jpg;19065;19165;35961;953;958;5
/net/per610a/home/mvp/mvp_db/news7-lv/2005/2005_06_10_19_00/2005_06_10_19_00.mpg;YUriko Koike.jpg;22949;23869;35961;1148;1194;46
/net/per610a/home/mvp/mvp_db/news7-lv/2005/2005_06_11_19_00/2005_06_11_19_00.mpg;Junichiro KOIZUMI.jpg;12041;12149;35957;602;607;5
/net/per610a/home/mvp/mvp_db/news7-lv/2005/2005_06_13_19_00/2005_06_13_19_00.mpg;Junichiro KOIZUMI.jpg;11853;11937;35961;592;597;5
/net/per610a/home/mvp/mvp_db/news7-lv/2005/2005_06_13_19_00/2005_06_13_19_00.mpg;Junichiro KOIZUMI.jpg;21525;21597;35961;1076;1080;4
/net/per610a/home/mvp/mvp_db/news7-lv/2005/2005_06_13_19_00/2005_06_13_19_00.mpg;Junichiro KOIZUMI.jpg;22569;22817;35961;1129;1141;12
/net/per610a/home/mvp/mvp_db/news7-lv/2005/2005_06_15_19_00/2005_06_15_19_00.mpg;Junichiro KOIZUMI.jpg;14409;15049;35961;720;752;32
/net/per610a/home/mvp/mvp_db/news7-lv/2005/2005_06_17_19_00/2005_06_17_19_00.mpg;Katsuya OKADA.jpg;2717;2881;35961;135;144;9
/net/per610a/home/mvp/mvp_db/news7-lv/2005/2005_06_17_19_00/2005_06_17_19_00.mpg;Katsuya OKADA.jpg;4421;4477;35961;221;223;2
/net/per610a/home/mvp/mvp_db/news7-lv/2005/2005_06_18_19_00/2005_06_18_19_00.mpg;Shinzo ABE.jpg;12293;13317;35961;614;666;52
/net/per610a/home/mvp/mvp_db/news7-lv/2005/2005_06_18_19_00/2005_06_18_19_00.mpg;Shinzo ABE.jpg;13457;13929;35961;673;696;23
/net/per610a/home/mvp/mvp_db/news7-lv/2005/2005_06_19_19_00/2005_06_19_19_00.mpg;Junichiro KOIZUMI.jpg;22661;23273;23973;1133;1163;30
/net/per610a/home/mvp/mvp_db/news7-lv/2005/2005_06_21_19_00/2005_06_21_19_00.mpg;Junichiro KOIZUMI.jpg;10413;10609;35961;520;530;10
/net/per610a/home/mvp/mvp_db/news7-lv/2005/2005_06_21_19_00/2005_06_21_19_00.mpg;Junichiro KOIZUMI.jpg;12889;13485;35961;644;674;30
/net/per610a/home/mvp/mvp_db/news7-lv/2005/2005_06_22_19_00/2005_06_22_19_00.mpg;Takenori KANZAKI.jpg;17749;18457;35961;887;923;36
/net/per610a/home/mvp/mvp_db/news7-lv/2005/2005_06_22_19_00/2005_06_22_19_00.mpg;Shinzo ABE.jpg;18689;19261;35961;934;963;29
/net/per610a/home/mvp/mvp_db/news7-lv/2005/2005_06_22_19_00/2005_06_22_19_00.mpg;Shinzo ABE.jpg;19357;19601;35961;968;980;12
/net/per610a/home/mvp/mvp_db/news7-lv/2005/2005_06_24_19_00/2005_06_24_19_00.mpg;Takenori KANZAKI.jpg;3793;6573;35961;189;328;139
/net/per610a/home/mvp/mvp_db/news7-lv/2005/2005_06_24_19_00/2005_06_24_19_00.mpg;Junichiro KOIZUMI.jpg;7341;7897;35961;367;395;28
/net/per610a/home/mvp/mvp_db/news7-lv/2005/2005_06_24_19_00/2005_06_24_19_00.mpg;Junichiro KOIZUMI.jpg;11425;12361;35961;571;618;47
/net/per610a/home/mvp/mvp_db/news7-lv/2005/2005_06_26_19_00/2005_06_26_19_00.mpg;Shinzo ABE.jpg;10709;11629;23973;535;581;46
/net/per610a/home/mvp/mvp_db/news7-lv/2005/2005_06_27_19_00/2005_06_27_19_00.mpg;Toranosuke Katayama.jpg;12485;12689;35961;624;634;10
/net/per610a/home/mvp/mvp_db/news7-lv/2005/2005_06_27_19_00/2005_06_27_19_00.mpg;Shizuka KAMEI.jpg;13701;13793;35961;685;690;5
/net/per610a/home/mvp/mvp_db/news7-lv/2005/2005_06_27_19_00/2005_06_27_19_00.mpg;Junichiro KOIZUMI.jpg;14421;15273;35961;721;764;43
/net/per610a/home/mvp/mvp_db/news7-lv/2005/2005_06_28_19_00/2005_06_28_19_00.mpg;Nariaki Nakayama.png;28797;29217;35961;1440;1461;21
/net/per610a/home/mvp/mvp_db/news7-lv/2005/2005_07_01_19_00/2005_07_01_19_00.mpg;Nariaki Nakayama.png;14713;15069;35961;736;753;17
/net/per610a/home/mvp/mvp_db/news7-lv/2005/2005_07_01_19_00/2005_07_01_19_00.mpg;Junichiro KOIZUMI.jpg;18513;19141;35961;926;957;31
/net/per610a/home/mvp/mvp_db/news7-lv/2005/2005_07_04_19_00/2005_07_04_19_00.mpg;Katsuya OKADA.jpg;5169;5693;35961;258;284;26
/net/per610a/home/mvp/mvp_db/news7-lv/2005/2005_07_04_19_00/2005_07_04_19_00.mpg;Katsuya OKADA.jpg;7753;8177;35961;387;409;22
/net/per610a/home/mvp/mvp_db/news7-lv/2005/2005_07_05_19_00/2005_07_05_19_00.mpg;Junichiro KOIZUMI.jpg;561;665;35961;28;33;5
/net/per610a/home/mvp/mvp_db/news7-lv/2005/2005_07_05_19_00/2005_07_05_19_00.mpg;Junichiro KOIZUMI.jpg;8013;9105;35961;400;455;55
/net/per610a/home/mvp/mvp_db/news7-lv/2005/2005_07_05_19_00/2005_07_05_19_00.mpg;Junichiro KOIZUMI.jpg;12193;12265;35961;609;613;4
/net/per610a/home/mvp/mvp_db/news7-lv/2005/2005_07_05_19_00/2005_07_05_19_00.mpg;Shizuka KAMEI.jpg;2325;2417;35961;116;120;4
/net/per610a/home/mvp/mvp_db/news7-lv/2005/2005_07_05_19_00/2005_07_05_19_00.mpg;Takeo Hiranuma.jpeg;2421;2469;35961;121;123;2
/net/per610a/home/mvp/mvp_db/news7-lv/2005/2005_07_05_19_00/2005_07_05_19_00.mpg;Takeo Hiranuma.jpeg;13329;13913;35961;666;696;30
/net/per610a/home/mvp/mvp_db/news7-lv/2005/2005_07_05_19_00/2005_07_05_19_00.mpg;Takeo Hiranuma.jpeg;13997;14061;35961;700;703;3
/net/per610a/home/mvp/mvp_db/news7-lv/2005/2005_07_05_19_00/2005_07_05_19_00.mpg;Ichiro OZAWA.jpg;5001;5085;35961;250;254;4
/net/per610a/home/mvp/mvp_db/news7-lv/2005/2005_07_05_19_00/2005_07_05_19_00.mpg;Taro ASO.jpg;12277;12385;35961;614;619;5
/net/per610a/home/mvp/mvp_db/news7-lv/2005/2005_07_06_19_00/2005_07_06_19_00.mpg;Katsuya OKADA.jpg;5421;5741;35961;271;287;16
/net/per610a/home/mvp/mvp_db/news7-lv/2005/2005_07_08_19_00/2005_07_08_19_00.mpg;Junichiro KOIZUMI.jpg;18857;19097;35961;943;955;12
/net/per610a/home/mvp/mvp_db/news7-lv/2005/2005_07_08_19_00/2005_07_08_19_00.mpg;Junichiro KOIZUMI.jpg;19881;19893;35961;994;995;1
/net/per610a/home/mvp/mvp_db/news7-lv/2005/2005_07_08_19_00/2005_07_08_19_00.mpg;Junichiro KOIZUMI.jpg;21505;21613;35961;1075;1081;6
/net/per610a/home/mvp/mvp_db/news7-lv/2005/2005_07_11_19_00/2005_07_11_19_00.mpg;Katsuya OKADA.jpg;19453;20117;35961;973;1006;33
/net/per610a/home/mvp/mvp_db/news7-lv/2005/2005_07_12_19_00/2005_07_12_19_00.mpg;Junichiro KOIZUMI.jpg;993;1033;35961;49;51;2
/net/per610a/home/mvp/mvp_db/news7-lv/2005/2005_07_12_19_00/2005_07_12_19_00.mpg;Junichiro KOIZUMI.jpg;16385;16445;35961;819;822;3
/net/per610a/home/mvp/mvp_db/news7-lv/2005/2005_07_12_19_00/2005_07_12_19_00.mpg;Junichiro KOIZUMI.jpg;16705;17057;35961;835;853;18
/net/per610a/home/mvp/mvp_db/news7-lv/2005/2005_07_13_19_00/2005_07_13_19_00.mpg;Natsuo YAMAGUCHI.jpg;12417;12501;35961;621;625;4
/net/per610a/home/mvp/mvp_db/news7-lv/2005/2005_07_13_19_00/2005_07_13_19_00.mpg;Junichiro KOIZUMI.jpg;25889;26765;35961;1295;1338;43
/net/per610a/home/mvp/mvp_db/news7-lv/2005/2005_07_15_19_00/2005_07_15_19_00.mpg;Junichiro KOIZUMI.jpg;16333;16801;35961;817;840;23
/net/per610a/home/mvp/mvp_db/news7-lv/2005/2005_07_15_19_00/2005_07_15_19_00.mpg;Junichiro KOIZUMI.jpg;17293;17861;35961;865;893;28
/net/per610a/home/mvp/mvp_db/news7-lv/2005/2005_07_15_19_00/2005_07_15_19_00.mpg;Junichiro KOIZUMI.jpg;18033;18701;35961;902;935;33
/net/per610a/home/mvp/mvp_db/news7-lv/2005/2005_07_15_19_00/2005_07_15_19_00.mpg;Junichiro KOIZUMI.jpg;19069;19425;35961;953;971;18
/net/per610a/home/mvp/mvp_db/news7-lv/2005/2005_07_15_19_00/2005_07_15_19_00.mpg;Junichiro KOIZUMI.jpg;22813;23525;35961;1141;1176;35
/net/per610a/home/mvp/mvp_db/news7-lv/2005/2005_07_19_19_00/2005_07_19_19_00.mpg;Toranosuke Katayama.jpg;12405;13461;35961;620;673;53
/net/per610a/home/mvp/mvp_db/news7-lv/2005/2005_07_19_19_00/2005_07_19_19_00.mpg;Sadakazu TANIGAKI.jpg;28089;28221;35961;1405;1411;6
/net/per610a/home/mvp/mvp_db/news7-lv/2005/2005_07_19_19_00/2005_07_19_19_00.mpg;Sadakazu TANIGAKI.jpg;28685;28981;35961;1435;1449;14
/net/per610a/home/mvp/mvp_db/news7-lv/2005/2005_07_20_19_00/2005_07_20_19_00.mpg;Junichiro KOIZUMI.jpg;15305;15797;35961;765;790;25
/net/per610a/home/mvp/mvp_db/news7-lv/2005/2005_07_24_19_00/2005_07_24_19_00.mpg;Natsuo YAMAGUCHI.jpg;409;629;23973;20;31;11
/net/per610a/home/mvp/mvp_db/news7-lv/2005/2005_07_24_19_00/2005_07_24_19_00.mpg;Natsuo YAMAGUCHI.jpg;5441;5777;23973;272;288;16
/net/per610a/home/mvp/mvp_db/news7-lv/2005/2005_07_24_19_00/2005_07_24_19_00.mpg;Natsuo YAMAGUCHI.jpg;6065;6601;23973;303;330;27
/net/per610a/home/mvp/mvp_db/news7-lv/2005/2005_07_27_19_00/2005_07_27_19_00.mpg;Takenori KANZAKI.jpg;25329;25981;35961;1267;1299;32
/net/per610a/home/mvp/mvp_db/news7-lv/2005/2005_07_27_19_00/2005_07_27_19_00.mpg;Takenori KANZAKI.jpg;26929;28025;35961;1347;1401;54
/net/per610a/home/mvp/mvp_db/news7-lv/2005/2005_07_28_19_00/2005_07_28_19_00.mpg;Junichiro KOIZUMI.jpg;16993;17817;35961;850;891;41
/net/per610a/home/mvp/mvp_db/news7-lv/2005/2005_07_29_19_00/2005_07_29_19_00.mpg;Toranosuke Katayama.jpg;22409;23277;35961;1121;1164;43
/net/per610a/home/mvp/mvp_db/news7-lv/2005/2005_07_29_19_00/2005_07_29_19_00.mpg;Junichiro KOIZUMI.jpg;23905;24493;35961;1195;1225;30
/net/per610a/home/mvp/mvp_db/news7-lv/2005/2005_08_01_19_00/2005_08_01_19_00.mpg;Junichiro KOIZUMI.jpg;13501;13517;35961;675;676;1
/net/per610a/home/mvp/mvp_db/news7-lv/2005/2005_08_01_19_00/2005_08_01_19_00.mpg;Junichiro KOIZUMI.jpg;13621;13757;35961;681;688;7
/net/per610a/home/mvp/mvp_db/news7-lv/2005/2005_08_01_19_00/2005_08_01_19_00.mpg;Junichiro KOIZUMI.jpg;14981;15749;35961;749;787;38
/net/per610a/home/mvp/mvp_db/news7-lv/2005/2005_08_01_19_00/2005_08_01_19_00.mpg;Katsuya OKADA.jpg;15833;16309;35961;792;815;23
/net/per610a/home/mvp/mvp_db/news7-lv/2005/2005_08_02_19_00/2005_08_02_19_00.mpg;Toranosuke Katayama.jpg;8921;9621;35961;446;481;35
/net/per610a/home/mvp/mvp_db/news7-lv/2005/2005_08_02_19_00/2005_08_02_19_00.mpg;Katsuya OKADA.jpg;11461;12093;35961;573;604;31
/net/per610a/home/mvp/mvp_db/news7-lv/2005/2005_08_02_19_00/2005_08_02_19_00.mpg;Takeo Hiranuma.jpeg;25321;25789;35961;1266;1290;24
/net/per610a/home/mvp/mvp_db/news7-lv/2005/2005_08_03_19_00/2005_08_03_19_00.mpg;Junichiro KOIZUMI.jpg;129;349;35961;6;17;11
/net/per610a/home/mvp/mvp_db/news7-lv/2005/2005_08_03_19_00/2005_08_03_19_00.mpg;Junichiro KOIZUMI.jpg;6605;7321;35961;330;366;36
/net/per610a/home/mvp/mvp_db/news7-lv/2005/2005_08_03_19_00/2005_08_03_19_00.mpg;Shinzo ABE.jpg;3361;3477;35961;168;173;5
/net/per610a/home/mvp/mvp_db/news7-lv/2005/2005_08_04_19_00/2005_08_04_19_00.mpg;Katsuya OKADA.jpg;8481;9209;35961;424;460;36
/net/per610a/home/mvp/mvp_db/news7-lv/2005/2005_08_05_19_00/2005_08_05_19_00.mpg;Junichiro KOIZUMI.jpg;3029;3081;35961;151;154;3
/net/per610a/home/mvp/mvp_db/news7-lv/2005/2005_08_05_19_00/2005_08_05_19_00.mpg;Junichiro KOIZUMI.jpg;11177;12193;35961;559;609;50
/net/per610a/home/mvp/mvp_db/news7-lv/2005/2005_08_05_19_00/2005_08_05_19_00.mpg;Toranosuke Katayama.jpg;6205;6689;35961;310;334;24
/net/per610a/home/mvp/mvp_db/news7-lv/2005/2005_08_05_19_00/2005_08_05_19_00.mpg;Toranosuke Katayama.jpg;13009;13813;35961;650;691;41
/net/per610a/home/mvp/mvp_db/news7-lv/2005/2005_08_05_19_00/2005_08_05_19_00.mpg;Shintaro ISHIHARA.jpg;30877;30877;35961;1544;1544;0
/net/per610a/home/mvp/mvp_db/news7-lv/2005/2005_08_05_19_00/2005_08_05_19_00.mpg;Shintaro ISHIHARA.jpg;31077;31273;35961;1554;1564;10
/net/per610a/home/mvp/mvp_db/news7-lv/2005/2005_08_06_19_00/2005_08_06_19_00.mpg;Junichiro KOIZUMI.jpg;309;437;35957;15;21;6
/net/per610a/home/mvp/mvp_db/news7-lv/2005/2005_08_06_19_00/2005_08_06_19_00.mpg;Junichiro KOIZUMI.jpg;1761;3117;35957;88;155;67
/net/per610a/home/mvp/mvp_db/news7-lv/2005/2005_08_06_19_00/2005_08_06_19_00.mpg;Junichiro KOIZUMI.jpg;4609;4697;35957;230;235;5
/net/per610a/home/mvp/mvp_db/news7-lv/2005/2005_08_06_19_00/2005_08_06_19_00.mpg;Junichiro KOIZUMI.jpg;5477;5497;35957;274;275;1
/net/per610a/home/mvp/mvp_db/news7-lv/2005/2005_08_06_19_00/2005_08_06_19_00.mpg;Katsuya OKADA.jpg;4701;5473;35957;235;273;38
/net/per610a/home/mvp/mvp_db/news7-lv/2005/2005_08_08_19_00/2005_08_08_19_00.mpg;Junichiro KOIZUMI.jpg;5489;5517;35961;274;275;1
/net/per610a/home/mvp/mvp_db/news7-lv/2005/2005_08_08_19_00/2005_08_08_19_00.mpg;Junichiro KOIZUMI.jpg;9373;9393;35961;468;469;1
/net/per610a/home/mvp/mvp_db/news7-lv/2005/2005_08_08_19_00/2005_08_08_19_00.mpg;Junichiro KOIZUMI.jpg;9517;9581;35961;476;479;3
/net/per610a/home/mvp/mvp_db/news7-lv/2005/2005_08_08_19_00/2005_08_08_19_00.mpg;Junichiro KOIZUMI.jpg;13701;13917;35961;685;696;11
/net/per610a/home/mvp/mvp_db/news7-lv/2005/2005_08_08_19_00/2005_08_08_19_00.mpg;Junichiro KOIZUMI.jpg;34361;34377;35961;1718;1719;1
/net/per610a/home/mvp/mvp_db/news7-lv/2005/2005_08_08_19_00/2005_08_08_19_00.mpg;Taro ASO.jpg;12097;12157;35961;605;608;3
/net/per610a/home/mvp/mvp_db/news7-lv/2005/2005_08_08_19_00/2005_08_08_19_00.mpg;Taro ASO.jpg;32373;32433;35961;1619;1622;3
/net/per610a/home/mvp/mvp_db/news7-lv/2005/2005_08_08_19_00/2005_08_08_19_00.mpg;Toranosuke Katayama.jpg;15385;15645;35961;769;782;13
/net/per610a/home/mvp/mvp_db/news7-lv/2005/2005_08_08_19_00/2005_08_08_19_00.mpg;Kazuo SHII.jpg;29741;31137;35961;1487;1557;70
/net/per610a/home/mvp/mvp_db/news7-lv/2005/2005_08_09_19_00/2005_08_09_19_00.mpg;Junichiro KOIZUMI.jpg;2297;2389;35961;114;119;5
/net/per610a/home/mvp/mvp_db/news7-lv/2005/2005_08_09_19_00/2005_08_09_19_00.mpg;Katsuya OKADA.jpg;6089;8773;35961;304;438;134
/net/per610a/home/mvp/mvp_db/news7-lv/2005/2005_08_10_19_00/2005_08_10_19_00.mpg;Shizuka KAMEI.jpg;361;485;35961;18;24;6
/net/per610a/home/mvp/mvp_db/news7-lv/2005/2005_08_10_19_00/2005_08_10_19_00.mpg;Junichiro KOIZUMI.jpg;7317;7961;35961;366;398;32
/net/per610a/home/mvp/mvp_db/news7-lv/2005/2005_08_11_19_00/2005_08_11_19_00.mpg;Junichiro KOIZUMI.jpg;4953;5021;35961;247;251;4
/net/per610a/home/mvp/mvp_db/news7-lv/2005/2005_08_11_19_00/2005_08_11_19_00.mpg;Junichiro KOIZUMI.jpg;9461;10501;35961;473;525;52
/net/per610a/home/mvp/mvp_db/news7-lv/2005/2005_08_11_19_00/2005_08_11_19_00.mpg;Katsuya OKADA.jpg;5801;6397;35961;290;320;30
/net/per610a/home/mvp/mvp_db/news7-lv/2005/2005_08_11_19_00/2005_08_11_19_00.mpg;Junichiro KOIZUMI.jpg;13813;13937;35961;691;697;6
/net/per610a/home/mvp/mvp_db/news7-lv/2005/2005_08_12_19_00/2005_08_12_19_00.mpg;Junichiro KOIZUMI.jpg;5881;6725;35961;294;336;42
/net/per610a/home/mvp/mvp_db/news7-lv/2005/2005_08_12_19_00/2005_08_12_19_00.mpg;Junichiro KOIZUMI.jpg;10773;11265;35961;538;563;25
/net/per610a/home/mvp/mvp_db/news7-lv/2005/2005_08_12_19_00/2005_08_12_19_00.mpg;Nariaki Nakayama.png;12341;12429;35961;617;621;4
/net/per610a/home/mvp/mvp_db/news7-lv/2005/2005_08_13_19_00/2005_08_13_19_00.mpg;Katsuya OKADA.jpg;16389;18429;35961;819;921;102
/net/per610a/home/mvp/mvp_db/news7-lv/2005/2005_08_14_19_00/2005_08_14_19_00.mpg;Junichiro KOIZUMI.jpg;65;165;23973;3;8;5
/net/per610a/home/mvp/mvp_db/news7-lv/2005/2005_08_14_19_00/2005_08_14_19_00.mpg;Junichiro KOIZUMI.jpg;12377;12513;23973;619;625;6
/net/per610a/home/mvp/mvp_db/news7-lv/2005/2005_08_15_19_00/2005_08_15_19_00.mpg;Junichiro KOIZUMI.jpg;10901;11197;35961;545;560;15
/net/per610a/home/mvp/mvp_db/news7-lv/2005/2005_08_15_19_00/2005_08_15_19_00.mpg;Junichiro KOIZUMI.jpg;15037;15849;35961;752;792;40
/net/per610a/home/mvp/mvp_db/news7-lv/2005/2005_08_15_19_00/2005_08_15_19_00.mpg;Katsuya OKADA.jpg;18369;20129;35961;918;1006;88
/net/per610a/home/mvp/mvp_db/news7-lv/2005/2005_08_17_19_00/2005_08_17_19_00.mpg;Takeo Hiranuma.jpeg;4657;5697;35961;232;285;53
/net/per610a/home/mvp/mvp_db/news7-lv/2005/2005_08_17_19_00/2005_08_17_19_00.mpg;Katsuya OKADA.jpg;7369;8237;35961;368;412;44
/net/per610a/home/mvp/mvp_db/news7-lv/2005/2005_08_17_19_00/2005_08_17_19_00.mpg;Takenori KANZAKI.jpg;8389;9849;35961;419;492;73
/net/per610a/home/mvp/mvp_db/news7-lv/2005/2005_08_18_19_00/2005_08_18_19_00.mpg;Junichiro KOIZUMI.jpg;3009;3941;35961;150;197;47
/net/per610a/home/mvp/mvp_db/news7-lv/2005/2005_08_19_19_00/2005_08_19_19_00.mpg;Junichiro KOIZUMI.jpg;12401;13165;35961;620;658;38
/net/per610a/home/mvp/mvp_db/news7-lv/2005/2005_08_19_19_00/2005_08_19_19_00.mpg;Junichiro KOIZUMI.jpg;13269;13573;35961;663;679;16
/net/per610a/home/mvp/mvp_db/news7-lv/2005/2005_08_20_19_00/2005_08_20_19_00.mpg;Junichiro KOIZUMI.jpg;1669;1909;35961;83;95;12
/net/per610a/home/mvp/mvp_db/news7-lv/2005/2005_08_20_19_00/2005_08_20_19_00.mpg;Takeo Hiranuma.jpeg;4005;5877;35961;200;294;94
/net/per610a/home/mvp/mvp_db/news7-lv/2005/2005_08_20_19_00/2005_08_20_19_00.mpg;Shizuka KAMEI.jpg;6141;6737;35961;307;337;30
/net/per610a/home/mvp/mvp_db/news7-lv/2005/2005_08_21_19_00/2005_08_21_19_00.mpg;Junichiro KOIZUMI.jpg;7261;9409;23973;363;470;107
/net/per610a/home/mvp/mvp_db/news7-lv/2005/2005_08_21_19_00/2005_08_21_19_00.mpg;Katsuya OKADA.jpg;9697;11037;23973;484;552;68
/net/per610a/home/mvp/mvp_db/news7-lv/2005/2005_08_21_19_00/2005_08_21_19_00.mpg;Kazuo SHII.jpg;11045;13177;23973;552;659;107
/net/per610a/home/mvp/mvp_db/news7-lv/2005/2005_08_23_19_00/2005_08_23_19_00.mpg;Kazuo SHII.jpg;649;669;35957;32;33;1
/net/per610a/home/mvp/mvp_db/news7-lv/2005/2005_08_23_19_00/2005_08_23_19_00.mpg;Kazuo SHII.jpg;10549;14009;35957;527;700;173
/net/per610a/home/mvp/mvp_db/news7-lv/2005/2005_08_26_19_00/2005_08_26_19_00.mpg;Ichiro OZAWA.jpg;16217;19781;35961;811;989;178
/net/per610a/home/mvp/mvp_db/news7-lv/2005/2005_08_28_19_00/2005_08_28_19_00.mpg;Ichiro OZAWA.jpg;4613;4957;23973;230;247;17
/net/per610a/home/mvp/mvp_db/news7-lv/2005/2005_08_29_19_00/2005_08_29_19_00.mpg;Junichiro KOIZUMI.jpg;89;125;35961;4;6;2
/net/per610a/home/mvp/mvp_db/news7-lv/2005/2005_08_29_19_00/2005_08_29_19_00.mpg;Junichiro KOIZUMI.jpg;2101;3697;35961;105;184;79
/net/per610a/home/mvp/mvp_db/news7-lv/2005/2005_08_29_19_00/2005_08_29_19_00.mpg;Kazuo SHII.jpg;209;245;35961;10;12;2
/net/per610a/home/mvp/mvp_db/news7-lv/2005/2005_08_29_19_00/2005_08_29_19_00.mpg;Kazuo SHII.jpg;5517;6189;35961;275;309;34
/net/per610a/home/mvp/mvp_db/news7-lv/2005/2005_08_30_19_00/2005_08_30_19_00.mpg;YUriko Koike.jpg;12269;12729;35961;613;636;23
/net/per610a/home/mvp/mvp_db/news7-lv/2005/2005_08_30_19_00/2005_08_30_19_00.mpg;Junichiro KOIZUMI.jpg;26441;35957;35961;1322;1798;476
/net/per610a/home/mvp/mvp_db/news7-lv/2005/2005_08_31_19_00/2005_08_31_19_00.mpg;Junichiro KOIZUMI.jpg;7177;10673;35961;359;533;174
/net/per610a/home/mvp/mvp_db/news7-lv/2005/2005_09_02_19_00/2005_09_02_19_00.mpg;Junichiro KOIZUMI.jpg;18321;18477;35961;916;924;8
/net/per610a/home/mvp/mvp_db/news7-lv/2005/2005_09_02_19_00/2005_09_02_19_00.mpg;Junichiro KOIZUMI.jpg;18661;18757;35961;933;938;5
/net/per610a/home/mvp/mvp_db/news7-lv/2005/2005_09_03_19_00/2005_09_03_19_00.mpg;Junichiro KOIZUMI.jpg;881;1157;35961;44;57;13
/net/per610a/home/mvp/mvp_db/news7-lv/2005/2005_09_03_19_00/2005_09_03_19_00.mpg;Junichiro KOIZUMI.jpg;17661;19181;35961;883;959;76
/net/per610a/home/mvp/mvp_db/news7-lv/2005/2005_09_04_19_00/2005_09_04_19_00.mpg;Kenji Eda.jpg;12165;12565;23973;608;628;20
/net/per610a/home/mvp/mvp_db/news7-lv/2005/2005_09_04_19_00/2005_09_04_19_00.mpg;Kenji Eda.jpg;13089;13397;23973;654;670;16
/net/per610a/home/mvp/mvp_db/news7-lv/2005/2005_09_09_19_00/2005_09_09_19_00.mpg;Junichiro KOIZUMI.jpg;73;349;35961;3;17;14
/net/per610a/home/mvp/mvp_db/news7-lv/2005/2005_09_09_19_00/2005_09_09_19_00.mpg;Junichiro KOIZUMI.jpg;2049;2265;35961;102;113;11
/net/per610a/home/mvp/mvp_db/news7-lv/2005/2005_09_10_19_00/2005_09_10_19_00.mpg;Kazuo SHII.jpg;237;445;35961;11;22;11
/net/per610a/home/mvp/mvp_db/news7-lv/2005/2005_09_10_19_00/2005_09_10_19_00.mpg;Kazuo SHII.jpg;5549;6913;35961;277;345;68
/net/per610a/home/mvp/mvp_db/news7-lv/2005/2005_09_10_19_00/2005_09_10_19_00.mpg;Junichiro KOIZUMI.jpg;2101;2309;35961;105;115;10
/net/per610a/home/mvp/mvp_db/news7-lv/2005/2005_09_12_19_00/2005_09_12_19_00.mpg;Junichiro KOIZUMI.jpg;137;349;35961;6;17;11
/net/per610a/home/mvp/mvp_db/news7-lv/2005/2005_09_12_19_00/2005_09_12_19_00.mpg;Junichiro KOIZUMI.jpg;1793;3033;35961;89;151;62
/net/per610a/home/mvp/mvp_db/news7-lv/2005/2005_09_12_19_00/2005_09_12_19_00.mpg;Junichiro KOIZUMI.jpg;3185;4333;35961;159;216;57
/net/per610a/home/mvp/mvp_db/news7-lv/2005/2005_09_12_19_00/2005_09_12_19_00.mpg;Junichiro KOIZUMI.jpg;4629;4881;35961;231;244;13
/net/per610a/home/mvp/mvp_db/news7-lv/2005/2005_09_12_19_00/2005_09_12_19_00.mpg;Junichiro KOIZUMI.jpg;8329;8909;35961;416;445;29
/net/per610a/home/mvp/mvp_db/news7-lv/2005/2005_09_12_19_00/2005_09_12_19_00.mpg;Junichiro KOIZUMI.jpg;5437;5505;35961;271;275;4
/net/per610a/home/mvp/mvp_db/news7-lv/2005/2005_09_12_19_00/2005_09_12_19_00.mpg;Junichiro KOIZUMI.jpg;5913;5953;35961;295;297;2
/net/per610a/home/mvp/mvp_db/news7-lv/2005/2005_09_12_19_00/2005_09_12_19_00.mpg;Junichiro KOIZUMI.jpg;14977;15021;35961;749;751;2
/net/per610a/home/mvp/mvp_db/news7-lv/2005/2005_09_12_19_00/2005_09_12_19_00.mpg;Junichiro KOIZUMI.jpg;15597;15661;35961;780;783;3
/net/per610a/home/mvp/mvp_db/news7-lv/2005/2005_09_12_19_00/2005_09_12_19_00.mpg;Junichiro KOIZUMI.jpg;16029;16089;35961;801;804;3
/net/per610a/home/mvp/mvp_db/news7-lv/2005/2005_09_12_19_00/2005_09_12_19_00.mpg;Junichiro KOIZUMI.jpg;16697;16749;35961;835;837;2
/net/per610a/home/mvp/mvp_db/news7-lv/2005/2005_09_12_19_00/2005_09_12_19_00.mpg;Junichiro KOIZUMI.jpg;18865;19109;35961;943;955;12
/net/per610a/home/mvp/mvp_db/news7-lv/2005/2005_09_12_19_00/2005_09_12_19_00.mpg;Takenori KANZAKI.jpg;5557;5681;35961;277;284;7
/net/per610a/home/mvp/mvp_db/news7-lv/2005/2005_09_12_19_00/2005_09_12_19_00.mpg;Takenori KANZAKI.jpg;5849;5877;35961;292;294;2
/net/per610a/home/mvp/mvp_db/news7-lv/2005/2005_09_12_19_00/2005_09_12_19_00.mpg;Takenori KANZAKI.jpg;5957;6013;35961;298;300;2
/net/per610a/home/mvp/mvp_db/news7-lv/2005/2005_09_12_19_00/2005_09_12_19_00.mpg;Yoshihiko Noda.jpg;13697;13825;35961;685;691;6
/net/per610a/home/mvp/mvp_db/news7-lv/2005/2005_09_13_19_00/2005_09_13_19_00.mpg;Junichiro KOIZUMI.jpg;3649;3965;35961;182;198;16
/net/per610a/home/mvp/mvp_db/news7-lv/2005/2005_09_13_19_00/2005_09_13_19_00.mpg;Junichiro KOIZUMI.jpg;6225;7709;35961;311;385;74
/net/per610a/home/mvp/mvp_db/news7-lv/2005/2005_09_13_19_00/2005_09_13_19_00.mpg;Junichiro KOIZUMI.jpg;4353;4545;35961;217;227;10
/net/per610a/home/mvp/mvp_db/news7-lv/2005/2005_09_13_19_00/2005_09_13_19_00.mpg;YUriko Koike.jpg;4625;6169;35961;231;308;77
/net/per610a/home/mvp/mvp_db/news7-lv/2005/2005_09_13_19_00/2005_09_13_19_00.mpg;Yukio HATOYAMA.jpg;9017;9329;35961;451;466;15
/net/per610a/home/mvp/mvp_db/news7-lv/2005/2005_09_15_19_00/2005_09_15_19_00.mpg;Seiji MAEHARA.jpg;133;257;35961;6;12;6
/net/per610a/home/mvp/mvp_db/news7-lv/2005/2005_09_15_19_00/2005_09_15_19_00.mpg;Seiji MAEHARA.jpg;5053;5997;35961;252;300;48
/net/per610a/home/mvp/mvp_db/news7-lv/2005/2005_09_15_19_00/2005_09_15_19_00.mpg;Naoto KAN.jpg;265;389;35961;13;19;6
/net/per610a/home/mvp/mvp_db/news7-lv/2005/2005_09_15_19_00/2005_09_15_19_00.mpg;Ichiro OZAWA.jpg;6581;6945;35961;329;347;18
/net/per610a/home/mvp/mvp_db/news7-lv/2005/2005_09_17_19_00/2005_09_17_19_00.mpg;Yukio HATOYAMA.jpg;3829;4177;35961;191;208;17
/net/per610a/home/mvp/mvp_db/news7-lv/2005/2005_09_17_19_00/2005_09_17_19_00.mpg;Seiji MAEHARA.jpg;6525;6697;35961;326;335;9
/net/per610a/home/mvp/mvp_db/news7-lv/2005/2005_09_17_19_00/2005_09_17_19_00.mpg;Seiji MAEHARA.jpg;34861;35077;35961;1743;1754;11
/net/per610a/home/mvp/mvp_db/news7-lv/2005/2005_09_18_19_00/2005_09_18_19_00.mpg;Seiji MAEHARA.jpg;1733;1813;23973;86;90;4
/net/per610a/home/mvp/mvp_db/news7-lv/2005/2005_09_18_19_00/2005_09_18_19_00.mpg;Seiji MAEHARA.jpg;2989;3005;23973;149;150;1
/net/per610a/home/mvp/mvp_db/news7-lv/2005/2005_09_18_19_00/2005_09_18_19_00.mpg;Seiji MAEHARA.jpg;6641;7073;23973;332;353;21
/net/per610a/home/mvp/mvp_db/news7-lv/2005/2005_09_18_19_00/2005_09_18_19_00.mpg;Seiji MAEHARA.jpg;3093;3157;23973;154;157;3
/net/per610a/home/mvp/mvp_db/news7-lv/2005/2005_09_19_19_00/2005_09_19_19_00.mpg;Ichiro OZAWA.jpg;18637;19573;35961;932;979;47
/net/per610a/home/mvp/mvp_db/news7-lv/2005/2005_09_20_19_00/2005_09_20_19_00.mpg;Yukio HATOYAMA.jpg;11553;11665;35961;577;583;6
/net/per610a/home/mvp/mvp_db/news7-lv/2005/2005_09_20_19_00/2005_09_20_19_00.mpg;Junichiro KOIZUMI.jpg;14721;14801;35961;736;740;4
/net/per610a/home/mvp/mvp_db/news7-lv/2005/2005_09_20_19_00/2005_09_20_19_00.mpg;Naoto KAN.jpg;28893;29329;35961;1445;1467;22
/net/per610a/home/mvp/mvp_db/news7-lv/2005/2005_09_21_19_00/2005_09_21_19_00.mpg;Junichiro KOIZUMI.jpg;309;333;35961;15;16;1
/net/per610a/home/mvp/mvp_db/news7-lv/2005/2005_09_21_19_00/2005_09_21_19_00.mpg;Junichiro KOIZUMI.jpg;7429;7453;35961;371;372;1
/net/per610a/home/mvp/mvp_db/news7-lv/2005/2005_09_21_19_00/2005_09_21_19_00.mpg;Junichiro KOIZUMI.jpg;7537;7645;35961;377;382;5
/net/per610a/home/mvp/mvp_db/news7-lv/2005/2005_09_21_19_00/2005_09_21_19_00.mpg;Junichiro KOIZUMI.jpg;12017;12493;35961;601;624;23
/net/per610a/home/mvp/mvp_db/news7-lv/2005/2005_09_21_19_00/2005_09_21_19_00.mpg;Junichiro KOIZUMI.jpg;373;745;35961;18;37;19
/net/per610a/home/mvp/mvp_db/news7-lv/2005/2005_09_21_19_00/2005_09_21_19_00.mpg;Junichiro KOIZUMI.jpg;12001;12013;35961;600;600;0
/net/per610a/home/mvp/mvp_db/news7-lv/2005/2005_09_21_19_00/2005_09_21_19_00.mpg;Junichiro KOIZUMI.jpg;12497;13149;35961;625;657;32
/net/per610a/home/mvp/mvp_db/news7-lv/2005/2005_09_21_19_00/2005_09_21_19_00.mpg;Ichiro OZAWA.jpg;24981;25249;35961;1249;1263;14
/net/per610a/home/mvp/mvp_db/news7-lv/2005/2005_09_22_19_00/2005_09_22_19_00.mpg;Shintaro ISHIHARA.jpg;1009;1061;35961;50;53;3
/net/per610a/home/mvp/mvp_db/news7-lv/2005/2005_09_22_19_00/2005_09_22_19_00.mpg;Shintaro ISHIHARA.jpg;19373;19877;35961;969;994;25
/net/per610a/home/mvp/mvp_db/news7-lv/2005/2005_09_25_19_00/2005_09_25_19_00.mpg;Junichiro KOIZUMI.jpg;6493;6609;23973;324;330;6
/net/per610a/home/mvp/mvp_db/news7-lv/2005/2005_09_26_19_00/2005_09_26_19_00.mpg;Junichiro KOIZUMI.jpg;2345;2725;35961;117;136;19
/net/per610a/home/mvp/mvp_db/news7-lv/2005/2005_09_26_19_00/2005_09_26_19_00.mpg;Junichiro KOIZUMI.jpg;4329;4441;35961;216;222;6
/net/per610a/home/mvp/mvp_db/news7-lv/2005/2005_09_26_19_00/2005_09_26_19_00.mpg;Junichiro KOIZUMI.jpg;4513;4689;35961;225;234;9
/net/per610a/home/mvp/mvp_db/news7-lv/2005/2005_09_28_19_00/2005_09_28_19_00.mpg;Junichiro KOIZUMI.jpg;8269;8921;35961;413;446;33
/net/per610a/home/mvp/mvp_db/news7-lv/2005/2005_09_28_19_00/2005_09_28_19_00.mpg;Junichiro KOIZUMI.jpg;14969;15081;35961;748;754;6
/net/per610a/home/mvp/mvp_db/news7-lv/2005/2005_09_30_19_00/2005_09_30_19_00.mpg;Junichiro KOIZUMI.jpg;6037;6233;35961;302;311;9
/net/per610a/home/mvp/mvp_db/news7-lv/2005/2005_10_01_19_00/2005_10_01_19_00.mpg;Junichiro KOIZUMI.jpg;11621;11785;35961;581;589;8
/net/per610a/home/mvp/mvp_db/news7-lv/2005/2005_10_01_19_00/2005_10_01_19_00.mpg;Junichiro KOIZUMI.jpg;12785;12865;35961;639;643;4
/net/per610a/home/mvp/mvp_db/news7-lv/2005/2005_10_01_19_00/2005_10_01_19_00.mpg;Nariaki Nakayama.png;24169;24545;35961;1209;1227;18
/net/per610a/home/mvp/mvp_db/news7-lv/2005/2005_10_04_19_00/2005_10_04_19_00.mpg;Junichiro KOIZUMI.jpg;11857;11857;35961;593;593;0
/net/per610a/home/mvp/mvp_db/news7-lv/2005/2005_10_04_19_00/2005_10_04_19_00.mpg;Junichiro KOIZUMI.jpg;11941;11993;35961;597;599;2
/net/per610a/home/mvp/mvp_db/news7-lv/2005/2005_10_04_19_00/2005_10_04_19_00.mpg;Junichiro KOIZUMI.jpg;12065;12153;35961;603;607;4
/net/per610a/home/mvp/mvp_db/news7-lv/2005/2005_10_04_19_00/2005_10_04_19_00.mpg;Junichiro KOIZUMI.jpg;14509;14885;35961;725;744;19
/net/per610a/home/mvp/mvp_db/news7-lv/2005/2005_10_04_19_00/2005_10_04_19_00.mpg;Seiji MAEHARA.jpg;18077;18557;35961;904;928;24
/net/per610a/home/mvp/mvp_db/news7-lv/2005/2005_10_07_19_00/2005_10_07_19_00.mpg;Junichiro KOIZUMI.jpg;8593;8685;35961;429;434;5
/net/per610a/home/mvp/mvp_db/news7-lv/2005/2005_10_07_19_00/2005_10_07_19_00.mpg;Junichiro KOIZUMI.jpg;9525;9805;35961;476;490;14
/net/per610a/home/mvp/mvp_db/news7-lv/2005/2005_10_07_19_00/2005_10_07_19_00.mpg;Junichiro KOIZUMI.jpg;10289;10769;35961;514;538;24
/net/per610a/home/mvp/mvp_db/news7-lv/2005/2005_10_07_19_00/2005_10_07_19_00.mpg;Yoshihiko Noda.jpg;14609;14993;35961;730;750;20
/net/per610a/home/mvp/mvp_db/news7-lv/2005/2005_10_11_19_00/2005_10_11_19_00.mpg;Seiji MAEHARA.jpg;2317;2357;35961;115;117;2
/net/per610a/home/mvp/mvp_db/news7-lv/2005/2005_10_11_19_00/2005_10_11_19_00.mpg;Seiji MAEHARA.jpg;5805;6261;35961;290;313;23
/net/per610a/home/mvp/mvp_db/news7-lv/2005/2005_10_11_19_00/2005_10_11_19_00.mpg;Seiji MAEHARA.jpg;11841;12341;35961;592;617;25
/net/per610a/home/mvp/mvp_db/news7-lv/2005/2005_10_11_19_00/2005_10_11_19_00.mpg;Junichiro KOIZUMI.jpg;5493;5761;35961;274;288;14
/net/per610a/home/mvp/mvp_db/news7-lv/2005/2005_10_11_19_00/2005_10_11_19_00.mpg;Junichiro KOIZUMI.jpg;10269;10985;35961;513;549;36
/net/per610a/home/mvp/mvp_db/news7-lv/2005/2005_10_13_19_00/2005_10_13_19_00.mpg;Junichiro KOIZUMI.jpg;24485;24845;35961;1224;1242;18
/net/per610a/home/mvp/mvp_db/news7-lv/2005/2005_10_13_19_00/2005_10_13_19_00.mpg;Junichiro KOIZUMI.jpg;25017;25533;35961;1251;1277;26
/net/per610a/home/mvp/mvp_db/news7-lv/2005/2005_10_17_19_00/2005_10_17_19_00.mpg;Junichiro KOIZUMI.jpg;145;245;35961;7;12;5
/net/per610a/home/mvp/mvp_db/news7-lv/2005/2005_10_17_19_00/2005_10_17_19_00.mpg;Junichiro KOIZUMI.jpg;3625;5857;35961;181;293;112
/net/per610a/home/mvp/mvp_db/news7-lv/2005/2005_10_17_19_00/2005_10_17_19_00.mpg;Junichiro KOIZUMI.jpg;19941;20265;35961;997;1013;16
/net/per610a/home/mvp/mvp_db/news7-lv/2005/2005_10_17_19_00/2005_10_17_19_00.mpg;Junichiro KOIZUMI.jpg;2553;2565;35961;127;128;1
/net/per610a/home/mvp/mvp_db/news7-lv/2005/2005_10_17_19_00/2005_10_17_19_00.mpg;Junichiro KOIZUMI.jpg;3297;3381;35961;164;169;5
/net/per610a/home/mvp/mvp_db/news7-lv/2005/2005_10_17_19_00/2005_10_17_19_00.mpg;Junichiro KOIZUMI.jpg;3481;3509;35961;174;175;1
/net/per610a/home/mvp/mvp_db/news7-lv/2005/2005_10_17_19_00/2005_10_17_19_00.mpg;Junichiro KOIZUMI.jpg;5861;6001;35961;293;300;7
/net/per610a/home/mvp/mvp_db/news7-lv/2005/2005_10_17_19_00/2005_10_17_19_00.mpg;Junichiro KOIZUMI.jpg;6253;6305;35961;312;315;3
/net/per610a/home/mvp/mvp_db/news7-lv/2005/2005_10_17_19_00/2005_10_17_19_00.mpg;Junichiro KOIZUMI.jpg;7993;11845;35961;399;592;193
/net/per610a/home/mvp/mvp_db/news7-lv/2005/2005_10_17_19_00/2005_10_17_19_00.mpg;Junichiro KOIZUMI.jpg;12773;12989;35961;638;649;11
/net/per610a/home/mvp/mvp_db/news7-lv/2005/2005_10_17_19_00/2005_10_17_19_00.mpg;Junichiro KOIZUMI.jpg;13425;13613;35961;671;681;10
/net/per610a/home/mvp/mvp_db/news7-lv/2005/2005_10_17_19_00/2005_10_17_19_00.mpg;Junichiro KOIZUMI.jpg;14225;14317;35961;711;716;5
/net/per610a/home/mvp/mvp_db/news7-lv/2005/2005_10_17_19_00/2005_10_17_19_00.mpg;Junichiro KOIZUMI.jpg;16105;16273;35961;805;814;9
/net/per610a/home/mvp/mvp_db/news7-lv/2005/2005_10_17_19_00/2005_10_17_19_00.mpg;Junichiro KOIZUMI.jpg;17597;17749;35961;880;887;7
/net/per610a/home/mvp/mvp_db/news7-lv/2005/2005_10_17_19_00/2005_10_17_19_00.mpg;Junichiro KOIZUMI.jpg;18909;18977;35961;945;949;4
/net/per610a/home/mvp/mvp_db/news7-lv/2005/2005_10_17_19_00/2005_10_17_19_00.mpg;Junichiro KOIZUMI.jpg;20269;20425;35961;1013;1021;8
/net/per610a/home/mvp/mvp_db/news7-lv/2005/2005_10_17_19_00/2005_10_17_19_00.mpg;Junichiro KOIZUMI.jpg;21337;21497;35961;1067;1075;8
/net/per610a/home/mvp/mvp_db/news7-lv/2005/2005_10_17_19_00/2005_10_17_19_00.mpg;Junichiro KOIZUMI.jpg;17753;18473;35961;888;924;36
/net/per610a/home/mvp/mvp_db/news7-lv/2005/2005_10_19_19_00/2005_10_19_19_00.mpg;Junichiro KOIZUMI.jpg;24873;25749;35961;1244;1288;44
/net/per610a/home/mvp/mvp_db/news7-lv/2005/2005_10_20_19_00/2005_10_20_19_00.mpg;Taro ASO.jpg;27333;27405;35961;1367;1370;3
/net/per610a/home/mvp/mvp_db/news7-lv/2005/2005_10_24_19_00/2005_10_24_19_00.mpg;Junichiro KOIZUMI.jpg;7685;7941;35961;384;397;13
/net/per610a/home/mvp/mvp_db/news7-lv/2005/2005_10_25_19_00/2005_10_25_19_00.mpg;Junichiro KOIZUMI.jpg;20233;20481;35961;1012;1024;12
/net/per610a/home/mvp/mvp_db/news7-lv/2005/2005_10_26_19_00/2005_10_26_19_00.mpg;Junichiro KOIZUMI.jpg;7441;8285;35961;372;414;42
/net/per610a/home/mvp/mvp_db/news7-lv/2005/2005_10_26_19_00/2005_10_26_19_00.mpg;Junichiro KOIZUMI.jpg;13921;13929;35961;696;696;0
/net/per610a/home/mvp/mvp_db/news7-lv/2005/2005_10_26_19_00/2005_10_26_19_00.mpg;Junichiro KOIZUMI.jpg;8529;8669;35961;426;433;7
/net/per610a/home/mvp/mvp_db/news7-lv/2005/2005_10_28_19_00/2005_10_28_19_00.mpg;Junichiro KOIZUMI.jpg;1937;2633;35961;96;131;35
/net/per610a/home/mvp/mvp_db/news7-lv/2005/2005_10_28_19_00/2005_10_28_19_00.mpg;Junichiro KOIZUMI.jpg;4133;4217;35961;206;210;4
/net/per610a/home/mvp/mvp_db/news7-lv/2005/2005_10_28_19_00/2005_10_28_19_00.mpg;Junichiro KOIZUMI.jpg;5413;5493;35961;270;274;4
/net/per610a/home/mvp/mvp_db/news7-lv/2005/2005_10_28_19_00/2005_10_28_19_00.mpg;Junichiro KOIZUMI.jpg;17017;17345;35961;851;867;16
/net/per610a/home/mvp/mvp_db/news7-lv/2005/2005_10_28_19_00/2005_10_28_19_00.mpg;Junichiro KOIZUMI.jpg;17425;17633;35961;871;882;11
/net/per610a/home/mvp/mvp_db/news7-lv/2005/2005_10_30_19_00/2005_10_30_19_00.mpg;Junichiro KOIZUMI.jpg;1813;2037;23973;90;101;11
/net/per610a/home/mvp/mvp_db/news7-lv/2005/2005_10_30_19_00/2005_10_30_19_00.mpg;Junichiro KOIZUMI.jpg;3445;3469;23973;172;173;1
/net/per610a/home/mvp/mvp_db/news7-lv/2005/2005_10_30_19_00/2005_10_30_19_00.mpg;Junichiro KOIZUMI.jpg;12809;13457;23973;640;673;33
/net/per610a/home/mvp/mvp_db/news7-lv/2005/2005_10_30_19_00/2005_10_30_19_00.mpg;Junichiro KOIZUMI.jpg;2041;2369;23973;102;118;16
/net/per610a/home/mvp/mvp_db/news7-lv/2005/2005_10_30_19_00/2005_10_30_19_00.mpg;Junichiro KOIZUMI.jpg;3229;3441;23973;161;172;11
/net/per610a/home/mvp/mvp_db/news7-lv/2005/2005_10_31_19_00/2005_10_31_19_00.mpg;Shinzo ABE.jpg;333;457;35961;16;22;6
/net/per610a/home/mvp/mvp_db/news7-lv/2005/2005_10_31_19_00/2005_10_31_19_00.mpg;Shinzo ABE.jpg;2005;2417;35961;100;120;20
/net/per610a/home/mvp/mvp_db/news7-lv/2005/2005_10_31_19_00/2005_10_31_19_00.mpg;Shinzo ABE.jpg;3553;3669;35961;177;183;6
/net/per610a/home/mvp/mvp_db/news7-lv/2005/2005_10_31_19_00/2005_10_31_19_00.mpg;Shinzo ABE.jpg;6001;6437;35961;300;322;22
/net/per610a/home/mvp/mvp_db/news7-lv/2005/2005_10_31_19_00/2005_10_31_19_00.mpg;Shinzo ABE.jpg;7141;7229;35961;357;361;4
/net/per610a/home/mvp/mvp_db/news7-lv/2005/2005_10_31_19_00/2005_10_31_19_00.mpg;Shinzo ABE.jpg;7325;7469;35961;366;373;7
/net/per610a/home/mvp/mvp_db/news7-lv/2005/2005_10_31_19_00/2005_10_31_19_00.mpg;Shinzo ABE.jpg;7773;8421;35961;388;421;33
/net/per610a/home/mvp/mvp_db/news7-lv/2005/2005_10_31_19_00/2005_10_31_19_00.mpg;Shinzo ABE.jpg;8505;8861;35961;425;443;18
/net/per610a/home/mvp/mvp_db/news7-lv/2005/2005_10_31_19_00/2005_10_31_19_00.mpg;Taro ASO.jpg;521;653;35961;26;32;6
/net/per610a/home/mvp/mvp_db/news7-lv/2005/2005_10_31_19_00/2005_10_31_19_00.mpg;Taro ASO.jpg;10733;11001;35961;536;550;14
/net/per610a/home/mvp/mvp_db/news7-lv/2005/2005_10_31_19_00/2005_10_31_19_00.mpg;Junichiro KOIZUMI.jpg;1565;1929;35961;78;96;18
/net/per610a/home/mvp/mvp_db/news7-lv/2005/2005_10_31_19_00/2005_10_31_19_00.mpg;Junichiro KOIZUMI.jpg;5677;5969;35961;283;298;15
/net/per610a/home/mvp/mvp_db/news7-lv/2005/2005_10_31_19_00/2005_10_31_19_00.mpg;Junichiro KOIZUMI.jpg;12761;12893;35961;638;644;6
/net/per610a/home/mvp/mvp_db/news7-lv/2005/2005_10_31_19_00/2005_10_31_19_00.mpg;Junichiro KOIZUMI.jpg;23257;23465;35961;1163;1173;10
/net/per610a/home/mvp/mvp_db/news7-lv/2005/2005_10_31_19_00/2005_10_31_19_00.mpg;Junichiro KOIZUMI.jpg;25477;25629;35961;1274;1282;8
/net/per610a/home/mvp/mvp_db/news7-lv/2005/2005_10_31_19_00/2005_10_31_19_00.mpg;Junichiro KOIZUMI.jpg;27413;27689;35961;1371;1385;14
/net/per610a/home/mvp/mvp_db/news7-lv/2005/2005_10_31_19_00/2005_10_31_19_00.mpg;Junichiro KOIZUMI.jpg;32721;32825;35961;1636;1642;6
/net/per610a/home/mvp/mvp_db/news7-lv/2005/2005_10_31_19_00/2005_10_31_19_00.mpg;Sadakazu TANIGAKI.jpg;12245;12757;35961;612;638;26
/net/per610a/home/mvp/mvp_db/news7-lv/2005/2005_10_31_19_00/2005_10_31_19_00.mpg;Masashi Nakano.jpg;13037;13133;35961;652;656;4
/net/per610a/home/mvp/mvp_db/news7-lv/2005/2005_10_31_19_00/2005_10_31_19_00.mpg;Masashi Nakano.jpg;13293;13713;35961;665;686;21
/net/per610a/home/mvp/mvp_db/news7-lv/2005/2005_10_31_19_00/2005_10_31_19_00.mpg;Masashi Nakano.jpg;14113;14409;35961;706;720;14
/net/per610a/home/mvp/mvp_db/news7-lv/2005/2005_10_31_19_00/2005_10_31_19_00.mpg;Masashi Nakano.jpg;14529;14849;35961;726;742;16
/net/per610a/home/mvp/mvp_db/news7-lv/2005/2005_10_31_19_00/2005_10_31_19_00.mpg;Masashi Nakano.jpg;14921;15129;35961;746;756;10
/net/per610a/home/mvp/mvp_db/news7-lv/2005/2005_10_31_19_00/2005_10_31_19_00.mpg;Takenori KANZAKI.jpg;23469;25473;35961;1174;1274;100
/net/per610a/home/mvp/mvp_db/news7-lv/2005/2005_10_31_19_00/2005_10_31_19_00.mpg;Taro ASO.jpg;25633;27409;35961;1282;1371;89
/net/per610a/home/mvp/mvp_db/news7-lv/2005/2005_11_01_19_00/2005_11_01_19_00.mpg;Shinzo ABE.jpg;493;629;35961;24;31;7
/net/per610a/home/mvp/mvp_db/news7-lv/2005/2005_11_01_19_00/2005_11_01_19_00.mpg;Shinzo ABE.jpg;8729;8885;35961;436;444;8
/net/per610a/home/mvp/mvp_db/news7-lv/2005/2005_11_01_19_00/2005_11_01_19_00.mpg;Shinzo ABE.jpg;23333;23429;35961;1167;1172;5
/net/per610a/home/mvp/mvp_db/news7-lv/2005/2005_11_01_19_00/2005_11_01_19_00.mpg;Seiji MAEHARA.jpg;12761;12849;35961;638;642;4
/net/per610a/home/mvp/mvp_db/news7-lv/2005/2005_11_02_19_00/2005_11_02_19_00.mpg;Shinzo ABE.jpg;8185;8457;35961;409;423;14
/net/per610a/home/mvp/mvp_db/news7-lv/2005/2005_11_03_19_00/2005_11_03_19_00.mpg;Akihiro OHTA.jpg;18345;18425;35961;917;921;4
/net/per610a/home/mvp/mvp_db/news7-lv/2005/2005_11_03_19_00/2005_11_03_19_00.mpg;Akihiro OHTA.jpg;20057;20293;35961;1003;1015;12
/net/per610a/home/mvp/mvp_db/news7-lv/2005/2005_11_03_19_00/2005_11_03_19_00.mpg;Akihiro OHTA.jpg;20381;21293;35961;1019;1065;46
/net/per610a/home/mvp/mvp_db/news7-lv/2005/2005_11_03_19_00/2005_11_03_19_00.mpg;Akihiro OHTA.jpg;21533;23125;35961;1077;1156;79
/net/per610a/home/mvp/mvp_db/news7-lv/2005/2005_11_04_19_00/2005_11_04_19_00.mpg;Shinzo ABE.jpg;161;313;35961;8;15;7
/net/per610a/home/mvp/mvp_db/news7-lv/2005/2005_11_04_19_00/2005_11_04_19_00.mpg;Shinzo ABE.jpg;3473;3721;35961;173;186;13
/net/per610a/home/mvp/mvp_db/news7-lv/2005/2005_11_04_19_00/2005_11_04_19_00.mpg;Junichiro KOIZUMI.jpg;9525;9957;35961;476;498;22
/net/per610a/home/mvp/mvp_db/news7-lv/2005/2005_11_05_19_00/2005_11_05_19_00.mpg;Natsuo YAMAGUCHI.jpg;273;333;35961;13;16;3
/net/per610a/home/mvp/mvp_db/news7-lv/2005/2005_11_07_19_00/2005_11_07_19_00.mpg;Shinzo ABE.jpg;15297;15593;35961;765;780;15
/net/per610a/home/mvp/mvp_db/news7-lv/2005/2005_11_09_19_00/2005_11_09_19_00.mpg;Shinzo ABE.jpg;20045;20545;35961;1002;1027;25
/net/per610a/home/mvp/mvp_db/news7-lv/2005/2005_11_11_19_00/2005_11_11_19_00.mpg;Shintaro ISHIHARA.jpg;9461;10333;35961;473;516;43
/net/per610a/home/mvp/mvp_db/news7-lv/2005/2005_11_14_19_00/2005_11_14_19_00.mpg;Shinzo ABE.jpg;149;281;35961;7;14;7
/net/per610a/home/mvp/mvp_db/news7-lv/2005/2005_11_14_19_00/2005_11_14_19_00.mpg;Shinzo ABE.jpg;23217;23609;35961;1161;1181;20
/net/per610a/home/mvp/mvp_db/news7-lv/2005/2005_11_14_19_00/2005_11_14_19_00.mpg;Junichiro KOIZUMI.jpg;19397;19741;35961;970;987;17
/net/per610a/home/mvp/mvp_db/news7-lv/2005/2005_11_14_19_00/2005_11_14_19_00.mpg;Junichiro KOIZUMI.jpg;24689;24709;35961;1235;1236;1
/net/per610a/home/mvp/mvp_db/news7-lv/2005/2005_11_14_19_00/2005_11_14_19_00.mpg;Sadakazu TANIGAKI.jpg;22317;22405;35961;1116;1120;4
/net/per610a/home/mvp/mvp_db/news7-lv/2005/2005_11_14_19_00/2005_11_14_19_00.mpg;Ichiro OZAWA.jpg;23629;23753;35961;1182;1188;6
/net/per610a/home/mvp/mvp_db/news7-lv/2005/2005_11_14_19_00/2005_11_14_19_00.mpg;Seiji MAEHARA.jpg;23761;23933;35961;1188;1197;9
/net/per610a/home/mvp/mvp_db/news7-lv/2005/2005_11_15_19_00/2005_11_15_19_00.mpg;Shintaro ISHIHARA.jpg;12817;14065;35961;641;703;62
/net/per610a/home/mvp/mvp_db/news7-lv/2005/2005_11_16_19_00/2005_11_16_19_00.mpg;Junichiro KOIZUMI.jpg;141;397;35961;7;19;12
/net/per610a/home/mvp/mvp_db/news7-lv/2005/2005_11_16_19_00/2005_11_16_19_00.mpg;Junichiro KOIZUMI.jpg;1889;1933;35961;94;96;2
/net/per610a/home/mvp/mvp_db/news7-lv/2005/2005_11_16_19_00/2005_11_16_19_00.mpg;Junichiro KOIZUMI.jpg;2025;2809;35961;101;140;39
/net/per610a/home/mvp/mvp_db/news7-lv/2005/2005_11_16_19_00/2005_11_16_19_00.mpg;Junichiro KOIZUMI.jpg;3461;3873;35961;173;193;20
/net/per610a/home/mvp/mvp_db/news7-lv/2005/2005_11_16_19_00/2005_11_16_19_00.mpg;Junichiro KOIZUMI.jpg;7297;7329;35961;365;366;1
/net/per610a/home/mvp/mvp_db/news7-lv/2005/2005_11_19_19_00/2005_11_19_19_00.mpg;Junichiro KOIZUMI.jpg;7233;7421;35961;361;371;10
/net/per610a/home/mvp/mvp_db/news7-lv/2005/2005_11_19_19_00/2005_11_19_19_00.mpg;Junichiro KOIZUMI.jpg;11721;13493;35961;586;675;89
/net/per610a/home/mvp/mvp_db/news7-lv/2005/2005_11_19_19_00/2005_11_19_19_00.mpg;Shintaro ISHIHARA.jpg;16905;17033;35961;845;852;7
/net/per610a/home/mvp/mvp_db/news7-lv/2005/2005_11_21_19_00/2005_11_21_19_00.mpg;Junichiro KOIZUMI.jpg;613;637;35961;30;31;1
/net/per610a/home/mvp/mvp_db/news7-lv/2005/2005_11_21_19_00/2005_11_21_19_00.mpg;Junichiro KOIZUMI.jpg;15321;15421;35961;766;771;5
/net/per610a/home/mvp/mvp_db/news7-lv/2005/2005_11_21_19_00/2005_11_21_19_00.mpg;Junichiro KOIZUMI.jpg;15521;16337;35961;776;817;41
/net/per610a/home/mvp/mvp_db/news7-lv/2005/2005_11_21_19_00/2005_11_21_19_00.mpg;Junichiro KOIZUMI.jpg;16457;16813;35961;823;841;18
/net/per610a/home/mvp/mvp_db/news7-lv/2005/2005_11_22_19_00/2005_11_22_19_00.mpg;Junichiro KOIZUMI.jpg;645;673;35961;32;33;1
/net/per610a/home/mvp/mvp_db/news7-lv/2005/2005_11_22_19_00/2005_11_22_19_00.mpg;Junichiro KOIZUMI.jpg;15629;15985;35961;781;799;18
/net/per610a/home/mvp/mvp_db/news7-lv/2005/2005_11_22_19_00/2005_11_22_19_00.mpg;Junichiro KOIZUMI.jpg;18157;18181;35961;908;909;1
/net/per610a/home/mvp/mvp_db/news7-lv/2005/2005_11_24_19_00/2005_11_24_19_00.mpg;Junichiro KOIZUMI.jpg;13201;13641;35961;660;682;22
/net/per610a/home/mvp/mvp_db/news7-lv/2005/2005_11_24_19_00/2005_11_24_19_00.mpg;Junichiro KOIZUMI.jpg;13717;13817;35961;686;691;5
/net/per610a/home/mvp/mvp_db/news7-lv/2005/2005_11_27_19_00/2005_11_27_19_00.mpg;Seiji MAEHARA.jpg;9521;10505;23973;476;525;49
/net/per610a/home/mvp/mvp_db/news7-lv/2005/2005_11_28_19_00/2005_11_28_19_00.mpg;Seiji MAEHARA.jpg;11573;11717;35961;578;586;8
/net/per610a/home/mvp/mvp_db/news7-lv/2005/2005_11_28_19_00/2005_11_28_19_00.mpg;Seiji MAEHARA.jpg;11905;12549;35961;595;627;32
/net/per610a/home/mvp/mvp_db/news7-lv/2005/2005_11_28_19_00/2005_11_28_19_00.mpg;Shinzo ABE.jpg;24969;25381;35961;1249;1269;20
/net/per610a/home/mvp/mvp_db/news7-lv/2005/2005_11_30_19_00/2005_11_30_19_00.mpg;Shinzo ABE.jpg;15841;17089;35961;792;854;62
/net/per610a/home/mvp/mvp_db/news7-lv/2005/2005_11_30_19_00/2005_11_30_19_00.mpg;Junichiro KOIZUMI.jpg;27077;27281;35961;1354;1364;10
/net/per610a/home/mvp/mvp_db/news7-lv/2005/2005_12_01_19_00/2005_12_01_19_00.mpg;Junichiro KOIZUMI.jpg;1613;1945;35961;80;97;17
/net/per610a/home/mvp/mvp_db/news7-lv/2005/2005_12_01_19_00/2005_12_01_19_00.mpg;Junichiro KOIZUMI.jpg;2969;3449;35961;148;172;24
/net/per610a/home/mvp/mvp_db/news7-lv/2005/2005_12_01_19_00/2005_12_01_19_00.mpg;Junichiro KOIZUMI.jpg;20541;20545;35961;1027;1027;0
/net/per610a/home/mvp/mvp_db/news7-lv/2005/2005_12_01_19_00/2005_12_01_19_00.mpg;Shinzo ABE.jpg;4829;5813;35961;241;290;49
/net/per610a/home/mvp/mvp_db/news7-lv/2005/2005_12_02_19_00/2005_12_02_19_00.mpg;Shintaro ISHIHARA.jpg;20997;21353;35961;1050;1068;18
/net/per610a/home/mvp/mvp_db/news7-lv/2005/2005_12_04_19_00/2005_12_04_19_00.mpg;Junichiro KOIZUMI.jpg;10661;11061;23973;533;553;20
/net/per610a/home/mvp/mvp_db/news7-lv/2005/2005_12_04_19_00/2005_12_04_19_00.mpg;Seiji MAEHARA.jpg;17117;17933;23973;856;896;40
/net/per610a/home/mvp/mvp_db/news7-lv/2005/2005_12_05_19_00/2005_12_05_19_00.mpg;Ichiro OZAWA.jpg;15597;15705;35961;780;785;5
/net/per610a/home/mvp/mvp_db/news7-lv/2005/2005_12_05_19_00/2005_12_05_19_00.mpg;Ichiro OZAWA.jpg;15941;16309;35961;797;815;18
/net/per610a/home/mvp/mvp_db/news7-lv/2005/2005_12_07_19_00/2005_12_07_19_00.mpg;YUriko Koike.jpg;16365;16713;35961;818;836;18
/net/per610a/home/mvp/mvp_db/news7-lv/2005/2005_12_08_19_00/2005_12_08_19_00.mpg;Ichiro OZAWA.jpg;16637;16721;35961;832;836;4
/net/per610a/home/mvp/mvp_db/news7-lv/2005/2005_12_10_19_00/2005_12_10_19_00.mpg;Seiji MAEHARA.jpg;26837;27021;35961;1342;1351;9
/net/per610a/home/mvp/mvp_db/news7-lv/2005/2005_12_14_19_00/2005_12_14_19_00.mpg;Junichiro KOIZUMI.jpg;24061;24353;35961;1203;1218;15
/net/per610a/home/mvp/mvp_db/news7-lv/2005/2005_12_14_19_00/2005_12_14_19_00.mpg;Junichiro KOIZUMI.jpg;25397;25397;35961;1270;1270;0
/net/per610a/home/mvp/mvp_db/news7-lv/2005/2005_12_14_19_00/2005_12_14_19_00.mpg;Junichiro KOIZUMI.jpg;25489;25497;35961;1275;1275;0
/net/per610a/home/mvp/mvp_db/news7-lv/2005/2005_12_14_19_00/2005_12_14_19_00.mpg;Junichiro KOIZUMI.jpg;26745;26901;35961;1337;1345;8
/net/per610a/home/mvp/mvp_db/news7-lv/2005/2005_12_15_19_00/2005_12_15_19_00.mpg;Yukio HATOYAMA.jpg;13913;14221;35961;696;711;15
/net/per610a/home/mvp/mvp_db/news7-lv/2005/2005_12_16_19_00/2005_12_16_19_00.mpg;Shintaro ISHIHARA.jpg;11689;12281;35961;584;614;30
/net/per610a/home/mvp/mvp_db/news7-lv/2005/2005_12_16_19_00/2005_12_16_19_00.mpg;Seiji MAEHARA.jpg;18969;19453;35961;948;973;25
/net/per610a/home/mvp/mvp_db/news7-lv/2005/2005_12_16_19_00/2005_12_16_19_00.mpg;Seiji MAEHARA.jpg;19521;21709;35961;976;1086;110
/net/per610a/home/mvp/mvp_db/news7-lv/2005/2005_12_17_19_00/2005_12_17_19_00.mpg;Seiji MAEHARA.jpg;19797;20273;35961;990;1014;24
/net/per610a/home/mvp/mvp_db/news7-lv/2005/2005_12_17_19_00/2005_12_17_19_00.mpg;Seiji MAEHARA.jpg;21661;22441;35961;1083;1122;39
/net/per610a/home/mvp/mvp_db/news7-lv/2005/2005_12_17_19_00/2005_12_17_19_00.mpg;Junichiro KOIZUMI.jpg;31057;31601;35961;1553;1580;27
/net/per610a/home/mvp/mvp_db/news7-lv/2005/2005_12_18_19_00/2005_12_18_19_00.mpg;Sadakazu TANIGAKI.jpg;16345;16433;23973;817;821;4
/net/per610a/home/mvp/mvp_db/news7-lv/2005/2005_12_18_19_00/2005_12_18_19_00.mpg;Sadakazu TANIGAKI.jpg;16565;16605;23973;828;830;2
/net/per610a/home/mvp/mvp_db/news7-lv/2005/2005_12_18_19_00/2005_12_18_19_00.mpg;Sadakazu TANIGAKI.jpg;17097;17769;23973;855;888;33
/net/per610a/home/mvp/mvp_db/news7-lv/2005/2005_12_19_19_00/2005_12_19_19_00.mpg;Sadakazu TANIGAKI.jpg;18521;18693;35957;926;935;9
/net/per610a/home/mvp/mvp_db/news7-lv/2005/2005_12_19_19_00/2005_12_19_19_00.mpg;Sadakazu TANIGAKI.jpg;18765;18865;35957;938;943;5
/net/per610a/home/mvp/mvp_db/news7-lv/2005/2005_12_19_19_00/2005_12_19_19_00.mpg;Shinzo ABE.jpg;25497;25709;35957;1275;1286;11
/net/per610a/home/mvp/mvp_db/news7-lv/2005/2005_12_24_19_00/2005_12_24_19_00.mpg;Junichiro KOIZUMI.jpg;17597;17985;35961;880;899;19
/net/per610a/home/mvp/mvp_db/news7-lv/2005/2005_12_24_19_00/2005_12_24_19_00.mpg;Junichiro KOIZUMI.jpg;18093;18161;35961;905;908;3
/net/per610a/home/mvp/mvp_db/news7-lv/2005/2005_12_24_19_00/2005_12_24_19_00.mpg;Sadakazu TANIGAKI.jpg;19041;19857;35961;952;993;41
/net/per610a/home/mvp/mvp_db/news7-lv/2005/2005_12_27_19_00/2005_12_27_19_00.mpg;Junichiro KOIZUMI.jpg;21417;21577;35961;1071;1079;8
/net/per610a/home/mvp/mvp_db/news7-lv/2005/2005_12_27_19_00/2005_12_27_19_00.mpg;Shinzo ABE.jpg;21761;21761;35961;1088;1088;0
/net/per610a/home/mvp/mvp_db/news7-lv/2005/2005_12_27_19_00/2005_12_27_19_00.mpg;Shinzo ABE.jpg;26981;27169;35961;1349;1359;10
/net/per610a/home/mvp/mvp_db/news7-lv/2005/2005_12_28_19_00/2005_12_28_19_00.mpg;Junichiro KOIZUMI.jpg;913;941;35961;45;47;2
/net/per610a/home/mvp/mvp_db/news7-lv/2005/2005_12_28_19_00/2005_12_28_19_00.mpg;Junichiro KOIZUMI.jpg;20953;21581;35961;1048;1079;31
/net/per610a/home/mvp/mvp_db/news7-lv/2005/2005_12_28_19_00/2005_12_28_19_00.mpg;Junichiro KOIZUMI.jpg;1061;1325;35961;53;66;13
/net/per610a/home/mvp/mvp_db/news7-lv/2005/2005_12_28_19_00/2005_12_28_19_00.mpg;Yukio HATOYAMA.jpg;22689;22973;35961;1135;1149;14
/net/per610a/home/mvp/mvp_db/news7-lv/2005/2005_12_31_19_00/2005_12_31_19_00.mpg;Junichiro KOIZUMI.jpg;13093;13421;23901;655;671;16
/net/per610a/home/mvp/mvp_db/news7-lv/2005/2005_12_31_19_00/2005_12_31_19_00.mpg;Junichiro KOIZUMI.jpg;15453;15501;23901;773;775;2
/net/per610a/home/mvp/mvp_db/news7-lv/2006/2006_01_01_19_00/2006_01_01_19_00.mpg;Junichiro KOIZUMI.jpg;9721;9801;23973;486;490;4
/net/per610a/home/mvp/mvp_db/news7-lv/2006/2006_01_01_19_00/2006_01_01_19_00.mpg;Junichiro KOIZUMI.jpg;11965;12357;23973;598;618;20
/net/per610a/home/mvp/mvp_db/news7-lv/2006/2006_01_01_19_00/2006_01_01_19_00.mpg;Yasuo FUKUDA.jpg;9953;10253;23973;497;512;15
/net/per610a/home/mvp/mvp_db/news7-lv/2006/2006_01_01_19_00/2006_01_01_19_00.mpg;Shinzo ABE.jpg;9957;10253;23973;497;512;15
/net/per610a/home/mvp/mvp_db/news7-lv/2006/2006_01_01_19_00/2006_01_01_19_00.mpg;Shinzo ABE.jpg;10341;10529;23973;517;526;9
/net/per610a/home/mvp/mvp_db/news7-lv/2006/2006_01_01_19_00/2006_01_01_19_00.mpg;Seiji MAEHARA.jpg;11625;11865;23973;581;593;12
/net/per610a/home/mvp/mvp_db/news7-lv/2006/2006_01_04_19_00/2006_01_04_19_00.mpg;Junichiro KOIZUMI.jpg;14069;14425;35961;703;721;18
/net/per610a/home/mvp/mvp_db/news7-lv/2006/2006_01_04_19_00/2006_01_04_19_00.mpg;Junichiro KOIZUMI.jpg;14537;16705;35961;727;835;108
/net/per610a/home/mvp/mvp_db/news7-lv/2006/2006_01_04_19_00/2006_01_04_19_00.mpg;Seiji MAEHARA.jpg;16709;17045;35961;835;852;17
/net/per610a/home/mvp/mvp_db/news7-lv/2006/2006_01_04_19_00/2006_01_04_19_00.mpg;Seiji MAEHARA.jpg;17109;19033;35961;855;952;97
/net/per610a/home/mvp/mvp_db/news7-lv/2006/2006_01_06_19_00/2006_01_06_19_00.mpg;Junichiro KOIZUMI.jpg;4825;5589;35961;241;279;38
/net/per610a/home/mvp/mvp_db/news7-lv/2006/2006_01_06_19_00/2006_01_06_19_00.mpg;Shinzo ABE.jpg;22697;23305;35961;1135;1165;30
/net/per610a/home/mvp/mvp_db/news7-lv/2006/2006_01_10_19_00/2006_01_10_19_00.mpg;Junichiro KOIZUMI.jpg;18913;18997;35961;946;950;4
/net/per610a/home/mvp/mvp_db/news7-lv/2006/2006_01_10_19_00/2006_01_10_19_00.mpg;Junichiro KOIZUMI.jpg;21225;21661;35961;1061;1083;22
/net/per610a/home/mvp/mvp_db/news7-lv/2006/2006_01_14_19_00/2006_01_14_19_00.mpg;Kazuo SHII.jpg;18741;19181;35961;937;959;22
/net/per610a/home/mvp/mvp_db/news7-lv/2006/2006_01_14_19_00/2006_01_14_19_00.mpg;Sadakazu TANIGAKI.jpg;21061;22721;35961;1053;1136;83
/net/per610a/home/mvp/mvp_db/news7-lv/2006/2006_01_14_19_00/2006_01_14_19_00.mpg;Toru Hashimoto.jpg;25845;25917;35961;1292;1296;4
/net/per610a/home/mvp/mvp_db/news7-lv/2006/2006_01_17_19_00/2006_01_17_19_00.mpg;Junichiro KOIZUMI.jpg;8089;8949;35961;404;447;43
/net/per610a/home/mvp/mvp_db/news7-lv/2006/2006_01_18_19_00/2006_01_18_19_00.mpg;Junichiro KOIZUMI.jpg;12217;12581;35961;611;629;18
/net/per610a/home/mvp/mvp_db/news7-lv/2006/2006_01_18_19_00/2006_01_18_19_00.mpg;Shinzo ABE.jpg;15317;15389;35961;766;769;3
/net/per610a/home/mvp/mvp_db/news7-lv/2006/2006_01_18_19_00/2006_01_18_19_00.mpg;Shinzo ABE.jpg;15785;15917;35961;789;796;7
/net/per610a/home/mvp/mvp_db/news7-lv/2006/2006_01_18_19_00/2006_01_18_19_00.mpg;Yasuo FUKUDA.jpg;15333;15381;35961;767;769;2
/net/per610a/home/mvp/mvp_db/news7-lv/2006/2006_01_18_19_00/2006_01_18_19_00.mpg;Yasuo FUKUDA.jpg;15925;16169;35961;796;808;12
/net/per610a/home/mvp/mvp_db/news7-lv/2006/2006_01_20_19_00/2006_01_20_19_00.mpg;Junichiro KOIZUMI.jpg;541;669;35961;27;33;6
/net/per610a/home/mvp/mvp_db/news7-lv/2006/2006_01_20_19_00/2006_01_20_19_00.mpg;Junichiro KOIZUMI.jpg;16117;16405;35961;806;820;14
/net/per610a/home/mvp/mvp_db/news7-lv/2006/2006_01_21_19_00/2006_01_21_19_00.mpg;Taro ASO.jpg;10753;11661;35961;537;583;46
/net/per610a/home/mvp/mvp_db/news7-lv/2006/2006_01_23_19_00/2006_01_23_19_00.mpg;Ichiro OZAWA.jpg;18773;19509;35961;939;975;36
/net/per610a/home/mvp/mvp_db/news7-lv/2006/2006_01_23_19_00/2006_01_23_19_00.mpg;Junichiro KOIZUMI.jpg;20569;21721;35961;1028;1086;58
/net/per610a/home/mvp/mvp_db/news7-lv/2006/2006_01_24_19_00/2006_01_24_19_00.mpg;Seiji MAEHARA.jpg;15969;16477;35961;798;824;26
/net/per610a/home/mvp/mvp_db/news7-lv/2006/2006_01_24_19_00/2006_01_24_19_00.mpg;Junichiro KOIZUMI.jpg;16537;17001;35961;827;850;23
/net/per610a/home/mvp/mvp_db/news7-lv/2006/2006_01_24_19_00/2006_01_24_19_00.mpg;Junichiro KOIZUMI.jpg;17053;17497;35961;853;875;22
/net/per610a/home/mvp/mvp_db/news7-lv/2006/2006_01_24_19_00/2006_01_24_19_00.mpg;Kazuo SHII.jpg;18585;19437;35961;929;972;43
/net/per610a/home/mvp/mvp_db/news7-lv/2006/2006_01_25_19_00/2006_01_25_19_00.mpg;Junichiro KOIZUMI.jpg;20265;20689;35961;1013;1034;21
/net/per610a/home/mvp/mvp_db/news7-lv/2006/2006_01_25_19_00/2006_01_25_19_00.mpg;Junichiro KOIZUMI.jpg;22745;22789;35961;1137;1140;3
/net/per610a/home/mvp/mvp_db/news7-lv/2006/2006_01_26_19_00/2006_01_26_19_00.mpg;Junichiro KOIZUMI.jpg;18925;19493;35961;946;975;29
/net/per610a/home/mvp/mvp_db/news7-lv/2006/2006_01_26_19_00/2006_01_26_19_00.mpg;Junichiro KOIZUMI.jpg;19953;20733;35961;998;1037;39
/net/per610a/home/mvp/mvp_db/news7-lv/2006/2006_01_26_19_00/2006_01_26_19_00.mpg;Junichiro KOIZUMI.jpg;21769;22165;35961;1089;1108;19
/net/per610a/home/mvp/mvp_db/news7-lv/2006/2006_01_26_19_00/2006_01_26_19_00.mpg;Shinzo ABE.jpg;20777;21173;35961;1039;1059;20
/net/per610a/home/mvp/mvp_db/news7-lv/2006/2006_01_27_19_00/2006_01_27_19_00.mpg;Shinzo ABE.jpg;9157;9413;35961;458;470;12
/net/per610a/home/mvp/mvp_db/news7-lv/2006/2006_01_27_19_00/2006_01_27_19_00.mpg;Yukio HATOYAMA.jpg;14961;15653;35961;748;783;35
/net/per610a/home/mvp/mvp_db/news7-lv/2006/2006_01_27_19_00/2006_01_27_19_00.mpg;Akihiro OHTA.jpg;16201;16309;35961;810;815;5
/net/per610a/home/mvp/mvp_db/news7-lv/2006/2006_01_27_19_00/2006_01_27_19_00.mpg;Akihiro OHTA.jpg;18045;18521;35961;902;926;24
/net/per610a/home/mvp/mvp_db/news7-lv/2006/2006_01_27_19_00/2006_01_27_19_00.mpg;Akihiro OHTA.jpg;18889;19341;35961;944;967;23
/net/per610a/home/mvp/mvp_db/news7-lv/2006/2006_01_27_19_00/2006_01_27_19_00.mpg;Akihiro OHTA.jpg;20293;20545;35961;1015;1027;12
/net/per610a/home/mvp/mvp_db/news7-lv/2006/2006_02_01_19_00/2006_02_01_19_00.mpg;Junichiro KOIZUMI.jpg;17093;18177;35961;855;909;54
/net/per610a/home/mvp/mvp_db/news7-lv/2006/2006_02_01_19_00/2006_02_01_19_00.mpg;Junichiro KOIZUMI.jpg;19425;19477;35961;971;974;3
/net/per610a/home/mvp/mvp_db/news7-lv/2006/2006_02_01_19_00/2006_02_01_19_00.mpg;Junichiro KOIZUMI.jpg;21053;21065;35961;1053;1053;0
/net/per610a/home/mvp/mvp_db/news7-lv/2006/2006_02_02_19_00/2006_02_02_19_00.mpg;Shinzo ABE.jpg;10873;11285;35961;543;564;21
/net/per610a/home/mvp/mvp_db/news7-lv/2006/2006_02_02_19_00/2006_02_02_19_00.mpg;Takeo Hiranuma.jpeg;17745;17833;35961;887;892;5
/net/per610a/home/mvp/mvp_db/news7-lv/2006/2006_02_02_19_00/2006_02_02_19_00.mpg;Junichiro KOIZUMI.jpg;19737;20277;35961;987;1014;27
/net/per610a/home/mvp/mvp_db/news7-lv/2006/2006_02_06_19_00/2006_02_06_19_00.mpg;Junichiro KOIZUMI.jpg;13397;14061;35961;670;703;33
/net/per610a/home/mvp/mvp_db/news7-lv/2006/2006_02_06_19_00/2006_02_06_19_00.mpg;Junichiro KOIZUMI.jpg;25185;25329;35961;1259;1267;8
/net/per610a/home/mvp/mvp_db/news7-lv/2006/2006_02_07_19_00/2006_02_07_19_00.mpg;Toranosuke Katayama.jpg;8549;10457;35961;427;523;96
/net/per610a/home/mvp/mvp_db/news7-lv/2006/2006_02_07_19_00/2006_02_07_19_00.mpg;Junichiro KOIZUMI.jpg;18885;19421;35961;944;971;27
/net/per610a/home/mvp/mvp_db/news7-lv/2006/2006_02_07_19_00/2006_02_07_19_00.mpg;Junichiro KOIZUMI.jpg;19805;20245;35961;990;1012;22
/net/per610a/home/mvp/mvp_db/news7-lv/2006/2006_02_07_19_00/2006_02_07_19_00.mpg;Junichiro KOIZUMI.jpg;20533;20997;35961;1027;1050;23
/net/per610a/home/mvp/mvp_db/news7-lv/2006/2006_02_08_19_00/2006_02_08_19_00.mpg;Shinzo ABE.jpg;7105;7233;35961;355;361;6
/net/per610a/home/mvp/mvp_db/news7-lv/2006/2006_02_09_19_00/2006_02_09_19_00.mpg;Shinzo ABE.jpg;19673;20077;35961;984;1004;20
/net/per610a/home/mvp/mvp_db/news7-lv/2006/2006_02_10_19_00/2006_02_10_19_00.mpg;Junichiro KOIZUMI.jpg;25833;25937;35961;1292;1297;5
/net/per610a/home/mvp/mvp_db/news7-lv/2006/2006_02_16_19_00/2006_02_16_19_00.mpg;Seiji MAEHARA.jpg;14337;14805;35961;717;740;23
/net/per610a/home/mvp/mvp_db/news7-lv/2006/2006_02_16_19_00/2006_02_16_19_00.mpg;Junichiro KOIZUMI.jpg;14845;15349;35961;742;767;25
/net/per610a/home/mvp/mvp_db/news7-lv/2006/2006_02_17_19_00/2006_02_17_19_00.mpg;Junichiro KOIZUMI.jpg;449;705;35957;22;35;13
/net/per610a/home/mvp/mvp_db/news7-lv/2006/2006_02_17_19_00/2006_02_17_19_00.mpg;Junichiro KOIZUMI.jpg;817;1093;35957;40;54;14
/net/per610a/home/mvp/mvp_db/news7-lv/2006/2006_02_17_19_00/2006_02_17_19_00.mpg;Junichiro KOIZUMI.jpg;15525;16073;35957;776;804;28
/net/per610a/home/mvp/mvp_db/news7-lv/2006/2006_02_17_19_00/2006_02_17_19_00.mpg;Junichiro KOIZUMI.jpg;17513;17741;35957;876;887;11
/net/per610a/home/mvp/mvp_db/news7-lv/2006/2006_02_17_19_00/2006_02_17_19_00.mpg;Junichiro KOIZUMI.jpg;18773;19125;35957;939;956;17
/net/per610a/home/mvp/mvp_db/news7-lv/2006/2006_02_20_19_00/2006_02_20_19_00.mpg;Seiji MAEHARA.jpg;25985;26617;35961;1299;1331;32
/net/per610a/home/mvp/mvp_db/news7-lv/2006/2006_02_20_19_00/2006_02_20_19_00.mpg;Junichiro KOIZUMI.jpg;33213;33633;35961;1661;1682;21
/net/per610a/home/mvp/mvp_db/news7-lv/2006/2006_02_21_19_00/2006_02_21_19_00.mpg;Seiji MAEHARA.jpg;14445;15289;35961;722;764;42
/net/per610a/home/mvp/mvp_db/news7-lv/2006/2006_02_22_19_00/2006_02_22_19_00.mpg;Seiji MAEHARA.jpg;22517;22937;35961;1126;1147;21
/net/per610a/home/mvp/mvp_db/news7-lv/2006/2006_02_23_19_00/2006_02_23_19_00.mpg;Junichiro KOIZUMI.jpg;7469;7641;35961;373;382;9
/net/per610a/home/mvp/mvp_db/news7-lv/2006/2006_02_23_19_00/2006_02_23_19_00.mpg;Seiji MAEHARA.jpg;7925;8201;35961;396;410;14
/net/per610a/home/mvp/mvp_db/news7-lv/2006/2006_02_23_19_00/2006_02_23_19_00.mpg;Seiji MAEHARA.jpg;13561;13905;35961;678;695;17
/net/per610a/home/mvp/mvp_db/news7-lv/2006/2006_02_24_19_00/2006_02_24_19_00.mpg;Seiji MAEHARA.jpg;15797;15885;35961;790;794;4
/net/per610a/home/mvp/mvp_db/news7-lv/2006/2006_02_24_19_00/2006_02_24_19_00.mpg;Yukio HATOYAMA.jpg;16317;16845;35961;816;842;26
/net/per610a/home/mvp/mvp_db/news7-lv/2006/2006_02_25_19_00/2006_02_25_19_00.mpg;Seiji MAEHARA.jpg;13405;16369;35961;670;818;148
/net/per610a/home/mvp/mvp_db/news7-lv/2006/2006_02_26_19_00/2006_02_26_19_00.mpg;Seiji MAEHARA.jpg;2485;2917;23973;124;145;21
/net/per610a/home/mvp/mvp_db/news7-lv/2006/2006_03_02_19_00/2006_03_02_19_00.mpg;Seiji MAEHARA.jpg;4161;4545;35961;208;227;19
/net/per610a/home/mvp/mvp_db/news7-lv/2006/2006_03_02_19_00/2006_03_02_19_00.mpg;Ichiro OZAWA.jpg;15049;15521;35961;752;776;24
/net/per610a/home/mvp/mvp_db/news7-lv/2006/2006_03_03_19_00/2006_03_03_19_00.mpg;Toranosuke Katayama.jpg;6353;6921;35961;317;346;29
/net/per610a/home/mvp/mvp_db/news7-lv/2006/2006_03_03_19_00/2006_03_03_19_00.mpg;Yukio HATOYAMA.jpg;9921;10361;35961;496;518;22
/net/per610a/home/mvp/mvp_db/news7-lv/2006/2006_03_04_19_00/2006_03_04_19_00.mpg;Seiji MAEHARA.jpg;6097;6441;35961;305;322;17
/net/per610a/home/mvp/mvp_db/news7-lv/2006/2006_03_05_19_00/2006_03_05_19_00.mpg;Seiji MAEHARA.jpg;1529;1585;23973;76;79;3
/net/per610a/home/mvp/mvp_db/news7-lv/2006/2006_03_05_19_00/2006_03_05_19_00.mpg;Seiji MAEHARA.jpg;1721;1721;23973;86;86;0
/net/per610a/home/mvp/mvp_db/news7-lv/2006/2006_03_05_19_00/2006_03_05_19_00.mpg;Seiji MAEHARA.jpg;3369;4897;23973;168;244;76
/net/per610a/home/mvp/mvp_db/news7-lv/2006/2006_03_06_19_00/2006_03_06_19_00.mpg;Junichiro KOIZUMI.jpg;13169;13873;35961;658;694;36
/net/per610a/home/mvp/mvp_db/news7-lv/2006/2006_03_06_19_00/2006_03_06_19_00.mpg;Junichiro KOIZUMI.jpg;14193;15229;35961;710;761;51
/net/per610a/home/mvp/mvp_db/news7-lv/2006/2006_03_07_19_00/2006_03_07_19_00.mpg;Shinzo ABE.jpg;13513;14013;35961;676;701;25
/net/per610a/home/mvp/mvp_db/news7-lv/2006/2006_03_08_19_00/2006_03_08_19_00.mpg;Shinzo ABE.jpg;3385;4829;35961;169;241;72
/net/per610a/home/mvp/mvp_db/news7-lv/2006/2006_03_08_19_00/2006_03_08_19_00.mpg;Shintaro ISHIHARA.jpg;24097;24417;35961;1205;1221;16
/net/per610a/home/mvp/mvp_db/news7-lv/2006/2006_03_09_19_00/2006_03_09_19_00.mpg;Shinzo ABE.jpg;3089;3725;35961;154;186;32
/net/per610a/home/mvp/mvp_db/news7-lv/2006/2006_03_09_19_00/2006_03_09_19_00.mpg;Junichiro KOIZUMI.jpg;6381;6633;35961;319;331;12
/net/per610a/home/mvp/mvp_db/news7-lv/2006/2006_03_10_19_00/2006_03_10_19_00.mpg;Yukio HATOYAMA.jpg;8721;9453;35961;436;472;36
/net/per610a/home/mvp/mvp_db/news7-lv/2006/2006_03_10_19_00/2006_03_10_19_00.mpg;Junichiro KOIZUMI.jpg;16461;17541;35961;823;877;54
/net/per610a/home/mvp/mvp_db/news7-lv/2006/2006_03_10_19_00/2006_03_10_19_00.mpg;Junichiro KOIZUMI.jpg;18741;19229;35961;937;961;24
/net/per610a/home/mvp/mvp_db/news7-lv/2006/2006_03_10_19_00/2006_03_10_19_00.mpg;Junichiro KOIZUMI.jpg;19669;19785;35961;983;989;6
/net/per610a/home/mvp/mvp_db/news7-lv/2006/2006_03_10_19_00/2006_03_10_19_00.mpg;Taro ASO.jpg;19793;19965;35961;990;998;8
/net/per610a/home/mvp/mvp_db/news7-lv/2006/2006_03_13_19_00/2006_03_13_19_00.mpg;Junichiro KOIZUMI.jpg;17973;18429;35961;899;921;22
/net/per610a/home/mvp/mvp_db/news7-lv/2006/2006_03_13_19_00/2006_03_13_19_00.mpg;Shinzo ABE.jpg;19493;19597;35961;975;980;5
/net/per610a/home/mvp/mvp_db/news7-lv/2006/2006_03_13_19_00/2006_03_13_19_00.mpg;Ichiro OZAWA.jpg;19837;19993;35961;992;1000;8
/net/per610a/home/mvp/mvp_db/news7-lv/2006/2006_03_13_19_00/2006_03_13_19_00.mpg;Junichiro KOIZUMI.jpg;23241;23933;35961;1162;1197;35
/net/per610a/home/mvp/mvp_db/news7-lv/2006/2006_03_15_19_00/2006_03_15_19_00.mpg;Shinzo ABE.jpg;7181;7609;35961;359;380;21
/net/per610a/home/mvp/mvp_db/news7-lv/2006/2006_03_17_19_00/2006_03_17_19_00.mpg;Shinzo ABE.jpg;22441;22561;35961;1122;1128;6
/net/per610a/home/mvp/mvp_db/news7-lv/2006/2006_03_18_19_00/2006_03_18_19_00.mpg;Taro ASO.jpg;13165;13573;35961;658;679;21
/net/per610a/home/mvp/mvp_db/news7-lv/2006/2006_03_20_19_00/2006_03_20_19_00.mpg;Shinzo ABE.jpg;22305;22725;35961;1115;1136;21
/net/per610a/home/mvp/mvp_db/news7-lv/2006/2006_03_22_19_00/2006_03_22_19_00.mpg;Junichiro KOIZUMI.jpg;10053;10461;35961;502;523;21
/net/per610a/home/mvp/mvp_db/news7-lv/2006/2006_03_22_19_00/2006_03_22_19_00.mpg;Akihiro OHTA.jpg;16085;17649;35961;804;882;78
/net/per610a/home/mvp/mvp_db/news7-lv/2006/2006_03_24_19_00/2006_03_24_19_00.mpg;Yukio HATOYAMA.jpg;12701;12985;35961;635;649;14
/net/per610a/home/mvp/mvp_db/news7-lv/2006/2006_03_24_19_00/2006_03_24_19_00.mpg;Junichiro KOIZUMI.jpg;13033;13453;35961;651;673;22
/net/per610a/home/mvp/mvp_db/news7-lv/2006/2006_03_26_19_00/2006_03_26_19_00.mpg;Yukio HATOYAMA.jpg;14969;15237;23973;748;762;14
/net/per610a/home/mvp/mvp_db/news7-lv/2006/2006_03_26_19_00/2006_03_26_19_00.mpg;Yukio HATOYAMA.jpg;15633;16001;23973;781;800;19
/net/per610a/home/mvp/mvp_db/news7-lv/2006/2006_03_26_19_00/2006_03_26_19_00.mpg;Yukio HATOYAMA.jpg;16069;17017;23973;803;851;48
/net/per610a/home/mvp/mvp_db/news7-lv/2006/2006_03_27_19_00/2006_03_27_19_00.mpg;Seiji MAEHARA.jpg;16269;16461;35961;813;823;10
/net/per610a/home/mvp/mvp_db/news7-lv/2006/2006_03_28_19_00/2006_03_28_19_00.mpg;Seiji MAEHARA.jpg;19145;19681;35961;957;984;27
/net/per610a/home/mvp/mvp_db/news7-lv/2006/2006_03_29_19_00/2006_03_29_19_00.mpg;Shinzo ABE.jpg;4921;5309;35961;246;265;19
/net/per610a/home/mvp/mvp_db/news7-lv/2006/2006_03_29_19_00/2006_03_29_19_00.mpg;Yukio HATOYAMA.jpg;8629;9329;35961;431;466;35
/net/per610a/home/mvp/mvp_db/news7-lv/2006/2006_03_29_19_00/2006_03_29_19_00.mpg;Taro ASO.jpg;14333;15541;35961;717;777;60
/net/per610a/home/mvp/mvp_db/news7-lv/2006/2006_03_30_19_00/2006_03_30_19_00.mpg;Shinzo ABE.jpg;20337;20641;35961;1017;1032;15
/net/per610a/home/mvp/mvp_db/news7-lv/2006/2006_03_31_19_00/2006_03_31_19_00.mpg;Seiji MAEHARA.jpg;1469;2277;35961;73;113;40
/net/per610a/home/mvp/mvp_db/news7-lv/2006/2006_03_31_19_00/2006_03_31_19_00.mpg;Seiji MAEHARA.jpg;2837;2953;35961;141;147;6
/net/per610a/home/mvp/mvp_db/news7-lv/2006/2006_03_31_19_00/2006_03_31_19_00.mpg;Seiji MAEHARA.jpg;3721;4197;35961;186;209;23
/net/per610a/home/mvp/mvp_db/news7-lv/2006/2006_03_31_19_00/2006_03_31_19_00.mpg;Seiji MAEHARA.jpg;4561;4721;35961;228;236;8
/net/per610a/home/mvp/mvp_db/news7-lv/2006/2006_03_31_19_00/2006_03_31_19_00.mpg;Seiji MAEHARA.jpg;6265;6473;35961;313;323;10
/net/per610a/home/mvp/mvp_db/news7-lv/2006/2006_03_31_19_00/2006_03_31_19_00.mpg;Seiji MAEHARA.jpg;11449;11569;35961;572;578;6
/net/per610a/home/mvp/mvp_db/news7-lv/2006/2006_03_31_19_00/2006_03_31_19_00.mpg;Seiji MAEHARA.jpg;13301;13393;35961;665;670;5
/net/per610a/home/mvp/mvp_db/news7-lv/2006/2006_03_31_19_00/2006_03_31_19_00.mpg;Seiji MAEHARA.jpg;14813;14937;35961;741;747;6
/net/per610a/home/mvp/mvp_db/news7-lv/2006/2006_03_31_19_00/2006_03_31_19_00.mpg;Seiji MAEHARA.jpg;17833;17905;35961;892;895;3
/net/per610a/home/mvp/mvp_db/news7-lv/2006/2006_03_31_19_00/2006_03_31_19_00.mpg;Seiji MAEHARA.jpg;2273;2381;35961;113;119;6
/net/per610a/home/mvp/mvp_db/news7-lv/2006/2006_03_31_19_00/2006_03_31_19_00.mpg;Yukio HATOYAMA.jpg;2461;2833;35961;123;141;18
/net/per610a/home/mvp/mvp_db/news7-lv/2006/2006_03_31_19_00/2006_03_31_19_00.mpg;Yukio HATOYAMA.jpg;16985;17201;35961;849;860;11
/net/per610a/home/mvp/mvp_db/news7-lv/2006/2006_03_31_19_00/2006_03_31_19_00.mpg;Seiji MAEHARA.jpg;10713;10745;35961;535;537;2
/net/per610a/home/mvp/mvp_db/news7-lv/2006/2006_03_31_19_00/2006_03_31_19_00.mpg;Seiji MAEHARA.jpg;14065;14117;35961;703;706;3
/net/per610a/home/mvp/mvp_db/news7-lv/2006/2006_03_31_19_00/2006_03_31_19_00.mpg;Junichiro KOIZUMI.jpg;14941;16453;35961;747;823;76
/net/per610a/home/mvp/mvp_db/news7-lv/2006/2006_04_01_19_00/2006_04_01_19_00.mpg;Seiji MAEHARA.jpg;11189;12229;35961;559;611;52
/net/per610a/home/mvp/mvp_db/news7-lv/2006/2006_04_01_19_00/2006_04_01_19_00.mpg;Seiji MAEHARA.jpg;13049;13189;35961;652;659;7
/net/per610a/home/mvp/mvp_db/news7-lv/2006/2006_04_01_19_00/2006_04_01_19_00.mpg;Seiji MAEHARA.jpg;11505;12229;35961;575;611;36
/net/per610a/home/mvp/mvp_db/news7-lv/2006/2006_04_03_19_00/2006_04_03_19_00.mpg;Yukio HATOYAMA.jpg;401;425;35961;20;21;1
/net/per610a/home/mvp/mvp_db/news7-lv/2006/2006_04_03_19_00/2006_04_03_19_00.mpg;Yukio HATOYAMA.jpg;5537;6133;35961;276;306;30
/net/per610a/home/mvp/mvp_db/news7-lv/2006/2006_04_05_19_00/2006_04_05_19_00.mpg;Junichiro KOIZUMI.jpg;6817;7485;35961;341;374;33
/net/per610a/home/mvp/mvp_db/news7-lv/2006/2006_04_06_19_00/2006_04_06_19_00.mpg;Ichiro OZAWA.jpg;2053;2613;35961;102;130;28
/net/per610a/home/mvp/mvp_db/news7-lv/2006/2006_04_06_19_00/2006_04_06_19_00.mpg;Ichiro OZAWA.jpg;4617;4713;35961;230;235;5
/net/per610a/home/mvp/mvp_db/news7-lv/2006/2006_04_06_19_00/2006_04_06_19_00.mpg;Ichiro OZAWA.jpg;5101;7177;35961;255;359;104
/net/per610a/home/mvp/mvp_db/news7-lv/2006/2006_04_06_19_00/2006_04_06_19_00.mpg;Ichiro OZAWA.jpg;8681;8781;35961;434;439;5
/net/per610a/home/mvp/mvp_db/news7-lv/2006/2006_04_06_19_00/2006_04_06_19_00.mpg;Ichiro OZAWA.jpg;34573;34673;35961;1729;1734;5
/net/per610a/home/mvp/mvp_db/news7-lv/2006/2006_04_06_19_00/2006_04_06_19_00.mpg;Naoto KAN.jpg;4729;4837;35961;236;241;5
/net/per610a/home/mvp/mvp_db/news7-lv/2006/2006_04_06_19_00/2006_04_06_19_00.mpg;Naoto KAN.jpg;4905;5081;35961;245;254;9
/net/per610a/home/mvp/mvp_db/news7-lv/2006/2006_04_06_19_00/2006_04_06_19_00.mpg;Naoto KAN.jpg;8793;8905;35961;439;445;6
/net/per610a/home/mvp/mvp_db/news7-lv/2006/2006_04_06_19_00/2006_04_06_19_00.mpg;Naoto KAN.jpg;34689;34793;35961;1735;1740;5
/net/per610a/home/mvp/mvp_db/news7-lv/2006/2006_04_06_19_00/2006_04_06_19_00.mpg;Naoto KAN.jpg;7849;8245;35961;392;412;20
/net/per610a/home/mvp/mvp_db/news7-lv/2006/2006_04_06_19_00/2006_04_06_19_00.mpg;Naoto KAN.jpg;8981;8981;35961;449;449;0
/net/per610a/home/mvp/mvp_db/news7-lv/2006/2006_04_06_19_00/2006_04_06_19_00.mpg;Naoto KAN.jpg;9133;9213;35961;456;460;4
/net/per610a/home/mvp/mvp_db/news7-lv/2006/2006_04_06_19_00/2006_04_06_19_00.mpg;Naoto KAN.jpg;34861;35041;35961;1743;1752;9
/net/per610a/home/mvp/mvp_db/news7-lv/2006/2006_04_07_19_00/2006_04_07_19_00.mpg;Ichiro OZAWA.jpg;1825;3369;35961;91;168;77
/net/per610a/home/mvp/mvp_db/news7-lv/2006/2006_04_07_19_00/2006_04_07_19_00.mpg;Ichiro OZAWA.jpg;3537;3901;35961;176;195;19
/net/per610a/home/mvp/mvp_db/news7-lv/2006/2006_04_07_19_00/2006_04_07_19_00.mpg;Ichiro OZAWA.jpg;9865;10013;35961;493;500;7
/net/per610a/home/mvp/mvp_db/news7-lv/2006/2006_04_07_19_00/2006_04_07_19_00.mpg;Ichiro OZAWA.jpg;12541;12561;35961;627;628;1
/net/per610a/home/mvp/mvp_db/news7-lv/2006/2006_04_07_19_00/2006_04_07_19_00.mpg;Ichiro OZAWA.jpg;13529;13673;35961;676;684;8
/net/per610a/home/mvp/mvp_db/news7-lv/2006/2006_04_07_19_00/2006_04_07_19_00.mpg;Naoto KAN.jpg;6069;6477;35961;303;324;21
/net/per610a/home/mvp/mvp_db/news7-lv/2006/2006_04_07_19_00/2006_04_07_19_00.mpg;Naoto KAN.jpg;7029;7165;35961;351;358;7
/net/per610a/home/mvp/mvp_db/news7-lv/2006/2006_04_07_19_00/2006_04_07_19_00.mpg;Junichiro KOIZUMI.jpg;15557;18249;35961;778;912;134
/net/per610a/home/mvp/mvp_db/news7-lv/2006/2006_04_08_19_00/2006_04_08_19_00.mpg;Yukio HATOYAMA.jpg;149;317;35961;7;15;8
/net/per610a/home/mvp/mvp_db/news7-lv/2006/2006_04_08_19_00/2006_04_08_19_00.mpg;Yukio HATOYAMA.jpg;1965;2041;35961;98;102;4
/net/per610a/home/mvp/mvp_db/news7-lv/2006/2006_04_08_19_00/2006_04_08_19_00.mpg;Yukio HATOYAMA.jpg;4385;4749;35961;219;237;18
/net/per610a/home/mvp/mvp_db/news7-lv/2006/2006_04_08_19_00/2006_04_08_19_00.mpg;Yukio HATOYAMA.jpg;3521;3565;35961;176;178;2
/net/per610a/home/mvp/mvp_db/news7-lv/2006/2006_04_08_19_00/2006_04_08_19_00.mpg;Yukio HATOYAMA.jpg;35073;35105;35961;1754;1756;2
/net/per610a/home/mvp/mvp_db/news7-lv/2006/2006_04_10_19_00/2006_04_10_19_00.mpg;Ichiro OZAWA.jpg;2569;2657;35961;128;132;4
/net/per610a/home/mvp/mvp_db/news7-lv/2006/2006_04_10_19_00/2006_04_10_19_00.mpg;Ichiro OZAWA.jpg;2833;2861;35961;141;143;2
/net/per610a/home/mvp/mvp_db/news7-lv/2006/2006_04_10_19_00/2006_04_10_19_00.mpg;Ichiro OZAWA.jpg;3289;3301;35961;164;165;1
/net/per610a/home/mvp/mvp_db/news7-lv/2006/2006_04_10_19_00/2006_04_10_19_00.mpg;Junichiro KOIZUMI.jpg;17817;18037;35961;891;902;11
/net/per610a/home/mvp/mvp_db/news7-lv/2006/2006_04_10_19_00/2006_04_10_19_00.mpg;Junichiro KOIZUMI.jpg;22541;22565;35961;1127;1128;1
/net/per610a/home/mvp/mvp_db/news7-lv/2006/2006_04_10_19_00/2006_04_10_19_00.mpg;Seiji MAEHARA.jpg;19029;19477;35961;951;974;23
/net/per610a/home/mvp/mvp_db/news7-lv/2006/2006_04_11_19_00/2006_04_11_19_00.mpg;Junichiro KOIZUMI.jpg;11001;12145;35961;550;607;57
/net/per610a/home/mvp/mvp_db/news7-lv/2006/2006_04_12_19_00/2006_04_12_19_00.mpg;Shinzo ABE.jpg;10689;11421;35961;534;571;37
/net/per610a/home/mvp/mvp_db/news7-lv/2006/2006_04_13_19_00/2006_04_13_19_00.mpg;Taro ASO.jpg;19561;19873;35961;978;994;16
/net/per610a/home/mvp/mvp_db/news7-lv/2006/2006_04_13_19_00/2006_04_13_19_00.mpg;Shinzo ABE.jpg;22573;23153;35961;1129;1158;29
/net/per610a/home/mvp/mvp_db/news7-lv/2006/2006_04_14_19_00/2006_04_14_19_00.mpg;Junichiro KOIZUMI.jpg;27481;27605;35961;1374;1380;6
/net/per610a/home/mvp/mvp_db/news7-lv/2006/2006_04_17_19_00/2006_04_17_19_00.mpg;Shinzo ABE.jpg;20089;20637;35961;1004;1032;28
/net/per610a/home/mvp/mvp_db/news7-lv/2006/2006_04_17_19_00/2006_04_17_19_00.mpg;Ichiro OZAWA.jpg;27589;28297;35961;1380;1415;35
/net/per610a/home/mvp/mvp_db/news7-lv/2006/2006_04_18_19_00/2006_04_18_19_00.mpg;YUriko Koike.jpg;20577;20897;35961;1029;1045;16
/net/per610a/home/mvp/mvp_db/news7-lv/2006/2006_04_18_19_00/2006_04_18_19_00.mpg;Ichiro OZAWA.jpg;21785;22649;35961;1089;1133;44
/net/per610a/home/mvp/mvp_db/news7-lv/2006/2006_04_19_19_00/2006_04_19_19_00.mpg;Shinzo ABE.jpg;8305;8705;35961;415;435;20
/net/per610a/home/mvp/mvp_db/news7-lv/2006/2006_04_19_19_00/2006_04_19_19_00.mpg;Junichiro KOIZUMI.jpg;20425;20861;35961;1021;1043;22
/net/per610a/home/mvp/mvp_db/news7-lv/2006/2006_04_19_19_00/2006_04_19_19_00.mpg;Junichiro KOIZUMI.jpg;20925;20949;35961;1046;1048;2
/net/per610a/home/mvp/mvp_db/news7-lv/2006/2006_04_19_19_00/2006_04_19_19_00.mpg;Junichiro KOIZUMI.jpg;21765;22177;35961;1088;1109;21
/net/per610a/home/mvp/mvp_db/news7-lv/2006/2006_04_20_19_00/2006_04_20_19_00.mpg;Shinzo ABE.jpg;8641;10037;35961;432;502;70
/net/per610a/home/mvp/mvp_db/news7-lv/2006/2006_04_21_19_00/2006_04_21_19_00.mpg;Junichiro KOIZUMI.jpg;9897;10289;35961;495;514;19
/net/per610a/home/mvp/mvp_db/news7-lv/2006/2006_04_21_19_00/2006_04_21_19_00.mpg;Toru Hashimoto.jpg;17457;17649;35961;873;882;9
/net/per610a/home/mvp/mvp_db/news7-lv/2006/2006_04_21_19_00/2006_04_21_19_00.mpg;Sadakazu TANIGAKI.jpg;18085;18317;35961;904;916;12
/net/per610a/home/mvp/mvp_db/news7-lv/2006/2006_04_24_19_00/2006_04_24_19_00.mpg;Junichiro KOIZUMI.jpg;14041;14265;35961;702;713;11
/net/per610a/home/mvp/mvp_db/news7-lv/2006/2006_04_25_19_00/2006_04_25_19_00.mpg;Junichiro KOIZUMI.jpg;1109;1217;35961;55;60;5
/net/per610a/home/mvp/mvp_db/news7-lv/2006/2006_04_25_19_00/2006_04_25_19_00.mpg;Junichiro KOIZUMI.jpg;19245;19277;35961;962;964;2
/net/per610a/home/mvp/mvp_db/news7-lv/2006/2006_04_25_19_00/2006_04_25_19_00.mpg;Junichiro KOIZUMI.jpg;19361;19965;35961;968;998;30
/net/per610a/home/mvp/mvp_db/news7-lv/2006/2006_04_26_19_00/2006_04_26_19_00.mpg;Junichiro KOIZUMI.jpg;23637;24093;35961;1182;1205;23
/net/per610a/home/mvp/mvp_db/news7-lv/2006/2006_04_26_19_00/2006_04_26_19_00.mpg;Junichiro KOIZUMI.jpg;24265;25021;35961;1213;1251;38
/net/per610a/home/mvp/mvp_db/news7-lv/2006/2006_04_26_19_00/2006_04_26_19_00.mpg;Junichiro KOIZUMI.jpg;25185;25617;35961;1259;1281;22
/net/per610a/home/mvp/mvp_db/news7-lv/2006/2006_04_26_19_00/2006_04_26_19_00.mpg;Junichiro KOIZUMI.jpg;25813;26253;35961;1291;1313;22
/net/per610a/home/mvp/mvp_db/news7-lv/2006/2006_04_26_19_00/2006_04_26_19_00.mpg;Junichiro KOIZUMI.jpg;26497;26685;35961;1325;1334;9
/net/per610a/home/mvp/mvp_db/news7-lv/2006/2006_04_26_19_00/2006_04_26_19_00.mpg;Seiji MAEHARA.jpg;27741;28137;35961;1387;1407;20
/net/per610a/home/mvp/mvp_db/news7-lv/2006/2006_04_28_19_00/2006_04_28_19_00.mpg;Junichiro KOIZUMI.jpg;9937;10581;35957;497;529;32
/net/per610a/home/mvp/mvp_db/news7-lv/2006/2006_04_29_19_00/2006_04_29_19_00.mpg;Junichiro KOIZUMI.jpg;7945;8469;35961;397;423;26
/net/per610a/home/mvp/mvp_db/news7-lv/2006/2006_04_29_19_00/2006_04_29_19_00.mpg;Junichiro KOIZUMI.jpg;25905;26173;35961;1295;1309;14
/net/per610a/home/mvp/mvp_db/news7-lv/2006/2006_04_30_19_00/2006_04_30_19_00.mpg;Junichiro KOIZUMI.jpg;14205;14913;23973;710;745;35
/net/per610a/home/mvp/mvp_db/news7-lv/2006/2006_05_01_19_00/2006_05_01_19_00.mpg;Shintaro ISHIHARA.jpg;14901;15089;35961;745;754;9
/net/per610a/home/mvp/mvp_db/news7-lv/2006/2006_05_01_19_00/2006_05_01_19_00.mpg;Shintaro ISHIHARA.jpg;17701;17721;35961;885;886;1
/net/per610a/home/mvp/mvp_db/news7-lv/2006/2006_05_01_19_00/2006_05_01_19_00.mpg;Ichiro OZAWA.jpg;14905;15085;35961;745;754;9
/net/per610a/home/mvp/mvp_db/news7-lv/2006/2006_05_01_19_00/2006_05_01_19_00.mpg;Ichiro OZAWA.jpg;16069;16257;35961;803;813;10
/net/per610a/home/mvp/mvp_db/news7-lv/2006/2006_05_01_19_00/2006_05_01_19_00.mpg;Ichiro OZAWA.jpg;17701;17721;35961;885;886;1
/net/per610a/home/mvp/mvp_db/news7-lv/2006/2006_05_02_19_00/2006_05_02_19_00.mpg;Taro ASO.jpg;5365;5781;35961;268;289;21
/net/per610a/home/mvp/mvp_db/news7-lv/2006/2006_05_08_19_00/2006_05_08_19_00.mpg;Shinzo ABE.jpg;14273;14677;35961;714;734;20
/net/per610a/home/mvp/mvp_db/news7-lv/2006/2006_05_08_19_00/2006_05_08_19_00.mpg;Shinzo ABE.jpg;14781;16129;35961;739;806;67
/net/per610a/home/mvp/mvp_db/news7-lv/2006/2006_05_09_19_00/2006_05_09_19_00.mpg;Shinzo ABE.jpg;9321;9561;35961;466;478;12
/net/per610a/home/mvp/mvp_db/news7-lv/2006/2006_05_10_19_00/2006_05_10_19_00.mpg;Junichiro KOIZUMI.jpg;21145;21397;35961;1057;1070;13
/net/per610a/home/mvp/mvp_db/news7-lv/2006/2006_05_11_19_00/2006_05_11_19_00.mpg;Shinzo ABE.jpg;11429;11465;35961;571;573;2
/net/per610a/home/mvp/mvp_db/news7-lv/2006/2006_05_11_19_00/2006_05_11_19_00.mpg;Shinzo ABE.jpg;11741;11741;35961;587;587;0
/net/per610a/home/mvp/mvp_db/news7-lv/2006/2006_05_11_19_00/2006_05_11_19_00.mpg;Shinzo ABE.jpg;12333;12625;35961;616;631;15
/net/per610a/home/mvp/mvp_db/news7-lv/2006/2006_05_11_19_00/2006_05_11_19_00.mpg;Shinzo ABE.jpg;13945;14769;35961;697;738;41
/net/per610a/home/mvp/mvp_db/news7-lv/2006/2006_05_11_19_00/2006_05_11_19_00.mpg;Yasuo FUKUDA.jpg;12333;13625;35961;616;681;65
/net/per610a/home/mvp/mvp_db/news7-lv/2006/2006_05_11_19_00/2006_05_11_19_00.mpg;Yasuo FUKUDA.jpg;15297;15685;35961;765;784;19
/net/per610a/home/mvp/mvp_db/news7-lv/2006/2006_05_11_19_00/2006_05_11_19_00.mpg;Taro ASO.jpg;16773;16985;35961;839;849;10
/net/per610a/home/mvp/mvp_db/news7-lv/2006/2006_05_12_19_00/2006_05_12_19_00.mpg;Shinzo ABE.jpg;7817;8161;35961;391;408;17
/net/per610a/home/mvp/mvp_db/news7-lv/2006/2006_05_15_19_00/2006_05_15_19_00.mpg;Junichiro KOIZUMI.jpg;16001;16157;35961;800;808;8
/net/per610a/home/mvp/mvp_db/news7-lv/2006/2006_05_15_19_00/2006_05_15_19_00.mpg;Shinzo ABE.jpg;17293;17601;35961;865;880;15
/net/per610a/home/mvp/mvp_db/news7-lv/2006/2006_05_15_19_00/2006_05_15_19_00.mpg;Shinzo ABE.jpg;24253;24521;35961;1213;1226;13
/net/per610a/home/mvp/mvp_db/news7-lv/2006/2006_05_15_19_00/2006_05_15_19_00.mpg;Yasuo FUKUDA.jpg;17293;17705;35961;865;885;20
/net/per610a/home/mvp/mvp_db/news7-lv/2006/2006_05_15_19_00/2006_05_15_19_00.mpg;Yasuo FUKUDA.jpg;24253;24521;35961;1213;1226;13
/net/per610a/home/mvp/mvp_db/news7-lv/2006/2006_05_15_19_00/2006_05_15_19_00.mpg;Sadakazu TANIGAKI.jpg;21649;21989;35961;1083;1100;17
/net/per610a/home/mvp/mvp_db/news7-lv/2006/2006_05_15_19_00/2006_05_15_19_00.mpg;Sadakazu TANIGAKI.jpg;22093;22561;35961;1105;1128;23
/net/per610a/home/mvp/mvp_db/news7-lv/2006/2006_05_15_19_00/2006_05_15_19_00.mpg;Sadakazu TANIGAKI.jpg;22741;23601;35961;1137;1180;43
/net/per610a/home/mvp/mvp_db/news7-lv/2006/2006_05_16_19_00/2006_05_16_19_00.mpg;Ichiro OZAWA.jpg;27541;27637;35961;1377;1382;5
/net/per610a/home/mvp/mvp_db/news7-lv/2006/2006_05_17_19_00/2006_05_17_19_00.mpg;Ichiro OZAWA.jpg;15761;15765;35961;788;788;0
/net/per610a/home/mvp/mvp_db/news7-lv/2006/2006_05_17_19_00/2006_05_17_19_00.mpg;Ichiro OZAWA.jpg;18057;18833;35961;903;942;39
/net/per610a/home/mvp/mvp_db/news7-lv/2006/2006_05_19_19_00/2006_05_19_19_00.mpg;Shinzo ABE.jpg;16501;16873;35961;825;844;19
/net/per610a/home/mvp/mvp_db/news7-lv/2006/2006_05_19_19_00/2006_05_19_19_00.mpg;Akihiro OHTA.jpg;24765;24829;35961;1238;1242;4
/net/per610a/home/mvp/mvp_db/news7-lv/2006/2006_05_20_19_00/2006_05_20_19_00.mpg;Yukio HATOYAMA.jpg;25021;25905;35957;1251;1296;45
/net/per610a/home/mvp/mvp_db/news7-lv/2006/2006_05_24_19_00/2006_05_24_19_00.mpg;Junichiro KOIZUMI.jpg;441;517;35961;22;25;3
/net/per610a/home/mvp/mvp_db/news7-lv/2006/2006_05_24_19_00/2006_05_24_19_00.mpg;Junichiro KOIZUMI.jpg;589;641;35961;29;32;3
/net/per610a/home/mvp/mvp_db/news7-lv/2006/2006_05_24_19_00/2006_05_24_19_00.mpg;Junichiro KOIZUMI.jpg;2633;2737;35961;131;136;5
/net/per610a/home/mvp/mvp_db/news7-lv/2006/2006_05_24_19_00/2006_05_24_19_00.mpg;Junichiro KOIZUMI.jpg;4137;4197;35961;206;209;3
/net/per610a/home/mvp/mvp_db/news7-lv/2006/2006_05_24_19_00/2006_05_24_19_00.mpg;Junichiro KOIZUMI.jpg;4313;4401;35961;215;220;5
/net/per610a/home/mvp/mvp_db/news7-lv/2006/2006_05_25_19_00/2006_05_25_19_00.mpg;Shinzo ABE.jpg;149;525;35961;7;26;19
/net/per610a/home/mvp/mvp_db/news7-lv/2006/2006_05_25_19_00/2006_05_25_19_00.mpg;Sadakazu TANIGAKI.jpg;2025;2025;35961;101;101;0
/net/per610a/home/mvp/mvp_db/news7-lv/2006/2006_05_25_19_00/2006_05_25_19_00.mpg;Sadakazu TANIGAKI.jpg;2133;2133;35961;106;106;0
/net/per610a/home/mvp/mvp_db/news7-lv/2006/2006_05_25_19_00/2006_05_25_19_00.mpg;Sadakazu TANIGAKI.jpg;2329;2337;35961;116;116;0
/net/per610a/home/mvp/mvp_db/news7-lv/2006/2006_05_25_19_00/2006_05_25_19_00.mpg;Sadakazu TANIGAKI.jpg;4485;5301;35961;224;265;41
/net/per610a/home/mvp/mvp_db/news7-lv/2006/2006_05_25_19_00/2006_05_25_19_00.mpg;Junichiro KOIZUMI.jpg;6865;7337;35961;343;367;24
/net/per610a/home/mvp/mvp_db/news7-lv/2006/2006_05_26_19_00/2006_05_26_19_00.mpg;Junichiro KOIZUMI.jpg;28105;28861;35961;1405;1443;38
/net/per610a/home/mvp/mvp_db/news7-lv/2006/2006_05_27_19_00/2006_05_27_19_00.mpg;Junichiro KOIZUMI.jpg;15653;16073;35961;783;804;21
/net/per610a/home/mvp/mvp_db/news7-lv/2006/2006_05_28_19_00/2006_05_28_19_00.mpg;Ichiro OZAWA.jpg;16621;17021;23973;831;851;20
/net/per610a/home/mvp/mvp_db/news7-lv/2006/2006_05_28_19_00/2006_05_28_19_00.mpg;Yasuo FUKUDA.jpg;17433;17829;23973;871;891;20
/net/per610a/home/mvp/mvp_db/news7-lv/2006/2006_05_28_19_00/2006_05_28_19_00.mpg;Shinzo ABE.jpg;18021;18213;23973;901;910;9
/net/per610a/home/mvp/mvp_db/news7-lv/2006/2006_05_28_19_00/2006_05_28_19_00.mpg;Shinzo ABE.jpg;19117;19133;23973;956;956;0
/net/per610a/home/mvp/mvp_db/news7-lv/2006/2006_06_02_19_00/2006_06_02_19_00.mpg;Shinzo ABE.jpg;565;797;35961;28;39;11
/net/per610a/home/mvp/mvp_db/news7-lv/2006/2006_06_02_19_00/2006_06_02_19_00.mpg;Shinzo ABE.jpg;6809;7089;35961;340;354;14
/net/per610a/home/mvp/mvp_db/news7-lv/2006/2006_06_02_19_00/2006_06_02_19_00.mpg;Shinzo ABE.jpg;7905;8397;35961;395;420;25
/net/per610a/home/mvp/mvp_db/news7-lv/2006/2006_06_02_19_00/2006_06_02_19_00.mpg;Shinzo ABE.jpg;10261;10269;35961;513;513;0
/net/per610a/home/mvp/mvp_db/news7-lv/2006/2006_06_02_19_00/2006_06_02_19_00.mpg;Masashi Nakano.jpg;7205;7269;35961;360;363;3
/net/per610a/home/mvp/mvp_db/news7-lv/2006/2006_06_02_19_00/2006_06_02_19_00.mpg;Junichiro KOIZUMI.jpg;9769;10257;35961;488;513;25
/net/per610a/home/mvp/mvp_db/news7-lv/2006/2006_06_02_19_00/2006_06_02_19_00.mpg;Ichiro OZAWA.jpg;18265;18405;35961;913;920;7
/net/per610a/home/mvp/mvp_db/news7-lv/2006/2006_06_10_19_00/2006_06_10_19_00.mpg;Sadakazu TANIGAKI.jpg;24245;24345;35961;1212;1217;5
/net/per610a/home/mvp/mvp_db/news7-lv/2006/2006_06_12_19_00/2006_06_12_19_00.mpg;Junichiro KOIZUMI.jpg;24413;24653;35961;1221;1233;12
/net/per610a/home/mvp/mvp_db/news7-lv/2006/2006_06_12_19_00/2006_06_12_19_00.mpg;Shinzo ABE.jpg;24849;25145;35961;1243;1257;14
/net/per610a/home/mvp/mvp_db/news7-lv/2006/2006_06_12_19_00/2006_06_12_19_00.mpg;Yasuo FUKUDA.jpg;24849;25145;35961;1243;1257;14
/net/per610a/home/mvp/mvp_db/news7-lv/2006/2006_06_12_19_00/2006_06_12_19_00.mpg;Ichiro OZAWA.jpg;25173;25381;35961;1259;1269;10
/net/per610a/home/mvp/mvp_db/news7-lv/2006/2006_06_12_19_00/2006_06_12_19_00.mpg;Taro ASO.jpg;25173;25381;35961;1259;1269;10
/net/per610a/home/mvp/mvp_db/news7-lv/2006/2006_06_12_19_00/2006_06_12_19_00.mpg;Sadakazu TANIGAKI.jpg;25173;25381;35961;1259;1269;10
/net/per610a/home/mvp/mvp_db/news7-lv/2006/2006_06_13_19_00/2006_06_13_19_00.mpg;Ichiro OZAWA.jpg;20097;20829;35961;1005;1042;37
/net/per610a/home/mvp/mvp_db/news7-lv/2006/2006_06_13_19_00/2006_06_13_19_00.mpg;Junichiro KOIZUMI.jpg;20873;21109;35961;1044;1056;12
/net/per610a/home/mvp/mvp_db/news7-lv/2006/2006_06_13_19_00/2006_06_13_19_00.mpg;YUriko Koike.jpg;30225;30381;35961;1512;1519;7
/net/per610a/home/mvp/mvp_db/news7-lv/2006/2006_06_15_19_00/2006_06_15_19_00.mpg;Junichiro KOIZUMI.jpg;13757;14257;35961;688;713;25
/net/per610a/home/mvp/mvp_db/news7-lv/2006/2006_06_16_19_00/2006_06_16_19_00.mpg;Junichiro KOIZUMI.jpg;177;421;35961;8;21;13
/net/per610a/home/mvp/mvp_db/news7-lv/2006/2006_06_16_19_00/2006_06_16_19_00.mpg;Junichiro KOIZUMI.jpg;2241;2273;35961;112;113;1
/net/per610a/home/mvp/mvp_db/news7-lv/2006/2006_06_16_19_00/2006_06_16_19_00.mpg;Junichiro KOIZUMI.jpg;2465;3137;35961;123;156;33
/net/per610a/home/mvp/mvp_db/news7-lv/2006/2006_06_16_19_00/2006_06_16_19_00.mpg;Shinzo ABE.jpg;237;237;35961;11;11;0
/net/per610a/home/mvp/mvp_db/news7-lv/2006/2006_06_16_19_00/2006_06_16_19_00.mpg;Shinzo ABE.jpg;18777;19393;35961;939;970;31
/net/per610a/home/mvp/mvp_db/news7-lv/2006/2006_06_16_19_00/2006_06_16_19_00.mpg;Junichiro KOIZUMI.jpg;1657;1697;35961;82;84;2
/net/per610a/home/mvp/mvp_db/news7-lv/2006/2006_06_16_19_00/2006_06_16_19_00.mpg;Junichiro KOIZUMI.jpg;1765;1869;35961;88;93;5
/net/per610a/home/mvp/mvp_db/news7-lv/2006/2006_06_16_19_00/2006_06_16_19_00.mpg;Junichiro KOIZUMI.jpg;2065;2149;35961;103;107;4
/net/per610a/home/mvp/mvp_db/news7-lv/2006/2006_06_16_19_00/2006_06_16_19_00.mpg;Sadakazu TANIGAKI.jpg;3313;3561;35961;165;178;13
/net/per610a/home/mvp/mvp_db/news7-lv/2006/2006_06_16_19_00/2006_06_16_19_00.mpg;Toranosuke Katayama.jpg;17021;17473;35961;851;874;23
/net/per610a/home/mvp/mvp_db/news7-lv/2006/2006_06_16_19_00/2006_06_16_19_00.mpg;Yukio HATOYAMA.jpg;17501;17973;35961;875;899;24
/net/per610a/home/mvp/mvp_db/news7-lv/2006/2006_06_16_19_00/2006_06_16_19_00.mpg;Shintaro ISHIHARA.jpg;27217;27333;35961;1361;1367;6
/net/per610a/home/mvp/mvp_db/news7-lv/2006/2006_06_16_19_00/2006_06_16_19_00.mpg;Shintaro ISHIHARA.jpg;27641;27997;35961;1382;1400;18
/net/per610a/home/mvp/mvp_db/news7-lv/2006/2006_06_18_19_00/2006_06_18_19_00.mpg;Taro ASO.jpg;3845;4465;35961;192;223;31
/net/per610a/home/mvp/mvp_db/news7-lv/2006/2006_06_19_19_00/2006_06_19_19_00.mpg;Junichiro KOIZUMI.jpg;9193;9457;35961;459;473;14
/net/per610a/home/mvp/mvp_db/news7-lv/2006/2006_06_19_19_00/2006_06_19_19_00.mpg;Junichiro KOIZUMI.jpg;9881;10301;35961;494;515;21
/net/per610a/home/mvp/mvp_db/news7-lv/2006/2006_06_19_19_00/2006_06_19_19_00.mpg;Junichiro KOIZUMI.jpg;11521;11889;35961;576;594;18
/net/per610a/home/mvp/mvp_db/news7-lv/2006/2006_06_20_19_00/2006_06_20_19_00.mpg;Ichiro OZAWA.jpg;32949;33213;35961;1648;1661;13
/net/per610a/home/mvp/mvp_db/news7-lv/2006/2006_06_21_19_00/2006_06_21_19_00.mpg;Shinzo ABE.jpg;7193;7501;35961;359;375;16
/net/per610a/home/mvp/mvp_db/news7-lv/2006/2006_06_21_19_00/2006_06_21_19_00.mpg;Junichiro KOIZUMI.jpg;11969;12589;35961;598;629;31
/net/per610a/home/mvp/mvp_db/news7-lv/2006/2006_06_22_19_00/2006_06_22_19_00.mpg;Shinzo ABE.jpg;30589;30801;35961;1530;1540;10
/net/per610a/home/mvp/mvp_db/news7-lv/2006/2006_06_24_19_00/2006_06_24_19_00.mpg;Kazuo SHII.jpg;13477;13545;35961;674;677;3
/net/per610a/home/mvp/mvp_db/news7-lv/2006/2006_06_24_19_00/2006_06_24_19_00.mpg;Kazuo SHII.jpg;13989;14141;35961;699;707;8
/net/per610a/home/mvp/mvp_db/news7-lv/2006/2006_06_27_19_00/2006_06_27_19_00.mpg;Shinzo ABE.jpg;22149;22505;35961;1108;1125;17
/net/per610a/home/mvp/mvp_db/news7-lv/2006/2006_06_29_19_00/2006_06_29_19_00.mpg;Shinzo ABE.jpg;7601;7945;35961;380;397;17
/net/per610a/home/mvp/mvp_db/news7-lv/2006/2006_06_30_19_00/2006_06_30_19_00.mpg;Shinzo ABE.jpg;4565;5185;35961;228;259;31
/net/per610a/home/mvp/mvp_db/news7-lv/2006/2006_06_30_19_00/2006_06_30_19_00.mpg;Shintaro ISHIHARA.jpg;15717;16069;35961;786;803;17
/net/per610a/home/mvp/mvp_db/news7-lv/2006/2006_06_30_19_00/2006_06_30_19_00.mpg;Ichiro OZAWA.jpg;16889;17313;35961;844;866;22
/net/per610a/home/mvp/mvp_db/news7-lv/2006/2006_07_01_19_00/2006_07_01_19_00.mpg;Ichiro OZAWA.jpg;8737;11101;35961;437;555;118
/net/per610a/home/mvp/mvp_db/news7-lv/2006/2006_07_03_19_00/2006_07_03_19_00.mpg;Shinzo ABE.jpg;4949;5321;35961;247;266;19
/net/per610a/home/mvp/mvp_db/news7-lv/2006/2006_07_03_19_00/2006_07_03_19_00.mpg;Shinzo ABE.jpg;16329;16429;35961;816;821;5
/net/per610a/home/mvp/mvp_db/news7-lv/2006/2006_07_04_19_00/2006_07_04_19_00.mpg;Toranosuke Katayama.jpg;7393;8093;35961;369;404;35
/net/per610a/home/mvp/mvp_db/news7-lv/2006/2006_07_05_19_00/2006_07_05_19_00.mpg;Junichiro KOIZUMI.jpg;329;481;35961;16;24;8
/net/per610a/home/mvp/mvp_db/news7-lv/2006/2006_07_05_19_00/2006_07_05_19_00.mpg;Junichiro KOIZUMI.jpg;1501;1817;35961;75;90;15
/net/per610a/home/mvp/mvp_db/news7-lv/2006/2006_07_05_19_00/2006_07_05_19_00.mpg;Junichiro KOIZUMI.jpg;12641;13093;35961;632;654;22
/net/per610a/home/mvp/mvp_db/news7-lv/2006/2006_07_05_19_00/2006_07_05_19_00.mpg;Shinzo ABE.jpg;6429;6821;35961;321;341;20
/net/per610a/home/mvp/mvp_db/news7-lv/2006/2006_07_05_19_00/2006_07_05_19_00.mpg;Shinzo ABE.jpg;12045;12409;35961;602;620;18
/net/per610a/home/mvp/mvp_db/news7-lv/2006/2006_07_05_19_00/2006_07_05_19_00.mpg;Junichiro KOIZUMI.jpg;17289;17349;35961;864;867;3
/net/per610a/home/mvp/mvp_db/news7-lv/2006/2006_07_05_19_00/2006_07_05_19_00.mpg;Junichiro KOIZUMI.jpg;31005;31209;35961;1551;1561;10
/net/per610a/home/mvp/mvp_db/news7-lv/2006/2006_07_06_19_00/2006_07_06_19_00.mpg;Shinzo ABE.jpg;8933;9737;35961;446;487;41
/net/per610a/home/mvp/mvp_db/news7-lv/2006/2006_07_07_19_00/2006_07_07_19_00.mpg;Shinzo ABE.jpg;5677;6513;35961;283;325;42
/net/per610a/home/mvp/mvp_db/news7-lv/2006/2006_07_07_19_00/2006_07_07_19_00.mpg;Junichiro KOIZUMI.jpg;6933;7501;35961;346;375;29
/net/per610a/home/mvp/mvp_db/news7-lv/2006/2006_07_08_19_00/2006_07_08_19_00.mpg;Taro ASO.jpg;10925;11877;35961;546;594;48
/net/per610a/home/mvp/mvp_db/news7-lv/2006/2006_07_09_19_00/2006_07_09_19_00.mpg;Taro ASO.jpg;5077;5749;35961;253;287;34
/net/per610a/home/mvp/mvp_db/news7-lv/2006/2006_07_09_19_00/2006_07_09_19_00.mpg;Taro ASO.jpg;6501;7485;35961;325;374;49
/net/per610a/home/mvp/mvp_db/news7-lv/2006/2006_07_10_19_00/2006_07_10_19_00.mpg;Shinzo ABE.jpg;421;573;35961;21;28;7
/net/per610a/home/mvp/mvp_db/news7-lv/2006/2006_07_10_19_00/2006_07_10_19_00.mpg;Shinzo ABE.jpg;12861;13697;35961;643;685;42
/net/per610a/home/mvp/mvp_db/news7-lv/2006/2006_07_10_19_00/2006_07_10_19_00.mpg;Shinzo ABE.jpg;15861;16201;35961;793;810;17
/net/per610a/home/mvp/mvp_db/news7-lv/2006/2006_07_10_19_00/2006_07_10_19_00.mpg;Junichiro KOIZUMI.jpg;3569;4545;35961;178;227;49
/net/per610a/home/mvp/mvp_db/news7-lv/2006/2006_07_10_19_00/2006_07_10_19_00.mpg;Junichiro KOIZUMI.jpg;15033;15073;35961;752;754;2
/net/per610a/home/mvp/mvp_db/news7-lv/2006/2006_07_10_19_00/2006_07_10_19_00.mpg;Junichiro KOIZUMI.jpg;15353;15545;35961;768;777;9
/net/per610a/home/mvp/mvp_db/news7-lv/2006/2006_07_10_19_00/2006_07_10_19_00.mpg;Ichiro OZAWA.jpg;16217;16433;35961;811;822;11
/net/per610a/home/mvp/mvp_db/news7-lv/2006/2006_07_10_19_00/2006_07_10_19_00.mpg;Sadakazu TANIGAKI.jpg;16217;16433;35961;811;822;11
/net/per610a/home/mvp/mvp_db/news7-lv/2006/2006_07_11_19_00/2006_07_11_19_00.mpg;Junichiro KOIZUMI.jpg;3413;4193;35961;170;209;39
/net/per610a/home/mvp/mvp_db/news7-lv/2006/2006_07_11_19_00/2006_07_11_19_00.mpg;Shinzo ABE.jpg;4245;4613;35961;212;230;18
/net/per610a/home/mvp/mvp_db/news7-lv/2006/2006_07_12_19_00/2006_07_12_19_00.mpg;Shinzo ABE.jpg;8713;9257;35961;435;463;28
/net/per610a/home/mvp/mvp_db/news7-lv/2006/2006_07_12_19_00/2006_07_12_19_00.mpg;Shinzo ABE.jpg;9321;9361;35961;466;468;2
/net/per610a/home/mvp/mvp_db/news7-lv/2006/2006_07_12_19_00/2006_07_12_19_00.mpg;Shinzo ABE.jpg;9437;9465;35961;472;473;1
/net/per610a/home/mvp/mvp_db/news7-lv/2006/2006_07_12_19_00/2006_07_12_19_00.mpg;Junichiro KOIZUMI.jpg;16537;16857;35961;827;843;16
/net/per610a/home/mvp/mvp_db/news7-lv/2006/2006_07_13_19_00/2006_07_13_19_00.mpg;Shinzo ABE.jpg;9273;10057;35961;463;503;40
/net/per610a/home/mvp/mvp_db/news7-lv/2006/2006_07_13_19_00/2006_07_13_19_00.mpg;Junichiro KOIZUMI.jpg;21277;21421;35961;1064;1071;7
/net/per610a/home/mvp/mvp_db/news7-lv/2006/2006_07_14_19_00/2006_07_14_19_00.mpg;Taro ASO.jpg;20085;20249;35961;1004;1012;8
/net/per610a/home/mvp/mvp_db/news7-lv/2006/2006_07_17_19_00/2006_07_17_19_00.mpg;Junichiro KOIZUMI.jpg;8913;9001;35961;445;450;5
/net/per610a/home/mvp/mvp_db/news7-lv/2006/2006_07_17_19_00/2006_07_17_19_00.mpg;Junichiro KOIZUMI.jpg;9405;9909;35961;470;495;25
/net/per610a/home/mvp/mvp_db/news7-lv/2006/2006_07_20_19_00/2006_07_20_19_00.mpg;Junichiro KOIZUMI.jpg;13845;15009;35961;692;750;58
/net/per610a/home/mvp/mvp_db/news7-lv/2006/2006_07_21_19_00/2006_07_21_19_00.mpg;Yasuo FUKUDA.jpg;2481;3173;35961;124;158;34
/net/per610a/home/mvp/mvp_db/news7-lv/2006/2006_07_23_19_00/2006_07_23_19_00.mpg;Taro ASO.jpg;20249;20333;35961;1012;1017;5
/net/per610a/home/mvp/mvp_db/news7-lv/2006/2006_07_23_19_00/2006_07_23_19_00.mpg;Taro ASO.jpg;20509;20633;35961;1025;1032;7
/net/per610a/home/mvp/mvp_db/news7-lv/2006/2006_07_23_19_00/2006_07_23_19_00.mpg;Taro ASO.jpg;20729;20841;35961;1036;1042;6
/net/per610a/home/mvp/mvp_db/news7-lv/2006/2006_07_26_19_00/2006_07_26_19_00.mpg;Nariaki Nakayama.png;19105;19545;35961;955;977;22
/net/per610a/home/mvp/mvp_db/news7-lv/2006/2006_07_27_19_00/2006_07_27_19_00.mpg;Shinzo ABE.jpg;233;389;35961;11;19;8
/net/per610a/home/mvp/mvp_db/news7-lv/2006/2006_07_27_19_00/2006_07_27_19_00.mpg;Sadakazu TANIGAKI.jpg;2765;3189;35961;138;159;21
/net/per610a/home/mvp/mvp_db/news7-lv/2006/2006_07_27_19_00/2006_07_27_19_00.mpg;Sadakazu TANIGAKI.jpg;3365;3677;35961;168;183;15
/net/per610a/home/mvp/mvp_db/news7-lv/2006/2006_07_27_19_00/2006_07_27_19_00.mpg;Sadakazu TANIGAKI.jpg;6133;6437;35961;306;322;16
/net/per610a/home/mvp/mvp_db/news7-lv/2006/2006_07_27_19_00/2006_07_27_19_00.mpg;Sadakazu TANIGAKI.jpg;6781;7697;35961;339;385;46
/net/per610a/home/mvp/mvp_db/news7-lv/2006/2006_07_27_19_00/2006_07_27_19_00.mpg;Shinzo ABE.jpg;3889;3993;35961;194;199;5
/net/per610a/home/mvp/mvp_db/news7-lv/2006/2006_07_27_19_00/2006_07_27_19_00.mpg;Sadakazu TANIGAKI.jpg;14793;15545;35961;740;777;37
/net/per610a/home/mvp/mvp_db/news7-lv/2006/2006_07_28_19_00/2006_07_28_19_00.mpg;Shinzo ABE.jpg;7033;8329;35961;351;416;65
/net/per610a/home/mvp/mvp_db/news7-lv/2006/2006_07_28_19_00/2006_07_28_19_00.mpg;Shinzo ABE.jpg;11161;11277;35961;558;564;6
/net/per610a/home/mvp/mvp_db/news7-lv/2006/2006_07_28_19_00/2006_07_28_19_00.mpg;Shinzo ABE.jpg;10373;10517;35961;518;526;8
/net/per610a/home/mvp/mvp_db/news7-lv/2006/2006_07_28_19_00/2006_07_28_19_00.mpg;Shinzo ABE.jpg;10585;11073;35961;529;553;24
/net/per610a/home/mvp/mvp_db/news7-lv/2006/2006_08_02_19_00/2006_08_02_19_00.mpg;Masashi Nakano.jpg;30553;30657;35961;1528;1533;5
/net/per610a/home/mvp/mvp_db/news7-lv/2006/2006_08_04_19_00/2006_08_04_19_00.mpg;Shinzo ABE.jpg;597;893;35961;29;44;15
/net/per610a/home/mvp/mvp_db/news7-lv/2006/2006_08_04_19_00/2006_08_04_19_00.mpg;Shinzo ABE.jpg;1845;2181;35961;92;109;17
/net/per610a/home/mvp/mvp_db/news7-lv/2006/2006_08_05_19_00/2006_08_05_19_00.mpg;Shinzo ABE.jpg;11577;11981;35961;579;599;20
/net/per610a/home/mvp/mvp_db/news7-lv/2006/2006_08_05_19_00/2006_08_05_19_00.mpg;Shinzo ABE.jpg;15857;16017;35961;793;801;8
/net/per610a/home/mvp/mvp_db/news7-lv/2006/2006_08_05_19_00/2006_08_05_19_00.mpg;Shinzo ABE.jpg;16085;16609;35961;804;830;26
/net/per610a/home/mvp/mvp_db/news7-lv/2006/2006_08_05_19_00/2006_08_05_19_00.mpg;Sadakazu TANIGAKI.jpg;13413;14333;35961;671;717;46
/net/per610a/home/mvp/mvp_db/news7-lv/2006/2006_08_05_19_00/2006_08_05_19_00.mpg;Taro ASO.jpg;15205;15657;35961;760;783;23
/net/per610a/home/mvp/mvp_db/news7-lv/2006/2006_08_06_19_00/2006_08_06_19_00.mpg;Shinzo ABE.jpg;20485;21221;35961;1024;1061;37
/net/per610a/home/mvp/mvp_db/news7-lv/2006/2006_08_06_19_00/2006_08_06_19_00.mpg;Taro ASO.jpg;21553;22553;35961;1078;1128;50
/net/per610a/home/mvp/mvp_db/news7-lv/2006/2006_08_08_19_00/2006_08_08_19_00.mpg;Akihiro OHTA.jpg;10529;11125;35961;526;556;30
/net/per610a/home/mvp/mvp_db/news7-lv/2006/2006_08_08_19_00/2006_08_08_19_00.mpg;Shinzo ABE.jpg;12885;13013;35961;644;650;6
/net/per610a/home/mvp/mvp_db/news7-lv/2006/2006_08_08_19_00/2006_08_08_19_00.mpg;Sadakazu TANIGAKI.jpg;12885;13013;35961;644;650;6
/net/per610a/home/mvp/mvp_db/news7-lv/2006/2006_08_08_19_00/2006_08_08_19_00.mpg;Taro ASO.jpg;13525;14173;35961;676;709;33
/net/per610a/home/mvp/mvp_db/news7-lv/2006/2006_08_08_19_00/2006_08_08_19_00.mpg;YUriko Koike.jpg;14245;14493;35961;712;725;13
/net/per610a/home/mvp/mvp_db/news7-lv/2006/2006_08_11_19_00/2006_08_11_19_00.mpg;Shinzo ABE.jpg;15977;16409;35961;799;820;21
/net/per610a/home/mvp/mvp_db/news7-lv/2006/2006_08_11_19_00/2006_08_11_19_00.mpg;Sadakazu TANIGAKI.jpg;15977;16377;35961;799;819;20
/net/per610a/home/mvp/mvp_db/news7-lv/2006/2006_08_12_19_00/2006_08_12_19_00.mpg;Shinzo ABE.jpg;13949;14505;35961;697;725;28
/net/per610a/home/mvp/mvp_db/news7-lv/2006/2006_08_12_19_00/2006_08_12_19_00.mpg;Shinzo ABE.jpg;14569;15337;35961;728;767;39
/net/per610a/home/mvp/mvp_db/news7-lv/2006/2006_08_15_19_00/2006_08_15_19_00.mpg;Junichiro KOIZUMI.jpg;665;765;35961;33;38;5
/net/per610a/home/mvp/mvp_db/news7-lv/2006/2006_08_15_19_00/2006_08_15_19_00.mpg;Junichiro KOIZUMI.jpg;4109;4621;35961;205;231;26
/net/per610a/home/mvp/mvp_db/news7-lv/2006/2006_08_15_19_00/2006_08_15_19_00.mpg;Toranosuke Katayama.jpg;4741;6085;35961;237;304;67
/net/per610a/home/mvp/mvp_db/news7-lv/2006/2006_08_15_19_00/2006_08_15_19_00.mpg;Yukio HATOYAMA.jpg;6857;8121;35961;343;406;63
/net/per610a/home/mvp/mvp_db/news7-lv/2006/2006_08_17_19_00/2006_08_17_19_00.mpg;Taro ASO.jpg;18345;18513;35961;917;926;9
/net/per610a/home/mvp/mvp_db/news7-lv/2006/2006_08_19_19_00/2006_08_19_19_00.mpg;Kyoko Nakayama.jpg;3229;3793;35961;161;189;28
/net/per610a/home/mvp/mvp_db/news7-lv/2006/2006_08_19_19_00/2006_08_19_19_00.mpg;Kyoko Nakayama.jpg;4065;4249;35961;203;212;9
/net/per610a/home/mvp/mvp_db/news7-lv/2006/2006_08_21_19_00/2006_08_21_19_00.mpg;Shinzo ABE.jpg;801;1029;35957;40;51;11
/net/per610a/home/mvp/mvp_db/news7-lv/2006/2006_08_21_19_00/2006_08_21_19_00.mpg;Shinzo ABE.jpg;23681;23897;35957;1184;1195;11
/net/per610a/home/mvp/mvp_db/news7-lv/2006/2006_08_21_19_00/2006_08_21_19_00.mpg;Sadakazu TANIGAKI.jpg;801;1025;35957;40;51;11
/net/per610a/home/mvp/mvp_db/news7-lv/2006/2006_08_21_19_00/2006_08_21_19_00.mpg;Sadakazu TANIGAKI.jpg;13661;13849;35957;683;692;9
/net/per610a/home/mvp/mvp_db/news7-lv/2006/2006_08_21_19_00/2006_08_21_19_00.mpg;Taro ASO.jpg;10385;11081;35957;519;554;35
/net/per610a/home/mvp/mvp_db/news7-lv/2006/2006_08_21_19_00/2006_08_21_19_00.mpg;Taro ASO.jpg;13661;14781;35957;683;739;56
/net/per610a/home/mvp/mvp_db/news7-lv/2006/2006_08_21_19_00/2006_08_21_19_00.mpg;Sadakazu TANIGAKI.jpg;15505;15737;35957;775;787;12
/net/per610a/home/mvp/mvp_db/news7-lv/2006/2006_08_21_19_00/2006_08_21_19_00.mpg;Ichiro OZAWA.jpg;23901;24429;35957;1195;1222;27
/net/per610a/home/mvp/mvp_db/news7-lv/2006/2006_08_21_19_00/2006_08_21_19_00.mpg;Yasuo FUKUDA.jpg;23901;24429;35957;1195;1222;27
/net/per610a/home/mvp/mvp_db/news7-lv/2006/2006_08_22_19_00/2006_08_22_19_00.mpg;Shinzo ABE.jpg;12025;13417;35961;601;671;70
/net/per610a/home/mvp/mvp_db/news7-lv/2006/2006_08_22_19_00/2006_08_22_19_00.mpg;Shinzo ABE.jpg;13497;14773;35961;675;739;64
/net/per610a/home/mvp/mvp_db/news7-lv/2006/2006_08_22_19_00/2006_08_22_19_00.mpg;Shinzo ABE.jpg;14857;15973;35961;743;799;56
/net/per610a/home/mvp/mvp_db/news7-lv/2006/2006_08_22_19_00/2006_08_22_19_00.mpg;Ichiro OZAWA.jpg;17257;17809;35961;863;890;27
/net/per610a/home/mvp/mvp_db/news7-lv/2006/2006_08_25_19_00/2006_08_25_19_00.mpg;Shinzo ABE.jpg;14589;14833;35961;729;742;13
/net/per610a/home/mvp/mvp_db/news7-lv/2006/2006_08_25_19_00/2006_08_25_19_00.mpg;Junichiro KOIZUMI.jpg;14897;15529;35961;745;776;31
/net/per610a/home/mvp/mvp_db/news7-lv/2006/2006_08_26_19_00/2006_08_26_19_00.mpg;Shinzo ABE.jpg;7769;12721;35961;388;636;248
/net/per610a/home/mvp/mvp_db/news7-lv/2006/2006_08_26_19_00/2006_08_26_19_00.mpg;Sadakazu TANIGAKI.jpg;9585;9629;35961;479;481;2
/net/per610a/home/mvp/mvp_db/news7-lv/2006/2006_08_26_19_00/2006_08_26_19_00.mpg;Sadakazu TANIGAKI.jpg;11457;11497;35961;573;575;2
/net/per610a/home/mvp/mvp_db/news7-lv/2006/2006_08_30_19_00/2006_08_30_19_00.mpg;Shintaro ISHIHARA.jpg;18921;18921;35961;946;946;0
/net/per610a/home/mvp/mvp_db/news7-lv/2006/2006_08_30_19_00/2006_08_30_19_00.mpg;Shintaro ISHIHARA.jpg;19561;19925;35961;978;996;18
/net/per610a/home/mvp/mvp_db/news7-lv/2006/2006_08_31_19_00/2006_08_31_19_00.mpg;Shintaro ISHIHARA.jpg;27217;27649;35961;1361;1383;22
/net/per610a/home/mvp/mvp_db/news7-lv/2006/2006_09_01_19_00/2006_09_01_19_00.mpg;Shinzo ABE.jpg;29;377;35961;1;18;17
/net/per610a/home/mvp/mvp_db/news7-lv/2006/2006_09_01_19_00/2006_09_01_19_00.mpg;Shinzo ABE.jpg;1689;1913;35961;84;95;11
/net/per610a/home/mvp/mvp_db/news7-lv/2006/2006_09_01_19_00/2006_09_01_19_00.mpg;Shinzo ABE.jpg;2025;3197;35961;101;159;58
/net/per610a/home/mvp/mvp_db/news7-lv/2006/2006_09_01_19_00/2006_09_01_19_00.mpg;Shinzo ABE.jpg;3597;4337;35961;179;216;37
/net/per610a/home/mvp/mvp_db/news7-lv/2006/2006_09_01_19_00/2006_09_01_19_00.mpg;Shinzo ABE.jpg;4445;4537;35961;222;226;4
/net/per610a/home/mvp/mvp_db/news7-lv/2006/2006_09_01_19_00/2006_09_01_19_00.mpg;Taro ASO.jpg;4541;4657;35961;227;232;5
/net/per610a/home/mvp/mvp_db/news7-lv/2006/2006_09_01_19_00/2006_09_01_19_00.mpg;Taro ASO.jpg;4957;5453;35961;247;272;25
/net/per610a/home/mvp/mvp_db/news7-lv/2006/2006_09_01_19_00/2006_09_01_19_00.mpg;Taro ASO.jpg;5981;7017;35961;299;351;52
/net/per610a/home/mvp/mvp_db/news7-lv/2006/2006_09_01_19_00/2006_09_01_19_00.mpg;Sadakazu TANIGAKI.jpg;5517;5961;35961;275;298;23
/net/per610a/home/mvp/mvp_db/news7-lv/2006/2006_09_01_19_00/2006_09_01_19_00.mpg;Junichiro KOIZUMI.jpg;8489;8725;35961;424;436;12
/net/per610a/home/mvp/mvp_db/news7-lv/2006/2006_09_01_19_00/2006_09_01_19_00.mpg;Shintaro ISHIHARA.jpg;10397;10617;35961;520;531;11
/net/per610a/home/mvp/mvp_db/news7-lv/2006/2006_09_03_19_00/2006_09_03_19_00.mpg;Shinzo ABE.jpg;3729;4425;35961;186;221;35
/net/per610a/home/mvp/mvp_db/news7-lv/2006/2006_09_03_19_00/2006_09_03_19_00.mpg;Kohei Otsuka.jpg;31397;31625;35961;1570;1582;12
/net/per610a/home/mvp/mvp_db/news7-lv/2006/2006_09_03_19_00/2006_09_03_19_00.mpg;Kohei Otsuka.jpg;31693;32365;35961;1585;1619;34
/net/per610a/home/mvp/mvp_db/news7-lv/2006/2006_09_06_19_00/2006_09_06_19_00.mpg;Junichiro KOIZUMI.jpg;34997;35957;35961;1750;1798;48
/net/per610a/home/mvp/mvp_db/news7-lv/2006/2006_09_07_19_00/2006_09_07_19_00.mpg;Junichiro KOIZUMI.jpg;16093;16957;35961;805;848;43
/net/per610a/home/mvp/mvp_db/news7-lv/2006/2006_09_07_19_00/2006_09_07_19_00.mpg;Ichiro OZAWA.jpg;16093;16957;35961;805;848;43
/net/per610a/home/mvp/mvp_db/news7-lv/2006/2006_09_08_19_00/2006_09_08_19_00.mpg;Sadakazu TANIGAKI.jpg;689;733;35961;34;36;2
/net/per610a/home/mvp/mvp_db/news7-lv/2006/2006_09_08_19_00/2006_09_08_19_00.mpg;Sadakazu TANIGAKI.jpg;2629;2749;35961;131;137;6
/net/per610a/home/mvp/mvp_db/news7-lv/2006/2006_09_08_19_00/2006_09_08_19_00.mpg;Shinzo ABE.jpg;1317;1389;35961;65;69;4
/net/per610a/home/mvp/mvp_db/news7-lv/2006/2006_09_08_19_00/2006_09_08_19_00.mpg;Shinzo ABE.jpg;1601;1761;35961;80;88;8
/net/per610a/home/mvp/mvp_db/news7-lv/2006/2006_09_08_19_00/2006_09_08_19_00.mpg;Shinzo ABE.jpg;3221;3433;35961;161;171;10
/net/per610a/home/mvp/mvp_db/news7-lv/2006/2006_09_08_19_00/2006_09_08_19_00.mpg;Shinzo ABE.jpg;4949;4985;35961;247;249;2
/net/per610a/home/mvp/mvp_db/news7-lv/2006/2006_09_08_19_00/2006_09_08_19_00.mpg;Shinzo ABE.jpg;5325;5349;35961;266;267;1
/net/per610a/home/mvp/mvp_db/news7-lv/2006/2006_09_08_19_00/2006_09_08_19_00.mpg;Shinzo ABE.jpg;5749;5885;35961;287;294;7
/net/per610a/home/mvp/mvp_db/news7-lv/2006/2006_09_08_19_00/2006_09_08_19_00.mpg;Shinzo ABE.jpg;7321;7353;35961;366;367;1
/net/per610a/home/mvp/mvp_db/news7-lv/2006/2006_09_08_19_00/2006_09_08_19_00.mpg;Shinzo ABE.jpg;5145;5205;35961;257;260;3
/net/per610a/home/mvp/mvp_db/news7-lv/2006/2006_09_08_19_00/2006_09_08_19_00.mpg;Shinzo ABE.jpg;7717;9961;35961;386;498;112
/net/per610a/home/mvp/mvp_db/news7-lv/2006/2006_09_08_19_00/2006_09_08_19_00.mpg;Shinzo ABE.jpg;17905;19605;35961;895;980;85
/net/per610a/home/mvp/mvp_db/news7-lv/2006/2006_09_08_19_00/2006_09_08_19_00.mpg;Shinzo ABE.jpg;23829;25669;35961;1192;1284;92
/net/per610a/home/mvp/mvp_db/news7-lv/2006/2006_09_08_19_00/2006_09_08_19_00.mpg;Shinzo ABE.jpg;25829;25917;35961;1292;1296;4
/net/per610a/home/mvp/mvp_db/news7-lv/2006/2006_09_08_19_00/2006_09_08_19_00.mpg;Shinzo ABE.jpg;26149;30745;35961;1308;1538;230
/net/per610a/home/mvp/mvp_db/news7-lv/2006/2006_09_08_19_00/2006_09_08_19_00.mpg;Shinzo ABE.jpg;31325;31421;35961;1567;1571;4
/net/per610a/home/mvp/mvp_db/news7-lv/2006/2006_09_08_19_00/2006_09_08_19_00.mpg;Sadakazu TANIGAKI.jpg;5361;5433;35961;268;271;3
/net/per610a/home/mvp/mvp_db/news7-lv/2006/2006_09_08_19_00/2006_09_08_19_00.mpg;Sadakazu TANIGAKI.jpg;10017;11809;35961;501;590;89
/net/per610a/home/mvp/mvp_db/news7-lv/2006/2006_09_08_19_00/2006_09_08_19_00.mpg;Sadakazu TANIGAKI.jpg;14893;15537;35961;745;777;32
/net/per610a/home/mvp/mvp_db/news7-lv/2006/2006_09_08_19_00/2006_09_08_19_00.mpg;Sadakazu TANIGAKI.jpg;15641;16165;35961;782;808;26
/net/per610a/home/mvp/mvp_db/news7-lv/2006/2006_09_08_19_00/2006_09_08_19_00.mpg;Sadakazu TANIGAKI.jpg;19765;20973;35961;988;1049;61
/net/per610a/home/mvp/mvp_db/news7-lv/2006/2006_09_08_19_00/2006_09_08_19_00.mpg;Sadakazu TANIGAKI.jpg;22497;22793;35961;1125;1140;15
/net/per610a/home/mvp/mvp_db/news7-lv/2006/2006_09_08_19_00/2006_09_08_19_00.mpg;Taro ASO.jpg;12173;14673;35961;608;734;126
/net/per610a/home/mvp/mvp_db/news7-lv/2006/2006_09_08_19_00/2006_09_08_19_00.mpg;Taro ASO.jpg;16229;17833;35961;811;892;81
/net/per610a/home/mvp/mvp_db/news7-lv/2006/2006_09_08_19_00/2006_09_08_19_00.mpg;Taro ASO.jpg;30809;31021;35961;1541;1551;10
/net/per610a/home/mvp/mvp_db/news7-lv/2006/2006_09_08_19_00/2006_09_08_19_00.mpg;Taro ASO.jpg;31557;35229;35961;1578;1762;184
/net/per610a/home/mvp/mvp_db/news7-lv/2006/2006_09_08_19_00/2006_09_08_19_00.mpg;Taro ASO.jpg;35417;35957;35961;1771;1798;27
/net/per610a/home/mvp/mvp_db/news7-lv/2006/2006_09_08_19_00/2006_09_08_19_00.mpg;Sadakazu TANIGAKI.jpg;21161;23685;35961;1058;1184;126
/net/per610a/home/mvp/mvp_db/news7-lv/2006/2006_09_08_19_00/2006_09_08_19_00.mpg;Sadakazu TANIGAKI.jpg;30753;30805;35961;1538;1541;3
/net/per610a/home/mvp/mvp_db/news7-lv/2006/2006_09_09_19_00/2006_09_09_19_00.mpg;Shinzo ABE.jpg;165;453;35961;8;22;14
/net/per610a/home/mvp/mvp_db/news7-lv/2006/2006_09_09_19_00/2006_09_09_19_00.mpg;Shinzo ABE.jpg;2141;3933;35961;107;196;89
/net/per610a/home/mvp/mvp_db/news7-lv/2006/2006_09_09_19_00/2006_09_09_19_00.mpg;Taro ASO.jpg;5109;6269;35961;255;313;58
/net/per610a/home/mvp/mvp_db/news7-lv/2006/2006_09_09_19_00/2006_09_09_19_00.mpg;Ichiro OZAWA.jpg;6313;7909;35961;315;395;80
/net/per610a/home/mvp/mvp_db/news7-lv/2006/2006_09_09_19_00/2006_09_09_19_00.mpg;Junichiro KOIZUMI.jpg;19457;19841;35961;973;992;19
/net/per610a/home/mvp/mvp_db/news7-lv/2006/2006_09_10_19_00/2006_09_10_19_00.mpg;Shinzo ABE.jpg;5741;5861;35961;287;293;6
/net/per610a/home/mvp/mvp_db/news7-lv/2006/2006_09_10_19_00/2006_09_10_19_00.mpg;Sadakazu TANIGAKI.jpg;7453;8161;35961;372;408;36
/net/per610a/home/mvp/mvp_db/news7-lv/2006/2006_09_10_19_00/2006_09_10_19_00.mpg;Taro ASO.jpg;8329;8345;35961;416;417;1
/net/per610a/home/mvp/mvp_db/news7-lv/2006/2006_09_10_19_00/2006_09_10_19_00.mpg;Taro ASO.jpg;8477;9249;35961;424;462;38
/net/per610a/home/mvp/mvp_db/news7-lv/2006/2006_09_11_19_00/2006_09_11_19_00.mpg;Shinzo ABE.jpg;13233;14857;35961;661;743;82
/net/per610a/home/mvp/mvp_db/news7-lv/2006/2006_09_11_19_00/2006_09_11_19_00.mpg;Shinzo ABE.jpg;14961;15901;35961;748;795;47
/net/per610a/home/mvp/mvp_db/news7-lv/2006/2006_09_11_19_00/2006_09_11_19_00.mpg;Shinzo ABE.jpg;21641;21993;35961;1082;1100;18
/net/per610a/home/mvp/mvp_db/news7-lv/2006/2006_09_11_19_00/2006_09_11_19_00.mpg;Sadakazu TANIGAKI.jpg;15905;16273;35961;795;814;19
/net/per610a/home/mvp/mvp_db/news7-lv/2006/2006_09_11_19_00/2006_09_11_19_00.mpg;Sadakazu TANIGAKI.jpg;22001;22129;35961;1100;1107;7
/net/per610a/home/mvp/mvp_db/news7-lv/2006/2006_09_11_19_00/2006_09_11_19_00.mpg;Taro ASO.jpg;16349;16577;35961;817;829;12
/net/per610a/home/mvp/mvp_db/news7-lv/2006/2006_09_11_19_00/2006_09_11_19_00.mpg;Ichiro OZAWA.jpg;16649;16965;35961;832;848;16
/net/per610a/home/mvp/mvp_db/news7-lv/2006/2006_09_11_19_00/2006_09_11_19_00.mpg;Ichiro OZAWA.jpg;18461;18473;35961;923;924;1
/net/per610a/home/mvp/mvp_db/news7-lv/2006/2006_09_11_19_00/2006_09_11_19_00.mpg;Ichiro OZAWA.jpg;17765;18089;35961;888;904;16
/net/per610a/home/mvp/mvp_db/news7-lv/2006/2006_09_11_19_00/2006_09_11_19_00.mpg;Ichiro OZAWA.jpg;21793;22129;35961;1090;1107;17
/net/per610a/home/mvp/mvp_db/news7-lv/2006/2006_09_11_19_00/2006_09_11_19_00.mpg;Junichiro KOIZUMI.jpg;19345;19405;35961;967;970;3
/net/per610a/home/mvp/mvp_db/news7-lv/2006/2006_09_11_19_00/2006_09_11_19_00.mpg;Junichiro KOIZUMI.jpg;19725;20193;35961;986;1010;24
/net/per610a/home/mvp/mvp_db/news7-lv/2006/2006_09_12_19_00/2006_09_12_19_00.mpg;Shinzo ABE.jpg;5225;5505;35961;261;275;14
/net/per610a/home/mvp/mvp_db/news7-lv/2006/2006_09_12_19_00/2006_09_12_19_00.mpg;Ichiro OZAWA.jpg;19233;19921;35961;962;996;34
/net/per610a/home/mvp/mvp_db/news7-lv/2006/2006_09_13_19_00/2006_09_13_19_00.mpg;Shinzo ABE.jpg;8529;9881;35961;426;494;68
/net/per610a/home/mvp/mvp_db/news7-lv/2006/2006_09_14_19_00/2006_09_14_19_00.mpg;Shinzo ABE.jpg;16629;18717;35961;831;936;105
/net/per610a/home/mvp/mvp_db/news7-lv/2006/2006_09_15_19_00/2006_09_15_19_00.mpg;Shinzo ABE.jpg;25041;26061;35961;1252;1303;51
/net/per610a/home/mvp/mvp_db/news7-lv/2006/2006_09_19_19_00/2006_09_19_19_00.mpg;Shinzo ABE.jpg;15361;16205;35957;768;810;42
/net/per610a/home/mvp/mvp_db/news7-lv/2006/2006_09_19_19_00/2006_09_19_19_00.mpg;Sadakazu TANIGAKI.jpg;16417;16573;35957;821;829;8
/net/per610a/home/mvp/mvp_db/news7-lv/2006/2006_09_19_19_00/2006_09_19_19_00.mpg;Sadakazu TANIGAKI.jpg;17057;17157;35957;853;858;5
/net/per610a/home/mvp/mvp_db/news7-lv/2006/2006_09_19_19_00/2006_09_19_19_00.mpg;Taro ASO.jpg;17409;18233;35957;871;912;41
/net/per610a/home/mvp/mvp_db/news7-lv/2006/2006_09_20_19_00/2006_09_20_19_00.mpg;Sadakazu TANIGAKI.jpg;2413;2661;35961;120;133;13
/net/per610a/home/mvp/mvp_db/news7-lv/2006/2006_09_20_19_00/2006_09_20_19_00.mpg;Sadakazu TANIGAKI.jpg;3373;3393;35961;168;169;1
/net/per610a/home/mvp/mvp_db/news7-lv/2006/2006_09_20_19_00/2006_09_20_19_00.mpg;Junichiro KOIZUMI.jpg;9029;9505;35961;451;475;24
/net/per610a/home/mvp/mvp_db/news7-lv/2006/2006_09_20_19_00/2006_09_20_19_00.mpg;Shinzo ABE.jpg;17693;17781;35961;885;889;4
/net/per610a/home/mvp/mvp_db/news7-lv/2006/2006_09_20_19_00/2006_09_20_19_00.mpg;Shinzo ABE.jpg;24157;24329;35961;1208;1217;9
/net/per610a/home/mvp/mvp_db/news7-lv/2006/2006_09_20_19_00/2006_09_20_19_00.mpg;Shinzo ABE.jpg;25057;25137;35961;1253;1257;4
/net/per610a/home/mvp/mvp_db/news7-lv/2006/2006_09_21_19_00/2006_09_21_19_00.mpg;Shinzo ABE.jpg;241;261;35961;12;13;1
/net/per610a/home/mvp/mvp_db/news7-lv/2006/2006_09_21_19_00/2006_09_21_19_00.mpg;Shinzo ABE.jpg;5013;5341;35961;250;267;17
/net/per610a/home/mvp/mvp_db/news7-lv/2006/2006_09_21_19_00/2006_09_21_19_00.mpg;Shinzo ABE.jpg;373;517;35961;18;25;7
/net/per610a/home/mvp/mvp_db/news7-lv/2006/2006_09_21_19_00/2006_09_21_19_00.mpg;YUriko Koike.jpg;25869;26073;35961;1294;1304;10
/net/per610a/home/mvp/mvp_db/news7-lv/2006/2006_09_22_19_00/2006_09_22_19_00.mpg;Junichiro KOIZUMI.jpg;7181;7389;35961;359;369;10
/net/per610a/home/mvp/mvp_db/news7-lv/2006/2006_09_25_19_00/2006_09_25_19_00.mpg;Shinzo ABE.jpg;41;137;35957;2;6;4
/net/per610a/home/mvp/mvp_db/news7-lv/2006/2006_09_25_19_00/2006_09_25_19_00.mpg;Shinzo ABE.jpg;5361;5453;35957;268;272;4
/net/per610a/home/mvp/mvp_db/news7-lv/2006/2006_09_25_19_00/2006_09_25_19_00.mpg;Shinzo ABE.jpg;6625;6681;35957;331;334;3
/net/per610a/home/mvp/mvp_db/news7-lv/2006/2006_09_25_19_00/2006_09_25_19_00.mpg;Shinzo ABE.jpg;7229;7353;35957;361;367;6
/net/per610a/home/mvp/mvp_db/news7-lv/2006/2006_09_25_19_00/2006_09_25_19_00.mpg;Takenori KANZAKI.jpg;5497;5573;35957;275;278;3
/net/per610a/home/mvp/mvp_db/news7-lv/2006/2006_09_25_19_00/2006_09_25_19_00.mpg;Takenori KANZAKI.jpg;5873;6217;35957;293;311;18
/net/per610a/home/mvp/mvp_db/news7-lv/2006/2006_09_25_19_00/2006_09_25_19_00.mpg;Ichiro OZAWA.jpg;9397;9777;35957;470;489;19
/net/per610a/home/mvp/mvp_db/news7-lv/2006/2006_09_25_19_00/2006_09_25_19_00.mpg;Ichiro OZAWA.jpg;10101;10653;35957;505;532;27
/net/per610a/home/mvp/mvp_db/news7-lv/2006/2006_09_25_19_00/2006_09_25_19_00.mpg;Ichiro OZAWA.jpg;13009;13009;35957;650;650;0
/net/per610a/home/mvp/mvp_db/news7-lv/2006/2006_09_25_19_00/2006_09_25_19_00.mpg;Ichiro OZAWA.jpg;13161;13213;35957;658;661;3
/net/per610a/home/mvp/mvp_db/news7-lv/2006/2006_09_25_19_00/2006_09_25_19_00.mpg;Junichiro KOIZUMI.jpg;14701;15529;35957;735;776;41
/net/per610a/home/mvp/mvp_db/news7-lv/2006/2006_09_25_19_00/2006_09_25_19_00.mpg;Junichiro KOIZUMI.jpg;15697;16113;35957;785;806;21
/net/per610a/home/mvp/mvp_db/news7-lv/2006/2006_09_25_19_00/2006_09_25_19_00.mpg;Junichiro KOIZUMI.jpg;16901;17261;35957;845;863;18
/net/per610a/home/mvp/mvp_db/news7-lv/2006/2006_09_26_19_00/2006_09_26_19_00.mpg;Junichiro KOIZUMI.jpg;20633;20653;35961;1032;1033;1
/net/per610a/home/mvp/mvp_db/news7-lv/2006/2006_09_26_19_00/2006_09_26_19_00.mpg;Junichiro KOIZUMI.jpg;22881;23013;35961;1144;1151;7
/net/per610a/home/mvp/mvp_db/news7-lv/2006/2006_09_27_19_00/2006_09_27_19_00.mpg;Shinzo ABE.jpg;521;609;35961;26;30;4
/net/per610a/home/mvp/mvp_db/news7-lv/2006/2006_09_27_19_00/2006_09_27_19_00.mpg;Shinzo ABE.jpg;9157;9289;35961;458;464;6
/net/per610a/home/mvp/mvp_db/news7-lv/2006/2006_09_27_19_00/2006_09_27_19_00.mpg;Shinzo ABE.jpg;15225;15481;35961;761;774;13
/net/per610a/home/mvp/mvp_db/news7-lv/2006/2006_09_28_19_00/2006_09_28_19_00.mpg;Shinzo ABE.jpg;2121;2245;35961;106;112;6
/net/per610a/home/mvp/mvp_db/news7-lv/2006/2006_09_28_19_00/2006_09_28_19_00.mpg;Shinzo ABE.jpg;7201;7213;35961;360;360;0
/net/per610a/home/mvp/mvp_db/news7-lv/2006/2006_09_28_19_00/2006_09_28_19_00.mpg;Naoto KAN.jpg;5401;5641;35961;270;282;12
/net/per610a/home/mvp/mvp_db/news7-lv/2006/2006_09_28_19_00/2006_09_28_19_00.mpg;Kazuo SHII.jpg;6145;6905;35961;307;345;38
/net/per610a/home/mvp/mvp_db/news7-lv/2006/2006_09_29_19_00/2006_09_29_19_00.mpg;Shinzo ABE.jpg;137;409;35961;6;20;14
/net/per610a/home/mvp/mvp_db/news7-lv/2006/2006_09_29_19_00/2006_09_29_19_00.mpg;Shinzo ABE.jpg;1373;1697;35961;68;84;16
/net/per610a/home/mvp/mvp_db/news7-lv/2006/2006_09_29_19_00/2006_09_29_19_00.mpg;Shinzo ABE.jpg;7957;8141;35961;398;407;9
/net/per610a/home/mvp/mvp_db/news7-lv/2006/2006_09_30_19_00/2006_09_30_19_00.mpg;Akihiro OHTA.jpg;9005;9057;35961;450;453;3
/net/per610a/home/mvp/mvp_db/news7-lv/2006/2006_09_30_19_00/2006_09_30_19_00.mpg;Akihiro OHTA.jpg;10953;11597;35961;547;580;33
/net/per610a/home/mvp/mvp_db/news7-lv/2006/2006_09_30_19_00/2006_09_30_19_00.mpg;Akihiro OHTA.jpg;12029;12509;35961;601;625;24
/net/per610a/home/mvp/mvp_db/news7-lv/2006/2006_09_30_19_00/2006_09_30_19_00.mpg;Akihiro OHTA.jpg;13045;13053;35961;652;652;0
/net/per610a/home/mvp/mvp_db/news7-lv/2006/2006_10_01_19_00/2006_10_01_19_00.mpg;Ichiro OZAWA.jpg;23405;23825;35961;1170;1191;21
/net/per610a/home/mvp/mvp_db/news7-lv/2006/2006_10_01_19_00/2006_10_01_19_00.mpg;Ichiro OZAWA.jpg;23993;24713;35961;1200;1236;36
/net/per610a/home/mvp/mvp_db/news7-lv/2006/2006_10_01_19_00/2006_10_01_19_00.mpg;Ichiro OZAWA.jpg;24777;25289;35961;1239;1265;26
/net/per610a/home/mvp/mvp_db/news7-lv/2006/2006_10_01_19_00/2006_10_01_19_00.mpg;Ichiro OZAWA.jpg;25417;25969;35961;1271;1299;28
/net/per610a/home/mvp/mvp_db/news7-lv/2006/2006_10_02_19_00/2006_10_02_19_00.mpg;Taro ASO.jpg;6541;7449;35961;327;372;45
/net/per610a/home/mvp/mvp_db/news7-lv/2006/2006_10_03_19_00/2006_10_03_19_00.mpg;Kazuo SHII.jpg;15761;15981;35961;788;799;11
/net/per610a/home/mvp/mvp_db/news7-lv/2006/2006_10_03_19_00/2006_10_03_19_00.mpg;Shinzo ABE.jpg;29069;29253;35961;1454;1463;9
/net/per610a/home/mvp/mvp_db/news7-lv/2006/2006_10_03_19_00/2006_10_03_19_00.mpg;Shinzo ABE.jpg;29505;29725;35961;1476;1487;11
/net/per610a/home/mvp/mvp_db/news7-lv/2006/2006_10_04_19_00/2006_10_04_19_00.mpg;Shinzo ABE.jpg;12989;13405;35961;649;670;21
/net/per610a/home/mvp/mvp_db/news7-lv/2006/2006_10_04_19_00/2006_10_04_19_00.mpg;Shinzo ABE.jpg;15685;15697;35961;784;785;1
/net/per610a/home/mvp/mvp_db/news7-lv/2006/2006_10_06_19_00/2006_10_06_19_00.mpg;Taro ASO.jpg;7325;7521;35961;366;376;10
/net/per610a/home/mvp/mvp_db/news7-lv/2006/2006_10_08_19_00/2006_10_08_19_00.mpg;Shinzo ABE.jpg;169;237;35961;8;11;3
/net/per610a/home/mvp/mvp_db/news7-lv/2006/2006_10_08_19_00/2006_10_08_19_00.mpg;Shinzo ABE.jpg;2769;3333;35961;138;166;28
/net/per610a/home/mvp/mvp_db/news7-lv/2006/2006_10_08_19_00/2006_10_08_19_00.mpg;Shinzo ABE.jpg;3541;3689;35961;177;184;7
/net/per610a/home/mvp/mvp_db/news7-lv/2006/2006_10_08_19_00/2006_10_08_19_00.mpg;Shinzo ABE.jpg;3813;3945;35961;190;197;7
/net/per610a/home/mvp/mvp_db/news7-lv/2006/2006_10_08_19_00/2006_10_08_19_00.mpg;Shinzo ABE.jpg;4301;4453;35961;215;222;7
/net/per610a/home/mvp/mvp_db/news7-lv/2006/2006_10_08_19_00/2006_10_08_19_00.mpg;Shinzo ABE.jpg;7277;7449;35961;364;372;8
/net/per610a/home/mvp/mvp_db/news7-lv/2006/2006_10_08_19_00/2006_10_08_19_00.mpg;Shinzo ABE.jpg;9325;9413;35961;466;470;4
/net/per610a/home/mvp/mvp_db/news7-lv/2006/2006_10_08_19_00/2006_10_08_19_00.mpg;Shinzo ABE.jpg;10765;10869;35961;538;543;5
/net/per610a/home/mvp/mvp_db/news7-lv/2006/2006_10_08_19_00/2006_10_08_19_00.mpg;Shinzo ABE.jpg;11193;11561;35961;559;578;19
/net/per610a/home/mvp/mvp_db/news7-lv/2006/2006_10_08_19_00/2006_10_08_19_00.mpg;Shinzo ABE.jpg;12385;12397;35961;619;620;1
/net/per610a/home/mvp/mvp_db/news7-lv/2006/2006_10_08_19_00/2006_10_08_19_00.mpg;Junichiro KOIZUMI.jpg;4777;4885;35961;238;244;6
/net/per610a/home/mvp/mvp_db/news7-lv/2006/2006_10_08_19_00/2006_10_08_19_00.mpg;Junichiro KOIZUMI.jpg;5325;5609;35961;266;280;14
/net/per610a/home/mvp/mvp_db/news7-lv/2006/2006_10_08_19_00/2006_10_08_19_00.mpg;Junichiro KOIZUMI.jpg;6929;7809;35961;346;390;44
/net/per610a/home/mvp/mvp_db/news7-lv/2006/2006_10_09_19_00/2006_10_09_19_00.mpg;Shinzo ABE.jpg;365;553;35961;18;27;9
/net/per610a/home/mvp/mvp_db/news7-lv/2006/2006_10_09_19_00/2006_10_09_19_00.mpg;Shinzo ABE.jpg;5345;5397;35961;267;269;2
/net/per610a/home/mvp/mvp_db/news7-lv/2006/2006_10_09_19_00/2006_10_09_19_00.mpg;Shinzo ABE.jpg;5517;5849;35961;275;292;17
/net/per610a/home/mvp/mvp_db/news7-lv/2006/2006_10_09_19_00/2006_10_09_19_00.mpg;Shinzo ABE.jpg;7065;9365;35961;353;468;115
/net/per610a/home/mvp/mvp_db/news7-lv/2006/2006_10_09_19_00/2006_10_09_19_00.mpg;Shinzo ABE.jpg;10505;11093;35961;525;554;29
/net/per610a/home/mvp/mvp_db/news7-lv/2006/2006_10_09_19_00/2006_10_09_19_00.mpg;Shinzo ABE.jpg;12625;12945;35961;631;647;16
/net/per610a/home/mvp/mvp_db/news7-lv/2006/2006_10_09_19_00/2006_10_09_19_00.mpg;Shinzo ABE.jpg;1837;1877;35961;91;93;2
/net/per610a/home/mvp/mvp_db/news7-lv/2006/2006_10_09_19_00/2006_10_09_19_00.mpg;Shinzo ABE.jpg;25289;26377;35961;1265;1319;54
/net/per610a/home/mvp/mvp_db/news7-lv/2006/2006_10_09_19_00/2006_10_09_19_00.mpg;Akihiro OHTA.jpg;11985;12565;35961;599;628;29
/net/per610a/home/mvp/mvp_db/news7-lv/2006/2006_10_10_19_00/2006_10_10_19_00.mpg;Shinzo ABE.jpg;21721;21897;35961;1086;1095;9
/net/per610a/home/mvp/mvp_db/news7-lv/2006/2006_10_10_19_00/2006_10_10_19_00.mpg;Shinzo ABE.jpg;23089;23173;35961;1155;1159;4
/net/per610a/home/mvp/mvp_db/news7-lv/2006/2006_10_11_19_00/2006_10_11_19_00.mpg;Shinzo ABE.jpg;1873;2029;35961;93;101;8
/net/per610a/home/mvp/mvp_db/news7-lv/2006/2006_10_11_19_00/2006_10_11_19_00.mpg;Shinzo ABE.jpg;8397;9589;35961;420;479;59
/net/per610a/home/mvp/mvp_db/news7-lv/2006/2006_10_11_19_00/2006_10_11_19_00.mpg;Shinzo ABE.jpg;9781;9833;35961;489;491;2
/net/per610a/home/mvp/mvp_db/news7-lv/2006/2006_10_11_19_00/2006_10_11_19_00.mpg;Shinzo ABE.jpg;26025;27045;35961;1301;1352;51
/net/per610a/home/mvp/mvp_db/news7-lv/2006/2006_10_11_19_00/2006_10_11_19_00.mpg;Shinzo ABE.jpg;28209;28601;35961;1411;1430;19
/net/per610a/home/mvp/mvp_db/news7-lv/2006/2006_10_12_19_00/2006_10_12_19_00.mpg;Shinzo ABE.jpg;9365;9905;35961;468;495;27
/net/per610a/home/mvp/mvp_db/news7-lv/2006/2006_10_12_19_00/2006_10_12_19_00.mpg;Shinzo ABE.jpg;9973;10457;35961;498;523;25
/net/per610a/home/mvp/mvp_db/news7-lv/2006/2006_10_13_19_00/2006_10_13_19_00.mpg;Natsuo YAMAGUCHI.jpg;10537;10689;35961;527;534;7
/net/per610a/home/mvp/mvp_db/news7-lv/2006/2006_10_14_19_00/2006_10_14_19_00.mpg;Masashi Nakano.jpg;23025;23201;35961;1151;1160;9
/net/per610a/home/mvp/mvp_db/news7-lv/2006/2006_10_14_19_00/2006_10_14_19_00.mpg;Masashi Nakano.jpg;23685;24201;35961;1184;1210;26
/net/per610a/home/mvp/mvp_db/news7-lv/2006/2006_10_14_19_00/2006_10_14_19_00.mpg;Masashi Nakano.jpg;24793;25413;35961;1240;1271;31
/net/per610a/home/mvp/mvp_db/news7-lv/2006/2006_10_15_19_00/2006_10_15_19_00.mpg;Shinzo ABE.jpg;5201;6001;35961;260;300;40
/net/per610a/home/mvp/mvp_db/news7-lv/2006/2006_10_19_19_00/2006_10_19_19_00.mpg;Taro ASO.jpg;601;717;35961;30;35;5
/net/per610a/home/mvp/mvp_db/news7-lv/2006/2006_10_20_19_00/2006_10_20_19_00.mpg;Shinzo ABE.jpg;9513;10213;35961;475;510;35
/net/per610a/home/mvp/mvp_db/news7-lv/2006/2006_10_20_19_00/2006_10_20_19_00.mpg;Shinzo ABE.jpg;15737;16073;35961;787;804;17
/net/per610a/home/mvp/mvp_db/news7-lv/2006/2006_10_20_19_00/2006_10_20_19_00.mpg;Shintaro ISHIHARA.jpg;18277;18865;35961;914;943;29
/net/per610a/home/mvp/mvp_db/news7-lv/2006/2006_10_23_19_00/2006_10_23_19_00.mpg;Yukio EDANO.jpg;3897;4025;35961;194;201;7
/net/per610a/home/mvp/mvp_db/news7-lv/2006/2006_10_23_19_00/2006_10_23_19_00.mpg;Yukio EDANO.jpg;6457;6597;35961;323;330;7
/net/per610a/home/mvp/mvp_db/news7-lv/2006/2006_10_23_19_00/2006_10_23_19_00.mpg;Shinzo ABE.jpg;20957;21669;35961;1048;1084;36
/net/per610a/home/mvp/mvp_db/news7-lv/2006/2006_10_24_19_00/2006_10_24_19_00.mpg;Toranosuke Katayama.jpg;25957;26657;35961;1298;1333;35
/net/per610a/home/mvp/mvp_db/news7-lv/2006/2006_10_24_19_00/2006_10_24_19_00.mpg;Ichiro OZAWA.jpg;26701;27441;35961;1335;1372;37
/net/per610a/home/mvp/mvp_db/news7-lv/2006/2006_10_24_19_00/2006_10_24_19_00.mpg;Shinzo ABE.jpg;29185;29921;35961;1460;1496;36
/net/per610a/home/mvp/mvp_db/news7-lv/2006/2006_10_25_19_00/2006_10_25_19_00.mpg;Yoshimi WATANABE.jpg;16161;16405;35961;808;820;12
/net/per610a/home/mvp/mvp_db/news7-lv/2006/2006_10_30_19_00/2006_10_30_19_00.mpg;Shinzo ABE.jpg;8173;9225;35961;408;461;53
/net/per610a/home/mvp/mvp_db/news7-lv/2006/2006_10_30_19_00/2006_10_30_19_00.mpg;Shinzo ABE.jpg;9509;10109;35961;475;505;30
/net/per610a/home/mvp/mvp_db/news7-lv/2006/2006_10_30_19_00/2006_10_30_19_00.mpg;Shinzo ABE.jpg;10253;10677;35961;512;534;22
/net/per610a/home/mvp/mvp_db/news7-lv/2006/2006_11_01_19_00/2006_11_01_19_00.mpg;Taro ASO.jpg;3845;4053;35961;192;202;10
/net/per610a/home/mvp/mvp_db/news7-lv/2006/2006_11_01_19_00/2006_11_01_19_00.mpg;Shinzo ABE.jpg;4441;5421;35961;222;271;49
/net/per610a/home/mvp/mvp_db/news7-lv/2006/2006_11_03_19_00/2006_11_03_19_00.mpg;Yukio HATOYAMA.jpg;10741;11553;35961;537;577;40
/net/per610a/home/mvp/mvp_db/news7-lv/2006/2006_11_06_19_00/2006_11_06_19_00.mpg;Shinzo ABE.jpg;2097;2169;35961;104;108;4
/net/per610a/home/mvp/mvp_db/news7-lv/2006/2006_11_06_19_00/2006_11_06_19_00.mpg;Shinzo ABE.jpg;2441;2625;35961;122;131;9
/net/per610a/home/mvp/mvp_db/news7-lv/2006/2006_11_08_19_00/2006_11_08_19_00.mpg;Shinzo ABE.jpg;7393;7813;35961;369;390;21
/net/per610a/home/mvp/mvp_db/news7-lv/2006/2006_11_08_19_00/2006_11_08_19_00.mpg;Shinzo ABE.jpg;20673;21073;35961;1034;1054;20
/net/per610a/home/mvp/mvp_db/news7-lv/2006/2006_11_08_19_00/2006_11_08_19_00.mpg;Ichiro OZAWA.jpg;21645;22145;35961;1082;1107;25
/net/per610a/home/mvp/mvp_db/news7-lv/2006/2006_11_09_19_00/2006_11_09_19_00.mpg;Shinzo ABE.jpg;7213;7625;35961;360;381;21
/net/per610a/home/mvp/mvp_db/news7-lv/2006/2006_11_10_19_00/2006_11_10_19_00.mpg;Toranosuke Katayama.jpg;22573;23961;35961;1129;1198;69
/net/per610a/home/mvp/mvp_db/news7-lv/2006/2006_11_13_19_00/2006_11_13_19_00.mpg;Shinzo ABE.jpg;21641;21673;35961;1082;1084;2
/net/per610a/home/mvp/mvp_db/news7-lv/2006/2006_11_13_19_00/2006_11_13_19_00.mpg;Shinzo ABE.jpg;21849;21925;35961;1093;1096;3
/net/per610a/home/mvp/mvp_db/news7-lv/2006/2006_11_13_19_00/2006_11_13_19_00.mpg;Shinzo ABE.jpg;22361;22457;35961;1118;1123;5
/net/per610a/home/mvp/mvp_db/news7-lv/2006/2006_11_13_19_00/2006_11_13_19_00.mpg;Shinzo ABE.jpg;24121;24177;35961;1206;1209;3
/net/per610a/home/mvp/mvp_db/news7-lv/2006/2006_11_13_19_00/2006_11_13_19_00.mpg;Shinzo ABE.jpg;24401;24789;35961;1220;1240;20
/net/per610a/home/mvp/mvp_db/news7-lv/2006/2006_11_13_19_00/2006_11_13_19_00.mpg;Yukio HATOYAMA.jpg;23061;23173;35961;1153;1159;6
/net/per610a/home/mvp/mvp_db/news7-lv/2006/2006_11_16_19_00/2006_11_16_19_00.mpg;Natsuo YAMAGUCHI.jpg;14457;15105;35961;723;755;32
/net/per610a/home/mvp/mvp_db/news7-lv/2006/2006_11_17_19_00/2006_11_17_19_00.mpg;Shinzo ABE.jpg;20949;22157;35961;1048;1108;60
/net/per610a/home/mvp/mvp_db/news7-lv/2006/2006_11_20_19_00/2006_11_20_19_00.mpg;Shinzo ABE.jpg;12213;12701;35961;610;635;25
/net/per610a/home/mvp/mvp_db/news7-lv/2006/2006_11_20_19_00/2006_11_20_19_00.mpg;Shinzo ABE.jpg;14281;14901;35961;714;745;31
/net/per610a/home/mvp/mvp_db/news7-lv/2006/2006_11_20_19_00/2006_11_20_19_00.mpg;Shinzo ABE.jpg;15173;15477;35961;759;774;15
/net/per610a/home/mvp/mvp_db/news7-lv/2006/2006_11_20_19_00/2006_11_20_19_00.mpg;Shinzo ABE.jpg;13885;14145;35961;694;707;13
/net/per610a/home/mvp/mvp_db/news7-lv/2006/2006_11_21_19_00/2006_11_21_19_00.mpg;Toranosuke Katayama.jpg;4617;5185;35961;230;259;29
/net/per610a/home/mvp/mvp_db/news7-lv/2006/2006_11_21_19_00/2006_11_21_19_00.mpg;Takeo Hiranuma.jpeg;8521;8921;35961;426;446;20
/net/per610a/home/mvp/mvp_db/news7-lv/2006/2006_11_22_19_00/2006_11_22_19_00.mpg;Shinzo ABE.jpg;19697;20337;35961;985;1017;32
/net/per610a/home/mvp/mvp_db/news7-lv/2006/2006_11_22_19_00/2006_11_22_19_00.mpg;Shinzo ABE.jpg;21249;21797;35961;1063;1090;27
/net/per610a/home/mvp/mvp_db/news7-lv/2006/2006_11_24_19_00/2006_11_24_19_00.mpg;Takeo Hiranuma.jpeg;1365;1885;35961;68;94;26
/net/per610a/home/mvp/mvp_db/news7-lv/2006/2006_11_24_19_00/2006_11_24_19_00.mpg;Takeo Hiranuma.jpeg;5149;5173;35961;257;258;1
/net/per610a/home/mvp/mvp_db/news7-lv/2006/2006_11_24_19_00/2006_11_24_19_00.mpg;Toranosuke Katayama.jpg;3857;5145;35961;192;257;65
/net/per610a/home/mvp/mvp_db/news7-lv/2006/2006_11_24_19_00/2006_11_24_19_00.mpg;Shintaro ISHIHARA.jpg;13677;14993;35961;684;750;66
/net/per610a/home/mvp/mvp_db/news7-lv/2006/2006_11_25_19_00/2006_11_25_19_00.mpg;Takeo Hiranuma.jpeg;309;513;35961;15;25;10
/net/per610a/home/mvp/mvp_db/news7-lv/2006/2006_11_25_19_00/2006_11_25_19_00.mpg;Takeo Hiranuma.jpeg;2849;3173;35961;142;158;16
/net/per610a/home/mvp/mvp_db/news7-lv/2006/2006_11_25_19_00/2006_11_25_19_00.mpg;Takeo Hiranuma.jpeg;3937;4693;35961;196;234;38
/net/per610a/home/mvp/mvp_db/news7-lv/2006/2006_11_25_19_00/2006_11_25_19_00.mpg;Takeo Hiranuma.jpeg;5273;5293;35961;263;264;1
/net/per610a/home/mvp/mvp_db/news7-lv/2006/2006_11_26_19_00/2006_11_26_19_00.mpg;Takeo Hiranuma.jpeg;385;609;35961;19;30;11
/net/per610a/home/mvp/mvp_db/news7-lv/2006/2006_11_26_19_00/2006_11_26_19_00.mpg;Takeo Hiranuma.jpeg;5433;6257;35961;271;313;42
/net/per610a/home/mvp/mvp_db/news7-lv/2006/2006_11_26_19_00/2006_11_26_19_00.mpg;Toranosuke Katayama.jpg;6321;6501;35961;316;325;9
/net/per610a/home/mvp/mvp_db/news7-lv/2006/2006_11_26_19_00/2006_11_26_19_00.mpg;Toranosuke Katayama.jpg;6569;7581;35961;328;379;51
/net/per610a/home/mvp/mvp_db/news7-lv/2006/2006_11_27_19_00/2006_11_27_19_00.mpg;Takeo Hiranuma.jpeg;269;533;35961;13;26;13
/net/per610a/home/mvp/mvp_db/news7-lv/2006/2006_11_27_19_00/2006_11_27_19_00.mpg;Takeo Hiranuma.jpeg;2429;2849;35961;121;142;21
/net/per610a/home/mvp/mvp_db/news7-lv/2006/2006_11_27_19_00/2006_11_27_19_00.mpg;Takeo Hiranuma.jpeg;4197;4741;35961;209;237;28
/net/per610a/home/mvp/mvp_db/news7-lv/2006/2006_11_27_19_00/2006_11_27_19_00.mpg;Takeo Hiranuma.jpeg;7709;7785;35961;385;389;4
/net/per610a/home/mvp/mvp_db/news7-lv/2006/2006_11_27_19_00/2006_11_27_19_00.mpg;Takeo Hiranuma.jpeg;7989;9433;35961;399;471;72
/net/per610a/home/mvp/mvp_db/news7-lv/2006/2006_11_27_19_00/2006_11_27_19_00.mpg;Shinzo ABE.jpg;1553;2081;35961;77;104;27
/net/per610a/home/mvp/mvp_db/news7-lv/2006/2006_11_27_19_00/2006_11_27_19_00.mpg;Shinzo ABE.jpg;6333;6817;35961;316;341;25
/net/per610a/home/mvp/mvp_db/news7-lv/2006/2006_11_27_19_00/2006_11_27_19_00.mpg;Shinzo ABE.jpg;9497;9513;35961;475;475;0
/net/per610a/home/mvp/mvp_db/news7-lv/2006/2006_11_27_19_00/2006_11_27_19_00.mpg;Shinzo ABE.jpg;9709;9769;35961;485;488;3
/net/per610a/home/mvp/mvp_db/news7-lv/2006/2006_11_27_19_00/2006_11_27_19_00.mpg;Shinzo ABE.jpg;10349;10677;35961;517;534;17
/net/per610a/home/mvp/mvp_db/news7-lv/2006/2006_11_27_19_00/2006_11_27_19_00.mpg;Shinzo ABE.jpg;10153;10201;35961;507;510;3
/net/per610a/home/mvp/mvp_db/news7-lv/2006/2006_11_28_19_00/2006_11_28_19_00.mpg;Naoto KAN.jpg;9321;9785;35961;466;489;23
/net/per610a/home/mvp/mvp_db/news7-lv/2006/2006_11_30_19_00/2006_11_30_19_00.mpg;Nariaki Nakayama.png;21653;22189;35961;1083;1110;27
/net/per610a/home/mvp/mvp_db/news7-lv/2006/2006_11_30_19_00/2006_11_30_19_00.mpg;Nariaki Nakayama.png;23473;23485;35961;1174;1174;0
/net/per610a/home/mvp/mvp_db/news7-lv/2006/2006_12_04_19_00/2006_12_04_19_00.mpg;Shinzo ABE.jpg;27017;27533;35961;1351;1377;26
/net/per610a/home/mvp/mvp_db/news7-lv/2006/2006_12_05_19_00/2006_12_05_19_00.mpg;Toranosuke Katayama.jpg;18629;18765;35961;931;938;7
/net/per610a/home/mvp/mvp_db/news7-lv/2006/2006_12_05_19_00/2006_12_05_19_00.mpg;Toranosuke Katayama.jpg;19389;19949;35961;969;997;28
/net/per610a/home/mvp/mvp_db/news7-lv/2006/2006_12_07_19_00/2006_12_07_19_00.mpg;Shinzo ABE.jpg;18181;18425;35961;909;921;12
/net/per610a/home/mvp/mvp_db/news7-lv/2006/2006_12_08_19_00/2006_12_08_19_00.mpg;Shinzo ABE.jpg;21057;21361;35961;1053;1068;15
/net/per610a/home/mvp/mvp_db/news7-lv/2006/2006_12_08_19_00/2006_12_08_19_00.mpg;Shinzo ABE.jpg;26837;27233;35961;1342;1362;20
/net/per610a/home/mvp/mvp_db/news7-lv/2006/2006_12_11_19_00/2006_12_11_19_00.mpg;Shinzo ABE.jpg;137;313;35961;6;15;9
/net/per610a/home/mvp/mvp_db/news7-lv/2006/2006_12_11_19_00/2006_12_11_19_00.mpg;Shinzo ABE.jpg;5157;6321;35961;257;316;59
/net/per610a/home/mvp/mvp_db/news7-lv/2006/2006_12_11_19_00/2006_12_11_19_00.mpg;Shinzo ABE.jpg;6869;7245;35961;343;362;19
/net/per610a/home/mvp/mvp_db/news7-lv/2006/2006_12_11_19_00/2006_12_11_19_00.mpg;Shinzo ABE.jpg;8097;8565;35961;405;428;23
/net/per610a/home/mvp/mvp_db/news7-lv/2006/2006_12_11_19_00/2006_12_11_19_00.mpg;Shinzo ABE.jpg;11001;11549;35961;550;577;27
/net/per610a/home/mvp/mvp_db/news7-lv/2006/2006_12_12_19_00/2006_12_12_19_00.mpg;Shinzo ABE.jpg;2937;3281;35961;146;164;18
/net/per610a/home/mvp/mvp_db/news7-lv/2006/2006_12_13_19_00/2006_12_13_19_00.mpg;Kenji Eda.jpg;6965;7409;35961;348;370;22
/net/per610a/home/mvp/mvp_db/news7-lv/2006/2006_12_13_19_00/2006_12_13_19_00.mpg;Kenji Eda.jpg;10093;10533;35961;504;526;22
/net/per610a/home/mvp/mvp_db/news7-lv/2006/2006_12_14_19_00/2006_12_14_19_00.mpg;Yukio HATOYAMA.jpg;4021;4125;35961;201;206;5
/net/per610a/home/mvp/mvp_db/news7-lv/2006/2006_12_14_19_00/2006_12_14_19_00.mpg;Shinzo ABE.jpg;15509;15569;35961;775;778;3
/net/per610a/home/mvp/mvp_db/news7-lv/2006/2006_12_14_19_00/2006_12_14_19_00.mpg;Shinzo ABE.jpg;15685;16109;35961;784;805;21
/net/per610a/home/mvp/mvp_db/news7-lv/2006/2006_12_15_19_00/2006_12_15_19_00.mpg;Yukio HATOYAMA.jpg;1685;1829;35961;84;91;7
/net/per610a/home/mvp/mvp_db/news7-lv/2006/2006_12_15_19_00/2006_12_15_19_00.mpg;Shinzo ABE.jpg;2029;2029;35961;101;101;0
/net/per610a/home/mvp/mvp_db/news7-lv/2006/2006_12_15_19_00/2006_12_15_19_00.mpg;Shinzo ABE.jpg;5749;8349;35961;287;417;130
/net/per610a/home/mvp/mvp_db/news7-lv/2006/2006_12_15_19_00/2006_12_15_19_00.mpg;Shinzo ABE.jpg;3137;3425;35961;156;171;15
/net/per610a/home/mvp/mvp_db/news7-lv/2006/2006_12_15_19_00/2006_12_15_19_00.mpg;Shinzo ABE.jpg;11741;11865;35961;587;593;6
/net/per610a/home/mvp/mvp_db/news7-lv/2006/2006_12_17_19_00/2006_12_17_19_00.mpg;Seiji MAEHARA.jpg;7557;8461;35961;378;423;45
/net/per610a/home/mvp/mvp_db/news7-lv/2006/2006_12_18_19_00/2006_12_18_19_00.mpg;Shinzo ABE.jpg;32625;33285;35961;1632;1665;33
/net/per610a/home/mvp/mvp_db/news7-lv/2006/2006_12_19_19_00/2006_12_19_19_00.mpg;Shinzo ABE.jpg;6769;7533;35961;338;376;38
/net/per610a/home/mvp/mvp_db/news7-lv/2006/2006_12_19_19_00/2006_12_19_19_00.mpg;Shinzo ABE.jpg;7601;9153;35961;380;457;77
/net/per610a/home/mvp/mvp_db/news7-lv/2006/2006_12_19_19_00/2006_12_19_19_00.mpg;Taro ASO.jpg;30217;30509;35961;1511;1526;15
/net/per610a/home/mvp/mvp_db/news7-lv/2006/2006_12_20_19_00/2006_12_20_19_00.mpg;Shinzo ABE.jpg;397;497;35961;19;24;5
/net/per610a/home/mvp/mvp_db/news7-lv/2006/2006_12_20_19_00/2006_12_20_19_00.mpg;Shinzo ABE.jpg;1593;1665;35961;79;83;4
/net/per610a/home/mvp/mvp_db/news7-lv/2006/2006_12_20_19_00/2006_12_20_19_00.mpg;Shinzo ABE.jpg;2181;2405;35961;109;120;11
/net/per610a/home/mvp/mvp_db/news7-lv/2006/2006_12_21_19_00/2006_12_21_19_00.mpg;Shinzo ABE.jpg;1969;2337;35961;98;116;18
/net/per610a/home/mvp/mvp_db/news7-lv/2006/2006_12_21_19_00/2006_12_21_19_00.mpg;Shinzo ABE.jpg;2653;2681;35961;132;134;2
/net/per610a/home/mvp/mvp_db/news7-lv/2006/2006_12_21_19_00/2006_12_21_19_00.mpg;Shinzo ABE.jpg;21969;22093;35961;1099;1105;6
/net/per610a/home/mvp/mvp_db/news7-lv/2006/2006_12_22_19_00/2006_12_22_19_00.mpg;Toru Hashimoto.jpg;29721;30093;35961;1486;1505;19
/net/per610a/home/mvp/mvp_db/news7-lv/2006/2006_12_24_19_00/2006_12_24_19_00.mpg;Shinzo ABE.jpg;1317;1513;35961;65;75;10
/net/per610a/home/mvp/mvp_db/news7-lv/2006/2006_12_24_19_00/2006_12_24_19_00.mpg;Shinzo ABE.jpg;1669;1717;35961;83;85;2
/net/per610a/home/mvp/mvp_db/news7-lv/2006/2006_12_26_19_00/2006_12_26_19_00.mpg;Shinzo ABE.jpg;15417;16777;35961;771;839;68
/net/per610a/home/mvp/mvp_db/news7-lv/2006/2006_12_27_19_00/2006_12_27_19_00.mpg;Toranosuke Katayama.jpg;4173;6925;35957;208;346;138
/net/per610a/home/mvp/mvp_db/news7-lv/2006/2006_12_27_19_00/2006_12_27_19_00.mpg;Shinzo ABE.jpg;8521;8537;35957;426;427;1
/net/per610a/home/mvp/mvp_db/news7-lv/2006/2006_12_27_19_00/2006_12_27_19_00.mpg;Shinzo ABE.jpg;8641;9045;35957;432;452;20
/net/per610a/home/mvp/mvp_db/news7-lv/2006/2006_12_28_19_00/2006_12_28_19_00.mpg;Yoshimi WATANABE.jpg;661;733;35961;33;36;3
/net/per610a/home/mvp/mvp_db/news7-lv/2006/2006_12_28_19_00/2006_12_28_19_00.mpg;Yoshimi WATANABE.jpg;7753;8497;35961;387;425;38
/net/per610a/home/mvp/mvp_db/news7-lv/2006/2006_12_28_19_00/2006_12_28_19_00.mpg;Yoshimi WATANABE.jpg;8561;11669;35961;428;583;155
/net/per610a/home/mvp/mvp_db/news7-lv/2006/2006_12_28_19_00/2006_12_28_19_00.mpg;Shinzo ABE.jpg;777;829;35961;38;41;3
/net/per610a/home/mvp/mvp_db/news7-lv/2006/2006_12_28_19_00/2006_12_28_19_00.mpg;Shinzo ABE.jpg;7753;8089;35961;387;404;17
/net/per610a/home/mvp/mvp_db/news7-lv/2006/2006_12_28_19_00/2006_12_28_19_00.mpg;Shinzo ABE.jpg;8341;8433;35961;417;421;4
/net/per610a/home/mvp/mvp_db/news7-lv/2007/2007_01_01_19_00/2007_01_01_19_00.mpg;Shinzo ABE.jpg;12037;12313;23881;602;616;14
/net/per610a/home/mvp/mvp_db/news7-lv/2007/2007_01_04_19_00/2007_01_04_19_00.mpg;Shinzo ABE.jpg;1425;1741;35961;71;87;16
/net/per610a/home/mvp/mvp_db/news7-lv/2007/2007_01_04_19_00/2007_01_04_19_00.mpg;Shinzo ABE.jpg;1833;2941;35961;91;147;56
/net/per610a/home/mvp/mvp_db/news7-lv/2007/2007_01_04_19_00/2007_01_04_19_00.mpg;Shinzo ABE.jpg;3005;3045;35961;150;152;2
/net/per610a/home/mvp/mvp_db/news7-lv/2007/2007_01_04_19_00/2007_01_04_19_00.mpg;Shinzo ABE.jpg;3301;3677;35961;165;183;18
/net/per610a/home/mvp/mvp_db/news7-lv/2007/2007_01_04_19_00/2007_01_04_19_00.mpg;Ichiro OZAWA.jpg;3733;4913;35961;186;245;59
/net/per610a/home/mvp/mvp_db/news7-lv/2007/2007_01_06_19_00/2007_01_06_19_00.mpg;Shinzo ABE.jpg;15733;15857;35961;787;793;6
/net/per610a/home/mvp/mvp_db/news7-lv/2007/2007_01_06_19_00/2007_01_06_19_00.mpg;Shinzo ABE.jpg;17149;17161;35961;857;858;1
/net/per610a/home/mvp/mvp_db/news7-lv/2007/2007_01_06_19_00/2007_01_06_19_00.mpg;Shinzo ABE.jpg;16017;16061;35961;801;803;2
/net/per610a/home/mvp/mvp_db/news7-lv/2007/2007_01_06_19_00/2007_01_06_19_00.mpg;Shinzo ABE.jpg;16513;16753;35961;826;838;12
/net/per610a/home/mvp/mvp_db/news7-lv/2007/2007_01_06_19_00/2007_01_06_19_00.mpg;Shinzo ABE.jpg;16861;16865;35961;843;843;0
/net/per610a/home/mvp/mvp_db/news7-lv/2007/2007_01_12_19_00/2007_01_12_19_00.mpg;Shinzo ABE.jpg;16729;18173;35961;836;909;73
/net/per610a/home/mvp/mvp_db/news7-lv/2007/2007_01_12_19_00/2007_01_12_19_00.mpg;Shinzo ABE.jpg;23809;24681;35961;1191;1234;43
/net/per610a/home/mvp/mvp_db/news7-lv/2007/2007_01_12_19_00/2007_01_12_19_00.mpg;Shinzo ABE.jpg;24881;25361;35961;1244;1268;24
/net/per610a/home/mvp/mvp_db/news7-lv/2007/2007_01_13_19_00/2007_01_13_19_00.mpg;Shinzo ABE.jpg;17349;18377;35961;867;919;52
/net/per610a/home/mvp/mvp_db/news7-lv/2007/2007_01_13_19_00/2007_01_13_19_00.mpg;Shinzo ABE.jpg;18637;19301;35961;932;965;33
/net/per610a/home/mvp/mvp_db/news7-lv/2007/2007_01_14_19_00/2007_01_14_19_00.mpg;Shinzo ABE.jpg;41;281;35961;2;14;12
/net/per610a/home/mvp/mvp_db/news7-lv/2007/2007_01_14_19_00/2007_01_14_19_00.mpg;Shinzo ABE.jpg;2633;2861;35961;131;143;12
/net/per610a/home/mvp/mvp_db/news7-lv/2007/2007_01_15_19_00/2007_01_15_19_00.mpg;Shinzo ABE.jpg;13681;13865;35961;684;693;9
/net/per610a/home/mvp/mvp_db/news7-lv/2007/2007_01_16_19_00/2007_01_16_19_00.mpg;Shinzo ABE.jpg;11285;12077;35961;564;604;40
/net/per610a/home/mvp/mvp_db/news7-lv/2007/2007_01_18_19_00/2007_01_18_19_00.mpg;Shinzo ABE.jpg;2393;3245;35961;119;162;43
/net/per610a/home/mvp/mvp_db/news7-lv/2007/2007_01_19_19_00/2007_01_19_19_00.mpg;Shinzo ABE.jpg;6425;6813;35961;321;340;19
/net/per610a/home/mvp/mvp_db/news7-lv/2007/2007_01_19_19_00/2007_01_19_19_00.mpg;Shinzo ABE.jpg;10841;10913;35961;542;545;3
/net/per610a/home/mvp/mvp_db/news7-lv/2007/2007_01_19_19_00/2007_01_19_19_00.mpg;Shinzo ABE.jpg;12477;12885;35961;624;644;20
/net/per610a/home/mvp/mvp_db/news7-lv/2007/2007_01_20_19_00/2007_01_20_19_00.mpg;Shintaro ISHIHARA.jpg;26041;26285;35961;1302;1314;12
/net/per610a/home/mvp/mvp_db/news7-lv/2007/2007_01_24_19_00/2007_01_24_19_00.mpg;Shinzo ABE.jpg;25133;25385;35961;1257;1269;12
/net/per610a/home/mvp/mvp_db/news7-lv/2007/2007_01_24_19_00/2007_01_24_19_00.mpg;Shinzo ABE.jpg;25493;25529;35961;1275;1277;2
/net/per610a/home/mvp/mvp_db/news7-lv/2007/2007_01_24_19_00/2007_01_24_19_00.mpg;Shinzo ABE.jpg;26837;27597;35961;1342;1380;38
/net/per610a/home/mvp/mvp_db/news7-lv/2007/2007_01_25_19_00/2007_01_25_19_00.mpg;Shinzo ABE.jpg;16081;16093;35961;804;805;1
/net/per610a/home/mvp/mvp_db/news7-lv/2007/2007_01_25_19_00/2007_01_25_19_00.mpg;Shinzo ABE.jpg;16377;16437;35961;819;822;3
/net/per610a/home/mvp/mvp_db/news7-lv/2007/2007_01_25_19_00/2007_01_25_19_00.mpg;Shinzo ABE.jpg;16517;17429;35961;826;871;45
/net/per610a/home/mvp/mvp_db/news7-lv/2007/2007_01_25_19_00/2007_01_25_19_00.mpg;Ichiro OZAWA.jpg;17509;18285;35961;875;914;39
/net/per610a/home/mvp/mvp_db/news7-lv/2007/2007_01_25_19_00/2007_01_25_19_00.mpg;Kazuo SHII.jpg;18289;19273;35961;914;964;50
/net/per610a/home/mvp/mvp_db/news7-lv/2007/2007_01_26_19_00/2007_01_26_19_00.mpg;Yukio HATOYAMA.jpg;3853;4825;35961;192;241;49
/net/per610a/home/mvp/mvp_db/news7-lv/2007/2007_01_26_19_00/2007_01_26_19_00.mpg;Shinzo ABE.jpg;4829;4985;35961;241;249;8
/net/per610a/home/mvp/mvp_db/news7-lv/2007/2007_01_26_19_00/2007_01_26_19_00.mpg;Shinzo ABE.jpg;11749;11781;35961;587;589;2
/net/per610a/home/mvp/mvp_db/news7-lv/2007/2007_01_26_19_00/2007_01_26_19_00.mpg;Shinzo ABE.jpg;12465;12581;35961;623;629;6
/net/per610a/home/mvp/mvp_db/news7-lv/2007/2007_01_26_19_00/2007_01_26_19_00.mpg;Ichiro OZAWA.jpg;13169;13473;35961;658;674;16
/net/per610a/home/mvp/mvp_db/news7-lv/2007/2007_01_29_19_00/2007_01_29_19_00.mpg;Shinzo ABE.jpg;77;393;35961;3;19;16
/net/per610a/home/mvp/mvp_db/news7-lv/2007/2007_01_29_19_00/2007_01_29_19_00.mpg;Shinzo ABE.jpg;2481;3093;35961;124;154;30
/net/per610a/home/mvp/mvp_db/news7-lv/2007/2007_01_29_19_00/2007_01_29_19_00.mpg;Shinzo ABE.jpg;5421;5705;35961;271;285;14
/net/per610a/home/mvp/mvp_db/news7-lv/2007/2007_01_29_19_00/2007_01_29_19_00.mpg;Shinzo ABE.jpg;6609;6689;35961;330;334;4
/net/per610a/home/mvp/mvp_db/news7-lv/2007/2007_01_29_19_00/2007_01_29_19_00.mpg;Ichiro OZAWA.jpg;1473;1489;35961;73;74;1
/net/per610a/home/mvp/mvp_db/news7-lv/2007/2007_01_29_19_00/2007_01_29_19_00.mpg;Ichiro OZAWA.jpg;5197;5293;35961;259;264;5
/net/per610a/home/mvp/mvp_db/news7-lv/2007/2007_01_29_19_00/2007_01_29_19_00.mpg;Ichiro OZAWA.jpg;5777;5817;35961;289;291;2
/net/per610a/home/mvp/mvp_db/news7-lv/2007/2007_01_30_19_00/2007_01_30_19_00.mpg;Ichiro OZAWA.jpg;14225;14313;35961;711;716;5
/net/per610a/home/mvp/mvp_db/news7-lv/2007/2007_01_30_19_00/2007_01_30_19_00.mpg;Kazuo SHII.jpg;15661;15965;35961;783;798;15
/net/per610a/home/mvp/mvp_db/news7-lv/2007/2007_01_30_19_00/2007_01_30_19_00.mpg;Shintaro ISHIHARA.jpg;20081;20865;35961;1004;1043;39
/net/per610a/home/mvp/mvp_db/news7-lv/2007/2007_01_31_19_00/2007_01_31_19_00.mpg;Yukio HATOYAMA.jpg;3277;3457;35961;163;172;9
/net/per610a/home/mvp/mvp_db/news7-lv/2007/2007_01_31_19_00/2007_01_31_19_00.mpg;Yukio HATOYAMA.jpg;4321;4501;35961;216;225;9
/net/per610a/home/mvp/mvp_db/news7-lv/2007/2007_01_31_19_00/2007_01_31_19_00.mpg;Shinzo ABE.jpg;10993;11417;35961;549;571;22
/net/per610a/home/mvp/mvp_db/news7-lv/2007/2007_01_31_19_00/2007_01_31_19_00.mpg;Shinzo ABE.jpg;13601;13609;35961;680;680;0
/net/per610a/home/mvp/mvp_db/news7-lv/2007/2007_01_31_19_00/2007_01_31_19_00.mpg;Shinzo ABE.jpg;19129;19253;35961;956;963;7
/net/per610a/home/mvp/mvp_db/news7-lv/2007/2007_02_01_19_00/2007_02_01_19_00.mpg;Shinzo ABE.jpg;2509;3033;35961;125;151;26
/net/per610a/home/mvp/mvp_db/news7-lv/2007/2007_02_01_19_00/2007_02_01_19_00.mpg;Kazuo SHII.jpg;4125;4337;35961;206;216;10
/net/per610a/home/mvp/mvp_db/news7-lv/2007/2007_02_01_19_00/2007_02_01_19_00.mpg;Seiji MAEHARA.jpg;23465;23693;35961;1173;1185;12
/net/per610a/home/mvp/mvp_db/news7-lv/2007/2007_02_02_19_00/2007_02_02_19_00.mpg;Yukio HATOYAMA.jpg;4121;4385;35961;206;219;13
/net/per610a/home/mvp/mvp_db/news7-lv/2007/2007_02_02_19_00/2007_02_02_19_00.mpg;Shintaro ISHIHARA.jpg;15721;16113;35961;786;806;20
/net/per610a/home/mvp/mvp_db/news7-lv/2007/2007_02_03_19_00/2007_02_03_19_00.mpg;Naoto KAN.jpg;81;481;35961;4;24;20
/net/per610a/home/mvp/mvp_db/news7-lv/2007/2007_02_03_19_00/2007_02_03_19_00.mpg;Naoto KAN.jpg;1961;2065;35961;98;103;5
/net/per610a/home/mvp/mvp_db/news7-lv/2007/2007_02_03_19_00/2007_02_03_19_00.mpg;Naoto KAN.jpg;2281;2613;35961;114;130;16
/net/per610a/home/mvp/mvp_db/news7-lv/2007/2007_02_03_19_00/2007_02_03_19_00.mpg;Ichiro OZAWA.jpg;1369;1869;35961;68;93;25
/net/per610a/home/mvp/mvp_db/news7-lv/2007/2007_02_03_19_00/2007_02_03_19_00.mpg;Shinzo ABE.jpg;4117;4169;35961;205;208;3
/net/per610a/home/mvp/mvp_db/news7-lv/2007/2007_02_03_19_00/2007_02_03_19_00.mpg;Shinzo ABE.jpg;4341;4765;35961;217;238;21
/net/per610a/home/mvp/mvp_db/news7-lv/2007/2007_02_03_19_00/2007_02_03_19_00.mpg;Akihiro OHTA.jpg;4817;5049;35961;240;252;12
/net/per610a/home/mvp/mvp_db/news7-lv/2007/2007_02_05_19_00/2007_02_05_19_00.mpg;Shinzo ABE.jpg;4089;5593;35961;204;279;75
/net/per610a/home/mvp/mvp_db/news7-lv/2007/2007_02_06_19_00/2007_02_06_19_00.mpg;Ichiro OZAWA.jpg;4661;6377;35961;233;319;86
/net/per610a/home/mvp/mvp_db/news7-lv/2007/2007_02_06_19_00/2007_02_06_19_00.mpg;Nariaki Nakayama.png;22625;23517;35961;1131;1176;45
/net/per610a/home/mvp/mvp_db/news7-lv/2007/2007_02_06_19_00/2007_02_06_19_00.mpg;Nariaki Nakayama.png;24185;24197;35961;1209;1210;1
/net/per610a/home/mvp/mvp_db/news7-lv/2007/2007_02_12_19_00/2007_02_12_19_00.mpg;Kyoko Nakayama.jpg;10445;12017;35961;522;601;79
/net/per610a/home/mvp/mvp_db/news7-lv/2007/2007_02_14_19_00/2007_02_14_19_00.mpg;Shinzo ABE.jpg;21925;21989;35961;1096;1100;4
/net/per610a/home/mvp/mvp_db/news7-lv/2007/2007_02_14_19_00/2007_02_14_19_00.mpg;Shinzo ABE.jpg;22101;22385;35961;1105;1119;14
/net/per610a/home/mvp/mvp_db/news7-lv/2007/2007_02_16_19_00/2007_02_16_19_00.mpg;Shinzo ABE.jpg;20377;20453;35961;1019;1023;4
/net/per610a/home/mvp/mvp_db/news7-lv/2007/2007_02_16_19_00/2007_02_16_19_00.mpg;Shinzo ABE.jpg;20781;20925;35961;1039;1046;7
/net/per610a/home/mvp/mvp_db/news7-lv/2007/2007_02_20_19_00/2007_02_20_19_00.mpg;Shinzo ABE.jpg;3961;6461;35961;198;323;125
/net/per610a/home/mvp/mvp_db/news7-lv/2007/2007_02_21_19_00/2007_02_21_19_00.mpg;Toranosuke Katayama.jpg;18413;18561;35961;921;928;7
/net/per610a/home/mvp/mvp_db/news7-lv/2007/2007_02_25_19_00/2007_02_25_19_00.mpg;Shinzo ABE.jpg;165;225;35961;8;11;3
/net/per610a/home/mvp/mvp_db/news7-lv/2007/2007_02_25_19_00/2007_02_25_19_00.mpg;Shinzo ABE.jpg;2145;2477;35961;107;123;16
/net/per610a/home/mvp/mvp_db/news7-lv/2007/2007_02_25_19_00/2007_02_25_19_00.mpg;Shinzo ABE.jpg;6049;6609;35961;302;330;28
/net/per610a/home/mvp/mvp_db/news7-lv/2007/2007_02_25_19_00/2007_02_25_19_00.mpg;Shinzo ABE.jpg;6693;6737;35961;334;337;3
/net/per610a/home/mvp/mvp_db/news7-lv/2007/2007_02_25_19_00/2007_02_25_19_00.mpg;Shinzo ABE.jpg;7285;7621;35961;364;381;17
/net/per610a/home/mvp/mvp_db/news7-lv/2007/2007_02_26_19_00/2007_02_26_19_00.mpg;Shinzo ABE.jpg;20265;20393;35961;1013;1020;7
/net/per610a/home/mvp/mvp_db/news7-lv/2007/2007_02_27_19_00/2007_02_27_19_00.mpg;Toranosuke Katayama.jpg;10741;11357;35961;537;568;31
/net/per610a/home/mvp/mvp_db/news7-lv/2007/2007_02_27_19_00/2007_02_27_19_00.mpg;Shinzo ABE.jpg;22881;23377;35961;1144;1169;25
/net/per610a/home/mvp/mvp_db/news7-lv/2007/2007_02_28_19_00/2007_02_28_19_00.mpg;Shintaro ISHIHARA.jpg;18297;18685;35961;915;934;19
/net/per610a/home/mvp/mvp_db/news7-lv/2007/2007_03_05_19_00/2007_03_05_19_00.mpg;Shinzo ABE.jpg;20241;20713;35961;1012;1036;24
/net/per610a/home/mvp/mvp_db/news7-lv/2007/2007_03_05_19_00/2007_03_05_19_00.mpg;Shinzo ABE.jpg;20789;20881;35961;1039;1044;5
/net/per610a/home/mvp/mvp_db/news7-lv/2007/2007_03_06_19_00/2007_03_06_19_00.mpg;Shinzo ABE.jpg;20789;21181;35961;1039;1059;20
/net/per610a/home/mvp/mvp_db/news7-lv/2007/2007_03_06_19_00/2007_03_06_19_00.mpg;Shinzo ABE.jpg;21517;21669;35961;1076;1084;8
/net/per610a/home/mvp/mvp_db/news7-lv/2007/2007_03_06_19_00/2007_03_06_19_00.mpg;Shinzo ABE.jpg;23557;23573;35961;1178;1179;1
/net/per610a/home/mvp/mvp_db/news7-lv/2007/2007_03_07_19_00/2007_03_07_19_00.mpg;Shinzo ABE.jpg;13525;14361;35961;676;718;42
/net/per610a/home/mvp/mvp_db/news7-lv/2007/2007_03_08_19_00/2007_03_08_19_00.mpg;Shinzo ABE.jpg;23637;24153;35961;1182;1208;26
/net/per610a/home/mvp/mvp_db/news7-lv/2007/2007_03_08_19_00/2007_03_08_19_00.mpg;Shinzo ABE.jpg;24901;25409;35961;1245;1271;26
/net/per610a/home/mvp/mvp_db/news7-lv/2007/2007_03_09_19_00/2007_03_09_19_00.mpg;Shinzo ABE.jpg;149;429;35961;7;21;14
/net/per610a/home/mvp/mvp_db/news7-lv/2007/2007_03_09_19_00/2007_03_09_19_00.mpg;Shinzo ABE.jpg;1125;2349;35961;56;117;61
/net/per610a/home/mvp/mvp_db/news7-lv/2007/2007_03_09_19_00/2007_03_09_19_00.mpg;Shinzo ABE.jpg;2417;3513;35961;120;175;55
/net/per610a/home/mvp/mvp_db/news7-lv/2007/2007_03_09_19_00/2007_03_09_19_00.mpg;Shinzo ABE.jpg;3633;4137;35961;181;206;25
/net/per610a/home/mvp/mvp_db/news7-lv/2007/2007_03_09_19_00/2007_03_09_19_00.mpg;Shinzo ABE.jpg;18053;18889;35961;903;944;41
/net/per610a/home/mvp/mvp_db/news7-lv/2007/2007_03_09_19_00/2007_03_09_19_00.mpg;Akihiro OHTA.jpg;17089;18013;35961;854;901;47
/net/per610a/home/mvp/mvp_db/news7-lv/2007/2007_03_10_19_00/2007_03_10_19_00.mpg;Shinzo ABE.jpg;14353;14721;35961;718;736;18
/net/per610a/home/mvp/mvp_db/news7-lv/2007/2007_03_10_19_00/2007_03_10_19_00.mpg;Shinzo ABE.jpg;15117;16045;35961;756;802;46
/net/per610a/home/mvp/mvp_db/news7-lv/2007/2007_03_10_19_00/2007_03_10_19_00.mpg;Yukio HATOYAMA.jpg;19353;19953;35961;968;998;30
/net/per610a/home/mvp/mvp_db/news7-lv/2007/2007_03_12_19_00/2007_03_12_19_00.mpg;Shinzo ABE.jpg;5525;6017;35961;276;301;25
/net/per610a/home/mvp/mvp_db/news7-lv/2007/2007_03_12_19_00/2007_03_12_19_00.mpg;Shinzo ABE.jpg;7221;7233;35961;361;361;0
/net/per610a/home/mvp/mvp_db/news7-lv/2007/2007_03_12_19_00/2007_03_12_19_00.mpg;Shinzo ABE.jpg;17077;17089;35961;854;854;0
/net/per610a/home/mvp/mvp_db/news7-lv/2007/2007_03_12_19_00/2007_03_12_19_00.mpg;Shinzo ABE.jpg;6977;7217;35961;349;361;12
/net/per610a/home/mvp/mvp_db/news7-lv/2007/2007_03_12_19_00/2007_03_12_19_00.mpg;Shinzo ABE.jpg;13317;13669;35961;666;683;17
/net/per610a/home/mvp/mvp_db/news7-lv/2007/2007_03_12_19_00/2007_03_12_19_00.mpg;Shinzo ABE.jpg;14029;14029;35961;701;701;0
/net/per610a/home/mvp/mvp_db/news7-lv/2007/2007_03_12_19_00/2007_03_12_19_00.mpg;Shinzo ABE.jpg;14393;15277;35961;720;764;44
/net/per610a/home/mvp/mvp_db/news7-lv/2007/2007_03_13_19_00/2007_03_13_19_00.mpg;Shinzo ABE.jpg;13533;13985;35961;677;699;22
/net/per610a/home/mvp/mvp_db/news7-lv/2007/2007_03_15_19_00/2007_03_15_19_00.mpg;Shinzo ABE.jpg;8517;9265;35961;426;463;37
/net/per610a/home/mvp/mvp_db/news7-lv/2007/2007_03_18_19_00/2007_03_18_19_00.mpg;Shinzo ABE.jpg;23757;23909;35961;1188;1196;8
/net/per610a/home/mvp/mvp_db/news7-lv/2007/2007_03_19_19_00/2007_03_19_19_00.mpg;Shinzo ABE.jpg;14065;14441;35961;703;722;19
/net/per610a/home/mvp/mvp_db/news7-lv/2007/2007_03_19_19_00/2007_03_19_19_00.mpg;Shinzo ABE.jpg;15517;15829;35961;776;791;15
/net/per610a/home/mvp/mvp_db/news7-lv/2007/2007_03_19_19_00/2007_03_19_19_00.mpg;Shinzo ABE.jpg;16193;16197;35961;810;810;0
/net/per610a/home/mvp/mvp_db/news7-lv/2007/2007_03_21_19_00/2007_03_21_19_00.mpg;Yoshimi WATANABE.jpg;24765;25897;35961;1238;1295;57
/net/per610a/home/mvp/mvp_db/news7-lv/2007/2007_03_22_19_00/2007_03_22_19_00.mpg;Shinzo ABE.jpg;25685;25985;35961;1284;1299;15
/net/per610a/home/mvp/mvp_db/news7-lv/2007/2007_03_23_19_00/2007_03_23_19_00.mpg;Toranosuke Katayama.jpg;24217;24521;35961;1211;1226;15
/net/per610a/home/mvp/mvp_db/news7-lv/2007/2007_03_24_19_00/2007_03_24_19_00.mpg;Shinzo ABE.jpg;4225;4517;35961;211;225;14
/net/per610a/home/mvp/mvp_db/news7-lv/2007/2007_03_24_19_00/2007_03_24_19_00.mpg;Shinzo ABE.jpg;6221;6233;35961;311;311;0
/net/per610a/home/mvp/mvp_db/news7-lv/2007/2007_03_24_19_00/2007_03_24_19_00.mpg;Yoshimi WATANABE.jpg;4581;6217;35961;229;311;82
/net/per610a/home/mvp/mvp_db/news7-lv/2007/2007_03_26_19_00/2007_03_26_19_00.mpg;Shinzo ABE.jpg;11189;11417;35961;559;571;12
/net/per610a/home/mvp/mvp_db/news7-lv/2007/2007_03_26_19_00/2007_03_26_19_00.mpg;Shinzo ABE.jpg;15841;16081;35961;792;804;12
/net/per610a/home/mvp/mvp_db/news7-lv/2007/2007_03_26_19_00/2007_03_26_19_00.mpg;Shinzo ABE.jpg;17953;18013;35961;898;901;3
/net/per610a/home/mvp/mvp_db/news7-lv/2007/2007_03_26_19_00/2007_03_26_19_00.mpg;Shinzo ABE.jpg;21001;21037;35961;1050;1052;2
/net/per610a/home/mvp/mvp_db/news7-lv/2007/2007_03_29_19_00/2007_03_29_19_00.mpg;Nariaki Nakayama.png;27277;27537;35961;1364;1377;13
/net/per610a/home/mvp/mvp_db/news7-lv/2007/2007_03_30_19_00/2007_03_30_19_00.mpg;Shinzo ABE.jpg;7501;7745;35961;375;387;12
/net/per610a/home/mvp/mvp_db/news7-lv/2007/2007_03_31_19_00/2007_03_31_19_00.mpg;Taro ASO.jpg;14693;15137;35961;735;757;22
/net/per610a/home/mvp/mvp_db/news7-lv/2007/2007_04_03_19_00/2007_04_03_19_00.mpg;Yoshimi WATANABE.jpg;19077;19145;35961;954;957;3
/net/per610a/home/mvp/mvp_db/news7-lv/2007/2007_04_03_19_00/2007_04_03_19_00.mpg;Shinzo ABE.jpg;19753;20609;35961;988;1030;42
/net/per610a/home/mvp/mvp_db/news7-lv/2007/2007_04_04_19_00/2007_04_04_19_00.mpg;Toranosuke Katayama.jpg;19193;19293;35961;960;965;5
/net/per610a/home/mvp/mvp_db/news7-lv/2007/2007_04_05_19_00/2007_04_05_19_00.mpg;Ichiro OZAWA.jpg;6925;7273;35961;346;363;17
/net/per610a/home/mvp/mvp_db/news7-lv/2007/2007_04_05_19_00/2007_04_05_19_00.mpg;Shinzo ABE.jpg;6925;7273;35961;346;363;17
/net/per610a/home/mvp/mvp_db/news7-lv/2007/2007_04_09_19_00/2007_04_09_19_00.mpg;Shintaro ISHIHARA.jpg;1;317;35961;0;15;15
/net/per610a/home/mvp/mvp_db/news7-lv/2007/2007_04_09_19_00/2007_04_09_19_00.mpg;Shintaro ISHIHARA.jpg;937;1193;35961;46;59;13
/net/per610a/home/mvp/mvp_db/news7-lv/2007/2007_04_09_19_00/2007_04_09_19_00.mpg;Shintaro ISHIHARA.jpg;1369;1425;35961;68;71;3
/net/per610a/home/mvp/mvp_db/news7-lv/2007/2007_04_09_19_00/2007_04_09_19_00.mpg;Shintaro ISHIHARA.jpg;4369;5041;35961;218;252;34
/net/per610a/home/mvp/mvp_db/news7-lv/2007/2007_04_09_19_00/2007_04_09_19_00.mpg;Yukio EDANO.jpg;9549;9913;35961;477;495;18
/net/per610a/home/mvp/mvp_db/news7-lv/2007/2007_04_09_19_00/2007_04_09_19_00.mpg;Shinzo ABE.jpg;19357;19725;35961;968;986;18
/net/per610a/home/mvp/mvp_db/news7-lv/2007/2007_04_11_19_00/2007_04_11_19_00.mpg;Shinzo ABE.jpg;2057;2149;35961;102;107;5
/net/per610a/home/mvp/mvp_db/news7-lv/2007/2007_04_11_19_00/2007_04_11_19_00.mpg;Shinzo ABE.jpg;3697;3745;35961;184;187;3
/net/per610a/home/mvp/mvp_db/news7-lv/2007/2007_04_12_19_00/2007_04_12_19_00.mpg;Shinzo ABE.jpg;7869;7961;35961;393;398;5
/net/per610a/home/mvp/mvp_db/news7-lv/2007/2007_04_12_19_00/2007_04_12_19_00.mpg;Toranosuke Katayama.jpg;29257;29405;35961;1463;1471;8
/net/per610a/home/mvp/mvp_db/news7-lv/2007/2007_04_18_19_00/2007_04_18_19_00.mpg;Shinzo ABE.jpg;25369;25425;35961;1269;1271;2
/net/per610a/home/mvp/mvp_db/news7-lv/2007/2007_04_18_19_00/2007_04_18_19_00.mpg;Shinzo ABE.jpg;25505;26021;35961;1275;1301;26
/net/per610a/home/mvp/mvp_db/news7-lv/2007/2007_04_22_19_00/2007_04_22_19_00.mpg;Shinzo ABE.jpg;12889;13057;35961;644;653;9
/net/per610a/home/mvp/mvp_db/news7-lv/2007/2007_04_23_19_00/2007_04_23_19_00.mpg;Shinzo ABE.jpg;10813;11321;35961;540;566;26
/net/per610a/home/mvp/mvp_db/news7-lv/2007/2007_04_24_19_00/2007_04_24_19_00.mpg;Shinzo ABE.jpg;12929;13433;35961;646;672;26
/net/per610a/home/mvp/mvp_db/news7-lv/2007/2007_04_24_19_00/2007_04_24_19_00.mpg;Shinzo ABE.jpg;14801;14829;35961;740;741;1
/net/per610a/home/mvp/mvp_db/news7-lv/2007/2007_04_24_19_00/2007_04_24_19_00.mpg;Shinzo ABE.jpg;17421;17605;35961;871;880;9
/net/per610a/home/mvp/mvp_db/news7-lv/2007/2007_04_24_19_00/2007_04_24_19_00.mpg;Yoshimi WATANABE.jpg;13437;14025;35961;672;701;29
/net/per610a/home/mvp/mvp_db/news7-lv/2007/2007_04_24_19_00/2007_04_24_19_00.mpg;Shinzo ABE.jpg;26461;26957;35961;1323;1348;25
/net/per610a/home/mvp/mvp_db/news7-lv/2007/2007_04_25_19_00/2007_04_25_19_00.mpg;Shinzo ABE.jpg;14949;16157;35961;747;808;61
/net/per610a/home/mvp/mvp_db/news7-lv/2007/2007_04_25_19_00/2007_04_25_19_00.mpg;Shinzo ABE.jpg;15849;16157;35961;792;808;16
/net/per610a/home/mvp/mvp_db/news7-lv/2007/2007_04_27_19_00/2007_04_27_19_00.mpg;Shinzo ABE.jpg;109;189;35961;5;9;4
/net/per610a/home/mvp/mvp_db/news7-lv/2007/2007_04_27_19_00/2007_04_27_19_00.mpg;Shinzo ABE.jpg;3853;3881;35961;192;194;2
/net/per610a/home/mvp/mvp_db/news7-lv/2007/2007_04_27_19_00/2007_04_27_19_00.mpg;Shinzo ABE.jpg;2289;2385;35961;114;119;5
/net/per610a/home/mvp/mvp_db/news7-lv/2007/2007_04_27_19_00/2007_04_27_19_00.mpg;Shinzo ABE.jpg;4633;4677;35961;231;233;2
/net/per610a/home/mvp/mvp_db/news7-lv/2007/2007_05_01_19_00/2007_05_01_19_00.mpg;Shinzo ABE.jpg;8221;8341;35961;411;417;6
/net/per610a/home/mvp/mvp_db/news7-lv/2007/2007_05_07_19_00/2007_05_07_19_00.mpg;Shinzo ABE.jpg;2581;2625;35961;129;131;2
/net/per610a/home/mvp/mvp_db/news7-lv/2007/2007_05_07_19_00/2007_05_07_19_00.mpg;Shinzo ABE.jpg;17017;17289;35961;851;864;13
/net/per610a/home/mvp/mvp_db/news7-lv/2007/2007_05_07_19_00/2007_05_07_19_00.mpg;Shinzo ABE.jpg;17801;17873;35961;890;894;4
/net/per610a/home/mvp/mvp_db/news7-lv/2007/2007_05_08_19_00/2007_05_08_19_00.mpg;Shinzo ABE.jpg;6893;7293;35961;344;364;20
/net/per610a/home/mvp/mvp_db/news7-lv/2007/2007_05_08_19_00/2007_05_08_19_00.mpg;Shinzo ABE.jpg;11493;11569;35961;574;578;4
/net/per610a/home/mvp/mvp_db/news7-lv/2007/2007_05_08_19_00/2007_05_08_19_00.mpg;Shinzo ABE.jpg;24709;24861;35961;1236;1243;7
/net/per610a/home/mvp/mvp_db/news7-lv/2007/2007_05_12_19_00/2007_05_12_19_00.mpg;Shinzo ABE.jpg;12549;12665;35961;627;633;6
/net/per610a/home/mvp/mvp_db/news7-lv/2007/2007_05_15_19_00/2007_05_15_19_00.mpg;Shinzo ABE.jpg;10889;11337;35961;544;567;23
/net/per610a/home/mvp/mvp_db/news7-lv/2007/2007_05_16_19_00/2007_05_16_19_00.mpg;Shinzo ABE.jpg;13;341;35961;0;17;17
/net/per610a/home/mvp/mvp_db/news7-lv/2007/2007_05_18_19_00/2007_05_18_19_00.mpg;Akihiro OHTA.jpg;20457;20561;35961;1023;1028;5
/net/per610a/home/mvp/mvp_db/news7-lv/2007/2007_05_18_19_00/2007_05_18_19_00.mpg;Shintaro ISHIHARA.jpg;22841;23421;35961;1142;1171;29
/net/per610a/home/mvp/mvp_db/news7-lv/2007/2007_05_19_19_00/2007_05_19_19_00.mpg;Shinzo ABE.jpg;23609;24125;35961;1181;1206;25
/net/per610a/home/mvp/mvp_db/news7-lv/2007/2007_05_23_19_00/2007_05_23_19_00.mpg;Shinzo ABE.jpg;8621;9009;35961;431;450;19
/net/per610a/home/mvp/mvp_db/news7-lv/2007/2007_05_24_19_00/2007_05_24_19_00.mpg;Shinzo ABE.jpg;19209;19545;35961;960;977;17
/net/per610a/home/mvp/mvp_db/news7-lv/2007/2007_05_24_19_00/2007_05_24_19_00.mpg;Shinzo ABE.jpg;20137;20253;35961;1007;1013;6
/net/per610a/home/mvp/mvp_db/news7-lv/2007/2007_05_24_19_00/2007_05_24_19_00.mpg;Shinzo ABE.jpg;20357;20445;35961;1018;1022;4
/net/per610a/home/mvp/mvp_db/news7-lv/2007/2007_05_26_19_00/2007_05_26_19_00.mpg;Shinzo ABE.jpg;25;189;35961;1;9;8
/net/per610a/home/mvp/mvp_db/news7-lv/2007/2007_05_26_19_00/2007_05_26_19_00.mpg;Shinzo ABE.jpg;1365;3025;35961;68;151;83
/net/per610a/home/mvp/mvp_db/news7-lv/2007/2007_05_28_19_00/2007_05_28_19_00.mpg;Shinzo ABE.jpg;189;421;35961;9;21;12
/net/per610a/home/mvp/mvp_db/news7-lv/2007/2007_05_28_19_00/2007_05_28_19_00.mpg;Shinzo ABE.jpg;1449;2069;35961;72;103;31
/net/per610a/home/mvp/mvp_db/news7-lv/2007/2007_05_28_19_00/2007_05_28_19_00.mpg;Shinzo ABE.jpg;5869;6125;35961;293;306;13
/net/per610a/home/mvp/mvp_db/news7-lv/2007/2007_05_28_19_00/2007_05_28_19_00.mpg;Shinzo ABE.jpg;14805;15425;35961;740;771;31
/net/per610a/home/mvp/mvp_db/news7-lv/2007/2007_05_28_19_00/2007_05_28_19_00.mpg;Yukio HATOYAMA.jpg;21357;21525;35961;1068;1076;8
/net/per610a/home/mvp/mvp_db/news7-lv/2007/2007_05_29_19_00/2007_05_29_19_00.mpg;Shinzo ABE.jpg;12177;12309;35961;609;615;6
/net/per610a/home/mvp/mvp_db/news7-lv/2007/2007_05_30_19_00/2007_05_30_19_00.mpg;Shinzo ABE.jpg;221;381;35961;11;19;8
/net/per610a/home/mvp/mvp_db/news7-lv/2007/2007_05_30_19_00/2007_05_30_19_00.mpg;Shinzo ABE.jpg;4061;4809;35961;203;240;37
/net/per610a/home/mvp/mvp_db/news7-lv/2007/2007_05_31_19_00/2007_05_31_19_00.mpg;Akihiro OHTA.jpg;3185;3345;35961;159;167;8
/net/per610a/home/mvp/mvp_db/news7-lv/2007/2007_06_01_19_00/2007_06_01_19_00.mpg;Shinzo ABE.jpg;29;281;35961;1;14;13
/net/per610a/home/mvp/mvp_db/news7-lv/2007/2007_06_01_19_00/2007_06_01_19_00.mpg;Shinzo ABE.jpg;1469;1473;35961;73;73;0
/net/per610a/home/mvp/mvp_db/news7-lv/2007/2007_06_01_19_00/2007_06_01_19_00.mpg;Shinzo ABE.jpg;1629;1721;35961;81;86;5
/net/per610a/home/mvp/mvp_db/news7-lv/2007/2007_06_01_19_00/2007_06_01_19_00.mpg;Shinzo ABE.jpg;1813;1909;35961;90;95;5
/net/per610a/home/mvp/mvp_db/news7-lv/2007/2007_06_01_19_00/2007_06_01_19_00.mpg;Shinzo ABE.jpg;3049;3337;35961;152;166;14
/net/per610a/home/mvp/mvp_db/news7-lv/2007/2007_06_01_19_00/2007_06_01_19_00.mpg;Naoto KAN.jpg;3961;4277;35961;198;213;15
/net/per610a/home/mvp/mvp_db/news7-lv/2007/2007_06_01_19_00/2007_06_01_19_00.mpg;Shintaro ISHIHARA.jpg;14817;15101;35961;741;755;14
/net/per610a/home/mvp/mvp_db/news7-lv/2007/2007_06_02_19_00/2007_06_02_19_00.mpg;Shinzo ABE.jpg;4845;5469;35961;242;273;31
/net/per610a/home/mvp/mvp_db/news7-lv/2007/2007_06_02_19_00/2007_06_02_19_00.mpg;Yukio HATOYAMA.jpg;11725;12405;35961;586;620;34
/net/per610a/home/mvp/mvp_db/news7-lv/2007/2007_06_02_19_00/2007_06_02_19_00.mpg;Yoshimi WATANABE.jpg;14125;15089;35961;706;754;48
/net/per610a/home/mvp/mvp_db/news7-lv/2007/2007_06_02_19_00/2007_06_02_19_00.mpg;Yoshimi WATANABE.jpg;15153;15533;35961;758;777;19
/net/per610a/home/mvp/mvp_db/news7-lv/2007/2007_06_03_19_00/2007_06_03_19_00.mpg;Shinzo ABE.jpg;6209;6617;35961;310;331;21
/net/per610a/home/mvp/mvp_db/news7-lv/2007/2007_06_03_19_00/2007_06_03_19_00.mpg;Shinzo ABE.jpg;7065;7397;35961;353;370;17
/net/per610a/home/mvp/mvp_db/news7-lv/2007/2007_06_03_19_00/2007_06_03_19_00.mpg;Yukio HATOYAMA.jpg;8005;9565;35961;400;478;78
/net/per610a/home/mvp/mvp_db/news7-lv/2007/2007_06_04_19_00/2007_06_04_19_00.mpg;Shinzo ABE.jpg;1021;1029;35961;51;51;0
/net/per610a/home/mvp/mvp_db/news7-lv/2007/2007_06_04_19_00/2007_06_04_19_00.mpg;Shinzo ABE.jpg;4801;4901;35961;240;245;5
/net/per610a/home/mvp/mvp_db/news7-lv/2007/2007_06_05_19_00/2007_06_05_19_00.mpg;Shinzo ABE.jpg;97;185;35961;4;9;5
/net/per610a/home/mvp/mvp_db/news7-lv/2007/2007_06_05_19_00/2007_06_05_19_00.mpg;Shinzo ABE.jpg;1305;1453;35961;65;72;7
/net/per610a/home/mvp/mvp_db/news7-lv/2007/2007_06_05_19_00/2007_06_05_19_00.mpg;Shinzo ABE.jpg;2253;3005;35961;112;150;38
/net/per610a/home/mvp/mvp_db/news7-lv/2007/2007_06_05_19_00/2007_06_05_19_00.mpg;Ichiro OZAWA.jpg;8641;9201;35961;432;460;28
/net/per610a/home/mvp/mvp_db/news7-lv/2007/2007_06_06_19_00/2007_06_06_19_00.mpg;Shinzo ABE.jpg;15453;15945;35961;773;797;24
/net/per610a/home/mvp/mvp_db/news7-lv/2007/2007_06_08_19_00/2007_06_08_19_00.mpg;Shinzo ABE.jpg;17189;17229;35961;859;861;2
/net/per610a/home/mvp/mvp_db/news7-lv/2007/2007_06_08_19_00/2007_06_08_19_00.mpg;Shinzo ABE.jpg;18109;18165;35961;905;908;3
/net/per610a/home/mvp/mvp_db/news7-lv/2007/2007_06_09_19_00/2007_06_09_19_00.mpg;Shinzo ABE.jpg;11333;11385;35961;566;569;3
/net/per610a/home/mvp/mvp_db/news7-lv/2007/2007_06_09_19_00/2007_06_09_19_00.mpg;Shinzo ABE.jpg;11645;11725;35961;582;586;4
/net/per610a/home/mvp/mvp_db/news7-lv/2007/2007_06_09_19_00/2007_06_09_19_00.mpg;Shinzo ABE.jpg;11809;12021;35961;590;601;11
/net/per610a/home/mvp/mvp_db/news7-lv/2007/2007_06_10_19_00/2007_06_10_19_00.mpg;Shinzo ABE.jpg;11873;12397;35961;593;620;27
/net/per610a/home/mvp/mvp_db/news7-lv/2007/2007_06_11_19_00/2007_06_11_19_00.mpg;Shinzo ABE.jpg;14013;14145;35961;701;707;6
/net/per610a/home/mvp/mvp_db/news7-lv/2007/2007_06_12_19_00/2007_06_12_19_00.mpg;Shintaro ISHIHARA.jpg;29421;29645;35961;1471;1483;12
/net/per610a/home/mvp/mvp_db/news7-lv/2007/2007_06_13_19_00/2007_06_13_19_00.mpg;Shinzo ABE.jpg;25693;26177;35961;1285;1309;24
/net/per610a/home/mvp/mvp_db/news7-lv/2007/2007_06_14_19_00/2007_06_14_19_00.mpg;Shinzo ABE.jpg;7285;7833;35961;364;391;27
/net/per610a/home/mvp/mvp_db/news7-lv/2007/2007_06_14_19_00/2007_06_14_19_00.mpg;Shinzo ABE.jpg;9173;9557;35961;458;478;20
/net/per610a/home/mvp/mvp_db/news7-lv/2007/2007_06_14_19_00/2007_06_14_19_00.mpg;Shinzo ABE.jpg;20985;21377;35961;1049;1069;20
/net/per610a/home/mvp/mvp_db/news7-lv/2007/2007_06_14_19_00/2007_06_14_19_00.mpg;Yoshimi WATANABE.jpg;21849;22017;35961;1093;1101;8
/net/per610a/home/mvp/mvp_db/news7-lv/2007/2007_06_15_19_00/2007_06_15_19_00.mpg;Shinzo ABE.jpg;2185;3205;35961;109;160;51
/net/per610a/home/mvp/mvp_db/news7-lv/2007/2007_06_16_19_00/2007_06_16_19_00.mpg;Shinzo ABE.jpg;2065;2073;35961;103;103;0
/net/per610a/home/mvp/mvp_db/news7-lv/2007/2007_06_16_19_00/2007_06_16_19_00.mpg;Shinzo ABE.jpg;2201;2525;35961;110;126;16
/net/per610a/home/mvp/mvp_db/news7-lv/2007/2007_06_16_19_00/2007_06_16_19_00.mpg;Shinzo ABE.jpg;8205;10805;35961;410;540;130
/net/per610a/home/mvp/mvp_db/news7-lv/2007/2007_06_19_19_00/2007_06_19_19_00.mpg;Toranosuke Katayama.jpg;15993;16217;35961;800;811;11
/net/per610a/home/mvp/mvp_db/news7-lv/2007/2007_06_20_19_00/2007_06_20_19_00.mpg;Shinzo ABE.jpg;15429;15913;35961;771;796;25
/net/per610a/home/mvp/mvp_db/news7-lv/2007/2007_06_20_19_00/2007_06_20_19_00.mpg;Ichiro OZAWA.jpg;18485;19321;35961;924;966;42
/net/per610a/home/mvp/mvp_db/news7-lv/2007/2007_06_21_19_00/2007_06_21_19_00.mpg;Shinzo ABE.jpg;8753;9949;35961;437;497;60
/net/per610a/home/mvp/mvp_db/news7-lv/2007/2007_06_21_19_00/2007_06_21_19_00.mpg;Taro ASO.jpg;10761;11145;35961;538;557;19
/net/per610a/home/mvp/mvp_db/news7-lv/2007/2007_06_22_19_00/2007_06_22_19_00.mpg;Shinzo ABE.jpg;6813;7393;35961;340;369;29
/net/per610a/home/mvp/mvp_db/news7-lv/2007/2007_06_22_19_00/2007_06_22_19_00.mpg;Shinzo ABE.jpg;27885;28541;35961;1394;1427;33
/net/per610a/home/mvp/mvp_db/news7-lv/2007/2007_06_22_19_00/2007_06_22_19_00.mpg;Toranosuke Katayama.jpg;26841;27125;35961;1342;1356;14
/net/per610a/home/mvp/mvp_db/news7-lv/2007/2007_06_22_19_00/2007_06_22_19_00.mpg;Yukio HATOYAMA.jpg;27549;27837;35961;1378;1392;14
/net/per610a/home/mvp/mvp_db/news7-lv/2007/2007_06_23_19_00/2007_06_23_19_00.mpg;Naoto KAN.jpg;18397;19289;35961;920;964;44
/net/per610a/home/mvp/mvp_db/news7-lv/2007/2007_06_25_19_00/2007_06_25_19_00.mpg;Shinzo ABE.jpg;11897;12209;35961;595;610;15
/net/per610a/home/mvp/mvp_db/news7-lv/2007/2007_06_25_19_00/2007_06_25_19_00.mpg;Shinzo ABE.jpg;12485;12525;35961;624;626;2
/net/per610a/home/mvp/mvp_db/news7-lv/2007/2007_06_25_19_00/2007_06_25_19_00.mpg;Shinzo ABE.jpg;21949;22445;35961;1098;1122;24
/net/per610a/home/mvp/mvp_db/news7-lv/2007/2007_06_26_19_00/2007_06_26_19_00.mpg;Yukio HATOYAMA.jpg;5433;6229;35961;271;311;40
/net/per610a/home/mvp/mvp_db/news7-lv/2007/2007_06_26_19_00/2007_06_26_19_00.mpg;Shinzo ABE.jpg;7753;8265;35961;387;413;26
/net/per610a/home/mvp/mvp_db/news7-lv/2007/2007_06_27_19_00/2007_06_27_19_00.mpg;Takeo Hiranuma.jpeg;12425;12481;35961;621;624;3
/net/per610a/home/mvp/mvp_db/news7-lv/2007/2007_06_27_19_00/2007_06_27_19_00.mpg;Takeo Hiranuma.jpeg;12829;13249;35961;641;662;21
/net/per610a/home/mvp/mvp_db/news7-lv/2007/2007_06_27_19_00/2007_06_27_19_00.mpg;Shinzo ABE.jpg;14061;14497;35961;703;725;22
/net/per610a/home/mvp/mvp_db/news7-lv/2007/2007_06_29_19_00/2007_06_29_19_00.mpg;Takeo Hiranuma.jpeg;945;1785;35961;47;89;42
/net/per610a/home/mvp/mvp_db/news7-lv/2007/2007_06_29_19_00/2007_06_29_19_00.mpg;Takeo Hiranuma.jpeg;2417;2561;35961;120;128;8
/net/per610a/home/mvp/mvp_db/news7-lv/2007/2007_06_29_19_00/2007_06_29_19_00.mpg;Takeo Hiranuma.jpeg;3289;3501;35961;164;175;11
/net/per610a/home/mvp/mvp_db/news7-lv/2007/2007_06_29_19_00/2007_06_29_19_00.mpg;Takeo Hiranuma.jpeg;3569;3613;35961;178;180;2
/net/per610a/home/mvp/mvp_db/news7-lv/2007/2007_06_29_19_00/2007_06_29_19_00.mpg;Takeo Hiranuma.jpeg;4401;4429;35961;220;221;1
/net/per610a/home/mvp/mvp_db/news7-lv/2007/2007_06_29_19_00/2007_06_29_19_00.mpg;Takeo Hiranuma.jpeg;4545;4861;35961;227;243;16
/net/per610a/home/mvp/mvp_db/news7-lv/2007/2007_06_29_19_00/2007_06_29_19_00.mpg;Takeo Hiranuma.jpeg;5037;5073;35961;251;253;2
/net/per610a/home/mvp/mvp_db/news7-lv/2007/2007_06_29_19_00/2007_06_29_19_00.mpg;Takeo Hiranuma.jpeg;5369;5405;35961;268;270;2
/net/per610a/home/mvp/mvp_db/news7-lv/2007/2007_06_29_19_00/2007_06_29_19_00.mpg;Takeo Hiranuma.jpeg;5501;6653;35961;275;332;57
/net/per610a/home/mvp/mvp_db/news7-lv/2007/2007_06_29_19_00/2007_06_29_19_00.mpg;Takeo Hiranuma.jpeg;8413;8645;35961;420;432;12
/net/per610a/home/mvp/mvp_db/news7-lv/2007/2007_06_29_19_00/2007_06_29_19_00.mpg;Yukio HATOYAMA.jpg;9249;9697;35961;462;485;23
/net/per610a/home/mvp/mvp_db/news7-lv/2007/2007_06_30_19_00/2007_06_30_19_00.mpg;Shinzo ABE.jpg;5049;5637;35961;252;281;29
/net/per610a/home/mvp/mvp_db/news7-lv/2007/2007_06_30_19_00/2007_06_30_19_00.mpg;Shinzo ABE.jpg;12309;15405;35961;615;770;155
/net/per610a/home/mvp/mvp_db/news7-lv/2007/2007_07_01_19_00/2007_07_01_19_00.mpg;Ichiro OZAWA.jpg;9945;10109;35961;497;505;8
/net/per610a/home/mvp/mvp_db/news7-lv/2007/2007_07_01_19_00/2007_07_01_19_00.mpg;Ichiro OZAWA.jpg;10173;10309;35961;508;515;7
/net/per610a/home/mvp/mvp_db/news7-lv/2007/2007_07_01_19_00/2007_07_01_19_00.mpg;Ichiro OZAWA.jpg;11489;11509;35961;574;575;1
/net/per610a/home/mvp/mvp_db/news7-lv/2007/2007_07_01_19_00/2007_07_01_19_00.mpg;Ichiro OZAWA.jpg;12213;13465;35961;610;673;63
/net/per610a/home/mvp/mvp_db/news7-lv/2007/2007_07_01_19_00/2007_07_01_19_00.mpg;Shinzo ABE.jpg;10485;11485;35961;524;574;50
/net/per610a/home/mvp/mvp_db/news7-lv/2007/2007_07_02_19_00/2007_07_02_19_00.mpg;Shinzo ABE.jpg;10417;11161;35961;521;558;37
/net/per610a/home/mvp/mvp_db/news7-lv/2007/2007_07_03_19_00/2007_07_03_19_00.mpg;Naoto KAN.jpg;12741;12889;35961;637;644;7
/net/per610a/home/mvp/mvp_db/news7-lv/2007/2007_07_03_19_00/2007_07_03_19_00.mpg;Shinzo ABE.jpg;14393;14405;35961;720;720;0
/net/per610a/home/mvp/mvp_db/news7-lv/2007/2007_07_03_19_00/2007_07_03_19_00.mpg;Shinzo ABE.jpg;14497;14549;35961;725;727;2
/net/per610a/home/mvp/mvp_db/news7-lv/2007/2007_07_04_19_00/2007_07_04_19_00.mpg;YUriko Koike.jpg;1489;1789;35961;74;89;15
/net/per610a/home/mvp/mvp_db/news7-lv/2007/2007_07_04_19_00/2007_07_04_19_00.mpg;YUriko Koike.jpg;5281;5293;35961;264;264;0
/net/per610a/home/mvp/mvp_db/news7-lv/2007/2007_07_04_19_00/2007_07_04_19_00.mpg;YUriko Koike.jpg;7409;8197;35961;370;410;40
/net/per610a/home/mvp/mvp_db/news7-lv/2007/2007_07_04_19_00/2007_07_04_19_00.mpg;Shinzo ABE.jpg;2805;2833;35961;140;141;1
/net/per610a/home/mvp/mvp_db/news7-lv/2007/2007_07_04_19_00/2007_07_04_19_00.mpg;Shinzo ABE.jpg;9577;10013;35961;479;500;21
/net/per610a/home/mvp/mvp_db/news7-lv/2007/2007_07_05_19_00/2007_07_05_19_00.mpg;Naoto KAN.jpg;385;477;35961;19;23;4
/net/per610a/home/mvp/mvp_db/news7-lv/2007/2007_07_05_19_00/2007_07_05_19_00.mpg;Naoto KAN.jpg;20977;21029;35961;1049;1052;3
/net/per610a/home/mvp/mvp_db/news7-lv/2007/2007_07_05_19_00/2007_07_05_19_00.mpg;Ichiro OZAWA.jpg;489;525;35961;24;26;2
/net/per610a/home/mvp/mvp_db/news7-lv/2007/2007_07_05_19_00/2007_07_05_19_00.mpg;Ichiro OZAWA.jpg;9445;9481;35961;472;474;2
/net/per610a/home/mvp/mvp_db/news7-lv/2007/2007_07_05_19_00/2007_07_05_19_00.mpg;Ichiro OZAWA.jpg;21161;21397;35961;1058;1070;12
/net/per610a/home/mvp/mvp_db/news7-lv/2007/2007_07_05_19_00/2007_07_05_19_00.mpg;Akihiro OHTA.jpg;9981;10341;35961;499;517;18
/net/per610a/home/mvp/mvp_db/news7-lv/2007/2007_07_05_19_00/2007_07_05_19_00.mpg;Kazuo SHII.jpg;21533;21845;35961;1077;1092;15
/net/per610a/home/mvp/mvp_db/news7-lv/2007/2007_07_05_19_00/2007_07_05_19_00.mpg;Ichiro OZAWA.jpg;23185;23449;35961;1159;1173;14
/net/per610a/home/mvp/mvp_db/news7-lv/2007/2007_07_07_19_00/2007_07_07_19_00.mpg;Yukio HATOYAMA.jpg;4473;5489;35961;223;274;51
/net/per610a/home/mvp/mvp_db/news7-lv/2007/2007_07_07_19_00/2007_07_07_19_00.mpg;Shinzo ABE.jpg;5941;6117;35961;297;306;9
/net/per610a/home/mvp/mvp_db/news7-lv/2007/2007_07_08_19_00/2007_07_08_19_00.mpg;Ichiro OZAWA.jpg;1;361;35961;0;18;18
/net/per610a/home/mvp/mvp_db/news7-lv/2007/2007_07_10_19_00/2007_07_10_19_00.mpg;Shinzo ABE.jpg;9453;9533;35961;472;476;4
/net/per610a/home/mvp/mvp_db/news7-lv/2007/2007_07_11_19_00/2007_07_11_19_00.mpg;Kazuo SHII.jpg;8057;8645;35961;403;432;29
/net/per610a/home/mvp/mvp_db/news7-lv/2007/2007_07_12_19_00/2007_07_12_19_00.mpg;Shinzo ABE.jpg;1453;1657;35961;72;82;10
/net/per610a/home/mvp/mvp_db/news7-lv/2007/2007_07_12_19_00/2007_07_12_19_00.mpg;Shinzo ABE.jpg;18561;19053;35961;928;953;25
/net/per610a/home/mvp/mvp_db/news7-lv/2007/2007_07_12_19_00/2007_07_12_19_00.mpg;Takeo Hiranuma.jpeg;9381;12349;35961;469;617;148
/net/per610a/home/mvp/mvp_db/news7-lv/2007/2007_07_12_19_00/2007_07_12_19_00.mpg;Ichiro OZAWA.jpg;19521;19949;35961;976;997;21
/net/per610a/home/mvp/mvp_db/news7-lv/2007/2007_07_12_19_00/2007_07_12_19_00.mpg;Ichiro OZAWA.jpg;23341;23653;35961;1167;1183;16
/net/per610a/home/mvp/mvp_db/news7-lv/2007/2007_07_17_19_00/2007_07_17_19_00.mpg;Shinzo ABE.jpg;29761;29841;35961;1488;1492;4
/net/per610a/home/mvp/mvp_db/news7-lv/2007/2007_07_18_19_00/2007_07_18_19_00.mpg;Nariaki Nakayama.png;18613;18897;35961;931;945;14
/net/per610a/home/mvp/mvp_db/news7-lv/2007/2007_07_23_19_00/2007_07_23_19_00.mpg;Yukio HATOYAMA.jpg;20125;20549;35961;1006;1027;21
/net/per610a/home/mvp/mvp_db/news7-lv/2007/2007_07_24_19_00/2007_07_24_19_00.mpg;Taro Yamamoto.jpg;9741;10165;35961;487;508;21
/net/per610a/home/mvp/mvp_db/news7-lv/2007/2007_07_31_19_00/2007_07_31_19_00.mpg;Ichiro OZAWA.jpg;9;33;35961;0;1;1
/net/per610a/home/mvp/mvp_db/news7-lv/2007/2007_07_31_19_00/2007_07_31_19_00.mpg;Ichiro OZAWA.jpg;1437;1589;35961;71;79;8
/net/per610a/home/mvp/mvp_db/news7-lv/2007/2007_07_31_19_00/2007_07_31_19_00.mpg;Ichiro OZAWA.jpg;12733;13397;35961;636;670;34
/net/per610a/home/mvp/mvp_db/news7-lv/2007/2007_07_31_19_00/2007_07_31_19_00.mpg;Shinzo ABE.jpg;1909;1997;35961;95;99;4
/net/per610a/home/mvp/mvp_db/news7-lv/2007/2007_07_31_19_00/2007_07_31_19_00.mpg;Shinzo ABE.jpg;7321;7661;35961;366;383;17
/net/per610a/home/mvp/mvp_db/news7-lv/2007/2007_08_01_19_00/2007_08_01_19_00.mpg;Shinzo ABE.jpg;2061;2105;35961;103;105;2
/net/per610a/home/mvp/mvp_db/news7-lv/2007/2007_08_01_19_00/2007_08_01_19_00.mpg;Shinzo ABE.jpg;4649;5421;35961;232;271;39
/net/per610a/home/mvp/mvp_db/news7-lv/2007/2007_08_01_19_00/2007_08_01_19_00.mpg;Shinzo ABE.jpg;7069;7269;35961;353;363;10
/net/per610a/home/mvp/mvp_db/news7-lv/2007/2007_08_01_19_00/2007_08_01_19_00.mpg;Shinzo ABE.jpg;15477;16121;35961;774;806;32
/net/per610a/home/mvp/mvp_db/news7-lv/2007/2007_08_03_19_00/2007_08_03_19_00.mpg;Shinzo ABE.jpg;6033;6737;35961;301;337;36
/net/per610a/home/mvp/mvp_db/news7-lv/2007/2007_08_05_19_00/2007_08_05_19_00.mpg;Shinzo ABE.jpg;965;965;35961;48;48;0
/net/per610a/home/mvp/mvp_db/news7-lv/2007/2007_08_05_19_00/2007_08_05_19_00.mpg;Shinzo ABE.jpg;1081;1081;35961;54;54;0
/net/per610a/home/mvp/mvp_db/news7-lv/2007/2007_08_05_19_00/2007_08_05_19_00.mpg;Shinzo ABE.jpg;2601;2769;35961;130;138;8
/net/per610a/home/mvp/mvp_db/news7-lv/2007/2007_08_07_19_00/2007_08_07_19_00.mpg;Kazuo SHII.jpg;7709;8101;35961;385;405;20
/net/per610a/home/mvp/mvp_db/news7-lv/2007/2007_08_07_19_00/2007_08_07_19_00.mpg;Shinzo ABE.jpg;8989;9741;35961;449;487;38
/net/per610a/home/mvp/mvp_db/news7-lv/2007/2007_08_08_19_00/2007_08_08_19_00.mpg;Akihiro OHTA.jpg;15701;15953;35961;785;798;13
/net/per610a/home/mvp/mvp_db/news7-lv/2007/2007_08_09_19_00/2007_08_09_19_00.mpg;Shinzo ABE.jpg;8381;8813;35961;419;440;21
/net/per610a/home/mvp/mvp_db/news7-lv/2007/2007_08_10_19_00/2007_08_10_19_00.mpg;Shinzo ABE.jpg;17165;17545;35961;858;877;19
/net/per610a/home/mvp/mvp_db/news7-lv/2007/2007_08_13_19_00/2007_08_13_19_00.mpg;Shinzo ABE.jpg;11409;11625;35961;570;581;11
/net/per610a/home/mvp/mvp_db/news7-lv/2007/2007_08_13_19_00/2007_08_13_19_00.mpg;Shinzo ABE.jpg;11805;12309;35961;590;615;25
/net/per610a/home/mvp/mvp_db/news7-lv/2007/2007_08_13_19_00/2007_08_13_19_00.mpg;Ichiro OZAWA.jpg;23401;23513;35961;1170;1176;6
/net/per610a/home/mvp/mvp_db/news7-lv/2007/2007_08_17_19_00/2007_08_17_19_00.mpg;Shinzo ABE.jpg;121;257;35961;6;12;6
/net/per610a/home/mvp/mvp_db/news7-lv/2007/2007_08_17_19_00/2007_08_17_19_00.mpg;Shinzo ABE.jpg;4757;4909;35961;237;245;8
/net/per610a/home/mvp/mvp_db/news7-lv/2007/2007_08_17_19_00/2007_08_17_19_00.mpg;Shinzo ABE.jpg;7585;7657;35961;379;383;4
/net/per610a/home/mvp/mvp_db/news7-lv/2007/2007_08_17_19_00/2007_08_17_19_00.mpg;YUriko Koike.jpg;3093;3741;35961;154;187;33
/net/per610a/home/mvp/mvp_db/news7-lv/2007/2007_08_17_19_00/2007_08_17_19_00.mpg;YUriko Koike.jpg;4297;4665;35961;214;233;19
/net/per610a/home/mvp/mvp_db/news7-lv/2007/2007_08_20_19_00/2007_08_20_19_00.mpg;Shinzo ABE.jpg;15529;16053;35961;776;803;27
/net/per610a/home/mvp/mvp_db/news7-lv/2007/2007_08_22_19_00/2007_08_22_19_00.mpg;Shinzo ABE.jpg;20269;20493;35961;1013;1025;12
/net/per610a/home/mvp/mvp_db/news7-lv/2007/2007_08_22_19_00/2007_08_22_19_00.mpg;Shinzo ABE.jpg;20649;20689;35961;1032;1034;2
/net/per610a/home/mvp/mvp_db/news7-lv/2007/2007_08_24_19_00/2007_08_24_19_00.mpg;Shinzo ABE.jpg;9637;10497;35961;482;525;43
/net/per610a/home/mvp/mvp_db/news7-lv/2007/2007_08_24_19_00/2007_08_24_19_00.mpg;Shinzo ABE.jpg;10561;11301;35961;528;565;37
/net/per610a/home/mvp/mvp_db/news7-lv/2007/2007_08_24_19_00/2007_08_24_19_00.mpg;Shinzo ABE.jpg;12641;12905;35961;632;645;13
/net/per610a/home/mvp/mvp_db/news7-lv/2007/2007_08_24_19_00/2007_08_24_19_00.mpg;Shinzo ABE.jpg;14665;14817;35961;733;741;8
/net/per610a/home/mvp/mvp_db/news7-lv/2007/2007_08_24_19_00/2007_08_24_19_00.mpg;Shinzo ABE.jpg;13333;13445;35961;667;672;5
/net/per610a/home/mvp/mvp_db/news7-lv/2007/2007_08_24_19_00/2007_08_24_19_00.mpg;Shinzo ABE.jpg;13521;14661;35961;676;733;57
/net/per610a/home/mvp/mvp_db/news7-lv/2007/2007_08_24_19_00/2007_08_24_19_00.mpg;YUriko Koike.jpg;28489;29553;35961;1425;1478;53
/net/per610a/home/mvp/mvp_db/news7-lv/2007/2007_08_25_19_00/2007_08_25_19_00.mpg;Shinzo ABE.jpg;1777;2297;35961;88;114;26
/net/per610a/home/mvp/mvp_db/news7-lv/2007/2007_08_26_19_00/2007_08_26_19_00.mpg;Taro ASO.jpg;1033;1321;35961;51;66;15
/net/per610a/home/mvp/mvp_db/news7-lv/2007/2007_08_26_19_00/2007_08_26_19_00.mpg;Taro ASO.jpg;1957;2009;35961;97;100;3
/net/per610a/home/mvp/mvp_db/news7-lv/2007/2007_08_26_19_00/2007_08_26_19_00.mpg;Taro ASO.jpg;3841;4557;35961;192;227;35
/net/per610a/home/mvp/mvp_db/news7-lv/2007/2007_08_27_19_00/2007_08_27_19_00.mpg;Shinzo ABE.jpg;1377;1417;35961;68;70;2
/net/per610a/home/mvp/mvp_db/news7-lv/2007/2007_08_27_19_00/2007_08_27_19_00.mpg;Shinzo ABE.jpg;23953;24097;35961;1198;1205;7
/net/per610a/home/mvp/mvp_db/news7-lv/2007/2007_08_27_19_00/2007_08_27_19_00.mpg;Shinzo ABE.jpg;24273;24321;35961;1214;1216;2
/net/per610a/home/mvp/mvp_db/news7-lv/2007/2007_08_27_19_00/2007_08_27_19_00.mpg;Taro ASO.jpg;2657;2777;35961;132;138;6
/net/per610a/home/mvp/mvp_db/news7-lv/2007/2007_08_27_19_00/2007_08_27_19_00.mpg;Taro ASO.jpg;23281;23321;35961;1164;1166;2
/net/per610a/home/mvp/mvp_db/news7-lv/2007/2007_08_27_19_00/2007_08_27_19_00.mpg;Taro ASO.jpg;23401;23465;35961;1170;1173;3
/net/per610a/home/mvp/mvp_db/news7-lv/2007/2007_08_27_19_00/2007_08_27_19_00.mpg;Taro ASO.jpg;2921;3649;35961;146;182;36
/net/per610a/home/mvp/mvp_db/news7-lv/2007/2007_08_27_19_00/2007_08_27_19_00.mpg;Taro ASO.jpg;22981;23033;35961;1149;1152;3
/net/per610a/home/mvp/mvp_db/news7-lv/2007/2007_08_27_19_00/2007_08_27_19_00.mpg;Kenji Eda.jpg;7097;7205;35961;355;360;5
/net/per610a/home/mvp/mvp_db/news7-lv/2007/2007_08_28_19_00/2007_08_28_19_00.mpg;Shinzo ABE.jpg;6157;6441;35961;308;322;14
/net/per610a/home/mvp/mvp_db/news7-lv/2007/2007_08_29_19_00/2007_08_29_19_00.mpg;Shinzo ABE.jpg;15109;15205;35961;755;760;5
/net/per610a/home/mvp/mvp_db/news7-lv/2007/2007_08_29_19_00/2007_08_29_19_00.mpg;Shinzo ABE.jpg;16053;17349;35961;803;867;64
/net/per610a/home/mvp/mvp_db/news7-lv/2007/2007_08_30_19_00/2007_08_30_19_00.mpg;Sadakazu TANIGAKI.jpg;14577;14869;35961;729;743;14
/net/per610a/home/mvp/mvp_db/news7-lv/2007/2007_08_30_19_00/2007_08_30_19_00.mpg;Ichiro OZAWA.jpg;15125;15685;35961;756;784;28
/net/per610a/home/mvp/mvp_db/news7-lv/2007/2007_08_31_19_00/2007_08_31_19_00.mpg;Ichiro OZAWA.jpg;1;341;35961;0;17;17
/net/per610a/home/mvp/mvp_db/news7-lv/2007/2007_08_31_19_00/2007_08_31_19_00.mpg;Ichiro OZAWA.jpg;1005;1713;35961;50;85;35
/net/per610a/home/mvp/mvp_db/news7-lv/2007/2007_08_31_19_00/2007_08_31_19_00.mpg;Ichiro OZAWA.jpg;3013;3905;35961;150;195;45
/net/per610a/home/mvp/mvp_db/news7-lv/2007/2007_08_31_19_00/2007_08_31_19_00.mpg;Ichiro OZAWA.jpg;4057;4117;35961;202;205;3
/net/per610a/home/mvp/mvp_db/news7-lv/2007/2007_08_31_19_00/2007_08_31_19_00.mpg;Ichiro OZAWA.jpg;4613;4749;35961;230;237;7
/net/per610a/home/mvp/mvp_db/news7-lv/2007/2007_08_31_19_00/2007_08_31_19_00.mpg;Yukio HATOYAMA.jpg;2093;2185;35961;104;109;5
/net/per610a/home/mvp/mvp_db/news7-lv/2007/2007_08_31_19_00/2007_08_31_19_00.mpg;Katsuya OKADA.jpg;2289;2501;35961;114;125;11
/net/per610a/home/mvp/mvp_db/news7-lv/2007/2007_08_31_19_00/2007_08_31_19_00.mpg;Seiji MAEHARA.jpg;4133;4325;35961;206;216;10
/net/per610a/home/mvp/mvp_db/news7-lv/2007/2007_08_31_19_00/2007_08_31_19_00.mpg;Yoshimi WATANABE.jpg;23909;24153;35961;1196;1208;12
/net/per610a/home/mvp/mvp_db/news7-lv/2007/2007_08_31_19_00/2007_08_31_19_00.mpg;Yoshimi WATANABE.jpg;24361;24709;35961;1218;1236;18
/net/per610a/home/mvp/mvp_db/news7-lv/2007/2007_08_31_19_00/2007_08_31_19_00.mpg;Yoshimi WATANABE.jpg;24917;27241;35961;1246;1362;116
/net/per610a/home/mvp/mvp_db/news7-lv/2007/2007_08_31_19_00/2007_08_31_19_00.mpg;Yoshimi WATANABE.jpg;27481;28249;35961;1374;1413;39
/net/per610a/home/mvp/mvp_db/news7-lv/2007/2007_09_01_19_00/2007_09_01_19_00.mpg;Shinzo ABE.jpg;9865;10021;35961;493;501;8
/net/per610a/home/mvp/mvp_db/news7-lv/2007/2007_09_02_19_00/2007_09_02_19_00.mpg;Akihiro OHTA.jpg;2909;3537;35961;145;176;31
/net/per610a/home/mvp/mvp_db/news7-lv/2007/2007_09_03_19_00/2007_09_03_19_00.mpg;Ichiro OZAWA.jpg;12665;14205;35961;633;710;77
/net/per610a/home/mvp/mvp_db/news7-lv/2007/2007_09_04_19_00/2007_09_04_19_00.mpg;Nariaki Nakayama.png;6817;8061;35961;341;403;62
/net/per610a/home/mvp/mvp_db/news7-lv/2007/2007_09_05_19_00/2007_09_05_19_00.mpg;Shinzo ABE.jpg;16269;16765;35961;813;838;25
/net/per610a/home/mvp/mvp_db/news7-lv/2007/2007_09_05_19_00/2007_09_05_19_00.mpg;Shintaro ISHIHARA.jpg;18049;18113;35961;902;906;4
/net/per610a/home/mvp/mvp_db/news7-lv/2007/2007_09_05_19_00/2007_09_05_19_00.mpg;Shintaro ISHIHARA.jpg;18341;19113;35961;917;956;39
/net/per610a/home/mvp/mvp_db/news7-lv/2007/2007_09_07_19_00/2007_09_07_19_00.mpg;Yukio HATOYAMA.jpg;397;593;35961;19;29;10
/net/per610a/home/mvp/mvp_db/news7-lv/2007/2007_09_07_19_00/2007_09_07_19_00.mpg;Yukio HATOYAMA.jpg;19509;19953;35961;975;998;23
/net/per610a/home/mvp/mvp_db/news7-lv/2007/2007_09_08_19_00/2007_09_08_19_00.mpg;Shinzo ABE.jpg;781;1697;35961;39;84;45
/net/per610a/home/mvp/mvp_db/news7-lv/2007/2007_09_08_19_00/2007_09_08_19_00.mpg;Shinzo ABE.jpg;3961;4017;35961;198;200;2
/net/per610a/home/mvp/mvp_db/news7-lv/2007/2007_09_08_19_00/2007_09_08_19_00.mpg;Shinzo ABE.jpg;4541;4685;35961;227;234;7
/net/per610a/home/mvp/mvp_db/news7-lv/2007/2007_09_08_19_00/2007_09_08_19_00.mpg;Shinzo ABE.jpg;6177;6541;35961;309;327;18
/net/per610a/home/mvp/mvp_db/news7-lv/2007/2007_09_08_19_00/2007_09_08_19_00.mpg;Shinzo ABE.jpg;8013;9013;35961;400;450;50
/net/per610a/home/mvp/mvp_db/news7-lv/2007/2007_09_08_19_00/2007_09_08_19_00.mpg;Shinzo ABE.jpg;5577;5873;35961;278;293;15
/net/per610a/home/mvp/mvp_db/news7-lv/2007/2007_09_08_19_00/2007_09_08_19_00.mpg;Shinzo ABE.jpg;6121;6173;35961;306;308;2
/net/per610a/home/mvp/mvp_db/news7-lv/2007/2007_09_08_19_00/2007_09_08_19_00.mpg;Shinzo ABE.jpg;6801;7365;35961;340;368;28
/net/per610a/home/mvp/mvp_db/news7-lv/2007/2007_09_09_19_00/2007_09_09_19_00.mpg;Shinzo ABE.jpg;17;337;35961;0;16;16
/net/per610a/home/mvp/mvp_db/news7-lv/2007/2007_09_09_19_00/2007_09_09_19_00.mpg;Shinzo ABE.jpg;593;1101;35961;29;55;26
/net/per610a/home/mvp/mvp_db/news7-lv/2007/2007_09_09_19_00/2007_09_09_19_00.mpg;Shinzo ABE.jpg;1189;2285;35961;59;114;55
/net/per610a/home/mvp/mvp_db/news7-lv/2007/2007_09_09_19_00/2007_09_09_19_00.mpg;Shinzo ABE.jpg;2445;3249;35961;122;162;40
/net/per610a/home/mvp/mvp_db/news7-lv/2007/2007_09_09_19_00/2007_09_09_19_00.mpg;Shinzo ABE.jpg;4609;4905;35961;230;245;15
/net/per610a/home/mvp/mvp_db/news7-lv/2007/2007_09_09_19_00/2007_09_09_19_00.mpg;Shinzo ABE.jpg;8417;8641;35961;421;432;11
/net/per610a/home/mvp/mvp_db/news7-lv/2007/2007_09_09_19_00/2007_09_09_19_00.mpg;Shinzo ABE.jpg;10125;10281;35961;506;514;8
/net/per610a/home/mvp/mvp_db/news7-lv/2007/2007_09_09_19_00/2007_09_09_19_00.mpg;Shinzo ABE.jpg;34921;35625;35961;1746;1782;36
/net/per610a/home/mvp/mvp_db/news7-lv/2007/2007_09_09_19_00/2007_09_09_19_00.mpg;Ichiro OZAWA.jpg;3869;4201;35961;193;210;17
/net/per610a/home/mvp/mvp_db/news7-lv/2007/2007_09_09_19_00/2007_09_09_19_00.mpg;Ichiro OZAWA.jpg;4513;4537;35961;225;226;1
/net/per610a/home/mvp/mvp_db/news7-lv/2007/2007_09_09_19_00/2007_09_09_19_00.mpg;Ichiro OZAWA.jpg;9425;9657;35961;471;483;12
/net/per610a/home/mvp/mvp_db/news7-lv/2007/2007_09_09_19_00/2007_09_09_19_00.mpg;Taro ASO.jpg;5285;7905;35961;264;395;131
/net/per610a/home/mvp/mvp_db/news7-lv/2007/2007_09_10_19_00/2007_09_10_19_00.mpg;Shinzo ABE.jpg;2277;2301;35961;113;115;2
/net/per610a/home/mvp/mvp_db/news7-lv/2007/2007_09_10_19_00/2007_09_10_19_00.mpg;Shinzo ABE.jpg;2389;2657;35961;119;132;13
/net/per610a/home/mvp/mvp_db/news7-lv/2007/2007_09_10_19_00/2007_09_10_19_00.mpg;Shinzo ABE.jpg;7545;7649;35961;377;382;5
/net/per610a/home/mvp/mvp_db/news7-lv/2007/2007_09_10_19_00/2007_09_10_19_00.mpg;Shinzo ABE.jpg;7809;7809;35961;390;390;0
/net/per610a/home/mvp/mvp_db/news7-lv/2007/2007_09_10_19_00/2007_09_10_19_00.mpg;Shinzo ABE.jpg;10205;10813;35961;510;540;30
/net/per610a/home/mvp/mvp_db/news7-lv/2007/2007_09_10_19_00/2007_09_10_19_00.mpg;Shinzo ABE.jpg;11093;11269;35961;554;563;9
/net/per610a/home/mvp/mvp_db/news7-lv/2007/2007_09_10_19_00/2007_09_10_19_00.mpg;Shinzo ABE.jpg;12881;13385;35961;644;669;25
/net/per610a/home/mvp/mvp_db/news7-lv/2007/2007_09_10_19_00/2007_09_10_19_00.mpg;Shinzo ABE.jpg;14145;14641;35961;707;732;25
/net/per610a/home/mvp/mvp_db/news7-lv/2007/2007_09_10_19_00/2007_09_10_19_00.mpg;Shinzo ABE.jpg;14705;14905;35961;735;745;10
/net/per610a/home/mvp/mvp_db/news7-lv/2007/2007_09_10_19_00/2007_09_10_19_00.mpg;Shinzo ABE.jpg;3033;3121;35961;151;156;5
/net/per610a/home/mvp/mvp_db/news7-lv/2007/2007_09_10_19_00/2007_09_10_19_00.mpg;Shinzo ABE.jpg;13793;13849;35961;690;692;2
/net/per610a/home/mvp/mvp_db/news7-lv/2007/2007_09_10_19_00/2007_09_10_19_00.mpg;Taro ASO.jpg;5037;7433;35961;251;371;120
/net/per610a/home/mvp/mvp_db/news7-lv/2007/2007_09_11_19_00/2007_09_11_19_00.mpg;Ichiro OZAWA.jpg;161;301;35961;8;15;7
/net/per610a/home/mvp/mvp_db/news7-lv/2007/2007_09_11_19_00/2007_09_11_19_00.mpg;Ichiro OZAWA.jpg;1741;2529;35961;87;126;39
/net/per610a/home/mvp/mvp_db/news7-lv/2007/2007_09_11_19_00/2007_09_11_19_00.mpg;Ichiro OZAWA.jpg;2613;2689;35961;130;134;4
/net/per610a/home/mvp/mvp_db/news7-lv/2007/2007_09_11_19_00/2007_09_11_19_00.mpg;Shinzo ABE.jpg;1181;1593;35961;59;79;20
/net/per610a/home/mvp/mvp_db/news7-lv/2007/2007_09_11_19_00/2007_09_11_19_00.mpg;Shinzo ABE.jpg;4529;4873;35961;226;243;17
/net/per610a/home/mvp/mvp_db/news7-lv/2007/2007_09_12_19_00/2007_09_12_19_00.mpg;Shinzo ABE.jpg;237;773;35961;11;38;27
/net/per610a/home/mvp/mvp_db/news7-lv/2007/2007_09_12_19_00/2007_09_12_19_00.mpg;Shinzo ABE.jpg;1009;1421;35961;50;71;21
/net/per610a/home/mvp/mvp_db/news7-lv/2007/2007_09_12_19_00/2007_09_12_19_00.mpg;Shinzo ABE.jpg;4365;7869;35961;218;393;175
/net/per610a/home/mvp/mvp_db/news7-lv/2007/2007_09_12_19_00/2007_09_12_19_00.mpg;Shinzo ABE.jpg;13637;14193;35961;682;710;28
/net/per610a/home/mvp/mvp_db/news7-lv/2007/2007_09_12_19_00/2007_09_12_19_00.mpg;Shinzo ABE.jpg;15217;16425;35961;761;821;60
/net/per610a/home/mvp/mvp_db/news7-lv/2007/2007_09_12_19_00/2007_09_12_19_00.mpg;Shinzo ABE.jpg;35693;35957;35961;1785;1798;13
/net/per610a/home/mvp/mvp_db/news7-lv/2007/2007_09_12_19_00/2007_09_12_19_00.mpg;Yukio HATOYAMA.jpg;1701;1893;35961;85;94;9
/net/per610a/home/mvp/mvp_db/news7-lv/2007/2007_09_12_19_00/2007_09_12_19_00.mpg;Shizuka KAMEI.jpg;2537;2637;35961;126;131;5
/net/per610a/home/mvp/mvp_db/news7-lv/2007/2007_09_12_19_00/2007_09_12_19_00.mpg;Taro ASO.jpg;12069;12665;35961;603;633;30
/net/per610a/home/mvp/mvp_db/news7-lv/2007/2007_09_12_19_00/2007_09_12_19_00.mpg;Taro ASO.jpg;12753;12769;35961;637;638;1
/net/per610a/home/mvp/mvp_db/news7-lv/2007/2007_09_12_19_00/2007_09_12_19_00.mpg;Taro ASO.jpg;12897;12941;35961;645;647;2
/net/per610a/home/mvp/mvp_db/news7-lv/2007/2007_09_12_19_00/2007_09_12_19_00.mpg;Shinzo ABE.jpg;13229;13269;35961;661;663;2
/net/per610a/home/mvp/mvp_db/news7-lv/2007/2007_09_12_19_00/2007_09_12_19_00.mpg;Shinzo ABE.jpg;33333;33381;35961;1667;1669;2
/net/per610a/home/mvp/mvp_db/news7-lv/2007/2007_09_12_19_00/2007_09_12_19_00.mpg;Shinzo ABE.jpg;35429;35429;35961;1772;1772;0
/net/per610a/home/mvp/mvp_db/news7-lv/2007/2007_09_12_19_00/2007_09_12_19_00.mpg;Shinzo ABE.jpg;35589;35649;35961;1780;1783;3
/net/per610a/home/mvp/mvp_db/news7-lv/2007/2007_09_12_19_00/2007_09_12_19_00.mpg;Sadakazu TANIGAKI.jpg;22185;26049;35961;1109;1303;194
/net/per610a/home/mvp/mvp_db/news7-lv/2007/2007_09_13_19_00/2007_09_13_19_00.mpg;Yasuo FUKUDA.jpg;2013;3613;35961;100;180;80
/net/per610a/home/mvp/mvp_db/news7-lv/2007/2007_09_13_19_00/2007_09_13_19_00.mpg;Yasuo FUKUDA.jpg;10485;11853;35961;524;592;68
/net/per610a/home/mvp/mvp_db/news7-lv/2007/2007_09_13_19_00/2007_09_13_19_00.mpg;Naoto KAN.jpg;16317;17149;35961;816;857;41
/net/per610a/home/mvp/mvp_db/news7-lv/2007/2007_09_14_19_00/2007_09_14_19_00.mpg;Taro ASO.jpg;569;685;35961;28;34;6
/net/per610a/home/mvp/mvp_db/news7-lv/2007/2007_09_14_19_00/2007_09_14_19_00.mpg;Taro ASO.jpg;7957;8353;35961;398;417;19
/net/per610a/home/mvp/mvp_db/news7-lv/2007/2007_09_14_19_00/2007_09_14_19_00.mpg;Taro ASO.jpg;10265;10429;35961;513;521;8
/net/per610a/home/mvp/mvp_db/news7-lv/2007/2007_09_14_19_00/2007_09_14_19_00.mpg;Taro ASO.jpg;10509;10621;35961;525;531;6
/net/per610a/home/mvp/mvp_db/news7-lv/2007/2007_09_14_19_00/2007_09_14_19_00.mpg;Yasuo FUKUDA.jpg;569;689;35961;28;34;6
/net/per610a/home/mvp/mvp_db/news7-lv/2007/2007_09_14_19_00/2007_09_14_19_00.mpg;Yasuo FUKUDA.jpg;1465;2237;35961;73;111;38
/net/per610a/home/mvp/mvp_db/news7-lv/2007/2007_09_14_19_00/2007_09_14_19_00.mpg;Yasuo FUKUDA.jpg;5857;5889;35961;293;294;1
/net/per610a/home/mvp/mvp_db/news7-lv/2007/2007_09_14_19_00/2007_09_14_19_00.mpg;Sadakazu TANIGAKI.jpg;3845;4153;35961;192;207;15
/net/per610a/home/mvp/mvp_db/news7-lv/2007/2007_09_14_19_00/2007_09_14_19_00.mpg;Yasuo FUKUDA.jpg;6033;6489;35961;301;324;23
/net/per610a/home/mvp/mvp_db/news7-lv/2007/2007_09_14_19_00/2007_09_14_19_00.mpg;Yasuo FUKUDA.jpg;10257;10633;35961;513;531;18
/net/per610a/home/mvp/mvp_db/news7-lv/2007/2007_09_14_19_00/2007_09_14_19_00.mpg;Yasuo FUKUDA.jpg;11393;11489;35961;569;574;5
/net/per610a/home/mvp/mvp_db/news7-lv/2007/2007_09_14_19_00/2007_09_14_19_00.mpg;Yukio HATOYAMA.jpg;17413;18225;35961;871;911;40
/net/per610a/home/mvp/mvp_db/news7-lv/2007/2007_09_14_19_00/2007_09_14_19_00.mpg;Shinzo ABE.jpg;21405;21625;35961;1070;1081;11
/net/per610a/home/mvp/mvp_db/news7-lv/2007/2007_09_14_19_00/2007_09_14_19_00.mpg;Ichiro OZAWA.jpg;21545;21629;35961;1077;1082;5
/net/per610a/home/mvp/mvp_db/news7-lv/2007/2007_09_14_19_00/2007_09_14_19_00.mpg;Akihiro OHTA.jpg;21829;21965;35961;1092;1098;6
/net/per610a/home/mvp/mvp_db/news7-lv/2007/2007_09_14_19_00/2007_09_14_19_00.mpg;Toru Hashimoto.jpg;22325;22441;35961;1116;1122;6
/net/per610a/home/mvp/mvp_db/news7-lv/2007/2007_09_14_19_00/2007_09_14_19_00.mpg;Shizuka KAMEI.jpg;22449;22565;35961;1123;1128;5
/net/per610a/home/mvp/mvp_db/news7-lv/2007/2007_09_15_19_00/2007_09_15_19_00.mpg;Yasuo FUKUDA.jpg;405;449;35961;20;22;2
/net/per610a/home/mvp/mvp_db/news7-lv/2007/2007_09_15_19_00/2007_09_15_19_00.mpg;Yasuo FUKUDA.jpg;1433;1781;35961;71;89;18
/net/per610a/home/mvp/mvp_db/news7-lv/2007/2007_09_15_19_00/2007_09_15_19_00.mpg;Yasuo FUKUDA.jpg;6005;6553;35961;300;327;27
/net/per610a/home/mvp/mvp_db/news7-lv/2007/2007_09_15_19_00/2007_09_15_19_00.mpg;Yasuo FUKUDA.jpg;13513;13545;35961;676;677;1
/net/per610a/home/mvp/mvp_db/news7-lv/2007/2007_09_15_19_00/2007_09_15_19_00.mpg;Yasuo FUKUDA.jpg;2657;2661;35961;132;133;1
/net/per610a/home/mvp/mvp_db/news7-lv/2007/2007_09_15_19_00/2007_09_15_19_00.mpg;Yasuo FUKUDA.jpg;5617;5633;35961;280;281;1
/net/per610a/home/mvp/mvp_db/news7-lv/2007/2007_09_15_19_00/2007_09_15_19_00.mpg;Yasuo FUKUDA.jpg;6589;6633;35961;329;331;2
/net/per610a/home/mvp/mvp_db/news7-lv/2007/2007_09_15_19_00/2007_09_15_19_00.mpg;Yasuo FUKUDA.jpg;6925;8065;35961;346;403;57
/net/per610a/home/mvp/mvp_db/news7-lv/2007/2007_09_15_19_00/2007_09_15_19_00.mpg;Yasuo FUKUDA.jpg;8241;8561;35961;412;428;16
/net/per610a/home/mvp/mvp_db/news7-lv/2007/2007_09_15_19_00/2007_09_15_19_00.mpg;Yasuo FUKUDA.jpg;8885;9861;35961;444;493;49
/net/per610a/home/mvp/mvp_db/news7-lv/2007/2007_09_15_19_00/2007_09_15_19_00.mpg;Yasuo FUKUDA.jpg;10089;11153;35961;504;557;53
/net/per610a/home/mvp/mvp_db/news7-lv/2007/2007_09_15_19_00/2007_09_15_19_00.mpg;Yasuo FUKUDA.jpg;11325;11969;35961;566;598;32
/net/per610a/home/mvp/mvp_db/news7-lv/2007/2007_09_15_19_00/2007_09_15_19_00.mpg;Yasuo FUKUDA.jpg;19021;19109;35961;951;955;4
/net/per610a/home/mvp/mvp_db/news7-lv/2007/2007_09_15_19_00/2007_09_15_19_00.mpg;Yasuo FUKUDA.jpg;19985;20241;35961;999;1012;13
/net/per610a/home/mvp/mvp_db/news7-lv/2007/2007_09_15_19_00/2007_09_15_19_00.mpg;Yasuo FUKUDA.jpg;22097;22621;35961;1105;1131;26
/net/per610a/home/mvp/mvp_db/news7-lv/2007/2007_09_15_19_00/2007_09_15_19_00.mpg;Yasuo FUKUDA.jpg;2689;2701;35961;134;135;1
/net/per610a/home/mvp/mvp_db/news7-lv/2007/2007_09_15_19_00/2007_09_15_19_00.mpg;Yasuo FUKUDA.jpg;3409;3509;35961;170;175;5
/net/per610a/home/mvp/mvp_db/news7-lv/2007/2007_09_15_19_00/2007_09_15_19_00.mpg;Yasuo FUKUDA.jpg;14125;14145;35961;706;707;1
/net/per610a/home/mvp/mvp_db/news7-lv/2007/2007_09_15_19_00/2007_09_15_19_00.mpg;Yasuo FUKUDA.jpg;12305;12421;35961;615;621;6
/net/per610a/home/mvp/mvp_db/news7-lv/2007/2007_09_15_19_00/2007_09_15_19_00.mpg;Yasuo FUKUDA.jpg;17665;18029;35961;883;901;18
/net/per610a/home/mvp/mvp_db/news7-lv/2007/2007_09_15_19_00/2007_09_15_19_00.mpg;Yasuo FUKUDA.jpg;19433;19557;35961;972;978;6
/net/per610a/home/mvp/mvp_db/news7-lv/2007/2007_09_15_19_00/2007_09_15_19_00.mpg;Yasuo FUKUDA.jpg;20909;21033;35961;1046;1052;6
/net/per610a/home/mvp/mvp_db/news7-lv/2007/2007_09_15_19_00/2007_09_15_19_00.mpg;Yasuo FUKUDA.jpg;21957;22013;35961;1098;1101;3
/net/per610a/home/mvp/mvp_db/news7-lv/2007/2007_09_16_19_00/2007_09_16_19_00.mpg;Taro ASO.jpg;4145;4153;35961;207;207;0
/net/per610a/home/mvp/mvp_db/news7-lv/2007/2007_09_16_19_00/2007_09_16_19_00.mpg;Taro ASO.jpg;7557;7901;35961;378;395;17
/net/per610a/home/mvp/mvp_db/news7-lv/2007/2007_09_18_19_00/2007_09_18_19_00.mpg;Yasuo FUKUDA.jpg;1;69;35961;0;3;3
/net/per610a/home/mvp/mvp_db/news7-lv/2007/2007_09_18_19_00/2007_09_18_19_00.mpg;Yasuo FUKUDA.jpg;897;1177;35961;44;58;14
/net/per610a/home/mvp/mvp_db/news7-lv/2007/2007_09_18_19_00/2007_09_18_19_00.mpg;Yasuo FUKUDA.jpg;3525;3601;35961;176;180;4
/net/per610a/home/mvp/mvp_db/news7-lv/2007/2007_09_18_19_00/2007_09_18_19_00.mpg;Yasuo FUKUDA.jpg;3701;4213;35961;185;210;25
/net/per610a/home/mvp/mvp_db/news7-lv/2007/2007_09_18_19_00/2007_09_18_19_00.mpg;Taro ASO.jpg;853;1121;35961;42;56;14
/net/per610a/home/mvp/mvp_db/news7-lv/2007/2007_09_18_19_00/2007_09_18_19_00.mpg;Taro ASO.jpg;2581;2853;35961;129;142;13
/net/per610a/home/mvp/mvp_db/news7-lv/2007/2007_09_18_19_00/2007_09_18_19_00.mpg;Taro ASO.jpg;4349;4429;35961;217;221;4
/net/per610a/home/mvp/mvp_db/news7-lv/2007/2007_09_18_19_00/2007_09_18_19_00.mpg;Ichiro OZAWA.jpg;8433;9341;35961;421;467;46
/net/per610a/home/mvp/mvp_db/news7-lv/2007/2007_09_19_19_00/2007_09_19_19_00.mpg;Yasuo FUKUDA.jpg;13;345;35961;0;17;17
/net/per610a/home/mvp/mvp_db/news7-lv/2007/2007_09_19_19_00/2007_09_19_19_00.mpg;Yasuo FUKUDA.jpg;1665;3717;35961;83;185;102
/net/per610a/home/mvp/mvp_db/news7-lv/2007/2007_09_19_19_00/2007_09_19_19_00.mpg;Yasuo FUKUDA.jpg;3781;4545;35961;189;227;38
/net/per610a/home/mvp/mvp_db/news7-lv/2007/2007_09_19_19_00/2007_09_19_19_00.mpg;Yasuo FUKUDA.jpg;5029;5089;35961;251;254;3
/net/per610a/home/mvp/mvp_db/news7-lv/2007/2007_09_19_19_00/2007_09_19_19_00.mpg;Taro ASO.jpg;7345;7545;35961;367;377;10
/net/per610a/home/mvp/mvp_db/news7-lv/2007/2007_09_19_19_00/2007_09_19_19_00.mpg;Taro ASO.jpg;8109;8477;35961;405;424;19
/net/per610a/home/mvp/mvp_db/news7-lv/2007/2007_09_21_19_00/2007_09_21_19_00.mpg;Yasuo FUKUDA.jpg;149;473;35961;7;23;16
/net/per610a/home/mvp/mvp_db/news7-lv/2007/2007_09_21_19_00/2007_09_21_19_00.mpg;Yasuo FUKUDA.jpg;1357;1501;35961;67;75;8
/net/per610a/home/mvp/mvp_db/news7-lv/2007/2007_09_21_19_00/2007_09_21_19_00.mpg;Yasuo FUKUDA.jpg;1565;1577;35961;78;78;0
/net/per610a/home/mvp/mvp_db/news7-lv/2007/2007_09_21_19_00/2007_09_21_19_00.mpg;Yasuo FUKUDA.jpg;1641;1685;35961;82;84;2
/net/per610a/home/mvp/mvp_db/news7-lv/2007/2007_09_21_19_00/2007_09_21_19_00.mpg;Yasuo FUKUDA.jpg;1757;1825;35961;87;91;4
/net/per610a/home/mvp/mvp_db/news7-lv/2007/2007_09_21_19_00/2007_09_21_19_00.mpg;Yasuo FUKUDA.jpg;2041;3241;35961;102;162;60
/net/per610a/home/mvp/mvp_db/news7-lv/2007/2007_09_21_19_00/2007_09_21_19_00.mpg;Yasuo FUKUDA.jpg;3561;3737;35961;178;186;8
/net/per610a/home/mvp/mvp_db/news7-lv/2007/2007_09_21_19_00/2007_09_21_19_00.mpg;Yasuo FUKUDA.jpg;4357;4893;35961;217;244;27
/net/per610a/home/mvp/mvp_db/news7-lv/2007/2007_09_21_19_00/2007_09_21_19_00.mpg;Yasuo FUKUDA.jpg;4981;5561;35961;249;278;29
/net/per610a/home/mvp/mvp_db/news7-lv/2007/2007_09_21_19_00/2007_09_21_19_00.mpg;Yasuo FUKUDA.jpg;6437;6661;35961;322;333;11
/net/per610a/home/mvp/mvp_db/news7-lv/2007/2007_09_21_19_00/2007_09_21_19_00.mpg;Yasuo FUKUDA.jpg;6821;6989;35961;341;349;8
/net/per610a/home/mvp/mvp_db/news7-lv/2007/2007_09_21_19_00/2007_09_21_19_00.mpg;Yasuo FUKUDA.jpg;7789;7849;35961;389;392;3
/net/per610a/home/mvp/mvp_db/news7-lv/2007/2007_09_21_19_00/2007_09_21_19_00.mpg;Taro ASO.jpg;1345;1817;35961;67;90;23
/net/per610a/home/mvp/mvp_db/news7-lv/2007/2007_09_21_19_00/2007_09_21_19_00.mpg;Taro ASO.jpg;3325;3557;35961;166;177;11
/net/per610a/home/mvp/mvp_db/news7-lv/2007/2007_09_21_19_00/2007_09_21_19_00.mpg;Taro ASO.jpg;3741;3917;35961;187;195;8
/net/per610a/home/mvp/mvp_db/news7-lv/2007/2007_09_21_19_00/2007_09_21_19_00.mpg;Taro ASO.jpg;3989;4197;35961;199;209;10
/net/per610a/home/mvp/mvp_db/news7-lv/2007/2007_09_21_19_00/2007_09_21_19_00.mpg;Taro ASO.jpg;5693;6129;35961;284;306;22
/net/per610a/home/mvp/mvp_db/news7-lv/2007/2007_09_21_19_00/2007_09_21_19_00.mpg;Taro ASO.jpg;7077;7289;35961;354;364;10
/net/per610a/home/mvp/mvp_db/news7-lv/2007/2007_09_22_19_00/2007_09_22_19_00.mpg;Yasuo FUKUDA.jpg;1465;2321;35961;73;116;43
/net/per610a/home/mvp/mvp_db/news7-lv/2007/2007_09_22_19_00/2007_09_22_19_00.mpg;Yasuo FUKUDA.jpg;6013;6049;35961;300;302;2
/net/per610a/home/mvp/mvp_db/news7-lv/2007/2007_09_22_19_00/2007_09_22_19_00.mpg;Yasuo FUKUDA.jpg;7989;8253;35961;399;412;13
/net/per610a/home/mvp/mvp_db/news7-lv/2007/2007_09_22_19_00/2007_09_22_19_00.mpg;Taro ASO.jpg;7633;7713;35961;381;385;4
/net/per610a/home/mvp/mvp_db/news7-lv/2007/2007_09_22_19_00/2007_09_22_19_00.mpg;Taro ASO.jpg;7789;8253;35961;389;412;23
/net/per610a/home/mvp/mvp_db/news7-lv/2007/2007_09_23_19_00/2007_09_23_19_00.mpg;Taro ASO.jpg;401;409;35961;20;20;0
/net/per610a/home/mvp/mvp_db/news7-lv/2007/2007_09_23_19_00/2007_09_23_19_00.mpg;Taro ASO.jpg;16121;16437;35961;806;822;16
/net/per610a/home/mvp/mvp_db/news7-lv/2007/2007_09_23_19_00/2007_09_23_19_00.mpg;Yasuo FUKUDA.jpg;21657;21949;35961;1083;1098;15
/net/per610a/home/mvp/mvp_db/news7-lv/2007/2007_09_23_19_00/2007_09_23_19_00.mpg;Yasuo FUKUDA.jpg;22981;23405;35961;1149;1170;21
/net/per610a/home/mvp/mvp_db/news7-lv/2007/2007_09_23_19_00/2007_09_23_19_00.mpg;Ichiro OZAWA.jpg;23449;23869;35961;1173;1194;21
/net/per610a/home/mvp/mvp_db/news7-lv/2007/2007_09_24_19_00/2007_09_24_19_00.mpg;Shinzo ABE.jpg;677;705;35961;33;35;2
/net/per610a/home/mvp/mvp_db/news7-lv/2007/2007_09_24_19_00/2007_09_24_19_00.mpg;Shinzo ABE.jpg;14137;15549;35961;707;777;70
/net/per610a/home/mvp/mvp_db/news7-lv/2007/2007_09_24_19_00/2007_09_24_19_00.mpg;Shinzo ABE.jpg;15613;17221;35961;781;861;80
/net/per610a/home/mvp/mvp_db/news7-lv/2007/2007_09_24_19_00/2007_09_24_19_00.mpg;Yasuo FUKUDA.jpg;1777;1945;35961;88;97;9
/net/per610a/home/mvp/mvp_db/news7-lv/2007/2007_09_24_19_00/2007_09_24_19_00.mpg;Yasuo FUKUDA.jpg;4845;4961;35961;242;248;6
/net/per610a/home/mvp/mvp_db/news7-lv/2007/2007_09_24_19_00/2007_09_24_19_00.mpg;Yasuo FUKUDA.jpg;8357;8585;35961;418;429;11
/net/per610a/home/mvp/mvp_db/news7-lv/2007/2007_09_24_19_00/2007_09_24_19_00.mpg;Yasuo FUKUDA.jpg;34333;34481;35961;1717;1724;7
/net/per610a/home/mvp/mvp_db/news7-lv/2007/2007_09_24_19_00/2007_09_24_19_00.mpg;Yasuo FUKUDA.jpg;34981;35001;35961;1749;1750;1
/net/per610a/home/mvp/mvp_db/news7-lv/2007/2007_09_24_19_00/2007_09_24_19_00.mpg;Yukio HATOYAMA.jpg;5357;6005;35961;267;300;33
/net/per610a/home/mvp/mvp_db/news7-lv/2007/2007_09_24_19_00/2007_09_24_19_00.mpg;Yasuo FUKUDA.jpg;13025;14053;35961;651;703;52
/net/per610a/home/mvp/mvp_db/news7-lv/2007/2007_09_24_19_00/2007_09_24_19_00.mpg;Yasuo FUKUDA.jpg;35033;35049;35961;1752;1753;1
/net/per610a/home/mvp/mvp_db/news7-lv/2007/2007_09_25_19_00/2007_09_25_19_00.mpg;Ichiro OZAWA.jpg;4109;5657;35961;205;282;77
/net/per610a/home/mvp/mvp_db/news7-lv/2007/2007_09_25_19_00/2007_09_25_19_00.mpg;Kenji Eda.jpg;7005;7133;35961;350;356;6
/net/per610a/home/mvp/mvp_db/news7-lv/2007/2007_09_25_19_00/2007_09_25_19_00.mpg;Yoshimi WATANABE.jpg;7837;7973;35961;392;398;6
/net/per610a/home/mvp/mvp_db/news7-lv/2007/2007_09_25_19_00/2007_09_25_19_00.mpg;Yasuo FUKUDA.jpg;26237;26297;35961;1312;1315;3
/net/per610a/home/mvp/mvp_db/news7-lv/2007/2007_09_25_19_00/2007_09_25_19_00.mpg;Yasuo FUKUDA.jpg;26433;26673;35961;1322;1334;12
/net/per610a/home/mvp/mvp_db/news7-lv/2007/2007_09_26_19_00/2007_09_26_19_00.mpg;Yasuo FUKUDA.jpg;1265;1437;35961;63;71;8
/net/per610a/home/mvp/mvp_db/news7-lv/2007/2007_09_26_19_00/2007_09_26_19_00.mpg;Yasuo FUKUDA.jpg;6677;7525;35961;334;376;42
/net/per610a/home/mvp/mvp_db/news7-lv/2007/2007_09_26_19_00/2007_09_26_19_00.mpg;Yoshimi WATANABE.jpg;3173;3673;35961;158;183;25
/net/per610a/home/mvp/mvp_db/news7-lv/2007/2007_09_26_19_00/2007_09_26_19_00.mpg;Kyoko Nakayama.jpg;24697;25181;35961;1235;1259;24
/net/per610a/home/mvp/mvp_db/news7-lv/2007/2007_09_27_19_00/2007_09_27_19_00.mpg;Yasuo FUKUDA.jpg;14713;14713;35961;736;736;0
/net/per610a/home/mvp/mvp_db/news7-lv/2007/2007_09_27_19_00/2007_09_27_19_00.mpg;Yasuo FUKUDA.jpg;14777;14889;35961;739;744;5
/net/per610a/home/mvp/mvp_db/news7-lv/2007/2007_09_27_19_00/2007_09_27_19_00.mpg;Yasuo FUKUDA.jpg;14965;15017;35961;748;751;3
/net/per610a/home/mvp/mvp_db/news7-lv/2007/2007_09_27_19_00/2007_09_27_19_00.mpg;Yasuo FUKUDA.jpg;15089;15221;35961;754;761;7
/net/per610a/home/mvp/mvp_db/news7-lv/2007/2007_09_27_19_00/2007_09_27_19_00.mpg;Yasuo FUKUDA.jpg;15405;15637;35961;770;782;12
/net/per610a/home/mvp/mvp_db/news7-lv/2007/2007_09_28_19_00/2007_09_28_19_00.mpg;Yasuo FUKUDA.jpg;16573;17301;35961;829;865;36
/net/per610a/home/mvp/mvp_db/news7-lv/2007/2007_09_28_19_00/2007_09_28_19_00.mpg;Yasuo FUKUDA.jpg;24529;25133;35961;1227;1257;30
/net/per610a/home/mvp/mvp_db/news7-lv/2007/2007_09_30_19_00/2007_09_30_19_00.mpg;Sadakazu TANIGAKI.jpg;27965;28297;35961;1398;1415;17
/net/per610a/home/mvp/mvp_db/news7-lv/2007/2007_09_30_19_00/2007_09_30_19_00.mpg;Sadakazu TANIGAKI.jpg;28301;28545;35961;1415;1428;13
/net/per610a/home/mvp/mvp_db/news7-lv/2007/2007_10_01_19_00/2007_10_01_19_00.mpg;Yasuo FUKUDA.jpg;8997;9093;35961;450;454;4
/net/per610a/home/mvp/mvp_db/news7-lv/2007/2007_10_01_19_00/2007_10_01_19_00.mpg;Yasuo FUKUDA.jpg;9429;9709;35961;471;485;14
/net/per610a/home/mvp/mvp_db/news7-lv/2007/2007_10_01_19_00/2007_10_01_19_00.mpg;Ichiro OZAWA.jpg;10677;10757;35961;534;538;4
/net/per610a/home/mvp/mvp_db/news7-lv/2007/2007_10_01_19_00/2007_10_01_19_00.mpg;Ichiro OZAWA.jpg;10841;10849;35961;542;542;0
/net/per610a/home/mvp/mvp_db/news7-lv/2007/2007_10_01_19_00/2007_10_01_19_00.mpg;Ichiro OZAWA.jpg;10945;11613;35961;547;580;33
/net/per610a/home/mvp/mvp_db/news7-lv/2007/2007_10_02_19_00/2007_10_02_19_00.mpg;Natsuo YAMAGUCHI.jpg;8829;8929;35961;441;446;5
/net/per610a/home/mvp/mvp_db/news7-lv/2007/2007_10_02_19_00/2007_10_02_19_00.mpg;Ichiro OZAWA.jpg;9769;10041;35961;488;502;14
/net/per610a/home/mvp/mvp_db/news7-lv/2007/2007_10_02_19_00/2007_10_02_19_00.mpg;Ichiro OZAWA.jpg;10113;10969;35961;505;548;43
/net/per610a/home/mvp/mvp_db/news7-lv/2007/2007_10_02_19_00/2007_10_02_19_00.mpg;Yasuo FUKUDA.jpg;11037;11405;35961;552;570;18
/net/per610a/home/mvp/mvp_db/news7-lv/2007/2007_10_03_19_00/2007_10_03_19_00.mpg;Yasuo FUKUDA.jpg;4409;5517;35961;220;275;55
/net/per610a/home/mvp/mvp_db/news7-lv/2007/2007_10_03_19_00/2007_10_03_19_00.mpg;Ichiro OZAWA.jpg;8385;8697;35961;419;435;16
/net/per610a/home/mvp/mvp_db/news7-lv/2007/2007_10_04_19_00/2007_10_04_19_00.mpg;Yasuo FUKUDA.jpg;17865;18369;35961;893;918;25
/net/per610a/home/mvp/mvp_db/news7-lv/2007/2007_10_04_19_00/2007_10_04_19_00.mpg;Yasuo FUKUDA.jpg;18809;19465;35961;940;973;33
/net/per610a/home/mvp/mvp_db/news7-lv/2007/2007_10_05_19_00/2007_10_05_19_00.mpg;Yasuo FUKUDA.jpg;11737;11849;35961;587;592;5
/net/per610a/home/mvp/mvp_db/news7-lv/2007/2007_10_05_19_00/2007_10_05_19_00.mpg;Yasuo FUKUDA.jpg;13033;13501;35961;651;675;24
/net/per610a/home/mvp/mvp_db/news7-lv/2007/2007_10_05_19_00/2007_10_05_19_00.mpg;Yukio HATOYAMA.jpg;11933;12357;35961;596;618;22
/net/per610a/home/mvp/mvp_db/news7-lv/2007/2007_10_05_19_00/2007_10_05_19_00.mpg;Ichiro OZAWA.jpg;16953;16997;35961;848;850;2
/net/per610a/home/mvp/mvp_db/news7-lv/2007/2007_10_05_19_00/2007_10_05_19_00.mpg;Ichiro OZAWA.jpg;17069;17329;35961;853;866;13
/net/per610a/home/mvp/mvp_db/news7-lv/2007/2007_10_05_19_00/2007_10_05_19_00.mpg;Ichiro OZAWA.jpg;17577;18505;35961;879;925;46
/net/per610a/home/mvp/mvp_db/news7-lv/2007/2007_10_05_19_00/2007_10_05_19_00.mpg;Ichiro OZAWA.jpg;19337;19577;35961;967;979;12
/net/per610a/home/mvp/mvp_db/news7-lv/2007/2007_10_09_19_00/2007_10_09_19_00.mpg;Yasuo FUKUDA.jpg;1173;1249;35961;58;62;4
/net/per610a/home/mvp/mvp_db/news7-lv/2007/2007_10_09_19_00/2007_10_09_19_00.mpg;Yasuo FUKUDA.jpg;1345;1549;35961;67;77;10
/net/per610a/home/mvp/mvp_db/news7-lv/2007/2007_10_09_19_00/2007_10_09_19_00.mpg;Yasuo FUKUDA.jpg;8889;9073;35961;444;453;9
/net/per610a/home/mvp/mvp_db/news7-lv/2007/2007_10_09_19_00/2007_10_09_19_00.mpg;Yasuo FUKUDA.jpg;10153;10677;35961;507;534;27
/net/per610a/home/mvp/mvp_db/news7-lv/2007/2007_10_09_19_00/2007_10_09_19_00.mpg;Yasuo FUKUDA.jpg;3801;4365;35961;190;218;28
/net/per610a/home/mvp/mvp_db/news7-lv/2007/2007_10_09_19_00/2007_10_09_19_00.mpg;Yasuo FUKUDA.jpg;9905;9953;35961;495;497;2
/net/per610a/home/mvp/mvp_db/news7-lv/2007/2007_10_09_19_00/2007_10_09_19_00.mpg;Yasuo FUKUDA.jpg;10685;11001;35961;534;550;16
/net/per610a/home/mvp/mvp_db/news7-lv/2007/2007_10_10_19_00/2007_10_10_19_00.mpg;Ichiro OZAWA.jpg;11121;11833;35961;556;591;35
/net/per610a/home/mvp/mvp_db/news7-lv/2007/2007_10_10_19_00/2007_10_10_19_00.mpg;Ichiro OZAWA.jpg;12249;13025;35961;612;651;39
/net/per610a/home/mvp/mvp_db/news7-lv/2007/2007_10_11_19_00/2007_10_11_19_00.mpg;Yasuo FUKUDA.jpg;2057;2373;35961;102;118;16
/net/per610a/home/mvp/mvp_db/news7-lv/2007/2007_10_11_19_00/2007_10_11_19_00.mpg;Ichiro OZAWA.jpg;16713;17661;35961;836;883;47
/net/per610a/home/mvp/mvp_db/news7-lv/2007/2007_10_11_19_00/2007_10_11_19_00.mpg;Kazuo SHII.jpg;17953;18913;35961;898;946;48
/net/per610a/home/mvp/mvp_db/news7-lv/2007/2007_10_12_19_00/2007_10_12_19_00.mpg;Yukiko Kada.jpg;20057;20369;35961;1003;1018;15
/net/per610a/home/mvp/mvp_db/news7-lv/2007/2007_10_12_19_00/2007_10_12_19_00.mpg;Shintaro ISHIHARA.jpg;28645;28969;35961;1433;1449;16
/net/per610a/home/mvp/mvp_db/news7-lv/2007/2007_10_13_19_00/2007_10_13_19_00.mpg;Yasuo FUKUDA.jpg;22153;22241;35961;1108;1112;4
/net/per610a/home/mvp/mvp_db/news7-lv/2007/2007_10_13_19_00/2007_10_13_19_00.mpg;Yasuo FUKUDA.jpg;22365;22581;35961;1118;1129;11
/net/per610a/home/mvp/mvp_db/news7-lv/2007/2007_10_16_19_00/2007_10_16_19_00.mpg;Ichiro OZAWA.jpg;8109;9061;35961;405;453;48
/net/per610a/home/mvp/mvp_db/news7-lv/2007/2007_10_18_19_00/2007_10_18_19_00.mpg;Naoto KAN.jpg;3745;4313;35961;187;215;28
/net/per610a/home/mvp/mvp_db/news7-lv/2007/2007_10_18_19_00/2007_10_18_19_00.mpg;Ichiro OZAWA.jpg;16985;17113;35961;849;856;7
/net/per610a/home/mvp/mvp_db/news7-lv/2007/2007_10_18_19_00/2007_10_18_19_00.mpg;Ichiro OZAWA.jpg;17397;17445;35961;870;872;2
/net/per610a/home/mvp/mvp_db/news7-lv/2007/2007_10_19_19_00/2007_10_19_19_00.mpg;YUriko Koike.jpg;3609;3761;35961;180;188;8
/net/per610a/home/mvp/mvp_db/news7-lv/2007/2007_10_19_19_00/2007_10_19_19_00.mpg;Yukio HATOYAMA.jpg;8969;9633;35961;448;481;33
/net/per610a/home/mvp/mvp_db/news7-lv/2007/2007_10_21_19_00/2007_10_21_19_00.mpg;Yasuo FUKUDA.jpg;6829;7321;35961;341;366;25
/net/per610a/home/mvp/mvp_db/news7-lv/2007/2007_10_22_19_00/2007_10_22_19_00.mpg;Yasuo FUKUDA.jpg;6733;6957;35961;336;348;12
/net/per610a/home/mvp/mvp_db/news7-lv/2007/2007_10_22_19_00/2007_10_22_19_00.mpg;Yasuo FUKUDA.jpg;9645;9773;35961;482;488;6
/net/per610a/home/mvp/mvp_db/news7-lv/2007/2007_10_23_19_00/2007_10_23_19_00.mpg;Yasuo FUKUDA.jpg;9249;10141;35961;462;507;45
/net/per610a/home/mvp/mvp_db/news7-lv/2007/2007_10_26_19_00/2007_10_26_19_00.mpg;Toru Hashimoto.jpg;15125;15645;35961;756;782;26
/net/per610a/home/mvp/mvp_db/news7-lv/2007/2007_10_28_19_00/2007_10_28_19_00.mpg;Ichiro OZAWA.jpg;13101;13137;35961;655;657;2
/net/per610a/home/mvp/mvp_db/news7-lv/2007/2007_10_28_19_00/2007_10_28_19_00.mpg;Ichiro OZAWA.jpg;13201;13201;35961;660;660;0
/net/per610a/home/mvp/mvp_db/news7-lv/2007/2007_10_28_19_00/2007_10_28_19_00.mpg;Ichiro OZAWA.jpg;13689;13813;35961;684;691;7
/net/per610a/home/mvp/mvp_db/news7-lv/2007/2007_10_28_19_00/2007_10_28_19_00.mpg;Ichiro OZAWA.jpg;14045;14249;35961;702;712;10
/net/per610a/home/mvp/mvp_db/news7-lv/2007/2007_10_28_19_00/2007_10_28_19_00.mpg;Ichiro OZAWA.jpg;15441;15773;35961;772;789;17
/net/per610a/home/mvp/mvp_db/news7-lv/2007/2007_10_28_19_00/2007_10_28_19_00.mpg;Yukiko Kada.jpg;21453;21981;35961;1073;1099;26
/net/per610a/home/mvp/mvp_db/news7-lv/2007/2007_10_29_19_00/2007_10_29_19_00.mpg;Yasuo FUKUDA.jpg;7033;10373;35961;351;518;167
/net/per610a/home/mvp/mvp_db/news7-lv/2007/2007_10_29_19_00/2007_10_29_19_00.mpg;Yasuo FUKUDA.jpg;12177;12605;35961;609;630;21
/net/per610a/home/mvp/mvp_db/news7-lv/2007/2007_10_29_19_00/2007_10_29_19_00.mpg;Ichiro OZAWA.jpg;12177;12605;35961;609;630;21
/net/per610a/home/mvp/mvp_db/news7-lv/2007/2007_10_30_19_00/2007_10_30_19_00.mpg;Ichiro OZAWA.jpg;405;461;35949;20;23;3
/net/per610a/home/mvp/mvp_db/news7-lv/2007/2007_10_30_19_00/2007_10_30_19_00.mpg;Ichiro OZAWA.jpg;2077;2109;35949;103;105;2
/net/per610a/home/mvp/mvp_db/news7-lv/2007/2007_10_30_19_00/2007_10_30_19_00.mpg;Ichiro OZAWA.jpg;4425;4477;35949;221;224;3
/net/per610a/home/mvp/mvp_db/news7-lv/2007/2007_10_30_19_00/2007_10_30_19_00.mpg;Yasuo FUKUDA.jpg;12257;12265;35949;613;613;0
/net/per610a/home/mvp/mvp_db/news7-lv/2007/2007_10_30_19_00/2007_10_30_19_00.mpg;Yasuo FUKUDA.jpg;12681;12797;35949;634;640;6
/net/per610a/home/mvp/mvp_db/news7-lv/2007/2007_10_30_19_00/2007_10_30_19_00.mpg;Yasuo FUKUDA.jpg;13665;13781;35949;683;689;6
/net/per610a/home/mvp/mvp_db/news7-lv/2007/2007_11_01_19_00/2007_11_01_19_00.mpg;Yasuo FUKUDA.jpg;4129;4445;35961;206;222;16
/net/per610a/home/mvp/mvp_db/news7-lv/2007/2007_11_01_19_00/2007_11_01_19_00.mpg;Naoto KAN.jpg;5953;7089;35961;297;354;57
/net/per610a/home/mvp/mvp_db/news7-lv/2007/2007_11_01_19_00/2007_11_01_19_00.mpg;Yasuo FUKUDA.jpg;7641;7757;35961;382;388;6
/net/per610a/home/mvp/mvp_db/news7-lv/2007/2007_11_01_19_00/2007_11_01_19_00.mpg;Yasuo FUKUDA.jpg;11805;12237;35961;590;612;22
/net/per610a/home/mvp/mvp_db/news7-lv/2007/2007_11_01_19_00/2007_11_01_19_00.mpg;Ichiro OZAWA.jpg;7837;8089;35961;392;404;12
/net/per610a/home/mvp/mvp_db/news7-lv/2007/2007_11_02_19_00/2007_11_02_19_00.mpg;Yasuo FUKUDA.jpg;73;105;35961;3;5;2
/net/per610a/home/mvp/mvp_db/news7-lv/2007/2007_11_02_19_00/2007_11_02_19_00.mpg;Yasuo FUKUDA.jpg;1597;1609;35961;79;80;1
/net/per610a/home/mvp/mvp_db/news7-lv/2007/2007_11_02_19_00/2007_11_02_19_00.mpg;Yasuo FUKUDA.jpg;1829;1945;35961;91;97;6
/net/per610a/home/mvp/mvp_db/news7-lv/2007/2007_11_02_19_00/2007_11_02_19_00.mpg;Yasuo FUKUDA.jpg;2397;2449;35961;119;122;3
/net/per610a/home/mvp/mvp_db/news7-lv/2007/2007_11_02_19_00/2007_11_02_19_00.mpg;Yasuo FUKUDA.jpg;2641;2693;35961;132;134;2
/net/per610a/home/mvp/mvp_db/news7-lv/2007/2007_11_02_19_00/2007_11_02_19_00.mpg;Yasuo FUKUDA.jpg;11389;11457;35961;569;573;4
/net/per610a/home/mvp/mvp_db/news7-lv/2007/2007_11_02_19_00/2007_11_02_19_00.mpg;Yasuo FUKUDA.jpg;11765;11785;35961;588;589;1
/net/per610a/home/mvp/mvp_db/news7-lv/2007/2007_11_02_19_00/2007_11_02_19_00.mpg;Yasuo FUKUDA.jpg;12809;12865;35961;640;643;3
/net/per610a/home/mvp/mvp_db/news7-lv/2007/2007_11_02_19_00/2007_11_02_19_00.mpg;Yasuo FUKUDA.jpg;33861;33953;35961;1693;1698;5
/net/per610a/home/mvp/mvp_db/news7-lv/2007/2007_11_02_19_00/2007_11_02_19_00.mpg;Yasuo FUKUDA.jpg;3429;3449;35961;171;172;1
/net/per610a/home/mvp/mvp_db/news7-lv/2007/2007_11_02_19_00/2007_11_02_19_00.mpg;Yasuo FUKUDA.jpg;34305;34341;35961;1716;1717;1
/net/per610a/home/mvp/mvp_db/news7-lv/2007/2007_11_02_19_00/2007_11_02_19_00.mpg;Yasuo FUKUDA.jpg;34637;34697;35961;1732;1735;3
/net/per610a/home/mvp/mvp_db/news7-lv/2007/2007_11_03_19_00/2007_11_03_19_00.mpg;Ichiro OZAWA.jpg;2257;2721;35961;112;136;24
/net/per610a/home/mvp/mvp_db/news7-lv/2007/2007_11_03_19_00/2007_11_03_19_00.mpg;Taro ASO.jpg;4197;6009;35961;209;300;91
/net/per610a/home/mvp/mvp_db/news7-lv/2007/2007_11_03_19_00/2007_11_03_19_00.mpg;Seiji Mataichi.jpg;6017;6681;35961;301;334;33
/net/per610a/home/mvp/mvp_db/news7-lv/2007/2007_11_04_19_00/2007_11_04_19_00.mpg;Yasuo FUKUDA.jpg;7605;7669;35961;380;383;3
/net/per610a/home/mvp/mvp_db/news7-lv/2007/2007_11_04_19_00/2007_11_04_19_00.mpg;Yasuo FUKUDA.jpg;8945;9057;35961;447;453;6
/net/per610a/home/mvp/mvp_db/news7-lv/2007/2007_11_04_19_00/2007_11_04_19_00.mpg;Yasuo FUKUDA.jpg;22873;22917;35961;1144;1146;2
/net/per610a/home/mvp/mvp_db/news7-lv/2007/2007_11_04_19_00/2007_11_04_19_00.mpg;Ichiro OZAWA.jpg;9337;9385;35961;467;469;2
/net/per610a/home/mvp/mvp_db/news7-lv/2007/2007_11_04_19_00/2007_11_04_19_00.mpg;Ichiro OZAWA.jpg;20485;20621;35961;1024;1031;7
/net/per610a/home/mvp/mvp_db/news7-lv/2007/2007_11_05_19_00/2007_11_05_19_00.mpg;Yasuo FUKUDA.jpg;33;109;35961;1;5;4
/net/per610a/home/mvp/mvp_db/news7-lv/2007/2007_11_05_19_00/2007_11_05_19_00.mpg;Yasuo FUKUDA.jpg;6781;8561;35961;339;428;89
/net/per610a/home/mvp/mvp_db/news7-lv/2007/2007_11_05_19_00/2007_11_05_19_00.mpg;Yasuo FUKUDA.jpg;9133;9181;35961;456;459;3
/net/per610a/home/mvp/mvp_db/news7-lv/2007/2007_11_05_19_00/2007_11_05_19_00.mpg;Yasuo FUKUDA.jpg;9729;9821;35961;486;491;5
/net/per610a/home/mvp/mvp_db/news7-lv/2007/2007_11_05_19_00/2007_11_05_19_00.mpg;Yukio HATOYAMA.jpg;185;317;35961;9;15;6
/net/per610a/home/mvp/mvp_db/news7-lv/2007/2007_11_05_19_00/2007_11_05_19_00.mpg;Ichiro OZAWA.jpg;869;1369;35961;43;68;25
/net/per610a/home/mvp/mvp_db/news7-lv/2007/2007_11_05_19_00/2007_11_05_19_00.mpg;Ichiro OZAWA.jpg;9901;9957;35961;495;498;3
/net/per610a/home/mvp/mvp_db/news7-lv/2007/2007_11_05_19_00/2007_11_05_19_00.mpg;Ichiro OZAWA.jpg;11729;12393;35961;586;619;33
/net/per610a/home/mvp/mvp_db/news7-lv/2007/2007_11_06_19_00/2007_11_06_19_00.mpg;Yukio HATOYAMA.jpg;1889;1933;35961;94;96;2
/net/per610a/home/mvp/mvp_db/news7-lv/2007/2007_11_06_19_00/2007_11_06_19_00.mpg;Yukio HATOYAMA.jpg;8245;8313;35961;412;415;3
/net/per610a/home/mvp/mvp_db/news7-lv/2007/2007_11_06_19_00/2007_11_06_19_00.mpg;Yasuo FUKUDA.jpg;8793;9001;35961;439;450;11
/net/per610a/home/mvp/mvp_db/news7-lv/2007/2007_11_06_19_00/2007_11_06_19_00.mpg;Yasuo FUKUDA.jpg;10541;10997;35961;527;550;23
/net/per610a/home/mvp/mvp_db/news7-lv/2007/2007_11_06_19_00/2007_11_06_19_00.mpg;Sadakazu TANIGAKI.jpg;9229;9333;35961;461;466;5
/net/per610a/home/mvp/mvp_db/news7-lv/2007/2007_11_06_19_00/2007_11_06_19_00.mpg;Ichiro OZAWA.jpg;12925;14105;35961;646;705;59
/net/per610a/home/mvp/mvp_db/news7-lv/2007/2007_11_07_19_00/2007_11_07_19_00.mpg;Katsuya OKADA.jpg;7645;8117;35961;382;406;24
/net/per610a/home/mvp/mvp_db/news7-lv/2007/2007_11_07_19_00/2007_11_07_19_00.mpg;Shizuka KAMEI.jpg;12581;12865;35961;629;643;14
/net/per610a/home/mvp/mvp_db/news7-lv/2007/2007_11_07_19_00/2007_11_07_19_00.mpg;Yasuo FUKUDA.jpg;16085;16137;35961;804;807;3
/net/per610a/home/mvp/mvp_db/news7-lv/2007/2007_11_07_19_00/2007_11_07_19_00.mpg;Yasuo FUKUDA.jpg;16381;16465;35961;819;823;4
/net/per610a/home/mvp/mvp_db/news7-lv/2007/2007_11_07_19_00/2007_11_07_19_00.mpg;Ichiro OZAWA.jpg;16561;16561;35961;828;828;0
/net/per610a/home/mvp/mvp_db/news7-lv/2007/2007_11_07_19_00/2007_11_07_19_00.mpg;Ichiro OZAWA.jpg;16653;16889;35961;833;844;11
/net/per610a/home/mvp/mvp_db/news7-lv/2007/2007_11_07_19_00/2007_11_07_19_00.mpg;Ichiro OZAWA.jpg;17101;17417;35961;855;871;16
/net/per610a/home/mvp/mvp_db/news7-lv/2007/2007_11_07_19_00/2007_11_07_19_00.mpg;Yorihisa Matsuno.png;27445;27853;35961;1372;1393;21
/net/per610a/home/mvp/mvp_db/news7-lv/2007/2007_11_07_19_00/2007_11_07_19_00.mpg;Yorihisa Matsuno.png;28665;29281;35961;1434;1464;30
/net/per610a/home/mvp/mvp_db/news7-lv/2007/2007_11_08_19_00/2007_11_08_19_00.mpg;Naoto KAN.jpg;16465;16857;35961;823;843;20
/net/per610a/home/mvp/mvp_db/news7-lv/2007/2007_11_09_19_00/2007_11_09_19_00.mpg;Yasuo FUKUDA.jpg;19957;20629;35961;998;1031;33
/net/per610a/home/mvp/mvp_db/news7-lv/2007/2007_11_10_19_00/2007_11_10_19_00.mpg;Yukio HATOYAMA.jpg;4277;4333;35961;213;216;3
/net/per610a/home/mvp/mvp_db/news7-lv/2007/2007_11_10_19_00/2007_11_10_19_00.mpg;Yukio HATOYAMA.jpg;4485;4745;35961;224;237;13
/net/per610a/home/mvp/mvp_db/news7-lv/2007/2007_11_12_19_00/2007_11_12_19_00.mpg;Ichiro OZAWA.jpg;10577;10577;35961;529;529;0
/net/per610a/home/mvp/mvp_db/news7-lv/2007/2007_11_12_19_00/2007_11_12_19_00.mpg;Ichiro OZAWA.jpg;11009;11325;35961;550;566;16
/net/per610a/home/mvp/mvp_db/news7-lv/2007/2007_11_13_19_00/2007_11_13_19_00.mpg;Shinzo ABE.jpg;3369;3837;35961;168;191;23
/net/per610a/home/mvp/mvp_db/news7-lv/2007/2007_11_13_19_00/2007_11_13_19_00.mpg;Shinzo ABE.jpg;22641;22717;35961;1132;1136;4
/net/per610a/home/mvp/mvp_db/news7-lv/2007/2007_11_14_19_00/2007_11_14_19_00.mpg;Yasuo FUKUDA.jpg;9141;9237;35961;457;462;5
/net/per610a/home/mvp/mvp_db/news7-lv/2007/2007_11_16_19_00/2007_11_16_19_00.mpg;Yukio HATOYAMA.jpg;18601;19677;35961;930;984;54
/net/per610a/home/mvp/mvp_db/news7-lv/2007/2007_11_20_19_00/2007_11_20_19_00.mpg;Ichiro OZAWA.jpg;16169;17681;35961;808;884;76
/net/per610a/home/mvp/mvp_db/news7-lv/2007/2007_11_22_19_00/2007_11_22_19_00.mpg;Akihiro OHTA.jpg;1009;1357;35961;50;67;17
/net/per610a/home/mvp/mvp_db/news7-lv/2007/2007_11_22_19_00/2007_11_22_19_00.mpg;Akihiro OHTA.jpg;1445;1513;35961;72;75;3
/net/per610a/home/mvp/mvp_db/news7-lv/2007/2007_11_22_19_00/2007_11_22_19_00.mpg;Akihiro OHTA.jpg;7193;8225;35961;359;411;52
/net/per610a/home/mvp/mvp_db/news7-lv/2007/2007_11_22_19_00/2007_11_22_19_00.mpg;Ichiro OZAWA.jpg;2961;3997;35961;148;199;51
/net/per610a/home/mvp/mvp_db/news7-lv/2007/2007_11_22_19_00/2007_11_22_19_00.mpg;Kazuo SHII.jpg;5549;5625;35961;277;281;4
/net/per610a/home/mvp/mvp_db/news7-lv/2007/2007_11_22_19_00/2007_11_22_19_00.mpg;Kazuo SHII.jpg;5901;6429;35961;295;321;26
/net/per610a/home/mvp/mvp_db/news7-lv/2007/2007_11_23_19_00/2007_11_23_19_00.mpg;Yasuo FUKUDA.jpg;17901;18161;35961;895;908;13
/net/per610a/home/mvp/mvp_db/news7-lv/2007/2007_11_23_19_00/2007_11_23_19_00.mpg;Ichiro OZAWA.jpg;19253;19333;35961;963;967;4
/net/per610a/home/mvp/mvp_db/news7-lv/2007/2007_11_23_19_00/2007_11_23_19_00.mpg;Ichiro OZAWA.jpg;20257;20605;35961;1013;1030;17
/net/per610a/home/mvp/mvp_db/news7-lv/2007/2007_11_23_19_00/2007_11_23_19_00.mpg;Shinzo ABE.jpg;19389;19909;35961;969;995;26
/net/per610a/home/mvp/mvp_db/news7-lv/2007/2007_11_26_19_00/2007_11_26_19_00.mpg;Ichiro OZAWA.jpg;11681;12177;35961;584;609;25
/net/per610a/home/mvp/mvp_db/news7-lv/2007/2007_11_29_19_00/2007_11_29_19_00.mpg;Akihiro OHTA.jpg;9465;11321;35961;473;566;93
/net/per610a/home/mvp/mvp_db/news7-lv/2007/2007_11_29_19_00/2007_11_29_19_00.mpg;Naoto KAN.jpg;13401;13957;35961;670;698;28
/net/per610a/home/mvp/mvp_db/news7-lv/2007/2007_12_02_19_00/2007_12_02_19_00.mpg;Masashi Nakano.jpg;23057;23201;35961;1153;1160;7
/net/per610a/home/mvp/mvp_db/news7-lv/2007/2007_12_05_19_00/2007_12_05_19_00.mpg;Yoshihiko Noda.jpg;18941;19009;35961;947;950;3
/net/per610a/home/mvp/mvp_db/news7-lv/2007/2007_12_05_19_00/2007_12_05_19_00.mpg;Yoshihiko Noda.jpg;20993;21053;35961;1050;1053;3
/net/per610a/home/mvp/mvp_db/news7-lv/2007/2007_12_05_19_00/2007_12_05_19_00.mpg;Yasuo FUKUDA.jpg;20797;20965;35961;1040;1048;8
/net/per610a/home/mvp/mvp_db/news7-lv/2007/2007_12_06_19_00/2007_12_06_19_00.mpg;Yasuo FUKUDA.jpg;1741;2177;35961;87;108;21
/net/per610a/home/mvp/mvp_db/news7-lv/2007/2007_12_07_19_00/2007_12_07_19_00.mpg;Akihiro OHTA.jpg;9657;10005;35961;483;500;17
/net/per610a/home/mvp/mvp_db/news7-lv/2007/2007_12_07_19_00/2007_12_07_19_00.mpg;Akihiro OHTA.jpg;10097;10549;35961;505;527;22
/net/per610a/home/mvp/mvp_db/news7-lv/2007/2007_12_07_19_00/2007_12_07_19_00.mpg;Yukio HATOYAMA.jpg;11645;12129;35961;582;606;24
/net/per610a/home/mvp/mvp_db/news7-lv/2007/2007_12_07_19_00/2007_12_07_19_00.mpg;Ichiro OZAWA.jpg;18873;18889;35961;944;944;0
/net/per610a/home/mvp/mvp_db/news7-lv/2007/2007_12_07_19_00/2007_12_07_19_00.mpg;Ichiro OZAWA.jpg;19189;19425;35961;959;971;12
/net/per610a/home/mvp/mvp_db/news7-lv/2007/2007_12_07_19_00/2007_12_07_19_00.mpg;Ichiro OZAWA.jpg;20605;21557;35961;1030;1078;48
/net/per610a/home/mvp/mvp_db/news7-lv/2007/2007_12_07_19_00/2007_12_07_19_00.mpg;Shintaro ISHIHARA.jpg;21069;21557;35961;1054;1078;24
/net/per610a/home/mvp/mvp_db/news7-lv/2007/2007_12_11_19_00/2007_12_11_19_00.mpg;Yasuo FUKUDA.jpg;6089;6497;35961;304;325;21
/net/per610a/home/mvp/mvp_db/news7-lv/2007/2007_12_11_19_00/2007_12_11_19_00.mpg;Yasuo FUKUDA.jpg;7169;7209;35961;358;360;2
/net/per610a/home/mvp/mvp_db/news7-lv/2007/2007_12_11_19_00/2007_12_11_19_00.mpg;Yasuo FUKUDA.jpg;13625;14173;35961;681;709;28
/net/per610a/home/mvp/mvp_db/news7-lv/2007/2007_12_11_19_00/2007_12_11_19_00.mpg;Ichiro OZAWA.jpg;8461;9701;35961;423;485;62
/net/per610a/home/mvp/mvp_db/news7-lv/2007/2007_12_11_19_00/2007_12_11_19_00.mpg;Shintaro ISHIHARA.jpg;13625;14173;35961;681;709;28
/net/per610a/home/mvp/mvp_db/news7-lv/2007/2007_12_12_19_00/2007_12_12_19_00.mpg;Shinzo ABE.jpg;3777;4117;35961;188;205;17
/net/per610a/home/mvp/mvp_db/news7-lv/2007/2007_12_12_19_00/2007_12_12_19_00.mpg;Yasuo FUKUDA.jpg;6601;7421;35961;330;371;41
/net/per610a/home/mvp/mvp_db/news7-lv/2007/2007_12_13_19_00/2007_12_13_19_00.mpg;Yasuo FUKUDA.jpg;4469;4717;35961;223;235;12
/net/per610a/home/mvp/mvp_db/news7-lv/2007/2007_12_13_19_00/2007_12_13_19_00.mpg;Shintaro ISHIHARA.jpg;20905;21121;35961;1045;1056;11
/net/per610a/home/mvp/mvp_db/news7-lv/2007/2007_12_14_19_00/2007_12_14_19_00.mpg;Ichiro OZAWA.jpg;15413;15469;35961;771;773;2
/net/per610a/home/mvp/mvp_db/news7-lv/2007/2007_12_14_19_00/2007_12_14_19_00.mpg;Ichiro OZAWA.jpg;18305;18421;35961;915;921;6
/net/per610a/home/mvp/mvp_db/news7-lv/2007/2007_12_14_19_00/2007_12_14_19_00.mpg;Yasuo FUKUDA.jpg;18045;18253;35961;902;913;11
/net/per610a/home/mvp/mvp_db/news7-lv/2007/2007_12_16_19_00/2007_12_16_19_00.mpg;Ichiro OZAWA.jpg;15741;16857;35961;787;843;56
/net/per610a/home/mvp/mvp_db/news7-lv/2007/2007_12_21_19_00/2007_12_21_19_00.mpg;Yukio HATOYAMA.jpg;5957;6445;35961;298;322;24
/net/per610a/home/mvp/mvp_db/news7-lv/2007/2007_12_21_19_00/2007_12_21_19_00.mpg;Ichiro OZAWA.jpg;9693;10733;35961;484;536;52
/net/per610a/home/mvp/mvp_db/news7-lv/2007/2007_12_21_19_00/2007_12_21_19_00.mpg;Akihiro OHTA.jpg;13709;14249;35961;685;712;27
/net/per610a/home/mvp/mvp_db/news7-lv/2007/2007_12_23_19_00/2007_12_23_19_00.mpg;Yasuo FUKUDA.jpg;1677;2357;35961;83;117;34
/net/per610a/home/mvp/mvp_db/news7-lv/2007/2007_12_23_19_00/2007_12_23_19_00.mpg;Yasuo FUKUDA.jpg;2777;2997;35961;138;149;11
/net/per610a/home/mvp/mvp_db/news7-lv/2007/2007_12_23_19_00/2007_12_23_19_00.mpg;Yasuo FUKUDA.jpg;13853;14057;35961;693;703;10
/net/per610a/home/mvp/mvp_db/news7-lv/2007/2007_12_23_19_00/2007_12_23_19_00.mpg;Yasuo FUKUDA.jpg;15049;15057;35961;752;753;1
/net/per610a/home/mvp/mvp_db/news7-lv/2007/2007_12_24_19_00/2007_12_24_19_00.mpg;Shinzo ABE.jpg;12557;12705;35961;628;635;7
/net/per610a/home/mvp/mvp_db/news7-lv/2007/2007_12_25_19_00/2007_12_25_19_00.mpg;Ichiro OZAWA.jpg;6293;7609;35941;314;380;66
/net/per610a/home/mvp/mvp_db/news7-lv/2007/2007_12_26_19_00/2007_12_26_19_00.mpg;Yasuo FUKUDA.jpg;18241;18377;35961;912;919;7
/net/per610a/home/mvp/mvp_db/news7-lv/2007/2007_12_26_19_00/2007_12_26_19_00.mpg;Yasuo FUKUDA.jpg;19785;19821;35961;989;991;2
/net/per610a/home/mvp/mvp_db/news7-lv/2007/2007_12_26_19_00/2007_12_26_19_00.mpg;Yasuo FUKUDA.jpg;20421;20845;35961;1021;1042;21
/net/per610a/home/mvp/mvp_db/news7-lv/2007/2007_12_26_19_00/2007_12_26_19_00.mpg;Yasuo FUKUDA.jpg;22885;22933;35961;1144;1147;3
/net/per610a/home/mvp/mvp_db/news7-lv/2007/2007_12_26_19_00/2007_12_26_19_00.mpg;Yasuo FUKUDA.jpg;23201;23213;35961;1160;1161;1
/net/per610a/home/mvp/mvp_db/news7-lv/2007/2007_12_26_19_00/2007_12_26_19_00.mpg;Ichiro OZAWA.jpg;19833;20061;35961;992;1003;11
/net/per610a/home/mvp/mvp_db/news7-lv/2007/2007_12_26_19_00/2007_12_26_19_00.mpg;Ichiro OZAWA.jpg;21745;22825;35961;1087;1141;54
/net/per610a/home/mvp/mvp_db/news7-lv/2007/2007_12_26_19_00/2007_12_26_19_00.mpg;Ichiro OZAWA.jpg;22945;23017;35961;1147;1151;4
/net/per610a/home/mvp/mvp_db/news7-lv/2007/2007_12_26_19_00/2007_12_26_19_00.mpg;Yasuo FUKUDA.jpg;21217;21505;35961;1061;1075;14
/net/per610a/home/mvp/mvp_db/news7-lv/2007/2007_12_27_19_00/2007_12_27_19_00.mpg;Yasuo FUKUDA.jpg;1209;2037;35961;60;101;41
/net/per610a/home/mvp/mvp_db/news7-lv/2007/2007_12_27_19_00/2007_12_27_19_00.mpg;Yasuo FUKUDA.jpg;2149;2409;35961;107;120;13
/net/per610a/home/mvp/mvp_db/news7-lv/2007/2007_12_27_19_00/2007_12_27_19_00.mpg;Yasuo FUKUDA.jpg;8117;9161;35961;406;458;52
/net/per610a/home/mvp/mvp_db/news7-lv/2007/2007_12_28_19_00/2007_12_28_19_00.mpg;Yasuo FUKUDA.jpg;5585;5757;35961;279;288;9
/net/per610a/home/mvp/mvp_db/news7-lv/2007/2007_12_28_19_00/2007_12_28_19_00.mpg;Yasuo FUKUDA.jpg;6073;6081;35961;303;304;1
/net/per610a/home/mvp/mvp_db/news7-lv/2007/2007_12_28_19_00/2007_12_28_19_00.mpg;Yasuo FUKUDA.jpg;6209;6281;35961;310;314;4
/net/per610a/home/mvp/mvp_db/news7-lv/2008/2008_01_01_19_00/2008_01_01_19_00.mpg;Yukio HATOYAMA.jpg;10993;11093;23881;550;555;5
/net/per610a/home/mvp/mvp_db/news7-lv/2008/2008_01_01_19_00/2008_01_01_19_00.mpg;Yasuo FUKUDA.jpg;11257;11593;23881;563;580;17
/net/per610a/home/mvp/mvp_db/news7-lv/2008/2008_01_01_19_00/2008_01_01_19_00.mpg;Yasuo FUKUDA.jpg;11849;11865;23881;592;593;1
/net/per610a/home/mvp/mvp_db/news7-lv/2008/2008_01_04_19_00/2008_01_04_19_00.mpg;Yasuo FUKUDA.jpg;7297;8557;35961;365;428;63
/net/per610a/home/mvp/mvp_db/news7-lv/2008/2008_01_04_19_00/2008_01_04_19_00.mpg;Yasuo FUKUDA.jpg;8713;8721;35961;435;436;1
/net/per610a/home/mvp/mvp_db/news7-lv/2008/2008_01_04_19_00/2008_01_04_19_00.mpg;Ichiro OZAWA.jpg;9149;10545;35961;457;527;70
/net/per610a/home/mvp/mvp_db/news7-lv/2008/2008_01_04_19_00/2008_01_04_19_00.mpg;Kazuo SHII.jpg;11461;12073;35961;573;603;30
/net/per610a/home/mvp/mvp_db/news7-lv/2008/2008_01_07_19_00/2008_01_07_19_00.mpg;Yasuo FUKUDA.jpg;11441;11921;35961;572;596;24
/net/per610a/home/mvp/mvp_db/news7-lv/2008/2008_01_07_19_00/2008_01_07_19_00.mpg;Ichiro OZAWA.jpg;11981;12605;35961;599;630;31
/net/per610a/home/mvp/mvp_db/news7-lv/2008/2008_01_09_19_00/2008_01_09_19_00.mpg;Keiichiro Asao.jpg;1525;1669;35961;76;83;7
/net/per610a/home/mvp/mvp_db/news7-lv/2008/2008_01_11_19_00/2008_01_11_19_00.mpg;Yukio HATOYAMA.jpg;7533;7865;35961;376;393;17
/net/per610a/home/mvp/mvp_db/news7-lv/2008/2008_01_11_19_00/2008_01_11_19_00.mpg;Ichiro OZAWA.jpg;9713;9801;35961;485;490;5
/net/per610a/home/mvp/mvp_db/news7-lv/2008/2008_01_11_19_00/2008_01_11_19_00.mpg;Kenji Eda.jpg;20569;21353;35961;1028;1068;40
/net/per610a/home/mvp/mvp_db/news7-lv/2008/2008_01_12_19_00/2008_01_12_19_00.mpg;Yasuo FUKUDA.jpg;6341;7917;35961;317;396;79
/net/per610a/home/mvp/mvp_db/news7-lv/2008/2008_01_12_19_00/2008_01_12_19_00.mpg;Toru Hashimoto.jpg;13633;14153;35961;682;708;26
/net/per610a/home/mvp/mvp_db/news7-lv/2008/2008_01_14_19_00/2008_01_14_19_00.mpg;Yasuo FUKUDA.jpg;15141;15921;35961;757;796;39
/net/per610a/home/mvp/mvp_db/news7-lv/2008/2008_01_15_19_00/2008_01_15_19_00.mpg;Yasuo FUKUDA.jpg;13;173;35961;0;8;8
/net/per610a/home/mvp/mvp_db/news7-lv/2008/2008_01_15_19_00/2008_01_15_19_00.mpg;Yasuo FUKUDA.jpg;877;3837;35961;43;191;148
/net/per610a/home/mvp/mvp_db/news7-lv/2008/2008_01_15_19_00/2008_01_15_19_00.mpg;Yasuo FUKUDA.jpg;6809;7065;35961;340;353;13
/net/per610a/home/mvp/mvp_db/news7-lv/2008/2008_01_15_19_00/2008_01_15_19_00.mpg;Yasuo FUKUDA.jpg;7465;7613;35961;373;380;7
/net/per610a/home/mvp/mvp_db/news7-lv/2008/2008_01_15_19_00/2008_01_15_19_00.mpg;Yasuo FUKUDA.jpg;7957;7993;35961;398;399;1
/net/per610a/home/mvp/mvp_db/news7-lv/2008/2008_01_16_19_00/2008_01_16_19_00.mpg;Yukio HATOYAMA.jpg;2857;3069;35961;142;153;11
/net/per610a/home/mvp/mvp_db/news7-lv/2008/2008_01_16_19_00/2008_01_16_19_00.mpg;Ichiro OZAWA.jpg;5429;6221;35961;271;311;40
/net/per610a/home/mvp/mvp_db/news7-lv/2008/2008_01_17_19_00/2008_01_17_19_00.mpg;Yasuo FUKUDA.jpg;273;429;35961;13;21;8
/net/per610a/home/mvp/mvp_db/news7-lv/2008/2008_01_17_19_00/2008_01_17_19_00.mpg;Yasuo FUKUDA.jpg;9377;9637;35961;469;482;13
/net/per610a/home/mvp/mvp_db/news7-lv/2008/2008_01_17_19_00/2008_01_17_19_00.mpg;Yasuo FUKUDA.jpg;9841;10337;35961;492;517;25
/net/per610a/home/mvp/mvp_db/news7-lv/2008/2008_01_17_19_00/2008_01_17_19_00.mpg;Yasuo FUKUDA.jpg;14181;14489;35961;709;724;15
/net/per610a/home/mvp/mvp_db/news7-lv/2008/2008_01_17_19_00/2008_01_17_19_00.mpg;Yasuo FUKUDA.jpg;15185;15257;35961;759;763;4
/net/per610a/home/mvp/mvp_db/news7-lv/2008/2008_01_18_19_00/2008_01_18_19_00.mpg;Ichiro OZAWA.jpg;585;633;35961;29;31;2
/net/per610a/home/mvp/mvp_db/news7-lv/2008/2008_01_18_19_00/2008_01_18_19_00.mpg;Ichiro OZAWA.jpg;9717;9905;35961;486;495;9
/net/per610a/home/mvp/mvp_db/news7-lv/2008/2008_01_18_19_00/2008_01_18_19_00.mpg;Yasuo FUKUDA.jpg;8741;9633;35961;437;481;44
/net/per610a/home/mvp/mvp_db/news7-lv/2008/2008_01_18_19_00/2008_01_18_19_00.mpg;Yasuo FUKUDA.jpg;16681;16697;35961;834;835;1
/net/per610a/home/mvp/mvp_db/news7-lv/2008/2008_01_18_19_00/2008_01_18_19_00.mpg;Yasuo FUKUDA.jpg;9913;11193;35961;495;559;64
/net/per610a/home/mvp/mvp_db/news7-lv/2008/2008_01_18_19_00/2008_01_18_19_00.mpg;Yasuo FUKUDA.jpg;14405;15277;35961;720;764;44
/net/per610a/home/mvp/mvp_db/news7-lv/2008/2008_01_18_19_00/2008_01_18_19_00.mpg;Yasuo FUKUDA.jpg;16757;17001;35961;838;850;12
/net/per610a/home/mvp/mvp_db/news7-lv/2008/2008_01_18_19_00/2008_01_18_19_00.mpg;Naoto KAN.jpg;15593;16249;35961;780;812;32
/net/per610a/home/mvp/mvp_db/news7-lv/2008/2008_01_21_19_00/2008_01_21_19_00.mpg;Yasuo FUKUDA.jpg;1137;1553;35961;56;77;21
/net/per610a/home/mvp/mvp_db/news7-lv/2008/2008_01_21_19_00/2008_01_21_19_00.mpg;Yasuo FUKUDA.jpg;4257;4365;35961;212;218;6
/net/per610a/home/mvp/mvp_db/news7-lv/2008/2008_01_21_19_00/2008_01_21_19_00.mpg;Yasuo FUKUDA.jpg;6281;6485;35961;314;324;10
/net/per610a/home/mvp/mvp_db/news7-lv/2008/2008_01_21_19_00/2008_01_21_19_00.mpg;Ichiro OZAWA.jpg;6641;7749;35961;332;387;55
/net/per610a/home/mvp/mvp_db/news7-lv/2008/2008_01_22_19_00/2008_01_22_19_00.mpg;Yasuo FUKUDA.jpg;11053;11545;35961;552;577;25
/net/per610a/home/mvp/mvp_db/news7-lv/2008/2008_01_23_19_00/2008_01_23_19_00.mpg;Yasuo FUKUDA.jpg;6753;6897;35961;337;345;8
/net/per610a/home/mvp/mvp_db/news7-lv/2008/2008_01_23_19_00/2008_01_23_19_00.mpg;Sadakazu TANIGAKI.jpg;10449;11449;35961;522;572;50
/net/per610a/home/mvp/mvp_db/news7-lv/2008/2008_01_23_19_00/2008_01_23_19_00.mpg;Yasuo FUKUDA.jpg;13857;14301;35961;693;715;22
/net/per610a/home/mvp/mvp_db/news7-lv/2008/2008_01_23_19_00/2008_01_23_19_00.mpg;Yasuo FUKUDA.jpg;14757;15105;35961;738;755;17
/net/per610a/home/mvp/mvp_db/news7-lv/2008/2008_01_26_19_00/2008_01_26_19_00.mpg;Naoto KAN.jpg;13793;14933;35961;690;747;57
/net/per610a/home/mvp/mvp_db/news7-lv/2008/2008_01_29_19_00/2008_01_29_19_00.mpg;Ichiro OZAWA.jpg;17;189;35961;0;9;9
/net/per610a/home/mvp/mvp_db/news7-lv/2008/2008_01_29_19_00/2008_01_29_19_00.mpg;Yukio HATOYAMA.jpg;5673;6345;35961;283;317;34
/net/per610a/home/mvp/mvp_db/news7-lv/2008/2008_01_30_19_00/2008_01_30_19_00.mpg;Ichiro OZAWA.jpg;14185;14533;35961;709;727;18
/net/per610a/home/mvp/mvp_db/news7-lv/2008/2008_01_30_19_00/2008_01_30_19_00.mpg;Ichiro OZAWA.jpg;20149;20389;35961;1007;1019;12
/net/per610a/home/mvp/mvp_db/news7-lv/2008/2008_01_30_19_00/2008_01_30_19_00.mpg;Yasuo FUKUDA.jpg;19421;19561;35961;971;978;7
/net/per610a/home/mvp/mvp_db/news7-lv/2008/2008_02_03_19_00/2008_02_03_19_00.mpg;Ichiro OZAWA.jpg;20877;24201;35961;1044;1210;166
/net/per610a/home/mvp/mvp_db/news7-lv/2008/2008_02_15_19_00/2008_02_15_19_00.mpg;Akihiro OHTA.jpg;11013;11345;35961;550;567;17
/net/per610a/home/mvp/mvp_db/news7-lv/2008/2008_02_16_19_00/2008_02_16_19_00.mpg;Yoshihiko Noda.jpg;11961;12977;35949;598;649;51
/net/per610a/home/mvp/mvp_db/news7-lv/2008/2008_02_18_19_00/2008_02_18_19_00.mpg;Yasuo FUKUDA.jpg;12605;12873;35961;630;643;13
/net/per610a/home/mvp/mvp_db/news7-lv/2008/2008_02_19_19_00/2008_02_19_19_00.mpg;Naoto KAN.jpg;21453;21889;35961;1073;1095;22
/net/per610a/home/mvp/mvp_db/news7-lv/2008/2008_02_19_19_00/2008_02_19_19_00.mpg;Naoto KAN.jpg;22193;22713;35961;1110;1136;26
/net/per610a/home/mvp/mvp_db/news7-lv/2008/2008_02_19_19_00/2008_02_19_19_00.mpg;Naoto KAN.jpg;23913;24317;35961;1196;1216;20
/net/per610a/home/mvp/mvp_db/news7-lv/2008/2008_02_19_19_00/2008_02_19_19_00.mpg;Naoto KAN.jpg;25405;25625;35961;1270;1281;11
/net/per610a/home/mvp/mvp_db/news7-lv/2008/2008_02_19_19_00/2008_02_19_19_00.mpg;Yasuo FUKUDA.jpg;32273;32705;35961;1614;1636;22
/net/per610a/home/mvp/mvp_db/news7-lv/2008/2008_02_20_19_00/2008_02_20_19_00.mpg;Yukio HATOYAMA.jpg;15013;16081;35961;751;804;53
/net/per610a/home/mvp/mvp_db/news7-lv/2008/2008_02_20_19_00/2008_02_20_19_00.mpg;Shintaro ISHIHARA.jpg;16085;16533;35961;804;827;23
/net/per610a/home/mvp/mvp_db/news7-lv/2008/2008_02_20_19_00/2008_02_20_19_00.mpg;Shintaro ISHIHARA.jpg;17421;17761;35961;871;888;17
/net/per610a/home/mvp/mvp_db/news7-lv/2008/2008_02_20_19_00/2008_02_20_19_00.mpg;Shintaro ISHIHARA.jpg;18385;18473;35961;919;924;5
/net/per610a/home/mvp/mvp_db/news7-lv/2008/2008_02_21_19_00/2008_02_21_19_00.mpg;Yukio HATOYAMA.jpg;16873;17121;35961;844;856;12
/net/per610a/home/mvp/mvp_db/news7-lv/2008/2008_02_21_19_00/2008_02_21_19_00.mpg;Kazuo SHII.jpg;17173;17521;35961;859;876;17
/net/per610a/home/mvp/mvp_db/news7-lv/2008/2008_02_21_19_00/2008_02_21_19_00.mpg;Yasuo FUKUDA.jpg;18429;19061;35961;921;953;32
/net/per610a/home/mvp/mvp_db/news7-lv/2008/2008_02_24_19_00/2008_02_24_19_00.mpg;Yasuo FUKUDA.jpg;25021;25581;35961;1251;1279;28
/net/per610a/home/mvp/mvp_db/news7-lv/2008/2008_02_24_19_00/2008_02_24_19_00.mpg;Yasuo FUKUDA.jpg;25837;26229;35961;1292;1312;20
/net/per610a/home/mvp/mvp_db/news7-lv/2008/2008_02_24_19_00/2008_02_24_19_00.mpg;Yasuo FUKUDA.jpg;26797;26849;35961;1340;1343;3
/net/per610a/home/mvp/mvp_db/news7-lv/2008/2008_02_26_19_00/2008_02_26_19_00.mpg;Yasuo FUKUDA.jpg;14777;15185;35961;739;759;20
/net/per610a/home/mvp/mvp_db/news7-lv/2008/2008_02_26_19_00/2008_02_26_19_00.mpg;Ichiro OZAWA.jpg;15413;17445;35961;771;872;101
/net/per610a/home/mvp/mvp_db/news7-lv/2008/2008_02_27_19_00/2008_02_27_19_00.mpg;Yasuo FUKUDA.jpg;11449;11849;35961;572;592;20
/net/per610a/home/mvp/mvp_db/news7-lv/2008/2008_02_27_19_00/2008_02_27_19_00.mpg;Yukio HATOYAMA.jpg;20653;21281;35961;1033;1064;31
/net/per610a/home/mvp/mvp_db/news7-lv/2008/2008_02_28_19_00/2008_02_28_19_00.mpg;Yukio HATOYAMA.jpg;18029;18077;35961;901;904;3
/net/per610a/home/mvp/mvp_db/news7-lv/2008/2008_02_28_19_00/2008_02_28_19_00.mpg;Yukio HATOYAMA.jpg;18309;19177;35961;915;959;44
/net/per610a/home/mvp/mvp_db/news7-lv/2008/2008_02_28_19_00/2008_02_28_19_00.mpg;Akihiro OHTA.jpg;19705;19813;35961;985;991;6
/net/per610a/home/mvp/mvp_db/news7-lv/2008/2008_03_01_19_00/2008_03_01_19_00.mpg;Ichiro OZAWA.jpg;85;305;35961;4;15;11
/net/per610a/home/mvp/mvp_db/news7-lv/2008/2008_03_01_19_00/2008_03_01_19_00.mpg;Ichiro OZAWA.jpg;1125;1489;35961;56;74;18
/net/per610a/home/mvp/mvp_db/news7-lv/2008/2008_03_01_19_00/2008_03_01_19_00.mpg;Ichiro OZAWA.jpg;2729;3073;35961;136;153;17
/net/per610a/home/mvp/mvp_db/news7-lv/2008/2008_03_01_19_00/2008_03_01_19_00.mpg;Ichiro OZAWA.jpg;2041;2665;35961;102;133;31
/net/per610a/home/mvp/mvp_db/news7-lv/2008/2008_03_01_19_00/2008_03_01_19_00.mpg;Ichiro OZAWA.jpg;3197;3385;35961;159;169;10
/net/per610a/home/mvp/mvp_db/news7-lv/2008/2008_03_02_19_00/2008_03_02_19_00.mpg;Yasuo FUKUDA.jpg;6089;6905;35961;304;345;41
/net/per610a/home/mvp/mvp_db/news7-lv/2008/2008_03_03_19_00/2008_03_03_19_00.mpg;Yoshihiko Noda.jpg;22773;23393;35961;1139;1170;31
/net/per610a/home/mvp/mvp_db/news7-lv/2008/2008_03_07_19_00/2008_03_07_19_00.mpg;Yukio HATOYAMA.jpg;8841;9441;35961;442;472;30
/net/per610a/home/mvp/mvp_db/news7-lv/2008/2008_03_07_19_00/2008_03_07_19_00.mpg;Kazuo SHII.jpg;9489;10593;35961;474;529;55
/net/per610a/home/mvp/mvp_db/news7-lv/2008/2008_03_08_19_00/2008_03_08_19_00.mpg;Sadakazu TANIGAKI.jpg;801;909;35961;40;45;5
/net/per610a/home/mvp/mvp_db/news7-lv/2008/2008_03_08_19_00/2008_03_08_19_00.mpg;Sadakazu TANIGAKI.jpg;9217;9249;35961;461;462;1
/net/per610a/home/mvp/mvp_db/news7-lv/2008/2008_03_08_19_00/2008_03_08_19_00.mpg;Sadakazu TANIGAKI.jpg;9889;10401;35961;494;520;26
/net/per610a/home/mvp/mvp_db/news7-lv/2008/2008_03_10_19_00/2008_03_10_19_00.mpg;Yasuo FUKUDA.jpg;17001;17837;35961;850;892;42
/net/per610a/home/mvp/mvp_db/news7-lv/2008/2008_03_10_19_00/2008_03_10_19_00.mpg;Yasuo FUKUDA.jpg;18173;18221;35961;909;911;2
/net/per610a/home/mvp/mvp_db/news7-lv/2008/2008_03_10_19_00/2008_03_10_19_00.mpg;Yasuo FUKUDA.jpg;18617;18985;35961;931;949;18
/net/per610a/home/mvp/mvp_db/news7-lv/2008/2008_03_11_19_00/2008_03_11_19_00.mpg;Ichiro OZAWA.jpg;569;629;35961;28;31;3
/net/per610a/home/mvp/mvp_db/news7-lv/2008/2008_03_11_19_00/2008_03_11_19_00.mpg;Ichiro OZAWA.jpg;5161;5257;35961;258;262;4
/net/per610a/home/mvp/mvp_db/news7-lv/2008/2008_03_13_19_00/2008_03_13_19_00.mpg;Naoto KAN.jpg;16641;17369;35961;832;868;36
/net/per610a/home/mvp/mvp_db/news7-lv/2008/2008_03_14_19_00/2008_03_14_19_00.mpg;Yasuo FUKUDA.jpg;2077;2141;35961;103;107;4
/net/per610a/home/mvp/mvp_db/news7-lv/2008/2008_03_14_19_00/2008_03_14_19_00.mpg;Yasuo FUKUDA.jpg;3085;3717;35961;154;185;31
/net/per610a/home/mvp/mvp_db/news7-lv/2008/2008_03_14_19_00/2008_03_14_19_00.mpg;Yasuo FUKUDA.jpg;10593;11241;35961;529;562;33
/net/per610a/home/mvp/mvp_db/news7-lv/2008/2008_03_14_19_00/2008_03_14_19_00.mpg;Akihiro OHTA.jpg;11309;11861;35961;565;593;28
/net/per610a/home/mvp/mvp_db/news7-lv/2008/2008_03_15_19_00/2008_03_15_19_00.mpg;Sadakazu TANIGAKI.jpg;16025;16941;35961;801;847;46
/net/per610a/home/mvp/mvp_db/news7-lv/2008/2008_03_16_19_00/2008_03_16_19_00.mpg;Sadakazu TANIGAKI.jpg;12093;12577;35961;604;629;25
/net/per610a/home/mvp/mvp_db/news7-lv/2008/2008_03_16_19_00/2008_03_16_19_00.mpg;Sadakazu TANIGAKI.jpg;12653;13377;35961;632;669;37
/net/per610a/home/mvp/mvp_db/news7-lv/2008/2008_03_17_19_00/2008_03_17_19_00.mpg;Yukio HATOYAMA.jpg;3057;3445;35961;152;172;20
/net/per610a/home/mvp/mvp_db/news7-lv/2008/2008_03_21_19_00/2008_03_21_19_00.mpg;Yasuo FUKUDA.jpg;16017;16669;35961;801;833;32
/net/per610a/home/mvp/mvp_db/news7-lv/2008/2008_03_22_19_00/2008_03_22_19_00.mpg;Yasuo FUKUDA.jpg;15529;15929;35961;776;796;20
/net/per610a/home/mvp/mvp_db/news7-lv/2008/2008_03_24_19_00/2008_03_24_19_00.mpg;Yasuo FUKUDA.jpg;11613;11637;35957;581;582;1
/net/per610a/home/mvp/mvp_db/news7-lv/2008/2008_03_24_19_00/2008_03_24_19_00.mpg;Yasuo FUKUDA.jpg;11785;12293;35957;589;615;26
/net/per610a/home/mvp/mvp_db/news7-lv/2008/2008_03_24_19_00/2008_03_24_19_00.mpg;Shintaro ISHIHARA.jpg;20405;20921;35957;1020;1046;26
/net/per610a/home/mvp/mvp_db/news7-lv/2008/2008_03_24_19_00/2008_03_24_19_00.mpg;Shintaro ISHIHARA.jpg;21049;21209;35957;1053;1061;8
/net/per610a/home/mvp/mvp_db/news7-lv/2008/2008_03_24_19_00/2008_03_24_19_00.mpg;Shintaro ISHIHARA.jpg;21813;21985;35957;1091;1099;8
/net/per610a/home/mvp/mvp_db/news7-lv/2008/2008_03_24_19_00/2008_03_24_19_00.mpg;Shintaro ISHIHARA.jpg;24709;24809;35957;1236;1241;5
/net/per610a/home/mvp/mvp_db/news7-lv/2008/2008_03_26_19_00/2008_03_26_19_00.mpg;Shintaro ISHIHARA.jpg;313;437;35961;15;21;6
/net/per610a/home/mvp/mvp_db/news7-lv/2008/2008_03_26_19_00/2008_03_26_19_00.mpg;Shintaro ISHIHARA.jpg;17053;17213;35961;853;861;8
/net/per610a/home/mvp/mvp_db/news7-lv/2008/2008_03_26_19_00/2008_03_26_19_00.mpg;Shintaro ISHIHARA.jpg;17349;17621;35961;867;881;14
/net/per610a/home/mvp/mvp_db/news7-lv/2008/2008_03_26_19_00/2008_03_26_19_00.mpg;Shintaro ISHIHARA.jpg;18193;18237;35961;910;912;2
/net/per610a/home/mvp/mvp_db/news7-lv/2008/2008_03_26_19_00/2008_03_26_19_00.mpg;Yasuo FUKUDA.jpg;13577;13585;35961;679;679;0
/net/per610a/home/mvp/mvp_db/news7-lv/2008/2008_03_26_19_00/2008_03_26_19_00.mpg;Yasuo FUKUDA.jpg;13749;13797;35961;687;690;3
/net/per610a/home/mvp/mvp_db/news7-lv/2008/2008_03_26_19_00/2008_03_26_19_00.mpg;Yasuo FUKUDA.jpg;14117;14169;35961;706;708;2
/net/per610a/home/mvp/mvp_db/news7-lv/2008/2008_03_26_19_00/2008_03_26_19_00.mpg;Yasuo FUKUDA.jpg;13597;13625;35961;680;681;1
/net/per610a/home/mvp/mvp_db/news7-lv/2008/2008_03_26_19_00/2008_03_26_19_00.mpg;Yasuo FUKUDA.jpg;14773;15113;35961;739;756;17
/net/per610a/home/mvp/mvp_db/news7-lv/2008/2008_03_26_19_00/2008_03_26_19_00.mpg;Ichiro OZAWA.jpg;16041;16233;35961;802;812;10
/net/per610a/home/mvp/mvp_db/news7-lv/2008/2008_03_26_19_00/2008_03_26_19_00.mpg;Shintaro ISHIHARA.jpg;19077;19449;35961;954;972;18
/net/per610a/home/mvp/mvp_db/news7-lv/2008/2008_03_27_19_00/2008_03_27_19_00.mpg;Yasuo FUKUDA.jpg;1;481;35961;0;24;24
/net/per610a/home/mvp/mvp_db/news7-lv/2008/2008_03_27_19_00/2008_03_27_19_00.mpg;Yasuo FUKUDA.jpg;1181;1653;35961;59;82;23
/net/per610a/home/mvp/mvp_db/news7-lv/2008/2008_03_27_19_00/2008_03_27_19_00.mpg;Yasuo FUKUDA.jpg;1757;3029;35961;87;151;64
/net/per610a/home/mvp/mvp_db/news7-lv/2008/2008_03_27_19_00/2008_03_27_19_00.mpg;Yasuo FUKUDA.jpg;3109;4197;35961;155;209;54
/net/per610a/home/mvp/mvp_db/news7-lv/2008/2008_03_28_19_00/2008_03_28_19_00.mpg;Ichiro OZAWA.jpg;145;405;35961;7;20;13
/net/per610a/home/mvp/mvp_db/news7-lv/2008/2008_03_28_19_00/2008_03_28_19_00.mpg;Shintaro ISHIHARA.jpg;23753;23933;35961;1188;1197;9
/net/per610a/home/mvp/mvp_db/news7-lv/2008/2008_03_29_19_00/2008_03_29_19_00.mpg;Shintaro ISHIHARA.jpg;1993;2525;35961;99;126;27
/net/per610a/home/mvp/mvp_db/news7-lv/2008/2008_03_30_19_00/2008_03_30_19_00.mpg;Yasuo FUKUDA.jpg;49;165;35961;2;8;6
/net/per610a/home/mvp/mvp_db/news7-lv/2008/2008_03_30_19_00/2008_03_30_19_00.mpg;Yasuo FUKUDA.jpg;1425;1837;35961;71;91;20
/net/per610a/home/mvp/mvp_db/news7-lv/2008/2008_03_30_19_00/2008_03_30_19_00.mpg;Yasuo FUKUDA.jpg;2389;2477;35961;119;123;4
/net/per610a/home/mvp/mvp_db/news7-lv/2008/2008_03_30_19_00/2008_03_30_19_00.mpg;Yasuo FUKUDA.jpg;2569;2797;35961;128;139;11
/net/per610a/home/mvp/mvp_db/news7-lv/2008/2008_03_30_19_00/2008_03_30_19_00.mpg;Yasuo FUKUDA.jpg;2945;3325;35961;147;166;19
/net/per610a/home/mvp/mvp_db/news7-lv/2008/2008_03_30_19_00/2008_03_30_19_00.mpg;Yasuo FUKUDA.jpg;3413;3605;35961;170;180;10
/net/per610a/home/mvp/mvp_db/news7-lv/2008/2008_03_30_19_00/2008_03_30_19_00.mpg;Yasuo FUKUDA.jpg;3729;4437;35961;186;221;35
/net/per610a/home/mvp/mvp_db/news7-lv/2008/2008_03_31_19_00/2008_03_31_19_00.mpg;Yasuo FUKUDA.jpg;229;429;35961;11;21;10
/net/per610a/home/mvp/mvp_db/news7-lv/2008/2008_03_31_19_00/2008_03_31_19_00.mpg;Yasuo FUKUDA.jpg;1085;1605;35961;54;80;26
/net/per610a/home/mvp/mvp_db/news7-lv/2008/2008_03_31_19_00/2008_03_31_19_00.mpg;Yasuo FUKUDA.jpg;1729;5445;35961;86;272;186
/net/per610a/home/mvp/mvp_db/news7-lv/2008/2008_03_31_19_00/2008_03_31_19_00.mpg;Yasuo FUKUDA.jpg;12541;12605;35961;627;630;3
/net/per610a/home/mvp/mvp_db/news7-lv/2008/2008_03_31_19_00/2008_03_31_19_00.mpg;Akihiro OHTA.jpg;12617;12697;35961;631;635;4
/net/per610a/home/mvp/mvp_db/news7-lv/2008/2008_04_01_19_00/2008_04_01_19_00.mpg;Toru Hashimoto.jpg;2593;2693;35961;129;134;5
/net/per610a/home/mvp/mvp_db/news7-lv/2008/2008_04_01_19_00/2008_04_01_19_00.mpg;Ichiro OZAWA.jpg;18657;19161;35961;933;958;25
/net/per610a/home/mvp/mvp_db/news7-lv/2008/2008_04_01_19_00/2008_04_01_19_00.mpg;Ichiro OZAWA.jpg;19741;19889;35961;987;994;7
/net/per610a/home/mvp/mvp_db/news7-lv/2008/2008_04_04_19_00/2008_04_04_19_00.mpg;Yukio HATOYAMA.jpg;2889;3309;35961;144;165;21
/net/per610a/home/mvp/mvp_db/news7-lv/2008/2008_04_04_19_00/2008_04_04_19_00.mpg;Yasuo FUKUDA.jpg;8765;9097;35961;438;455;17
/net/per610a/home/mvp/mvp_db/news7-lv/2008/2008_04_04_19_00/2008_04_04_19_00.mpg;Toru Hashimoto.jpg;23881;24277;35961;1194;1214;20
/net/per610a/home/mvp/mvp_db/news7-lv/2008/2008_04_06_19_00/2008_04_06_19_00.mpg;Yasuo FUKUDA.jpg;18485;19553;35961;924;978;54
/net/per610a/home/mvp/mvp_db/news7-lv/2008/2008_04_06_19_00/2008_04_06_19_00.mpg;Ichiro OZAWA.jpg;19629;20429;35961;981;1021;40
/net/per610a/home/mvp/mvp_db/news7-lv/2008/2008_04_07_19_00/2008_04_07_19_00.mpg;Yasuo FUKUDA.jpg;1825;1845;35961;91;92;1
/net/per610a/home/mvp/mvp_db/news7-lv/2008/2008_04_07_19_00/2008_04_07_19_00.mpg;Yasuo FUKUDA.jpg;3785;4433;35961;189;221;32
/net/per610a/home/mvp/mvp_db/news7-lv/2008/2008_04_07_19_00/2008_04_07_19_00.mpg;Ichiro OZAWA.jpg;6861;7241;35961;343;362;19
/net/per610a/home/mvp/mvp_db/news7-lv/2008/2008_04_09_19_00/2008_04_09_19_00.mpg;Seiji MAEHARA.jpg;11545;11857;35961;577;593;16
/net/per610a/home/mvp/mvp_db/news7-lv/2008/2008_04_09_19_00/2008_04_09_19_00.mpg;Yukio HATOYAMA.jpg;11873;13249;35961;593;662;69
/net/per610a/home/mvp/mvp_db/news7-lv/2008/2008_04_11_19_00/2008_04_11_19_00.mpg;Yasuo FUKUDA.jpg;15713;16097;35961;786;805;19
/net/per610a/home/mvp/mvp_db/news7-lv/2008/2008_04_11_19_00/2008_04_11_19_00.mpg;Yasuo FUKUDA.jpg;16225;16593;35961;811;830;19
/net/per610a/home/mvp/mvp_db/news7-lv/2008/2008_04_11_19_00/2008_04_11_19_00.mpg;Yasuo FUKUDA.jpg;19001;19449;35961;950;972;22
/net/per610a/home/mvp/mvp_db/news7-lv/2008/2008_04_11_19_00/2008_04_11_19_00.mpg;Yukio HATOYAMA.jpg;18385;18953;35961;919;948;29
/net/per610a/home/mvp/mvp_db/news7-lv/2008/2008_04_11_19_00/2008_04_11_19_00.mpg;Yukio HATOYAMA.jpg;24829;25185;35961;1242;1259;17
/net/per610a/home/mvp/mvp_db/news7-lv/2008/2008_04_12_19_00/2008_04_12_19_00.mpg;Yasuo FUKUDA.jpg;26849;26877;35961;1343;1344;1
/net/per610a/home/mvp/mvp_db/news7-lv/2008/2008_04_12_19_00/2008_04_12_19_00.mpg;Yasuo FUKUDA.jpg;26977;27341;35961;1349;1367;18
/net/per610a/home/mvp/mvp_db/news7-lv/2008/2008_04_14_19_00/2008_04_14_19_00.mpg;Yukio HATOYAMA.jpg;1637;4121;35957;81;206;125
/net/per610a/home/mvp/mvp_db/news7-lv/2008/2008_04_14_19_00/2008_04_14_19_00.mpg;Yasuo FUKUDA.jpg;14489;14765;35957;724;738;14
/net/per610a/home/mvp/mvp_db/news7-lv/2008/2008_04_15_19_00/2008_04_15_19_00.mpg;Akihiro OHTA.jpg;10561;10857;35961;528;543;15
/net/per610a/home/mvp/mvp_db/news7-lv/2008/2008_04_15_19_00/2008_04_15_19_00.mpg;Natsuo YAMAGUCHI.jpg;19377;19533;35961;969;977;8
/net/per610a/home/mvp/mvp_db/news7-lv/2008/2008_04_16_19_00/2008_04_16_19_00.mpg;Yasuo FUKUDA.jpg;14521;14897;35957;726;745;19
/net/per610a/home/mvp/mvp_db/news7-lv/2008/2008_04_16_19_00/2008_04_16_19_00.mpg;Junichiro KOIZUMI.jpg;18981;19817;35957;949;991;42
/net/per610a/home/mvp/mvp_db/news7-lv/2008/2008_04_19_19_00/2008_04_19_19_00.mpg;Ichiro OZAWA.jpg;9701;10961;35961;485;548;63
/net/per610a/home/mvp/mvp_db/news7-lv/2008/2008_04_21_19_00/2008_04_21_19_00.mpg;Takenori KANZAKI.jpg;449;557;35961;22;27;5
/net/per610a/home/mvp/mvp_db/news7-lv/2008/2008_04_21_19_00/2008_04_21_19_00.mpg;Takenori KANZAKI.jpg;14185;14325;35961;709;716;7
/net/per610a/home/mvp/mvp_db/news7-lv/2008/2008_04_21_19_00/2008_04_21_19_00.mpg;Takenori KANZAKI.jpg;15917;16265;35961;796;813;17
/net/per610a/home/mvp/mvp_db/news7-lv/2008/2008_04_21_19_00/2008_04_21_19_00.mpg;Yasuo FUKUDA.jpg;7525;7913;35961;376;395;19
/net/per610a/home/mvp/mvp_db/news7-lv/2008/2008_04_21_19_00/2008_04_21_19_00.mpg;Yasuo FUKUDA.jpg;8745;8825;35961;437;441;4
/net/per610a/home/mvp/mvp_db/news7-lv/2008/2008_04_21_19_00/2008_04_21_19_00.mpg;Yasuo FUKUDA.jpg;9933;9961;35961;496;498;2
/net/per610a/home/mvp/mvp_db/news7-lv/2008/2008_04_21_19_00/2008_04_21_19_00.mpg;Yasuo FUKUDA.jpg;11737;11809;35961;587;590;3
/net/per610a/home/mvp/mvp_db/news7-lv/2008/2008_04_25_19_00/2008_04_25_19_00.mpg;Shintaro ISHIHARA.jpg;10201;10289;35957;510;514;4
/net/per610a/home/mvp/mvp_db/news7-lv/2008/2008_04_25_19_00/2008_04_25_19_00.mpg;Shintaro ISHIHARA.jpg;10377;10833;35957;519;541;22
/net/per610a/home/mvp/mvp_db/news7-lv/2008/2008_04_26_19_00/2008_04_26_19_00.mpg;Yasuo FUKUDA.jpg;22009;22157;35961;1101;1108;7
/net/per610a/home/mvp/mvp_db/news7-lv/2008/2008_04_26_19_00/2008_04_26_19_00.mpg;Yasuo FUKUDA.jpg;22253;22261;35961;1113;1113;0
/net/per610a/home/mvp/mvp_db/news7-lv/2008/2008_04_26_19_00/2008_04_26_19_00.mpg;Yasuo FUKUDA.jpg;23105;23637;35961;1155;1182;27
/net/per610a/home/mvp/mvp_db/news7-lv/2008/2008_04_26_19_00/2008_04_26_19_00.mpg;Yasuo FUKUDA.jpg;24393;25149;35961;1220;1258;38
/net/per610a/home/mvp/mvp_db/news7-lv/2008/2008_04_26_19_00/2008_04_26_19_00.mpg;Ichiro OZAWA.jpg;26477;27521;35961;1324;1376;52
/net/per610a/home/mvp/mvp_db/news7-lv/2008/2008_04_27_19_00/2008_04_27_19_00.mpg;Natsuo YAMAGUCHI.jpg;10501;10909;35961;525;545;20
/net/per610a/home/mvp/mvp_db/news7-lv/2008/2008_04_28_19_00/2008_04_28_19_00.mpg;Ichiro OZAWA.jpg;6365;7125;35961;318;356;38
/net/per610a/home/mvp/mvp_db/news7-lv/2008/2008_04_28_19_00/2008_04_28_19_00.mpg;Yasuo FUKUDA.jpg;8365;9125;35961;418;456;38
/net/per610a/home/mvp/mvp_db/news7-lv/2008/2008_04_30_19_00/2008_04_30_19_00.mpg;Yasuo FUKUDA.jpg;345;509;35961;17;25;8
/net/per610a/home/mvp/mvp_db/news7-lv/2008/2008_04_30_19_00/2008_04_30_19_00.mpg;Yasuo FUKUDA.jpg;1309;1721;35961;65;86;21
/net/per610a/home/mvp/mvp_db/news7-lv/2008/2008_04_30_19_00/2008_04_30_19_00.mpg;Yasuo FUKUDA.jpg;4581;4661;35961;229;233;4
/net/per610a/home/mvp/mvp_db/news7-lv/2008/2008_04_30_19_00/2008_04_30_19_00.mpg;Yasuo FUKUDA.jpg;4989;5213;35961;249;260;11
/net/per610a/home/mvp/mvp_db/news7-lv/2008/2008_04_30_19_00/2008_04_30_19_00.mpg;Yasuo FUKUDA.jpg;9925;10185;35961;496;509;13
/net/per610a/home/mvp/mvp_db/news7-lv/2008/2008_04_30_19_00/2008_04_30_19_00.mpg;Yasuo FUKUDA.jpg;1785;1929;35961;89;96;7
/net/per610a/home/mvp/mvp_db/news7-lv/2008/2008_04_30_19_00/2008_04_30_19_00.mpg;Naoto KAN.jpg;1989;2109;35961;99;105;6
/net/per610a/home/mvp/mvp_db/news7-lv/2008/2008_04_30_19_00/2008_04_30_19_00.mpg;Yasuo FUKUDA.jpg;5341;5449;35961;267;272;5
/net/per610a/home/mvp/mvp_db/news7-lv/2008/2008_04_30_19_00/2008_04_30_19_00.mpg;Yasuo FUKUDA.jpg;11381;11629;35961;569;581;12
/net/per610a/home/mvp/mvp_db/news7-lv/2008/2008_05_02_19_00/2008_05_02_19_00.mpg;Yasuo FUKUDA.jpg;18381;18473;35961;919;924;5
/net/per610a/home/mvp/mvp_db/news7-lv/2008/2008_05_02_19_00/2008_05_02_19_00.mpg;Yasuo FUKUDA.jpg;18757;19253;35961;938;963;25
/net/per610a/home/mvp/mvp_db/news7-lv/2008/2008_05_02_19_00/2008_05_02_19_00.mpg;Yasuo FUKUDA.jpg;20473;20537;35961;1024;1027;3
/net/per610a/home/mvp/mvp_db/news7-lv/2008/2008_05_06_19_00/2008_05_06_19_00.mpg;Yasuo FUKUDA.jpg;7093;7333;35953;354;366;12
/net/per610a/home/mvp/mvp_db/news7-lv/2008/2008_05_06_19_00/2008_05_06_19_00.mpg;Yukio HATOYAMA.jpg;21037;21193;35953;1052;1060;8
/net/per610a/home/mvp/mvp_db/news7-lv/2008/2008_05_06_19_00/2008_05_06_19_00.mpg;Yukio HATOYAMA.jpg;21953;22385;35953;1098;1120;22
/net/per610a/home/mvp/mvp_db/news7-lv/2008/2008_05_07_19_00/2008_05_07_19_00.mpg;Yasuo FUKUDA.jpg;45;341;35957;2;17;15
/net/per610a/home/mvp/mvp_db/news7-lv/2008/2008_05_07_19_00/2008_05_07_19_00.mpg;Yasuo FUKUDA.jpg;3605;4201;35957;180;210;30
/net/per610a/home/mvp/mvp_db/news7-lv/2008/2008_05_07_19_00/2008_05_07_19_00.mpg;Yasuo FUKUDA.jpg;7725;8201;35957;386;410;24
/net/per610a/home/mvp/mvp_db/news7-lv/2008/2008_05_07_19_00/2008_05_07_19_00.mpg;Yasuo FUKUDA.jpg;9137;9357;35957;457;468;11
/net/per610a/home/mvp/mvp_db/news7-lv/2008/2008_05_07_19_00/2008_05_07_19_00.mpg;Yasuo FUKUDA.jpg;11777;11777;35957;589;589;0
/net/per610a/home/mvp/mvp_db/news7-lv/2008/2008_05_07_19_00/2008_05_07_19_00.mpg;Yasuo FUKUDA.jpg;12461;12709;35957;623;635;12
/net/per610a/home/mvp/mvp_db/news7-lv/2008/2008_05_07_19_00/2008_05_07_19_00.mpg;Yasuo FUKUDA.jpg;13853;14005;35957;693;700;7
/net/per610a/home/mvp/mvp_db/news7-lv/2008/2008_05_08_19_00/2008_05_08_19_00.mpg;Yasuo FUKUDA.jpg;2525;2921;35961;126;146;20
/net/per610a/home/mvp/mvp_db/news7-lv/2008/2008_05_08_19_00/2008_05_08_19_00.mpg;Yasuo FUKUDA.jpg;6789;7245;35961;339;362;23
/net/per610a/home/mvp/mvp_db/news7-lv/2008/2008_05_12_19_00/2008_05_12_19_00.mpg;Yasuo FUKUDA.jpg;14677;15077;35961;734;754;20
/net/per610a/home/mvp/mvp_db/news7-lv/2008/2008_05_12_19_00/2008_05_12_19_00.mpg;Yasuo FUKUDA.jpg;18557;18941;35961;928;947;19
/net/per610a/home/mvp/mvp_db/news7-lv/2008/2008_05_13_19_00/2008_05_13_19_00.mpg;Yasuo FUKUDA.jpg;20501;20729;35961;1025;1036;11
/net/per610a/home/mvp/mvp_db/news7-lv/2008/2008_05_13_19_00/2008_05_13_19_00.mpg;Yasuo FUKUDA.jpg;21013;21013;35961;1051;1051;0
/net/per610a/home/mvp/mvp_db/news7-lv/2008/2008_05_13_19_00/2008_05_13_19_00.mpg;Yasuo FUKUDA.jpg;21397;21953;35961;1070;1098;28
/net/per610a/home/mvp/mvp_db/news7-lv/2008/2008_05_13_19_00/2008_05_13_19_00.mpg;Yasuo FUKUDA.jpg;24565;25205;35961;1228;1260;32
/net/per610a/home/mvp/mvp_db/news7-lv/2008/2008_05_15_19_00/2008_05_15_19_00.mpg;Yasuo FUKUDA.jpg;13213;13637;35961;660;682;22
/net/per610a/home/mvp/mvp_db/news7-lv/2008/2008_05_17_19_00/2008_05_17_19_00.mpg;Akihiro OHTA.jpg;18189;18701;35957;910;935;25
/net/per610a/home/mvp/mvp_db/news7-lv/2008/2008_05_17_19_00/2008_05_17_19_00.mpg;Akihiro OHTA.jpg;18873;19589;35957;944;980;36
/net/per610a/home/mvp/mvp_db/news7-lv/2008/2008_05_18_19_00/2008_05_18_19_00.mpg;Yasuo FUKUDA.jpg;20921;21157;35957;1046;1058;12
/net/per610a/home/mvp/mvp_db/news7-lv/2008/2008_05_20_19_00/2008_05_20_19_00.mpg;Yasuo FUKUDA.jpg;11081;11629;35961;554;581;27
/net/per610a/home/mvp/mvp_db/news7-lv/2008/2008_05_20_19_00/2008_05_20_19_00.mpg;Yasuo FUKUDA.jpg;13853;13893;35961;693;695;2
/net/per610a/home/mvp/mvp_db/news7-lv/2008/2008_05_20_19_00/2008_05_20_19_00.mpg;Yasuo FUKUDA.jpg;14533;14881;35961;727;744;17
/net/per610a/home/mvp/mvp_db/news7-lv/2008/2008_05_20_19_00/2008_05_20_19_00.mpg;Ichiro OZAWA.jpg;14917;15813;35961;746;791;45
/net/per610a/home/mvp/mvp_db/news7-lv/2008/2008_05_22_19_00/2008_05_22_19_00.mpg;Yasuo FUKUDA.jpg;18857;19365;35957;943;968;25
/net/per610a/home/mvp/mvp_db/news7-lv/2008/2008_05_22_19_00/2008_05_22_19_00.mpg;Yasuo FUKUDA.jpg;26825;27105;35957;1342;1356;14
/net/per610a/home/mvp/mvp_db/news7-lv/2008/2008_05_23_19_00/2008_05_23_19_00.mpg;Yukio HATOYAMA.jpg;321;649;35961;16;32;16
/net/per610a/home/mvp/mvp_db/news7-lv/2008/2008_05_23_19_00/2008_05_23_19_00.mpg;Yukio HATOYAMA.jpg;7801;8529;35961;390;426;36
/net/per610a/home/mvp/mvp_db/news7-lv/2008/2008_05_23_19_00/2008_05_23_19_00.mpg;Yasuo FUKUDA.jpg;10033;10469;35961;501;523;22
/net/per610a/home/mvp/mvp_db/news7-lv/2008/2008_05_23_19_00/2008_05_23_19_00.mpg;Ichiro OZAWA.jpg;13609;14129;35961;680;706;26
/net/per610a/home/mvp/mvp_db/news7-lv/2008/2008_05_27_19_00/2008_05_27_19_00.mpg;Yasuo FUKUDA.jpg;433;457;35957;21;22;1
/net/per610a/home/mvp/mvp_db/news7-lv/2008/2008_05_27_19_00/2008_05_27_19_00.mpg;Yasuo FUKUDA.jpg;9505;9549;35957;475;477;2
/net/per610a/home/mvp/mvp_db/news7-lv/2008/2008_05_27_19_00/2008_05_27_19_00.mpg;Yasuo FUKUDA.jpg;9613;9681;35957;480;484;4
/net/per610a/home/mvp/mvp_db/news7-lv/2008/2008_05_28_19_00/2008_05_28_19_00.mpg;Yasuo FUKUDA.jpg;3773;3841;35961;188;192;4
/net/per610a/home/mvp/mvp_db/news7-lv/2008/2008_05_28_19_00/2008_05_28_19_00.mpg;Yasuo FUKUDA.jpg;9113;9301;35961;455;465;10
/net/per610a/home/mvp/mvp_db/news7-lv/2008/2008_05_28_19_00/2008_05_28_19_00.mpg;Yasuo FUKUDA.jpg;11425;11541;35961;571;577;6
/net/per610a/home/mvp/mvp_db/news7-lv/2008/2008_05_28_19_00/2008_05_28_19_00.mpg;Yasuo FUKUDA.jpg;11877;11901;35961;594;595;1
/net/per610a/home/mvp/mvp_db/news7-lv/2008/2008_05_28_19_00/2008_05_28_19_00.mpg;Yoshimi WATANABE.jpg;23321;23673;35961;1166;1184;18
/net/per610a/home/mvp/mvp_db/news7-lv/2008/2008_05_28_19_00/2008_05_28_19_00.mpg;Yukio HATOYAMA.jpg;23789;23981;35961;1190;1199;9
/net/per610a/home/mvp/mvp_db/news7-lv/2008/2008_05_28_19_00/2008_05_28_19_00.mpg;Yukio HATOYAMA.jpg;24397;24437;35961;1220;1222;2
/net/per610a/home/mvp/mvp_db/news7-lv/2008/2008_05_31_19_00/2008_05_31_19_00.mpg;Yasuo FUKUDA.jpg;24213;24569;35961;1211;1229;18
/net/per610a/home/mvp/mvp_db/news7-lv/2008/2008_06_02_19_00/2008_06_02_19_00.mpg;Yasuo FUKUDA.jpg;26589;26893;35961;1330;1345;15
/net/per610a/home/mvp/mvp_db/news7-lv/2008/2008_06_02_19_00/2008_06_02_19_00.mpg;Yasuo FUKUDA.jpg;26977;27545;35961;1349;1377;28
/net/per610a/home/mvp/mvp_db/news7-lv/2008/2008_06_02_19_00/2008_06_02_19_00.mpg;Yasuo FUKUDA.jpg;27633;28313;35961;1382;1416;34
/net/per610a/home/mvp/mvp_db/news7-lv/2008/2008_06_05_19_00/2008_06_05_19_00.mpg;Renho.jpg;2173;2873;35961;108;143;35
/net/per610a/home/mvp/mvp_db/news7-lv/2008/2008_06_05_19_00/2008_06_05_19_00.mpg;Yukio HATOYAMA.jpg;2965;3093;35961;148;154;6
/net/per610a/home/mvp/mvp_db/news7-lv/2008/2008_06_05_19_00/2008_06_05_19_00.mpg;Ichiro OZAWA.jpg;3401;4249;35961;170;212;42
/net/per610a/home/mvp/mvp_db/news7-lv/2008/2008_06_05_19_00/2008_06_05_19_00.mpg;Toru Hashimoto.jpg;15325;15917;35961;766;796;30
/net/per610a/home/mvp/mvp_db/news7-lv/2008/2008_06_05_19_00/2008_06_05_19_00.mpg;Toru Hashimoto.jpg;16001;16461;35961;800;823;23
/net/per610a/home/mvp/mvp_db/news7-lv/2008/2008_06_05_19_00/2008_06_05_19_00.mpg;Toru Hashimoto.jpg;16877;16877;35961;844;844;0
/net/per610a/home/mvp/mvp_db/news7-lv/2008/2008_06_05_19_00/2008_06_05_19_00.mpg;Toru Hashimoto.jpg;17109;17125;35961;855;856;1
/net/per610a/home/mvp/mvp_db/news7-lv/2008/2008_06_05_19_00/2008_06_05_19_00.mpg;Toru Hashimoto.jpg;17557;18057;35961;878;903;25
/net/per610a/home/mvp/mvp_db/news7-lv/2008/2008_06_05_19_00/2008_06_05_19_00.mpg;Toru Hashimoto.jpg;18853;19505;35961;943;975;32
/net/per610a/home/mvp/mvp_db/news7-lv/2008/2008_06_05_19_00/2008_06_05_19_00.mpg;Shintaro ISHIHARA.jpg;23889;24081;35961;1195;1204;9
/net/per610a/home/mvp/mvp_db/news7-lv/2008/2008_06_05_19_00/2008_06_05_19_00.mpg;Shintaro ISHIHARA.jpg;25465;25749;35961;1273;1288;15
/net/per610a/home/mvp/mvp_db/news7-lv/2008/2008_06_05_19_00/2008_06_05_19_00.mpg;Shintaro ISHIHARA.jpg;26789;27041;35961;1340;1352;12
/net/per610a/home/mvp/mvp_db/news7-lv/2008/2008_06_05_19_00/2008_06_05_19_00.mpg;Shintaro ISHIHARA.jpg;27957;28465;35961;1398;1424;26
/net/per610a/home/mvp/mvp_db/news7-lv/2008/2008_06_06_19_00/2008_06_06_19_00.mpg;Yukio HATOYAMA.jpg;16433;16769;35961;822;838;16
/net/per610a/home/mvp/mvp_db/news7-lv/2008/2008_06_07_19_00/2008_06_07_19_00.mpg;Ichiro OZAWA.jpg;1;145;35961;0;7;7
/net/per610a/home/mvp/mvp_db/news7-lv/2008/2008_06_07_19_00/2008_06_07_19_00.mpg;Ichiro OZAWA.jpg;2497;2845;35961;124;142;18
/net/per610a/home/mvp/mvp_db/news7-lv/2008/2008_06_09_19_00/2008_06_09_19_00.mpg;Yasuo FUKUDA.jpg;24197;24693;35961;1210;1235;25
/net/per610a/home/mvp/mvp_db/news7-lv/2008/2008_06_09_19_00/2008_06_09_19_00.mpg;Yasuo FUKUDA.jpg;24797;25033;35961;1240;1252;12
/net/per610a/home/mvp/mvp_db/news7-lv/2008/2008_06_09_19_00/2008_06_09_19_00.mpg;Yasuo FUKUDA.jpg;29317;29589;35961;1466;1480;14
/net/per610a/home/mvp/mvp_db/news7-lv/2008/2008_06_10_19_00/2008_06_10_19_00.mpg;Yasuo FUKUDA.jpg;12185;12673;35961;609;633;24
/net/per610a/home/mvp/mvp_db/news7-lv/2008/2008_06_10_19_00/2008_06_10_19_00.mpg;Yasuo FUKUDA.jpg;15097;15157;35961;755;758;3
/net/per610a/home/mvp/mvp_db/news7-lv/2008/2008_06_10_19_00/2008_06_10_19_00.mpg;Yasuo FUKUDA.jpg;15441;15509;35961;772;775;3
/net/per610a/home/mvp/mvp_db/news7-lv/2008/2008_06_10_19_00/2008_06_10_19_00.mpg;Yasuo FUKUDA.jpg;16005;16345;35961;800;817;17
/net/per610a/home/mvp/mvp_db/news7-lv/2008/2008_06_11_19_00/2008_06_11_19_00.mpg;Yasuo FUKUDA.jpg;1933;2173;35961;96;108;12
/net/per610a/home/mvp/mvp_db/news7-lv/2008/2008_06_11_19_00/2008_06_11_19_00.mpg;Yasuo FUKUDA.jpg;2561;2637;35961;128;131;3
/net/per610a/home/mvp/mvp_db/news7-lv/2008/2008_06_11_19_00/2008_06_11_19_00.mpg;Yasuo FUKUDA.jpg;3225;3373;35961;161;168;7
/net/per610a/home/mvp/mvp_db/news7-lv/2008/2008_06_11_19_00/2008_06_11_19_00.mpg;Yasuo FUKUDA.jpg;3569;3621;35961;178;181;3
/net/per610a/home/mvp/mvp_db/news7-lv/2008/2008_06_11_19_00/2008_06_11_19_00.mpg;Yasuo FUKUDA.jpg;3673;4005;35961;183;200;17
/net/per610a/home/mvp/mvp_db/news7-lv/2008/2008_06_11_19_00/2008_06_11_19_00.mpg;Yasuo FUKUDA.jpg;6145;6185;35961;307;309;2
/net/per610a/home/mvp/mvp_db/news7-lv/2008/2008_06_11_19_00/2008_06_11_19_00.mpg;Ichiro OZAWA.jpg;4461;6093;35961;223;304;81
/net/per610a/home/mvp/mvp_db/news7-lv/2008/2008_06_11_19_00/2008_06_11_19_00.mpg;Ichiro OZAWA.jpg;7621;7669;35961;381;383;2
/net/per610a/home/mvp/mvp_db/news7-lv/2008/2008_06_11_19_00/2008_06_11_19_00.mpg;Ichiro OZAWA.jpg;8285;8353;35961;414;417;3
/net/per610a/home/mvp/mvp_db/news7-lv/2008/2008_06_12_19_00/2008_06_12_19_00.mpg;Yasuo FUKUDA.jpg;26693;27993;35961;1335;1400;65
/net/per610a/home/mvp/mvp_db/news7-lv/2008/2008_06_13_19_00/2008_06_13_19_00.mpg;Yasuo FUKUDA.jpg;27825;28125;35961;1391;1406;15
/net/per610a/home/mvp/mvp_db/news7-lv/2008/2008_06_18_19_00/2008_06_18_19_00.mpg;Yasuo FUKUDA.jpg;20005;20049;35961;1000;1002;2
/net/per610a/home/mvp/mvp_db/news7-lv/2008/2008_06_18_19_00/2008_06_18_19_00.mpg;Yasuo FUKUDA.jpg;20125;20377;35961;1006;1019;13
/net/per610a/home/mvp/mvp_db/news7-lv/2008/2008_06_18_19_00/2008_06_18_19_00.mpg;Yasuo FUKUDA.jpg;24105;24573;35961;1205;1229;24
/net/per610a/home/mvp/mvp_db/news7-lv/2008/2008_06_20_19_00/2008_06_20_19_00.mpg;Yasuo FUKUDA.jpg;133;497;35961;6;24;18
/net/per610a/home/mvp/mvp_db/news7-lv/2008/2008_06_20_19_00/2008_06_20_19_00.mpg;Yasuo FUKUDA.jpg;11553;12385;35961;577;619;42
/net/per610a/home/mvp/mvp_db/news7-lv/2008/2008_06_20_19_00/2008_06_20_19_00.mpg;Yasuo FUKUDA.jpg;12469;12589;35961;623;629;6
/net/per610a/home/mvp/mvp_db/news7-lv/2008/2008_06_20_19_00/2008_06_20_19_00.mpg;Ichiro OZAWA.jpg;9925;10237;35961;496;512;16
/net/per610a/home/mvp/mvp_db/news7-lv/2008/2008_06_20_19_00/2008_06_20_19_00.mpg;Ichiro OZAWA.jpg;12213;12385;35961;610;619;9
/net/per610a/home/mvp/mvp_db/news7-lv/2008/2008_06_20_19_00/2008_06_20_19_00.mpg;Ichiro OZAWA.jpg;10877;11501;35961;544;575;31
/net/per610a/home/mvp/mvp_db/news7-lv/2008/2008_06_20_19_00/2008_06_20_19_00.mpg;Ichiro OZAWA.jpg;13209;13517;35961;660;676;16
/net/per610a/home/mvp/mvp_db/news7-lv/2008/2008_06_20_19_00/2008_06_20_19_00.mpg;Yukio HATOYAMA.jpg;15157;15529;35961;758;776;18
/net/per610a/home/mvp/mvp_db/news7-lv/2008/2008_06_20_19_00/2008_06_20_19_00.mpg;Yasuo FUKUDA.jpg;16381;16701;35961;819;835;16
/net/per610a/home/mvp/mvp_db/news7-lv/2008/2008_06_20_19_00/2008_06_20_19_00.mpg;Yasuo FUKUDA.jpg;16901;16913;35961;845;846;1
/net/per610a/home/mvp/mvp_db/news7-lv/2008/2008_06_23_19_00/2008_06_23_19_00.mpg;Yasuo FUKUDA.jpg;18221;18657;35961;911;933;22
/net/per610a/home/mvp/mvp_db/news7-lv/2008/2008_06_23_19_00/2008_06_23_19_00.mpg;Yasuo FUKUDA.jpg;18737;21457;35961;937;1073;136
/net/per610a/home/mvp/mvp_db/news7-lv/2008/2008_06_24_19_00/2008_06_24_19_00.mpg;Yasuo FUKUDA.jpg;24485;24985;35961;1224;1249;25
/net/per610a/home/mvp/mvp_db/news7-lv/2008/2008_06_25_19_00/2008_06_25_19_00.mpg;Yasuo FUKUDA.jpg;11369;11729;35961;568;586;18
/net/per610a/home/mvp/mvp_db/news7-lv/2008/2008_06_26_19_00/2008_06_26_19_00.mpg;Yasuo FUKUDA.jpg;3449;4929;35961;172;246;74
/net/per610a/home/mvp/mvp_db/news7-lv/2008/2008_06_26_19_00/2008_06_26_19_00.mpg;Yasuo FUKUDA.jpg;9341;9489;35961;467;474;7
/net/per610a/home/mvp/mvp_db/news7-lv/2008/2008_06_28_19_00/2008_06_28_19_00.mpg;Ichiro OZAWA.jpg;28065;28293;35961;1403;1415;12
/net/per610a/home/mvp/mvp_db/news7-lv/2008/2008_07_01_19_00/2008_07_01_19_00.mpg;Ichiro OZAWA.jpg;13601;14557;35961;680;728;48
/net/per610a/home/mvp/mvp_db/news7-lv/2008/2008_07_03_19_00/2008_07_03_19_00.mpg;Yukio HATOYAMA.jpg;3285;3777;35961;164;188;24
/net/per610a/home/mvp/mvp_db/news7-lv/2008/2008_07_06_19_00/2008_07_06_19_00.mpg;Yasuo FUKUDA.jpg;5797;5957;35961;290;298;8
/net/per610a/home/mvp/mvp_db/news7-lv/2008/2008_07_06_19_00/2008_07_06_19_00.mpg;Yasuo FUKUDA.jpg;9245;9289;35961;462;464;2
/net/per610a/home/mvp/mvp_db/news7-lv/2008/2008_07_06_19_00/2008_07_06_19_00.mpg;Yasuo FUKUDA.jpg;10861;11033;35961;543;551;8
/net/per610a/home/mvp/mvp_db/news7-lv/2008/2008_07_07_19_00/2008_07_07_19_00.mpg;Yasuo FUKUDA.jpg;1;13;35961;0;0;0
/net/per610a/home/mvp/mvp_db/news7-lv/2008/2008_07_07_19_00/2008_07_07_19_00.mpg;Yasuo FUKUDA.jpg;4301;4393;35961;215;219;4
/net/per610a/home/mvp/mvp_db/news7-lv/2008/2008_07_07_19_00/2008_07_07_19_00.mpg;Yasuo FUKUDA.jpg;11353;11369;35961;567;568;1
/net/per610a/home/mvp/mvp_db/news7-lv/2008/2008_07_07_19_00/2008_07_07_19_00.mpg;Yasuo FUKUDA.jpg;10589;10589;35961;529;529;0
/net/per610a/home/mvp/mvp_db/news7-lv/2008/2008_07_07_19_00/2008_07_07_19_00.mpg;Yasuo FUKUDA.jpg;10689;10689;35961;534;534;0
/net/per610a/home/mvp/mvp_db/news7-lv/2008/2008_07_07_19_00/2008_07_07_19_00.mpg;Yasuo FUKUDA.jpg;10821;10821;35961;541;541;0
/net/per610a/home/mvp/mvp_db/news7-lv/2008/2008_07_07_19_00/2008_07_07_19_00.mpg;Yasuo FUKUDA.jpg;12117;12169;35961;606;608;2
/net/per610a/home/mvp/mvp_db/news7-lv/2008/2008_07_07_19_00/2008_07_07_19_00.mpg;Yasuo FUKUDA.jpg;18185;18505;35961;909;925;16
/net/per610a/home/mvp/mvp_db/news7-lv/2008/2008_07_07_19_00/2008_07_07_19_00.mpg;Yasuo FUKUDA.jpg;19941;20177;35961;997;1009;12
/net/per610a/home/mvp/mvp_db/news7-lv/2008/2008_07_07_19_00/2008_07_07_19_00.mpg;Yasuo FUKUDA.jpg;34277;34529;35961;1714;1727;13
/net/per610a/home/mvp/mvp_db/news7-lv/2008/2008_07_07_19_00/2008_07_07_19_00.mpg;Junichiro KOIZUMI.jpg;11213;11297;35961;560;565;5
/net/per610a/home/mvp/mvp_db/news7-lv/2008/2008_07_08_19_00/2008_07_08_19_00.mpg;Yasuo FUKUDA.jpg;8781;8833;35961;439;441;2
/net/per610a/home/mvp/mvp_db/news7-lv/2008/2008_07_08_19_00/2008_07_08_19_00.mpg;Yasuo FUKUDA.jpg;11137;11489;35961;557;574;17
/net/per610a/home/mvp/mvp_db/news7-lv/2008/2008_07_09_19_00/2008_07_09_19_00.mpg;Yasuo FUKUDA.jpg;5045;5105;35961;252;255;3
/net/per610a/home/mvp/mvp_db/news7-lv/2008/2008_07_09_19_00/2008_07_09_19_00.mpg;Yasuo FUKUDA.jpg;10813;11201;35961;540;560;20
/net/per610a/home/mvp/mvp_db/news7-lv/2008/2008_07_09_19_00/2008_07_09_19_00.mpg;Yasuo FUKUDA.jpg;12857;13077;35961;643;654;11
/net/per610a/home/mvp/mvp_db/news7-lv/2008/2008_07_10_19_00/2008_07_10_19_00.mpg;Yasuo FUKUDA.jpg;16785;17153;35961;839;858;19
/net/per610a/home/mvp/mvp_db/news7-lv/2008/2008_07_14_19_00/2008_07_14_19_00.mpg;Yasuo FUKUDA.jpg;7705;8037;35961;385;402;17
/net/per610a/home/mvp/mvp_db/news7-lv/2008/2008_07_14_19_00/2008_07_14_19_00.mpg;Yasuo FUKUDA.jpg;21045;21389;35961;1052;1070;18
/net/per610a/home/mvp/mvp_db/news7-lv/2008/2008_07_14_19_00/2008_07_14_19_00.mpg;Yasuo FUKUDA.jpg;22729;22789;35961;1137;1140;3
/net/per610a/home/mvp/mvp_db/news7-lv/2008/2008_07_14_19_00/2008_07_14_19_00.mpg;Yasuo FUKUDA.jpg;23949;24045;35961;1198;1202;4
/net/per610a/home/mvp/mvp_db/news7-lv/2008/2008_07_14_19_00/2008_07_14_19_00.mpg;Ichiro OZAWA.jpg;23333;23561;35961;1167;1178;11
/net/per610a/home/mvp/mvp_db/news7-lv/2008/2008_07_16_19_00/2008_07_16_19_00.mpg;Yasuo FUKUDA.jpg;26317;26677;35961;1316;1334;18
/net/per610a/home/mvp/mvp_db/news7-lv/2008/2008_07_23_19_00/2008_07_23_19_00.mpg;Shintaro ISHIHARA.jpg;26841;27097;35961;1342;1355;13
/net/per610a/home/mvp/mvp_db/news7-lv/2008/2008_07_24_19_00/2008_07_24_19_00.mpg;Toru Hashimoto.jpg;10869;11389;35961;543;569;26
/net/per610a/home/mvp/mvp_db/news7-lv/2008/2008_07_28_19_00/2008_07_28_19_00.mpg;Yasuo FUKUDA.jpg;32313;32705;35961;1616;1636;20
/net/per610a/home/mvp/mvp_db/news7-lv/2008/2008_07_31_19_00/2008_07_31_19_00.mpg;Ichiro OZAWA.jpg;4581;5353;35961;229;267;38
/net/per610a/home/mvp/mvp_db/news7-lv/2008/2008_08_02_19_00/2008_08_02_19_00.mpg;Yasuo FUKUDA.jpg;1109;1477;35961;55;73;18
/net/per610a/home/mvp/mvp_db/news7-lv/2008/2008_08_02_19_00/2008_08_02_19_00.mpg;Yasuo FUKUDA.jpg;1657;1729;35961;82;86;4
/net/per610a/home/mvp/mvp_db/news7-lv/2008/2008_08_02_19_00/2008_08_02_19_00.mpg;Yasuo FUKUDA.jpg;2425;2493;35961;121;124;3
/net/per610a/home/mvp/mvp_db/news7-lv/2008/2008_08_02_19_00/2008_08_02_19_00.mpg;Yasuo FUKUDA.jpg;7653;7869;35961;382;393;11
/net/per610a/home/mvp/mvp_db/news7-lv/2008/2008_08_02_19_00/2008_08_02_19_00.mpg;Yasuo FUKUDA.jpg;8149;8205;35961;407;410;3
/net/per610a/home/mvp/mvp_db/news7-lv/2008/2008_08_02_19_00/2008_08_02_19_00.mpg;Yasuo FUKUDA.jpg;10001;10109;35961;500;505;5
/net/per610a/home/mvp/mvp_db/news7-lv/2008/2008_08_03_19_00/2008_08_03_19_00.mpg;Kyoko Nakayama.jpg;24773;25469;35957;1239;1274;35
/net/per610a/home/mvp/mvp_db/news7-lv/2008/2008_08_04_19_00/2008_08_04_19_00.mpg;Yasuo FUKUDA.jpg;23297;23481;35961;1165;1174;9
/net/per610a/home/mvp/mvp_db/news7-lv/2008/2008_08_04_19_00/2008_08_04_19_00.mpg;Yasuo FUKUDA.jpg;25525;26405;35961;1276;1320;44
/net/per610a/home/mvp/mvp_db/news7-lv/2008/2008_08_08_19_00/2008_08_08_19_00.mpg;Yasuo FUKUDA.jpg;6705;6821;35961;335;341;6
/net/per610a/home/mvp/mvp_db/news7-lv/2008/2008_08_08_19_00/2008_08_08_19_00.mpg;Yasuo FUKUDA.jpg;34357;34373;35961;1718;1719;1
/net/per610a/home/mvp/mvp_db/news7-lv/2008/2008_08_10_19_00/2008_08_10_19_00.mpg;Yukio HATOYAMA.jpg;26453;27237;35961;1323;1362;39
/net/per610a/home/mvp/mvp_db/news7-lv/2008/2008_08_14_19_00/2008_08_14_19_00.mpg;Kyoko Nakayama.jpg;26717;27241;35961;1336;1362;26
/net/per610a/home/mvp/mvp_db/news7-lv/2008/2008_08_18_19_00/2008_08_18_19_00.mpg;Yasuo FUKUDA.jpg;19729;20233;35961;986;1012;26
/net/per610a/home/mvp/mvp_db/news7-lv/2008/2008_08_19_19_00/2008_08_19_19_00.mpg;Yasuo FUKUDA.jpg;24669;25069;35961;1234;1254;20
/net/per610a/home/mvp/mvp_db/news7-lv/2008/2008_08_21_19_00/2008_08_21_19_00.mpg;Yoshihiko Noda.jpg;22429;22933;35957;1122;1147;25
/net/per610a/home/mvp/mvp_db/news7-lv/2008/2008_08_21_19_00/2008_08_21_19_00.mpg;Yoshihiko Noda.jpg;23813;24049;35957;1191;1203;12
/net/per610a/home/mvp/mvp_db/news7-lv/2008/2008_08_22_19_00/2008_08_22_19_00.mpg;Yukio EDANO.jpg;17497;17817;35961;875;891;16
/net/per610a/home/mvp/mvp_db/news7-lv/2008/2008_08_22_19_00/2008_08_22_19_00.mpg;Yukio HATOYAMA.jpg;18033;18765;35961;902;938;36
/net/per610a/home/mvp/mvp_db/news7-lv/2008/2008_08_24_19_00/2008_08_24_19_00.mpg;Kyoko Nakayama.jpg;20757;21145;35961;1038;1057;19
/net/per610a/home/mvp/mvp_db/news7-lv/2008/2008_08_26_19_00/2008_08_26_19_00.mpg;Taro ASO.jpg;15573;16013;35961;779;801;22
/net/per610a/home/mvp/mvp_db/news7-lv/2008/2008_08_26_19_00/2008_08_26_19_00.mpg;Yukio HATOYAMA.jpg;16049;17021;35961;802;851;49
/net/per610a/home/mvp/mvp_db/news7-lv/2008/2008_08_26_19_00/2008_08_26_19_00.mpg;Akihiro OHTA.jpg;20993;21113;35961;1050;1056;6
/net/per610a/home/mvp/mvp_db/news7-lv/2008/2008_08_26_19_00/2008_08_26_19_00.mpg;Akihiro OHTA.jpg;22489;22929;35961;1125;1147;22
/net/per610a/home/mvp/mvp_db/news7-lv/2008/2008_08_26_19_00/2008_08_26_19_00.mpg;Ichiro OZAWA.jpg;21993;22365;35961;1100;1118;18
/net/per610a/home/mvp/mvp_db/news7-lv/2008/2008_08_26_19_00/2008_08_26_19_00.mpg;Yasuo FUKUDA.jpg;22489;22929;35961;1125;1147;22
/net/per610a/home/mvp/mvp_db/news7-lv/2008/2008_08_27_19_00/2008_08_27_19_00.mpg;Yasuo FUKUDA.jpg;34541;34757;35961;1727;1738;11
/net/per610a/home/mvp/mvp_db/news7-lv/2008/2008_08_28_19_00/2008_08_28_19_00.mpg;Yasuo FUKUDA.jpg;13477;14061;35961;674;703;29
/net/per610a/home/mvp/mvp_db/news7-lv/2008/2008_08_28_19_00/2008_08_28_19_00.mpg;Ichiro OZAWA.jpg;18473;18849;35961;924;942;18
/net/per610a/home/mvp/mvp_db/news7-lv/2008/2008_08_28_19_00/2008_08_28_19_00.mpg;Akihiro OHTA.jpg;19273;19353;35961;964;968;4
/net/per610a/home/mvp/mvp_db/news7-lv/2008/2008_08_28_19_00/2008_08_28_19_00.mpg;Akihiro OHTA.jpg;19545;20317;35961;977;1016;39
/net/per610a/home/mvp/mvp_db/news7-lv/2008/2008_08_28_19_00/2008_08_28_19_00.mpg;Akihiro OHTA.jpg;23809;23929;35961;1191;1197;6
/net/per610a/home/mvp/mvp_db/news7-lv/2008/2008_08_28_19_00/2008_08_28_19_00.mpg;Natsuo YAMAGUCHI.jpg;25013;25117;35961;1251;1256;5
/net/per610a/home/mvp/mvp_db/news7-lv/2008/2008_08_29_19_00/2008_08_29_19_00.mpg;Yasuo FUKUDA.jpg;21145;21373;35961;1057;1069;12
/net/per610a/home/mvp/mvp_db/news7-lv/2008/2008_08_29_19_00/2008_08_29_19_00.mpg;Yukio HATOYAMA.jpg;23585;23993;35961;1179;1200;21
/net/per610a/home/mvp/mvp_db/news7-lv/2008/2008_09_01_19_00/2008_09_01_19_00.mpg;Ichiro OZAWA.jpg;1105;1349;35961;55;67;12
/net/per610a/home/mvp/mvp_db/news7-lv/2008/2008_09_01_19_00/2008_09_01_19_00.mpg;Ichiro OZAWA.jpg;1441;1973;35961;72;98;26
/net/per610a/home/mvp/mvp_db/news7-lv/2008/2008_09_01_19_00/2008_09_01_19_00.mpg;Ichiro OZAWA.jpg;3209;3293;35961;160;164;4
/net/per610a/home/mvp/mvp_db/news7-lv/2008/2008_09_01_19_00/2008_09_01_19_00.mpg;Yasuo FUKUDA.jpg;25097;25245;35961;1255;1262;7
/net/per610a/home/mvp/mvp_db/news7-lv/2008/2008_09_02_19_00/2008_09_02_19_00.mpg;Yasuo FUKUDA.jpg;1;85;35961;0;4;4
/net/per610a/home/mvp/mvp_db/news7-lv/2008/2008_09_02_19_00/2008_09_02_19_00.mpg;Yasuo FUKUDA.jpg;2605;2845;35961;130;142;12
/net/per610a/home/mvp/mvp_db/news7-lv/2008/2008_09_02_19_00/2008_09_02_19_00.mpg;Yasuo FUKUDA.jpg;20229;20305;35961;1011;1015;4
/net/per610a/home/mvp/mvp_db/news7-lv/2008/2008_09_02_19_00/2008_09_02_19_00.mpg;Yasuo FUKUDA.jpg;22833;22849;35961;1142;1143;1
/net/per610a/home/mvp/mvp_db/news7-lv/2008/2008_09_02_19_00/2008_09_02_19_00.mpg;Yasuo FUKUDA.jpg;22929;22969;35961;1147;1149;2
/net/per610a/home/mvp/mvp_db/news7-lv/2008/2008_09_02_19_00/2008_09_02_19_00.mpg;Taro ASO.jpg;1997;2009;35961;99;100;1
/net/per610a/home/mvp/mvp_db/news7-lv/2008/2008_09_02_19_00/2008_09_02_19_00.mpg;Taro ASO.jpg;3377;3849;35961;168;192;24
/net/per610a/home/mvp/mvp_db/news7-lv/2008/2008_09_02_19_00/2008_09_02_19_00.mpg;Akihiro OHTA.jpg;7261;7681;35961;363;384;21
/net/per610a/home/mvp/mvp_db/news7-lv/2008/2008_09_02_19_00/2008_09_02_19_00.mpg;Ichiro OZAWA.jpg;7693;7757;35961;384;388;4
/net/per610a/home/mvp/mvp_db/news7-lv/2008/2008_09_02_19_00/2008_09_02_19_00.mpg;Ichiro OZAWA.jpg;7833;7841;35961;391;392;1
/net/per610a/home/mvp/mvp_db/news7-lv/2008/2008_09_02_19_00/2008_09_02_19_00.mpg;Ichiro OZAWA.jpg;7949;7969;35961;397;398;1
/net/per610a/home/mvp/mvp_db/news7-lv/2008/2008_09_02_19_00/2008_09_02_19_00.mpg;Yukio HATOYAMA.jpg;8441;8801;35961;422;440;18
/net/per610a/home/mvp/mvp_db/news7-lv/2008/2008_09_02_19_00/2008_09_02_19_00.mpg;Kazuo SHII.jpg;8969;9313;35961;448;465;17
/net/per610a/home/mvp/mvp_db/news7-lv/2008/2008_09_03_19_00/2008_09_03_19_00.mpg;Taro ASO.jpg;1;157;35961;0;7;7
/net/per610a/home/mvp/mvp_db/news7-lv/2008/2008_09_03_19_00/2008_09_03_19_00.mpg;Yasuo FUKUDA.jpg;1117;1569;35961;55;78;23
/net/per610a/home/mvp/mvp_db/news7-lv/2008/2008_09_03_19_00/2008_09_03_19_00.mpg;Yasuo FUKUDA.jpg;1633;1969;35961;81;98;17
/net/per610a/home/mvp/mvp_db/news7-lv/2008/2008_09_03_19_00/2008_09_03_19_00.mpg;Yasuo FUKUDA.jpg;5621;5781;35961;281;289;8
/net/per610a/home/mvp/mvp_db/news7-lv/2008/2008_09_04_19_00/2008_09_04_19_00.mpg;Yukio HATOYAMA.jpg;11393;11573;35961;569;578;9
/net/per610a/home/mvp/mvp_db/news7-lv/2008/2008_09_04_19_00/2008_09_04_19_00.mpg;Yukio HATOYAMA.jpg;11737;12249;35961;587;612;25
/net/per610a/home/mvp/mvp_db/news7-lv/2008/2008_09_04_19_00/2008_09_04_19_00.mpg;Kazuo SHII.jpg;12341;12801;35961;617;640;23
/net/per610a/home/mvp/mvp_db/news7-lv/2008/2008_09_05_19_00/2008_09_05_19_00.mpg;YUriko Koike.jpg;417;621;35961;20;31;11
/net/per610a/home/mvp/mvp_db/news7-lv/2008/2008_09_05_19_00/2008_09_05_19_00.mpg;YUriko Koike.jpg;5861;6213;35961;293;310;17
/net/per610a/home/mvp/mvp_db/news7-lv/2008/2008_09_05_19_00/2008_09_05_19_00.mpg;Taro ASO.jpg;1997;2237;35961;99;111;12
/net/per610a/home/mvp/mvp_db/news7-lv/2008/2008_09_05_19_00/2008_09_05_19_00.mpg;Taro ASO.jpg;2393;2873;35961;119;143;24
/net/per610a/home/mvp/mvp_db/news7-lv/2008/2008_09_06_19_00/2008_09_06_19_00.mpg;Yukio HATOYAMA.jpg;15361;16593;35961;768;830;62
/net/per610a/home/mvp/mvp_db/news7-lv/2008/2008_09_07_19_00/2008_09_07_19_00.mpg;Ichiro OZAWA.jpg;8957;11137;35961;448;557;109
/net/per610a/home/mvp/mvp_db/news7-lv/2008/2008_09_08_19_00/2008_09_08_19_00.mpg;Ichiro OZAWA.jpg;1121;1525;35961;56;76;20
/net/per610a/home/mvp/mvp_db/news7-lv/2008/2008_09_08_19_00/2008_09_08_19_00.mpg;Ichiro OZAWA.jpg;1589;1993;35961;79;99;20
/net/per610a/home/mvp/mvp_db/news7-lv/2008/2008_09_08_19_00/2008_09_08_19_00.mpg;Ichiro OZAWA.jpg;3665;3697;35961;183;184;1
/net/per610a/home/mvp/mvp_db/news7-lv/2008/2008_09_08_19_00/2008_09_08_19_00.mpg;Ichiro OZAWA.jpg;8397;8613;35961;420;430;10
/net/per610a/home/mvp/mvp_db/news7-lv/2008/2008_09_08_19_00/2008_09_08_19_00.mpg;Ichiro OZAWA.jpg;31217;31597;35961;1561;1580;19
/net/per610a/home/mvp/mvp_db/news7-lv/2008/2008_09_08_19_00/2008_09_08_19_00.mpg;Ichiro OZAWA.jpg;3705;4741;35961;185;237;52
/net/per610a/home/mvp/mvp_db/news7-lv/2008/2008_09_08_19_00/2008_09_08_19_00.mpg;Ichiro OZAWA.jpg;9409;9849;35961;470;492;22
/net/per610a/home/mvp/mvp_db/news7-lv/2008/2008_09_08_19_00/2008_09_08_19_00.mpg;Yukio HATOYAMA.jpg;4801;6041;35961;240;302;62
/net/per610a/home/mvp/mvp_db/news7-lv/2008/2008_09_08_19_00/2008_09_08_19_00.mpg;YUriko Koike.jpg;11529;11593;35961;576;579;3
/net/per610a/home/mvp/mvp_db/news7-lv/2008/2008_09_08_19_00/2008_09_08_19_00.mpg;YUriko Koike.jpg;11717;12437;35961;586;622;36
/net/per610a/home/mvp/mvp_db/news7-lv/2008/2008_09_08_19_00/2008_09_08_19_00.mpg;Yasuo FUKUDA.jpg;27801;28241;35961;1390;1412;22
/net/per610a/home/mvp/mvp_db/news7-lv/2008/2008_09_08_19_00/2008_09_08_19_00.mpg;Yasuo FUKUDA.jpg;28977;30033;35961;1449;1502;53
/net/per610a/home/mvp/mvp_db/news7-lv/2008/2008_09_09_19_00/2008_09_09_19_00.mpg;YUriko Koike.jpg;17045;17617;35961;852;881;29
/net/per610a/home/mvp/mvp_db/news7-lv/2008/2008_09_10_19_00/2008_09_10_19_00.mpg;Taro ASO.jpg;765;765;35961;38;38;0
/net/per610a/home/mvp/mvp_db/news7-lv/2008/2008_09_10_19_00/2008_09_10_19_00.mpg;Taro ASO.jpg;3025;3089;35961;151;154;3
/net/per610a/home/mvp/mvp_db/news7-lv/2008/2008_09_10_19_00/2008_09_10_19_00.mpg;Taro ASO.jpg;8929;9053;35961;446;452;6
/net/per610a/home/mvp/mvp_db/news7-lv/2008/2008_09_10_19_00/2008_09_10_19_00.mpg;Taro ASO.jpg;9185;11961;35961;459;598;139
/net/per610a/home/mvp/mvp_db/news7-lv/2008/2008_09_10_19_00/2008_09_10_19_00.mpg;Taro ASO.jpg;15441;16569;35961;772;828;56
/net/per610a/home/mvp/mvp_db/news7-lv/2008/2008_09_10_19_00/2008_09_10_19_00.mpg;Taro ASO.jpg;17597;17945;35961;880;897;17
/net/per610a/home/mvp/mvp_db/news7-lv/2008/2008_09_10_19_00/2008_09_10_19_00.mpg;Taro ASO.jpg;18093;19017;35961;905;951;46
/net/per610a/home/mvp/mvp_db/news7-lv/2008/2008_09_10_19_00/2008_09_10_19_00.mpg;Taro ASO.jpg;20897;21457;35961;1045;1073;28
/net/per610a/home/mvp/mvp_db/news7-lv/2008/2008_09_10_19_00/2008_09_10_19_00.mpg;Taro ASO.jpg;30405;31121;35961;1521;1556;35
/net/per610a/home/mvp/mvp_db/news7-lv/2008/2008_09_10_19_00/2008_09_10_19_00.mpg;Taro ASO.jpg;33417;33945;35961;1671;1698;27
/net/per610a/home/mvp/mvp_db/news7-lv/2008/2008_09_10_19_00/2008_09_10_19_00.mpg;Taro ASO.jpg;34085;35957;35961;1705;1798;93
/net/per610a/home/mvp/mvp_db/news7-lv/2008/2008_09_10_19_00/2008_09_10_19_00.mpg;YUriko Koike.jpg;2157;2173;35961;107;108;1
/net/per610a/home/mvp/mvp_db/news7-lv/2008/2008_09_10_19_00/2008_09_10_19_00.mpg;YUriko Koike.jpg;2493;2589;35961;124;129;5
/net/per610a/home/mvp/mvp_db/news7-lv/2008/2008_09_10_19_00/2008_09_10_19_00.mpg;YUriko Koike.jpg;7137;7265;35961;357;363;6
/net/per610a/home/mvp/mvp_db/news7-lv/2008/2008_09_10_19_00/2008_09_10_19_00.mpg;YUriko Koike.jpg;7385;8849;35961;369;442;73
/net/per610a/home/mvp/mvp_db/news7-lv/2008/2008_09_10_19_00/2008_09_10_19_00.mpg;YUriko Koike.jpg;27185;27245;35961;1359;1362;3
/net/per610a/home/mvp/mvp_db/news7-lv/2008/2008_09_10_19_00/2008_09_10_19_00.mpg;YUriko Koike.jpg;28649;29189;35961;1433;1460;27
/net/per610a/home/mvp/mvp_db/news7-lv/2008/2008_09_10_19_00/2008_09_10_19_00.mpg;YUriko Koike.jpg;31193;33337;35961;1560;1667;107
/net/per610a/home/mvp/mvp_db/news7-lv/2008/2008_09_11_19_00/2008_09_11_19_00.mpg;Yasuo FUKUDA.jpg;12157;12549;35961;608;627;19
/net/per610a/home/mvp/mvp_db/news7-lv/2008/2008_09_12_19_00/2008_09_12_19_00.mpg;Toru Hashimoto.jpg;661;821;35961;33;41;8
/net/per610a/home/mvp/mvp_db/news7-lv/2008/2008_09_12_19_00/2008_09_12_19_00.mpg;Toru Hashimoto.jpg;11313;11893;35961;565;594;29
/net/per610a/home/mvp/mvp_db/news7-lv/2008/2008_09_12_19_00/2008_09_12_19_00.mpg;Yukio HATOYAMA.jpg;18261;18653;35961;913;933;20
/net/per610a/home/mvp/mvp_db/news7-lv/2008/2008_09_12_19_00/2008_09_12_19_00.mpg;Yasuo FUKUDA.jpg;23341;24229;35961;1167;1212;45
/net/per610a/home/mvp/mvp_db/news7-lv/2008/2008_09_13_19_00/2008_09_13_19_00.mpg;Naoto KAN.jpg;22245;24509;35961;1112;1226;114
/net/per610a/home/mvp/mvp_db/news7-lv/2008/2008_09_16_19_00/2008_09_16_19_00.mpg;Akihiro OHTA.jpg;22861;23237;35961;1143;1162;19
/net/per610a/home/mvp/mvp_db/news7-lv/2008/2008_09_16_19_00/2008_09_16_19_00.mpg;Akihiro OHTA.jpg;23741;24589;35961;1187;1230;43
/net/per610a/home/mvp/mvp_db/news7-lv/2008/2008_09_21_19_00/2008_09_21_19_00.mpg;Ichiro OZAWA.jpg;12109;12177;35961;605;609;4
/net/per610a/home/mvp/mvp_db/news7-lv/2008/2008_09_21_19_00/2008_09_21_19_00.mpg;Ichiro OZAWA.jpg;13577;13625;35961;679;681;2
/net/per610a/home/mvp/mvp_db/news7-lv/2008/2008_09_21_19_00/2008_09_21_19_00.mpg;Ichiro OZAWA.jpg;14557;15193;35961;728;760;32
/net/per610a/home/mvp/mvp_db/news7-lv/2008/2008_09_21_19_00/2008_09_21_19_00.mpg;Ichiro OZAWA.jpg;16453;16685;35961;823;834;11
/net/per610a/home/mvp/mvp_db/news7-lv/2008/2008_09_21_19_00/2008_09_21_19_00.mpg;Yasuo FUKUDA.jpg;13521;13569;35961;676;678;2
/net/per610a/home/mvp/mvp_db/news7-lv/2008/2008_09_21_19_00/2008_09_21_19_00.mpg;Yasuo FUKUDA.jpg;14385;14445;35961;719;722;3
/net/per610a/home/mvp/mvp_db/news7-lv/2008/2008_09_21_19_00/2008_09_21_19_00.mpg;Ichiro OZAWA.jpg;13841;13857;35961;692;693;1
/net/per610a/home/mvp/mvp_db/news7-lv/2008/2008_09_21_19_00/2008_09_21_19_00.mpg;Ichiro OZAWA.jpg;15885;16081;35961;794;804;10
/net/per610a/home/mvp/mvp_db/news7-lv/2008/2008_09_21_19_00/2008_09_21_19_00.mpg;Ichiro OZAWA.jpg;16841;17617;35961;842;881;39
/net/per610a/home/mvp/mvp_db/news7-lv/2008/2008_09_21_19_00/2008_09_21_19_00.mpg;YUriko Koike.jpg;18397;19537;35961;920;977;57
/net/per610a/home/mvp/mvp_db/news7-lv/2008/2008_09_22_19_00/2008_09_22_19_00.mpg;Taro ASO.jpg;3305;3681;35961;165;184;19
/net/per610a/home/mvp/mvp_db/news7-lv/2008/2008_09_22_19_00/2008_09_22_19_00.mpg;Yukio HATOYAMA.jpg;9933;12037;35961;496;602;106
/net/per610a/home/mvp/mvp_db/news7-lv/2008/2008_09_22_19_00/2008_09_22_19_00.mpg;Taro ASO.jpg;13017;13145;35961;651;657;6
/net/per610a/home/mvp/mvp_db/news7-lv/2008/2008_09_22_19_00/2008_09_22_19_00.mpg;Taro ASO.jpg;14497;14685;35961;725;734;9
/net/per610a/home/mvp/mvp_db/news7-lv/2008/2008_09_22_19_00/2008_09_22_19_00.mpg;Taro ASO.jpg;15393;15397;35961;770;770;0
/net/per610a/home/mvp/mvp_db/news7-lv/2008/2008_09_22_19_00/2008_09_22_19_00.mpg;Yasuo FUKUDA.jpg;15669;15769;35961;783;788;5
/net/per610a/home/mvp/mvp_db/news7-lv/2008/2008_09_23_19_00/2008_09_23_19_00.mpg;Taro ASO.jpg;6197;6661;35961;310;333;23
/net/per610a/home/mvp/mvp_db/news7-lv/2008/2008_09_24_19_00/2008_09_24_19_00.mpg;Taro ASO.jpg;3733;3861;35961;186;193;7
/net/per610a/home/mvp/mvp_db/news7-lv/2008/2008_09_24_19_00/2008_09_24_19_00.mpg;Taro ASO.jpg;5437;5681;35961;271;284;13
/net/per610a/home/mvp/mvp_db/news7-lv/2008/2008_09_24_19_00/2008_09_24_19_00.mpg;Taro ASO.jpg;6197;6277;35961;310;314;4
/net/per610a/home/mvp/mvp_db/news7-lv/2008/2008_09_24_19_00/2008_09_24_19_00.mpg;Taro ASO.jpg;8589;8673;35961;429;433;4
/net/per610a/home/mvp/mvp_db/news7-lv/2008/2008_09_24_19_00/2008_09_24_19_00.mpg;Taro ASO.jpg;9261;9309;35961;463;465;2
/net/per610a/home/mvp/mvp_db/news7-lv/2008/2008_09_24_19_00/2008_09_24_19_00.mpg;Taro ASO.jpg;10525;12205;35961;526;610;84
/net/per610a/home/mvp/mvp_db/news7-lv/2008/2008_09_24_19_00/2008_09_24_19_00.mpg;Taro ASO.jpg;12273;13537;35961;613;677;64
/net/per610a/home/mvp/mvp_db/news7-lv/2008/2008_09_24_19_00/2008_09_24_19_00.mpg;Taro ASO.jpg;30533;30577;35961;1527;1529;2
/net/per610a/home/mvp/mvp_db/news7-lv/2008/2008_09_24_19_00/2008_09_24_19_00.mpg;Taro ASO.jpg;32401;33289;35961;1620;1665;45
/net/per610a/home/mvp/mvp_db/news7-lv/2008/2008_09_24_19_00/2008_09_24_19_00.mpg;Ichiro OZAWA.jpg;5117;5337;35961;255;266;11
/net/per610a/home/mvp/mvp_db/news7-lv/2008/2008_09_24_19_00/2008_09_24_19_00.mpg;Ichiro OZAWA.jpg;9485;9545;35961;474;477;3
/net/per610a/home/mvp/mvp_db/news7-lv/2008/2008_09_24_19_00/2008_09_24_19_00.mpg;Ichiro OZAWA.jpg;9765;9765;35961;488;488;0
/net/per610a/home/mvp/mvp_db/news7-lv/2008/2008_09_24_19_00/2008_09_24_19_00.mpg;Ichiro OZAWA.jpg;14953;17437;35961;748;872;124
/net/per610a/home/mvp/mvp_db/news7-lv/2008/2008_09_24_19_00/2008_09_24_19_00.mpg;Ichiro OZAWA.jpg;6825;6897;35961;341;345;4
/net/per610a/home/mvp/mvp_db/news7-lv/2008/2008_09_25_19_00/2008_09_25_19_00.mpg;Taro ASO.jpg;41;177;35961;2;8;6
/net/per610a/home/mvp/mvp_db/news7-lv/2008/2008_09_25_19_00/2008_09_25_19_00.mpg;Taro ASO.jpg;2609;2641;35961;130;132;2
/net/per610a/home/mvp/mvp_db/news7-lv/2008/2008_09_25_19_00/2008_09_25_19_00.mpg;Taro ASO.jpg;3401;4069;35961;170;203;33
/net/per610a/home/mvp/mvp_db/news7-lv/2008/2008_09_25_19_00/2008_09_25_19_00.mpg;Ichiro OZAWA.jpg;8513;8825;35961;425;441;16
/net/per610a/home/mvp/mvp_db/news7-lv/2008/2008_09_25_19_00/2008_09_25_19_00.mpg;Kazuo SHII.jpg;11837;12769;35961;592;638;46
/net/per610a/home/mvp/mvp_db/news7-lv/2008/2008_09_25_19_00/2008_09_25_19_00.mpg;Junichiro KOIZUMI.jpg;26433;26829;35961;1322;1342;20
/net/per610a/home/mvp/mvp_db/news7-lv/2008/2008_09_26_19_00/2008_09_26_19_00.mpg;Taro ASO.jpg;1;117;35961;0;5;5
/net/per610a/home/mvp/mvp_db/news7-lv/2008/2008_09_26_19_00/2008_09_26_19_00.mpg;Taro ASO.jpg;11281;11281;35961;564;564;0
/net/per610a/home/mvp/mvp_db/news7-lv/2008/2008_09_26_19_00/2008_09_26_19_00.mpg;Taro ASO.jpg;11345;11385;35961;567;569;2
/net/per610a/home/mvp/mvp_db/news7-lv/2008/2008_09_26_19_00/2008_09_26_19_00.mpg;Taro ASO.jpg;1169;1633;35961;58;81;23
/net/per610a/home/mvp/mvp_db/news7-lv/2008/2008_09_26_19_00/2008_09_26_19_00.mpg;Taro ASO.jpg;9453;9541;35961;472;477;5
/net/per610a/home/mvp/mvp_db/news7-lv/2008/2008_09_26_19_00/2008_09_26_19_00.mpg;Taro ASO.jpg;9617;9617;35961;481;481;0
/net/per610a/home/mvp/mvp_db/news7-lv/2008/2008_09_26_19_00/2008_09_26_19_00.mpg;Taro ASO.jpg;10717;11245;35961;536;562;26
/net/per610a/home/mvp/mvp_db/news7-lv/2008/2008_09_26_19_00/2008_09_26_19_00.mpg;Yukio HATOYAMA.jpg;3201;3809;35961;160;190;30
/net/per610a/home/mvp/mvp_db/news7-lv/2008/2008_09_26_19_00/2008_09_26_19_00.mpg;Yukio HATOYAMA.jpg;7805;9041;35961;390;452;62
/net/per610a/home/mvp/mvp_db/news7-lv/2008/2008_09_26_19_00/2008_09_26_19_00.mpg;Shinzo ABE.jpg;13585;14001;35961;679;700;21
/net/per610a/home/mvp/mvp_db/news7-lv/2008/2008_09_28_19_00/2008_09_28_19_00.mpg;Nariaki Nakayama.png;1145;1561;35961;57;78;21
/net/per610a/home/mvp/mvp_db/news7-lv/2008/2008_09_28_19_00/2008_09_28_19_00.mpg;Nariaki Nakayama.png;3941;3977;35961;197;198;1
/net/per610a/home/mvp/mvp_db/news7-lv/2008/2008_09_28_19_00/2008_09_28_19_00.mpg;Nariaki Nakayama.png;13389;13933;35961;669;697;28
/net/per610a/home/mvp/mvp_db/news7-lv/2008/2008_09_28_19_00/2008_09_28_19_00.mpg;Taro ASO.jpg;1625;2013;35961;81;100;19
/net/per610a/home/mvp/mvp_db/news7-lv/2008/2008_09_28_19_00/2008_09_28_19_00.mpg;Taro ASO.jpg;2241;2425;35961;112;121;9
/net/per610a/home/mvp/mvp_db/news7-lv/2008/2008_09_28_19_00/2008_09_28_19_00.mpg;Taro ASO.jpg;5301;5941;35961;265;297;32
/net/per610a/home/mvp/mvp_db/news7-lv/2008/2008_09_28_19_00/2008_09_28_19_00.mpg;Taro ASO.jpg;13937;13993;35961;697;700;3
/net/per610a/home/mvp/mvp_db/news7-lv/2008/2008_09_28_19_00/2008_09_28_19_00.mpg;Ichiro OZAWA.jpg;11697;12221;35961;585;611;26
/net/per610a/home/mvp/mvp_db/news7-lv/2008/2008_09_28_19_00/2008_09_28_19_00.mpg;Yukio HATOYAMA.jpg;14501;14933;35961;725;747;22
/net/per610a/home/mvp/mvp_db/news7-lv/2008/2008_09_29_19_00/2008_09_29_19_00.mpg;Taro ASO.jpg;1957;2113;35961;97;105;8
/net/per610a/home/mvp/mvp_db/news7-lv/2008/2008_09_29_19_00/2008_09_29_19_00.mpg;Taro ASO.jpg;2853;2913;35961;142;145;3
/net/per610a/home/mvp/mvp_db/news7-lv/2008/2008_09_29_19_00/2008_09_29_19_00.mpg;Taro ASO.jpg;2989;2997;35961;149;149;0
/net/per610a/home/mvp/mvp_db/news7-lv/2008/2008_09_29_19_00/2008_09_29_19_00.mpg;Taro ASO.jpg;3109;3385;35961;155;169;14
/net/per610a/home/mvp/mvp_db/news7-lv/2008/2008_09_29_19_00/2008_09_29_19_00.mpg;Taro ASO.jpg;3625;3945;35961;181;197;16
/net/per610a/home/mvp/mvp_db/news7-lv/2008/2008_09_29_19_00/2008_09_29_19_00.mpg;Taro ASO.jpg;5613;5673;35961;280;283;3
/net/per610a/home/mvp/mvp_db/news7-lv/2008/2008_09_29_19_00/2008_09_29_19_00.mpg;Taro ASO.jpg;9269;9321;35961;463;466;3
/net/per610a/home/mvp/mvp_db/news7-lv/2008/2008_09_29_19_00/2008_09_29_19_00.mpg;Taro ASO.jpg;12553;12869;35961;627;643;16
/net/per610a/home/mvp/mvp_db/news7-lv/2008/2008_09_29_19_00/2008_09_29_19_00.mpg;Taro ASO.jpg;16321;16753;35961;816;838;22
/net/per610a/home/mvp/mvp_db/news7-lv/2008/2008_09_29_19_00/2008_09_29_19_00.mpg;Ichiro OZAWA.jpg;16321;16753;35961;816;838;22
/net/per610a/home/mvp/mvp_db/news7-lv/2008/2008_09_30_19_00/2008_09_30_19_00.mpg;Taro ASO.jpg;2813;2885;35961;140;144;4
/net/per610a/home/mvp/mvp_db/news7-lv/2008/2008_09_30_19_00/2008_09_30_19_00.mpg;Taro ASO.jpg;4953;5593;35961;247;279;32
/net/per610a/home/mvp/mvp_db/news7-lv/2008/2008_09_30_19_00/2008_09_30_19_00.mpg;Taro ASO.jpg;13013;13761;35961;650;688;38
/net/per610a/home/mvp/mvp_db/news7-lv/2008/2008_09_30_19_00/2008_09_30_19_00.mpg;Taro ASO.jpg;14197;14433;35961;710;722;12
/net/per610a/home/mvp/mvp_db/news7-lv/2008/2008_09_30_19_00/2008_09_30_19_00.mpg;Kenji Eda.jpg;13973;14085;35961;699;704;5
/net/per610a/home/mvp/mvp_db/news7-lv/2008/2008_10_01_19_00/2008_10_01_19_00.mpg;Toru Hashimoto.jpg;1761;1917;35961;88;95;7
/net/per610a/home/mvp/mvp_db/news7-lv/2008/2008_10_01_19_00/2008_10_01_19_00.mpg;Taro ASO.jpg;11513;12085;35961;575;604;29
/net/per610a/home/mvp/mvp_db/news7-lv/2008/2008_10_01_19_00/2008_10_01_19_00.mpg;Taro ASO.jpg;16797;17725;35961;840;886;46
/net/per610a/home/mvp/mvp_db/news7-lv/2008/2008_10_01_19_00/2008_10_01_19_00.mpg;Taro ASO.jpg;22329;22333;35961;1117;1117;0
/net/per610a/home/mvp/mvp_db/news7-lv/2008/2008_10_01_19_00/2008_10_01_19_00.mpg;Taro ASO.jpg;22409;23021;35961;1121;1151;30
/net/per610a/home/mvp/mvp_db/news7-lv/2008/2008_10_01_19_00/2008_10_01_19_00.mpg;Ichiro OZAWA.jpg;11513;12085;35961;575;604;29
/net/per610a/home/mvp/mvp_db/news7-lv/2008/2008_10_01_19_00/2008_10_01_19_00.mpg;Ichiro OZAWA.jpg;13421;14833;35961;671;742;71
/net/per610a/home/mvp/mvp_db/news7-lv/2008/2008_10_01_19_00/2008_10_01_19_00.mpg;Ichiro OZAWA.jpg;16569;16737;35961;828;837;9
/net/per610a/home/mvp/mvp_db/news7-lv/2008/2008_10_03_19_00/2008_10_03_19_00.mpg;Taro ASO.jpg;15801;16105;35957;790;805;15
/net/per610a/home/mvp/mvp_db/news7-lv/2008/2008_10_07_19_00/2008_10_07_19_00.mpg;Taro ASO.jpg;13445;13685;35961;672;684;12
/net/per610a/home/mvp/mvp_db/news7-lv/2008/2008_10_07_19_00/2008_10_07_19_00.mpg;Taro ASO.jpg;13977;14385;35961;699;719;20
/net/per610a/home/mvp/mvp_db/news7-lv/2008/2008_10_09_19_00/2008_10_09_19_00.mpg;Naoto KAN.jpg;10277;11073;35961;514;553;39
/net/per610a/home/mvp/mvp_db/news7-lv/2008/2008_10_10_19_00/2008_10_10_19_00.mpg;Taro ASO.jpg;23133;23689;35961;1157;1185;28
/net/per610a/home/mvp/mvp_db/news7-lv/2008/2008_10_10_19_00/2008_10_10_19_00.mpg;Yukio HATOYAMA.jpg;25385;26101;35961;1269;1305;36
/net/per610a/home/mvp/mvp_db/news7-lv/2008/2008_10_12_19_00/2008_10_12_19_00.mpg;Taro ASO.jpg;13905;13925;35961;695;696;1
/net/per610a/home/mvp/mvp_db/news7-lv/2008/2008_10_12_19_00/2008_10_12_19_00.mpg;Taro ASO.jpg;16093;16125;35961;805;806;1
/net/per610a/home/mvp/mvp_db/news7-lv/2008/2008_10_12_19_00/2008_10_12_19_00.mpg;Taro ASO.jpg;16965;17053;35961;848;853;5
/net/per610a/home/mvp/mvp_db/news7-lv/2008/2008_10_12_19_00/2008_10_12_19_00.mpg;Taro ASO.jpg;22073;22477;35961;1104;1124;20
/net/per610a/home/mvp/mvp_db/news7-lv/2008/2008_10_14_19_00/2008_10_14_19_00.mpg;Taro ASO.jpg;13409;13657;35961;670;683;13
/net/per610a/home/mvp/mvp_db/news7-lv/2008/2008_10_14_19_00/2008_10_14_19_00.mpg;Taro ASO.jpg;15081;15965;35961;754;798;44
/net/per610a/home/mvp/mvp_db/news7-lv/2008/2008_10_14_19_00/2008_10_14_19_00.mpg;Taro ASO.jpg;17521;17917;35961;876;896;20
/net/per610a/home/mvp/mvp_db/news7-lv/2008/2008_10_14_19_00/2008_10_14_19_00.mpg;Taro ASO.jpg;18957;19397;35961;948;970;22
/net/per610a/home/mvp/mvp_db/news7-lv/2008/2008_10_14_19_00/2008_10_14_19_00.mpg;Taro ASO.jpg;20477;20893;35961;1024;1045;21
/net/per610a/home/mvp/mvp_db/news7-lv/2008/2008_10_14_19_00/2008_10_14_19_00.mpg;Ichiro OZAWA.jpg;20477;20893;35961;1024;1045;21
/net/per610a/home/mvp/mvp_db/news7-lv/2008/2008_10_16_19_00/2008_10_16_19_00.mpg;Naoto KAN.jpg;18177;18677;35961;909;934;25
/net/per610a/home/mvp/mvp_db/news7-lv/2008/2008_10_16_19_00/2008_10_16_19_00.mpg;Kyoko Nakayama.jpg;30213;30413;35961;1511;1521;10
/net/per610a/home/mvp/mvp_db/news7-lv/2008/2008_10_17_19_00/2008_10_17_19_00.mpg;Taro ASO.jpg;6153;6657;35961;307;333;26
/net/per610a/home/mvp/mvp_db/news7-lv/2008/2008_10_18_19_00/2008_10_18_19_00.mpg;Yukio HATOYAMA.jpg;8757;10041;35961;438;502;64
/net/per610a/home/mvp/mvp_db/news7-lv/2008/2008_10_20_19_00/2008_10_20_19_00.mpg;Kazuo SHII.jpg;2077;2189;35961;103;109;6
/net/per610a/home/mvp/mvp_db/news7-lv/2008/2008_10_20_19_00/2008_10_20_19_00.mpg;Kazuo SHII.jpg;2761;2941;35961;138;147;9
/net/per610a/home/mvp/mvp_db/news7-lv/2008/2008_10_20_19_00/2008_10_20_19_00.mpg;Kazuo SHII.jpg;4577;4797;35961;228;239;11
/net/per610a/home/mvp/mvp_db/news7-lv/2008/2008_10_20_19_00/2008_10_20_19_00.mpg;Yukio EDANO.jpg;16573;16905;35961;829;845;16
/net/per610a/home/mvp/mvp_db/news7-lv/2008/2008_10_21_19_00/2008_10_21_19_00.mpg;Taro ASO.jpg;8245;8677;35961;412;434;22
/net/per610a/home/mvp/mvp_db/news7-lv/2008/2008_10_21_19_00/2008_10_21_19_00.mpg;Taro ASO.jpg;8885;8913;35961;444;445;1
/net/per610a/home/mvp/mvp_db/news7-lv/2008/2008_10_21_19_00/2008_10_21_19_00.mpg;Taro ASO.jpg;9369;9465;35961;468;473;5
/net/per610a/home/mvp/mvp_db/news7-lv/2008/2008_10_21_19_00/2008_10_21_19_00.mpg;Taro ASO.jpg;10025;10101;35961;501;505;4
/net/per610a/home/mvp/mvp_db/news7-lv/2008/2008_10_21_19_00/2008_10_21_19_00.mpg;Taro ASO.jpg;10593;10849;35961;529;542;13
/net/per610a/home/mvp/mvp_db/news7-lv/2008/2008_10_21_19_00/2008_10_21_19_00.mpg;Taro ASO.jpg;13401;13609;35961;670;680;10
/net/per610a/home/mvp/mvp_db/news7-lv/2008/2008_10_21_19_00/2008_10_21_19_00.mpg;Taro ASO.jpg;15969;16769;35961;798;838;40
/net/per610a/home/mvp/mvp_db/news7-lv/2008/2008_10_21_19_00/2008_10_21_19_00.mpg;Ichiro OZAWA.jpg;11589;12225;35961;579;611;32
/net/per610a/home/mvp/mvp_db/news7-lv/2008/2008_10_22_19_00/2008_10_22_19_00.mpg;Shintaro ISHIHARA.jpg;33;145;35961;1;7;6
/net/per610a/home/mvp/mvp_db/news7-lv/2008/2008_10_24_19_00/2008_10_24_19_00.mpg;Naoto KAN.jpg;7649;7933;35961;382;396;14
/net/per610a/home/mvp/mvp_db/news7-lv/2008/2008_10_24_19_00/2008_10_24_19_00.mpg;Shintaro ISHIHARA.jpg;23625;23897;35961;1181;1195;14
/net/per610a/home/mvp/mvp_db/news7-lv/2008/2008_10_25_19_00/2008_10_25_19_00.mpg;Taro ASO.jpg;1649;4385;35961;82;219;137
/net/per610a/home/mvp/mvp_db/news7-lv/2008/2008_10_25_19_00/2008_10_25_19_00.mpg;Taro ASO.jpg;8697;9233;35961;435;461;26
/net/per610a/home/mvp/mvp_db/news7-lv/2008/2008_10_26_19_00/2008_10_26_19_00.mpg;Naoto KAN.jpg;593;769;35961;29;38;9
/net/per610a/home/mvp/mvp_db/news7-lv/2008/2008_10_26_19_00/2008_10_26_19_00.mpg;Naoto KAN.jpg;10565;11165;35961;528;558;30
/net/per610a/home/mvp/mvp_db/news7-lv/2008/2008_10_27_19_00/2008_10_27_19_00.mpg;Taro ASO.jpg;3561;3853;35961;178;192;14
/net/per610a/home/mvp/mvp_db/news7-lv/2008/2008_10_27_19_00/2008_10_27_19_00.mpg;Taro ASO.jpg;17437;18129;35961;872;906;34
/net/per610a/home/mvp/mvp_db/news7-lv/2008/2008_10_27_19_00/2008_10_27_19_00.mpg;Shintaro ISHIHARA.jpg;27349;28217;35961;1368;1411;43
/net/per610a/home/mvp/mvp_db/news7-lv/2008/2008_10_28_19_00/2008_10_28_19_00.mpg;Taro ASO.jpg;20177;20549;35961;1009;1027;18
/net/per610a/home/mvp/mvp_db/news7-lv/2008/2008_10_29_19_00/2008_10_29_19_00.mpg;Taro ASO.jpg;109;509;35961;5;25;20
/net/per610a/home/mvp/mvp_db/news7-lv/2008/2008_10_29_19_00/2008_10_29_19_00.mpg;Taro ASO.jpg;3249;3585;35961;162;179;17
/net/per610a/home/mvp/mvp_db/news7-lv/2008/2008_10_29_19_00/2008_10_29_19_00.mpg;Taro ASO.jpg;4909;5229;35961;245;261;16
/net/per610a/home/mvp/mvp_db/news7-lv/2008/2008_10_29_19_00/2008_10_29_19_00.mpg;Akihiro OHTA.jpg;19409;19625;35961;970;981;11
/net/per610a/home/mvp/mvp_db/news7-lv/2008/2008_10_29_19_00/2008_10_29_19_00.mpg;Akihiro OHTA.jpg;19873;20269;35961;994;1013;19
/net/per610a/home/mvp/mvp_db/news7-lv/2008/2008_10_29_19_00/2008_10_29_19_00.mpg;Akihiro OHTA.jpg;22049;22225;35961;1103;1111;8
/net/per610a/home/mvp/mvp_db/news7-lv/2008/2008_10_30_19_00/2008_10_30_19_00.mpg;Akihiro OHTA.jpg;9685;11601;35961;484;580;96
/net/per610a/home/mvp/mvp_db/news7-lv/2008/2008_11_03_19_00/2008_11_03_19_00.mpg;Ichiro OZAWA.jpg;9625;10693;35961;481;534;53
/net/per610a/home/mvp/mvp_db/news7-lv/2008/2008_11_04_19_00/2008_11_04_19_00.mpg;Ichiro OZAWA.jpg;24697;25225;35961;1235;1261;26
/net/per610a/home/mvp/mvp_db/news7-lv/2008/2008_11_05_19_00/2008_11_05_19_00.mpg;Taro ASO.jpg;20665;21141;35961;1033;1057;24
/net/per610a/home/mvp/mvp_db/news7-lv/2008/2008_11_06_19_00/2008_11_06_19_00.mpg;Taro ASO.jpg;7705;8025;35961;385;401;16
/net/per610a/home/mvp/mvp_db/news7-lv/2008/2008_11_06_19_00/2008_11_06_19_00.mpg;Taro ASO.jpg;8129;8401;35961;406;420;14
/net/per610a/home/mvp/mvp_db/news7-lv/2008/2008_11_06_19_00/2008_11_06_19_00.mpg;Taro ASO.jpg;22417;22505;35961;1121;1125;4
/net/per610a/home/mvp/mvp_db/news7-lv/2008/2008_11_07_19_00/2008_11_07_19_00.mpg;Natsuo YAMAGUCHI.jpg;2793;3297;35961;139;164;25
/net/per610a/home/mvp/mvp_db/news7-lv/2008/2008_11_07_19_00/2008_11_07_19_00.mpg;Natsuo YAMAGUCHI.jpg;3701;4201;35961;185;210;25
/net/per610a/home/mvp/mvp_db/news7-lv/2008/2008_11_08_19_00/2008_11_08_19_00.mpg;Yukio HATOYAMA.jpg;20901;22361;35961;1045;1118;73
/net/per610a/home/mvp/mvp_db/news7-lv/2008/2008_11_09_19_00/2008_11_09_19_00.mpg;Takako DOI.jpg;837;1025;35961;41;51;10
/net/per610a/home/mvp/mvp_db/news7-lv/2008/2008_11_09_19_00/2008_11_09_19_00.mpg;Takako DOI.jpg;9453;9585;35961;472;479;7
/net/per610a/home/mvp/mvp_db/news7-lv/2008/2008_11_10_19_00/2008_11_10_19_00.mpg;Akihiro OHTA.jpg;2185;2521;35961;109;126;17
/net/per610a/home/mvp/mvp_db/news7-lv/2008/2008_11_10_19_00/2008_11_10_19_00.mpg;Taro ASO.jpg;9477;10177;35961;474;509;35
/net/per610a/home/mvp/mvp_db/news7-lv/2008/2008_11_10_19_00/2008_11_10_19_00.mpg;Taro ASO.jpg;11329;11725;35961;566;586;20
/net/per610a/home/mvp/mvp_db/news7-lv/2008/2008_11_12_19_00/2008_11_12_19_00.mpg;Shintaro ISHIHARA.jpg;525;837;35961;26;41;15
/net/per610a/home/mvp/mvp_db/news7-lv/2008/2008_11_12_19_00/2008_11_12_19_00.mpg;Shintaro ISHIHARA.jpg;14693;15061;35961;735;753;18
/net/per610a/home/mvp/mvp_db/news7-lv/2008/2008_11_12_19_00/2008_11_12_19_00.mpg;Toru Hashimoto.jpg;15469;15605;35961;773;780;7
/net/per610a/home/mvp/mvp_db/news7-lv/2008/2008_11_13_19_00/2008_11_13_19_00.mpg;Ichiro OZAWA.jpg;3297;4445;35961;164;222;58
/net/per610a/home/mvp/mvp_db/news7-lv/2008/2008_11_14_19_00/2008_11_14_19_00.mpg;Shintaro ISHIHARA.jpg;4329;4613;35961;216;230;14
/net/per610a/home/mvp/mvp_db/news7-lv/2008/2008_11_14_19_00/2008_11_14_19_00.mpg;Taro ASO.jpg;6745;6745;35961;337;337;0
/net/per610a/home/mvp/mvp_db/news7-lv/2008/2008_11_14_19_00/2008_11_14_19_00.mpg;Taro ASO.jpg;6845;6865;35961;342;343;1
/net/per610a/home/mvp/mvp_db/news7-lv/2008/2008_11_14_19_00/2008_11_14_19_00.mpg;Taro ASO.jpg;6933;6933;35961;346;346;0
/net/per610a/home/mvp/mvp_db/news7-lv/2008/2008_11_14_19_00/2008_11_14_19_00.mpg;Taro ASO.jpg;13145;13257;35961;657;663;6
/net/per610a/home/mvp/mvp_db/news7-lv/2008/2008_11_15_19_00/2008_11_15_19_00.mpg;Taro ASO.jpg;8585;8609;35961;429;430;1
/net/per610a/home/mvp/mvp_db/news7-lv/2008/2008_11_15_19_00/2008_11_15_19_00.mpg;Taro ASO.jpg;8761;8905;35961;438;445;7
/net/per610a/home/mvp/mvp_db/news7-lv/2008/2008_11_17_19_00/2008_11_17_19_00.mpg;Ichiro OZAWA.jpg;5;17;35961;0;0;0
/net/per610a/home/mvp/mvp_db/news7-lv/2008/2008_11_17_19_00/2008_11_17_19_00.mpg;Ichiro OZAWA.jpg;957;1673;35961;47;83;36
/net/per610a/home/mvp/mvp_db/news7-lv/2008/2008_11_17_19_00/2008_11_17_19_00.mpg;Ichiro OZAWA.jpg;1929;2009;35961;96;100;4
/net/per610a/home/mvp/mvp_db/news7-lv/2008/2008_11_17_19_00/2008_11_17_19_00.mpg;Ichiro OZAWA.jpg;2345;2645;35961;117;132;15
/net/per610a/home/mvp/mvp_db/news7-lv/2008/2008_11_17_19_00/2008_11_17_19_00.mpg;Ichiro OZAWA.jpg;3925;4481;35961;196;224;28
/net/per610a/home/mvp/mvp_db/news7-lv/2008/2008_11_17_19_00/2008_11_17_19_00.mpg;Yukio HATOYAMA.jpg;2825;2881;35961;141;144;3
/net/per610a/home/mvp/mvp_db/news7-lv/2008/2008_11_17_19_00/2008_11_17_19_00.mpg;Yukio HATOYAMA.jpg;4729;4797;35961;236;239;3
/net/per610a/home/mvp/mvp_db/news7-lv/2008/2008_11_18_19_00/2008_11_18_19_00.mpg;Sadakazu TANIGAKI.jpg;5841;5953;35961;292;297;5
/net/per610a/home/mvp/mvp_db/news7-lv/2008/2008_11_18_19_00/2008_11_18_19_00.mpg;Ichiro OZAWA.jpg;9761;10353;35961;488;517;29
/net/per610a/home/mvp/mvp_db/news7-lv/2008/2008_11_18_19_00/2008_11_18_19_00.mpg;Ichiro OZAWA.jpg;14429;14445;35961;721;722;1
/net/per610a/home/mvp/mvp_db/news7-lv/2008/2008_11_18_19_00/2008_11_18_19_00.mpg;Taro ASO.jpg;12665;13241;35961;633;662;29
/net/per610a/home/mvp/mvp_db/news7-lv/2008/2008_11_18_19_00/2008_11_18_19_00.mpg;Taro ASO.jpg;15921;16601;35961;796;830;34
/net/per610a/home/mvp/mvp_db/news7-lv/2008/2008_11_19_19_00/2008_11_19_19_00.mpg;Taro ASO.jpg;18133;20441;35961;907;1022;115
/net/per610a/home/mvp/mvp_db/news7-lv/2008/2008_11_19_19_00/2008_11_19_19_00.mpg;Taro ASO.jpg;20741;21253;35961;1037;1063;26
/net/per610a/home/mvp/mvp_db/news7-lv/2008/2008_11_20_19_00/2008_11_20_19_00.mpg;Naoto KAN.jpg;10577;11769;35961;529;588;59
/net/per610a/home/mvp/mvp_db/news7-lv/2008/2008_11_20_19_00/2008_11_20_19_00.mpg;Taro ASO.jpg;14913;15289;35961;746;764;18
/net/per610a/home/mvp/mvp_db/news7-lv/2008/2008_11_21_19_00/2008_11_21_19_00.mpg;Yoshimi WATANABE.jpg;19185;19685;35961;959;984;25
/net/per610a/home/mvp/mvp_db/news7-lv/2008/2008_11_21_19_00/2008_11_21_19_00.mpg;Yoshimi WATANABE.jpg;21057;21101;35961;1053;1055;2
/net/per610a/home/mvp/mvp_db/news7-lv/2008/2008_11_22_19_00/2008_11_22_19_00.mpg;Ichiro OZAWA.jpg;10057;10309;35961;503;515;12
/net/per610a/home/mvp/mvp_db/news7-lv/2008/2008_11_22_19_00/2008_11_22_19_00.mpg;Ichiro OZAWA.jpg;10401;10941;35961;520;547;27
/net/per610a/home/mvp/mvp_db/news7-lv/2008/2008_11_22_19_00/2008_11_22_19_00.mpg;Taro ASO.jpg;11233;11401;35961;561;570;9
/net/per610a/home/mvp/mvp_db/news7-lv/2008/2008_11_22_19_00/2008_11_22_19_00.mpg;Taro ASO.jpg;11497;12249;35961;575;612;37
/net/per610a/home/mvp/mvp_db/news7-lv/2008/2008_11_23_19_00/2008_11_23_19_00.mpg;Taro ASO.jpg;22061;22313;35961;1103;1116;13
/net/per610a/home/mvp/mvp_db/news7-lv/2008/2008_11_25_19_00/2008_11_25_19_00.mpg;Taro ASO.jpg;369;653;35961;18;32;14
/net/per610a/home/mvp/mvp_db/news7-lv/2008/2008_11_25_19_00/2008_11_25_19_00.mpg;Taro ASO.jpg;10265;11457;35961;513;573;60
/net/per610a/home/mvp/mvp_db/news7-lv/2008/2008_11_25_19_00/2008_11_25_19_00.mpg;Taro ASO.jpg;14901;15209;35961;745;760;15
/net/per610a/home/mvp/mvp_db/news7-lv/2008/2008_11_25_19_00/2008_11_25_19_00.mpg;Yukio HATOYAMA.jpg;709;877;35961;35;43;8
/net/per610a/home/mvp/mvp_db/news7-lv/2008/2008_11_25_19_00/2008_11_25_19_00.mpg;Yukio HATOYAMA.jpg;12637;14333;35961;632;717;85
/net/per610a/home/mvp/mvp_db/news7-lv/2008/2008_11_25_19_00/2008_11_25_19_00.mpg;Yukio HATOYAMA.jpg;11661;11729;35961;583;586;3
/net/per610a/home/mvp/mvp_db/news7-lv/2008/2008_11_25_19_00/2008_11_25_19_00.mpg;Yukio HATOYAMA.jpg;11813;11881;35961;590;594;4
/net/per610a/home/mvp/mvp_db/news7-lv/2008/2008_11_27_19_00/2008_11_27_19_00.mpg;Taro ASO.jpg;12945;13245;35961;647;662;15
/net/per610a/home/mvp/mvp_db/news7-lv/2008/2008_11_27_19_00/2008_11_27_19_00.mpg;Taro ASO.jpg;18381;18777;35961;919;939;20
/net/per610a/home/mvp/mvp_db/news7-lv/2008/2008_11_27_19_00/2008_11_27_19_00.mpg;Taro ASO.jpg;20257;20825;35961;1013;1041;28
/net/per610a/home/mvp/mvp_db/news7-lv/2008/2008_11_27_19_00/2008_11_27_19_00.mpg;Akihiro OHTA.jpg;18781;20121;35961;939;1006;67
/net/per610a/home/mvp/mvp_db/news7-lv/2008/2008_11_28_19_00/2008_11_28_19_00.mpg;Ichiro OZAWA.jpg;17385;18241;35961;869;912;43
/net/per610a/home/mvp/mvp_db/news7-lv/2008/2008_12_01_19_00/2008_12_01_19_00.mpg;Masashi Nakano.jpg;2321;2461;35961;116;123;7
/net/per610a/home/mvp/mvp_db/news7-lv/2008/2008_12_02_19_00/2008_12_02_19_00.mpg;Taro ASO.jpg;9957;10977;35961;498;549;51
/net/per610a/home/mvp/mvp_db/news7-lv/2008/2008_12_02_19_00/2008_12_02_19_00.mpg;Taro ASO.jpg;18673;19077;35961;934;954;20
/net/per610a/home/mvp/mvp_db/news7-lv/2008/2008_12_03_19_00/2008_12_03_19_00.mpg;Yukio HATOYAMA.jpg;10209;10745;35961;510;537;27
/net/per610a/home/mvp/mvp_db/news7-lv/2008/2008_12_05_19_00/2008_12_05_19_00.mpg;Taro ASO.jpg;4013;4157;35961;200;207;7
/net/per610a/home/mvp/mvp_db/news7-lv/2008/2008_12_05_19_00/2008_12_05_19_00.mpg;Taro ASO.jpg;4621;5209;35961;231;260;29
/net/per610a/home/mvp/mvp_db/news7-lv/2008/2008_12_05_19_00/2008_12_05_19_00.mpg;Taro ASO.jpg;5757;5869;35961;288;293;5
/net/per610a/home/mvp/mvp_db/news7-lv/2008/2008_12_05_19_00/2008_12_05_19_00.mpg;Taro ASO.jpg;6721;7081;35961;336;354;18
/net/per610a/home/mvp/mvp_db/news7-lv/2008/2008_12_05_19_00/2008_12_05_19_00.mpg;Shintaro ISHIHARA.jpg;24513;24761;35961;1226;1238;12
/net/per610a/home/mvp/mvp_db/news7-lv/2008/2008_12_06_19_00/2008_12_06_19_00.mpg;Taro ASO.jpg;25161;25333;35957;1258;1267;9
/net/per610a/home/mvp/mvp_db/news7-lv/2008/2008_12_07_19_00/2008_12_07_19_00.mpg;Yukio HATOYAMA.jpg;16969;18625;35961;848;931;83
/net/per610a/home/mvp/mvp_db/news7-lv/2008/2008_12_08_19_00/2008_12_08_19_00.mpg;Ichiro OZAWA.jpg;13929;14189;35961;696;709;13
/net/per610a/home/mvp/mvp_db/news7-lv/2008/2008_12_09_19_00/2008_12_09_19_00.mpg;Akihiro OHTA.jpg;18573;19673;35961;929;984;55
/net/per610a/home/mvp/mvp_db/news7-lv/2008/2008_12_10_19_00/2008_12_10_19_00.mpg;Taro ASO.jpg;1085;1521;35961;54;76;22
/net/per610a/home/mvp/mvp_db/news7-lv/2008/2008_12_10_19_00/2008_12_10_19_00.mpg;Taro ASO.jpg;1845;2093;35961;92;104;12
/net/per610a/home/mvp/mvp_db/news7-lv/2008/2008_12_10_19_00/2008_12_10_19_00.mpg;Taro ASO.jpg;2385;2705;35961;119;135;16
/net/per610a/home/mvp/mvp_db/news7-lv/2008/2008_12_10_19_00/2008_12_10_19_00.mpg;Taro ASO.jpg;4457;4781;35961;222;239;17
/net/per610a/home/mvp/mvp_db/news7-lv/2008/2008_12_10_19_00/2008_12_10_19_00.mpg;Taro ASO.jpg;10265;11441;35961;513;572;59
/net/per610a/home/mvp/mvp_db/news7-lv/2008/2008_12_12_19_00/2008_12_12_19_00.mpg;Taro ASO.jpg;7237;7805;35961;362;390;28
/net/per610a/home/mvp/mvp_db/news7-lv/2008/2008_12_12_19_00/2008_12_12_19_00.mpg;Taro ASO.jpg;9473;9557;35961;473;478;5
/net/per610a/home/mvp/mvp_db/news7-lv/2008/2008_12_12_19_00/2008_12_12_19_00.mpg;Taro ASO.jpg;10957;11393;35961;548;569;21
/net/per610a/home/mvp/mvp_db/news7-lv/2008/2008_12_12_19_00/2008_12_12_19_00.mpg;Taro ASO.jpg;12213;12297;35961;610;615;5
/net/per610a/home/mvp/mvp_db/news7-lv/2008/2008_12_12_19_00/2008_12_12_19_00.mpg;Taro ASO.jpg;23461;23549;35961;1173;1178;5
/net/per610a/home/mvp/mvp_db/news7-lv/2008/2008_12_12_19_00/2008_12_12_19_00.mpg;Yukio HATOYAMA.jpg;25301;25801;35961;1265;1290;25
/net/per610a/home/mvp/mvp_db/news7-lv/2008/2008_12_13_19_00/2008_12_13_19_00.mpg;Taro ASO.jpg;369;521;35961;18;26;8
/net/per610a/home/mvp/mvp_db/news7-lv/2008/2008_12_13_19_00/2008_12_13_19_00.mpg;Taro ASO.jpg;3757;4441;35961;187;222;35
/net/per610a/home/mvp/mvp_db/news7-lv/2008/2008_12_13_19_00/2008_12_13_19_00.mpg;Taro ASO.jpg;4533;4541;35961;226;227;1
/net/per610a/home/mvp/mvp_db/news7-lv/2008/2008_12_13_19_00/2008_12_13_19_00.mpg;Taro ASO.jpg;4637;4785;35961;231;239;8
/net/per610a/home/mvp/mvp_db/news7-lv/2008/2008_12_13_19_00/2008_12_13_19_00.mpg;Taro ASO.jpg;5073;5557;35961;253;277;24
/net/per610a/home/mvp/mvp_db/news7-lv/2008/2008_12_13_19_00/2008_12_13_19_00.mpg;Taro ASO.jpg;8325;8741;35961;416;437;21
/net/per610a/home/mvp/mvp_db/news7-lv/2008/2008_12_14_19_00/2008_12_14_19_00.mpg;Taro ASO.jpg;9745;10069;35961;487;503;16
/net/per610a/home/mvp/mvp_db/news7-lv/2008/2008_12_17_19_00/2008_12_17_19_00.mpg;Taro ASO.jpg;7533;7681;35961;376;384;8
/net/per610a/home/mvp/mvp_db/news7-lv/2008/2008_12_22_19_00/2008_12_22_19_00.mpg;Taro ASO.jpg;13861;14105;35961;693;705;12
/net/per610a/home/mvp/mvp_db/news7-lv/2008/2008_12_22_19_00/2008_12_22_19_00.mpg;Taro ASO.jpg;28713;28853;35961;1436;1443;7
/net/per610a/home/mvp/mvp_db/news7-lv/2008/2008_12_24_19_00/2008_12_24_19_00.mpg;Taro ASO.jpg;105;141;35961;5;7;2
/net/per610a/home/mvp/mvp_db/news7-lv/2008/2008_12_24_19_00/2008_12_24_19_00.mpg;Taro ASO.jpg;8509;8705;35961;425;435;10
/net/per610a/home/mvp/mvp_db/news7-lv/2008/2008_12_24_19_00/2008_12_24_19_00.mpg;Taro ASO.jpg;9001;9429;35961;450;471;21
/net/per610a/home/mvp/mvp_db/news7-lv/2008/2008_12_24_19_00/2008_12_24_19_00.mpg;Taro ASO.jpg;14341;15293;35961;717;765;48
/net/per610a/home/mvp/mvp_db/news7-lv/2008/2008_12_24_19_00/2008_12_24_19_00.mpg;Taro ASO.jpg;17549;17689;35961;877;884;7
/net/per610a/home/mvp/mvp_db/news7-lv/2008/2008_12_24_19_00/2008_12_24_19_00.mpg;Ichiro OZAWA.jpg;9973;10485;35961;498;524;26
/net/per610a/home/mvp/mvp_db/news7-lv/2008/2008_12_24_19_00/2008_12_24_19_00.mpg;Ichiro OZAWA.jpg;15349;17049;35961;767;852;85
/net/per610a/home/mvp/mvp_db/news7-lv/2008/2008_12_24_19_00/2008_12_24_19_00.mpg;Ichiro OZAWA.jpg;18185;18349;35961;909;917;8
/net/per610a/home/mvp/mvp_db/news7-lv/2008/2008_12_24_19_00/2008_12_24_19_00.mpg;Yoshimi WATANABE.jpg;12361;12485;35961;618;624;6
/net/per610a/home/mvp/mvp_db/news7-lv/2008/2008_12_24_19_00/2008_12_24_19_00.mpg;Yoshimi WATANABE.jpg;12641;13561;35961;632;678;46
/net/per610a/home/mvp/mvp_db/news7-lv/2008/2008_12_24_19_00/2008_12_24_19_00.mpg;Yoshimi WATANABE.jpg;12537;12589;35961;627;629;2
/net/per610a/home/mvp/mvp_db/news7-lv/2008/2008_12_24_19_00/2008_12_24_19_00.mpg;Yoshimi WATANABE.jpg;20373;20685;35961;1019;1034;15
/net/per610a/home/mvp/mvp_db/news7-lv/2008/2008_12_26_19_00/2008_12_26_19_00.mpg;Taro ASO.jpg;14069;14669;35961;703;733;30
/net/per610a/home/mvp/mvp_db/news7-lv/2008/2008_12_31_19_00/2008_12_31_19_00.mpg;Taro ASO.jpg;14373;15033;23889;718;751;33
/net/per610a/home/mvp/mvp_db/news7-lv/2009/2009_01_01_19_00/2009_01_01_19_00.mpg;Yukiko Kada.jpg;8885;9021;23901;444;451;7
/net/per610a/home/mvp/mvp_db/news7-lv/2009/2009_01_01_19_00/2009_01_01_19_00.mpg;Taro ASO.jpg;13681;13769;23901;684;688;4
/net/per610a/home/mvp/mvp_db/news7-lv/2009/2009_01_01_19_00/2009_01_01_19_00.mpg;Taro ASO.jpg;15145;15761;23901;757;788;31
/net/per610a/home/mvp/mvp_db/news7-lv/2009/2009_01_01_19_00/2009_01_01_19_00.mpg;Taro ASO.jpg;13833;13865;23901;692;693;1
/net/per610a/home/mvp/mvp_db/news7-lv/2009/2009_01_01_19_00/2009_01_01_19_00.mpg;Taro ASO.jpg;15829;16169;23901;792;809;17
/net/per610a/home/mvp/mvp_db/news7-lv/2009/2009_01_01_19_00/2009_01_01_19_00.mpg;Ichiro OZAWA.jpg;16233;16565;23901;812;828;16
/net/per610a/home/mvp/mvp_db/news7-lv/2009/2009_01_01_19_00/2009_01_01_19_00.mpg;Akihiro OHTA.jpg;16557;16749;23901;828;838;10
/net/per610a/home/mvp/mvp_db/news7-lv/2009/2009_01_04_19_00/2009_01_04_19_00.mpg;Taro ASO.jpg;8909;9381;35961;445;469;24
/net/per610a/home/mvp/mvp_db/news7-lv/2009/2009_01_04_19_00/2009_01_04_19_00.mpg;Taro ASO.jpg;13749;14261;35961;687;713;26
/net/per610a/home/mvp/mvp_db/news7-lv/2009/2009_01_04_19_00/2009_01_04_19_00.mpg;Taro ASO.jpg;14701;14725;35961;735;736;1
/net/per610a/home/mvp/mvp_db/news7-lv/2009/2009_01_04_19_00/2009_01_04_19_00.mpg;Taro ASO.jpg;15061;15877;35961;753;794;41
/net/per610a/home/mvp/mvp_db/news7-lv/2009/2009_01_04_19_00/2009_01_04_19_00.mpg;Taro ASO.jpg;16301;17069;35961;815;853;38
/net/per610a/home/mvp/mvp_db/news7-lv/2009/2009_01_04_19_00/2009_01_04_19_00.mpg;Taro ASO.jpg;18757;19001;35961;938;950;12
/net/per610a/home/mvp/mvp_db/news7-lv/2009/2009_01_05_19_00/2009_01_05_19_00.mpg;Ichiro OZAWA.jpg;1;233;35961;0;11;11
/net/per610a/home/mvp/mvp_db/news7-lv/2009/2009_01_05_19_00/2009_01_05_19_00.mpg;Ichiro OZAWA.jpg;1097;1561;35961;54;78;24
/net/per610a/home/mvp/mvp_db/news7-lv/2009/2009_01_05_19_00/2009_01_05_19_00.mpg;Yukio HATOYAMA.jpg;2153;2357;35961;107;117;10
/net/per610a/home/mvp/mvp_db/news7-lv/2009/2009_01_05_19_00/2009_01_05_19_00.mpg;Taro ASO.jpg;4481;4997;35961;224;249;25
/net/per610a/home/mvp/mvp_db/news7-lv/2009/2009_01_05_19_00/2009_01_05_19_00.mpg;Ichiro OZAWA.jpg;5021;5961;35961;251;298;47
/net/per610a/home/mvp/mvp_db/news7-lv/2009/2009_01_05_19_00/2009_01_05_19_00.mpg;Yoshimi WATANABE.jpg;7385;8425;35961;369;421;52
/net/per610a/home/mvp/mvp_db/news7-lv/2009/2009_01_06_19_00/2009_01_06_19_00.mpg;Taro ASO.jpg;14233;14389;35957;712;719;7
/net/per610a/home/mvp/mvp_db/news7-lv/2009/2009_01_06_19_00/2009_01_06_19_00.mpg;Taro ASO.jpg;14785;15193;35957;739;760;21
/net/per610a/home/mvp/mvp_db/news7-lv/2009/2009_01_06_19_00/2009_01_06_19_00.mpg;Taro ASO.jpg;16361;16845;35957;818;842;24
/net/per610a/home/mvp/mvp_db/news7-lv/2009/2009_01_06_19_00/2009_01_06_19_00.mpg;Taro ASO.jpg;18921;19133;35957;946;957;11
/net/per610a/home/mvp/mvp_db/news7-lv/2009/2009_01_08_19_00/2009_01_08_19_00.mpg;Taro ASO.jpg;209;369;35961;10;18;8
/net/per610a/home/mvp/mvp_db/news7-lv/2009/2009_01_08_19_00/2009_01_08_19_00.mpg;Taro ASO.jpg;2521;3141;35961;126;157;31
/net/per610a/home/mvp/mvp_db/news7-lv/2009/2009_01_09_19_00/2009_01_09_19_00.mpg;Taro ASO.jpg;4689;4773;35961;234;238;4
/net/per610a/home/mvp/mvp_db/news7-lv/2009/2009_01_09_19_00/2009_01_09_19_00.mpg;Taro ASO.jpg;4901;5293;35961;245;264;19
/net/per610a/home/mvp/mvp_db/news7-lv/2009/2009_01_09_19_00/2009_01_09_19_00.mpg;Yukio HATOYAMA.jpg;7729;8029;35961;386;401;15
/net/per610a/home/mvp/mvp_db/news7-lv/2009/2009_01_09_19_00/2009_01_09_19_00.mpg;Yukio HATOYAMA.jpg;8145;8209;35961;407;410;3
/net/per610a/home/mvp/mvp_db/news7-lv/2009/2009_01_09_19_00/2009_01_09_19_00.mpg;Yoshimi WATANABE.jpg;8777;8777;35961;439;439;0
/net/per610a/home/mvp/mvp_db/news7-lv/2009/2009_01_09_19_00/2009_01_09_19_00.mpg;Yoshimi WATANABE.jpg;8945;9365;35961;447;468;21
/net/per610a/home/mvp/mvp_db/news7-lv/2009/2009_01_11_19_00/2009_01_11_19_00.mpg;Taro ASO.jpg;997;1021;35961;49;51;2
/net/per610a/home/mvp/mvp_db/news7-lv/2009/2009_01_11_19_00/2009_01_11_19_00.mpg;Taro ASO.jpg;1125;1133;35961;56;56;0
/net/per610a/home/mvp/mvp_db/news7-lv/2009/2009_01_11_19_00/2009_01_11_19_00.mpg;Taro ASO.jpg;1281;1341;35961;64;67;3
/net/per610a/home/mvp/mvp_db/news7-lv/2009/2009_01_11_19_00/2009_01_11_19_00.mpg;Taro ASO.jpg;3897;4181;35961;194;209;15
/net/per610a/home/mvp/mvp_db/news7-lv/2009/2009_01_11_19_00/2009_01_11_19_00.mpg;Taro ASO.jpg;4417;4749;35961;220;237;17
/net/per610a/home/mvp/mvp_db/news7-lv/2009/2009_01_11_19_00/2009_01_11_19_00.mpg;Taro ASO.jpg;3169;3873;35961;158;193;35
/net/per610a/home/mvp/mvp_db/news7-lv/2009/2009_01_12_19_00/2009_01_12_19_00.mpg;Taro ASO.jpg;65;373;35961;3;18;15
/net/per610a/home/mvp/mvp_db/news7-lv/2009/2009_01_12_19_00/2009_01_12_19_00.mpg;Taro ASO.jpg;1369;1369;35961;68;68;0
/net/per610a/home/mvp/mvp_db/news7-lv/2009/2009_01_12_19_00/2009_01_12_19_00.mpg;Taro ASO.jpg;2729;3157;35961;136;157;21
/net/per610a/home/mvp/mvp_db/news7-lv/2009/2009_01_12_19_00/2009_01_12_19_00.mpg;Taro ASO.jpg;3809;3881;35961;190;194;4
/net/per610a/home/mvp/mvp_db/news7-lv/2009/2009_01_12_19_00/2009_01_12_19_00.mpg;Taro ASO.jpg;3885;3945;35961;194;197;3
/net/per610a/home/mvp/mvp_db/news7-lv/2009/2009_01_12_19_00/2009_01_12_19_00.mpg;Taro ASO.jpg;6661;7861;35961;333;393;60
/net/per610a/home/mvp/mvp_db/news7-lv/2009/2009_01_12_19_00/2009_01_12_19_00.mpg;Yoshihiko Noda.jpg;4457;4717;35961;222;235;13
/net/per610a/home/mvp/mvp_db/news7-lv/2009/2009_01_13_19_00/2009_01_13_19_00.mpg;Taro ASO.jpg;77;149;35961;3;7;4
/net/per610a/home/mvp/mvp_db/news7-lv/2009/2009_01_13_19_00/2009_01_13_19_00.mpg;Taro ASO.jpg;4117;4185;35961;205;209;4
/net/per610a/home/mvp/mvp_db/news7-lv/2009/2009_01_13_19_00/2009_01_13_19_00.mpg;Taro ASO.jpg;14661;14821;35961;733;741;8
/net/per610a/home/mvp/mvp_db/news7-lv/2009/2009_01_13_19_00/2009_01_13_19_00.mpg;Taro ASO.jpg;15649;16857;35961;782;843;61
/net/per610a/home/mvp/mvp_db/news7-lv/2009/2009_01_13_19_00/2009_01_13_19_00.mpg;Taro ASO.jpg;1629;1929;35961;81;96;15
/net/per610a/home/mvp/mvp_db/news7-lv/2009/2009_01_13_19_00/2009_01_13_19_00.mpg;Taro ASO.jpg;7521;7601;35961;376;380;4
/net/per610a/home/mvp/mvp_db/news7-lv/2009/2009_01_13_19_00/2009_01_13_19_00.mpg;Taro ASO.jpg;12737;13665;35961;637;683;46
/net/per610a/home/mvp/mvp_db/news7-lv/2009/2009_01_13_19_00/2009_01_13_19_00.mpg;Yoshimi WATANABE.jpg;5241;5265;35961;262;263;1
/net/per610a/home/mvp/mvp_db/news7-lv/2009/2009_01_13_19_00/2009_01_13_19_00.mpg;Yoshimi WATANABE.jpg;10881;10921;35961;544;546;2
/net/per610a/home/mvp/mvp_db/news7-lv/2009/2009_01_13_19_00/2009_01_13_19_00.mpg;Yoshimi WATANABE.jpg;11241;11285;35961;562;564;2
/net/per610a/home/mvp/mvp_db/news7-lv/2009/2009_01_13_19_00/2009_01_13_19_00.mpg;Yoshimi WATANABE.jpg;5769;5989;35961;288;299;11
/net/per610a/home/mvp/mvp_db/news7-lv/2009/2009_01_13_19_00/2009_01_13_19_00.mpg;Yoshimi WATANABE.jpg;11333;11765;35961;566;588;22
/net/per610a/home/mvp/mvp_db/news7-lv/2009/2009_01_13_19_00/2009_01_13_19_00.mpg;Taro ASO.jpg;17373;17777;35961;869;889;20
/net/per610a/home/mvp/mvp_db/news7-lv/2009/2009_01_13_19_00/2009_01_13_19_00.mpg;Shintaro ISHIHARA.jpg;26213;26309;35961;1311;1316;5
/net/per610a/home/mvp/mvp_db/news7-lv/2009/2009_01_14_19_00/2009_01_14_19_00.mpg;Taro ASO.jpg;5957;6193;35961;298;309;11
/net/per610a/home/mvp/mvp_db/news7-lv/2009/2009_01_14_19_00/2009_01_14_19_00.mpg;Ichiro OZAWA.jpg;5957;6193;35961;298;309;11
/net/per610a/home/mvp/mvp_db/news7-lv/2009/2009_01_16_19_00/2009_01_16_19_00.mpg;Yoshimi WATANABE.jpg;13785;13873;35961;689;694;5
/net/per610a/home/mvp/mvp_db/news7-lv/2009/2009_01_16_19_00/2009_01_16_19_00.mpg;Yoshimi WATANABE.jpg;14141;15233;35961;707;762;55
/net/per610a/home/mvp/mvp_db/news7-lv/2009/2009_01_16_19_00/2009_01_16_19_00.mpg;Yoshimi WATANABE.jpg;15325;15337;35961;766;767;1
/net/per610a/home/mvp/mvp_db/news7-lv/2009/2009_01_18_19_00/2009_01_18_19_00.mpg;Ichiro OZAWA.jpg;1229;1313;35961;61;65;4
/net/per610a/home/mvp/mvp_db/news7-lv/2009/2009_01_18_19_00/2009_01_18_19_00.mpg;Ichiro OZAWA.jpg;1381;1381;35961;69;69;0
/net/per610a/home/mvp/mvp_db/news7-lv/2009/2009_01_18_19_00/2009_01_18_19_00.mpg;Ichiro OZAWA.jpg;8101;8913;35961;405;445;40
/net/per610a/home/mvp/mvp_db/news7-lv/2009/2009_01_18_19_00/2009_01_18_19_00.mpg;Ichiro OZAWA.jpg;9697;9833;35961;485;491;6
/net/per610a/home/mvp/mvp_db/news7-lv/2009/2009_01_18_19_00/2009_01_18_19_00.mpg;Ichiro OZAWA.jpg;10097;10341;35961;505;517;12
/net/per610a/home/mvp/mvp_db/news7-lv/2009/2009_01_18_19_00/2009_01_18_19_00.mpg;Akihiro OHTA.jpg;2501;2753;35961;125;137;12
/net/per610a/home/mvp/mvp_db/news7-lv/2009/2009_01_19_19_00/2009_01_19_19_00.mpg;Taro ASO.jpg;15265;15341;35957;763;767;4
/net/per610a/home/mvp/mvp_db/news7-lv/2009/2009_01_19_19_00/2009_01_19_19_00.mpg;Taro ASO.jpg;15433;15433;35957;772;772;0
/net/per610a/home/mvp/mvp_db/news7-lv/2009/2009_01_19_19_00/2009_01_19_19_00.mpg;Taro ASO.jpg;15553;15729;35957;778;786;8
/net/per610a/home/mvp/mvp_db/news7-lv/2009/2009_01_19_19_00/2009_01_19_19_00.mpg;Taro ASO.jpg;16177;16721;35957;809;836;27
/net/per610a/home/mvp/mvp_db/news7-lv/2009/2009_01_19_19_00/2009_01_19_19_00.mpg;Taro ASO.jpg;16793;17177;35957;840;859;19
/net/per610a/home/mvp/mvp_db/news7-lv/2009/2009_01_19_19_00/2009_01_19_19_00.mpg;Taro ASO.jpg;17249;17317;35957;863;866;3
/net/per610a/home/mvp/mvp_db/news7-lv/2009/2009_01_19_19_00/2009_01_19_19_00.mpg;Taro ASO.jpg;17529;17625;35957;877;881;4
/net/per610a/home/mvp/mvp_db/news7-lv/2009/2009_01_19_19_00/2009_01_19_19_00.mpg;Taro ASO.jpg;17721;18221;35957;886;911;25
/net/per610a/home/mvp/mvp_db/news7-lv/2009/2009_01_19_19_00/2009_01_19_19_00.mpg;Taro ASO.jpg;19057;19293;35957;953;965;12
/net/per610a/home/mvp/mvp_db/news7-lv/2009/2009_01_20_19_00/2009_01_20_19_00.mpg;Taro ASO.jpg;9593;9725;35961;479;486;7
/net/per610a/home/mvp/mvp_db/news7-lv/2009/2009_01_20_19_00/2009_01_20_19_00.mpg;Taro ASO.jpg;14105;14297;35961;705;715;10
/net/per610a/home/mvp/mvp_db/news7-lv/2009/2009_01_20_19_00/2009_01_20_19_00.mpg;Taro ASO.jpg;15249;15413;35961;762;771;9
/net/per610a/home/mvp/mvp_db/news7-lv/2009/2009_01_20_19_00/2009_01_20_19_00.mpg;Taro ASO.jpg;16037;16469;35961;802;823;21
/net/per610a/home/mvp/mvp_db/news7-lv/2009/2009_01_20_19_00/2009_01_20_19_00.mpg;Taro ASO.jpg;16721;17125;35961;836;856;20
/net/per610a/home/mvp/mvp_db/news7-lv/2009/2009_01_20_19_00/2009_01_20_19_00.mpg;Taro ASO.jpg;9773;9921;35961;488;496;8
/net/per610a/home/mvp/mvp_db/news7-lv/2009/2009_01_20_19_00/2009_01_20_19_00.mpg;Taro ASO.jpg;10041;10449;35961;502;522;20
/net/per610a/home/mvp/mvp_db/news7-lv/2009/2009_01_20_19_00/2009_01_20_19_00.mpg;Taro ASO.jpg;13801;14101;35961;690;705;15
/net/per610a/home/mvp/mvp_db/news7-lv/2009/2009_01_21_19_00/2009_01_21_19_00.mpg;Taro ASO.jpg;15769;16217;35961;788;811;23
/net/per610a/home/mvp/mvp_db/news7-lv/2009/2009_01_22_19_00/2009_01_22_19_00.mpg;Naoto KAN.jpg;16893;17377;35961;845;869;24
/net/per610a/home/mvp/mvp_db/news7-lv/2009/2009_01_24_19_00/2009_01_24_19_00.mpg;Yasuo FUKUDA.jpg;12077;12317;35961;604;616;12
/net/per610a/home/mvp/mvp_db/news7-lv/2009/2009_01_25_19_00/2009_01_25_19_00.mpg;Ichiro OZAWA.jpg;10013;10405;35961;500;520;20
/net/per610a/home/mvp/mvp_db/news7-lv/2009/2009_01_25_19_00/2009_01_25_19_00.mpg;Ichiro OZAWA.jpg;10481;10957;35961;524;548;24
/net/per610a/home/mvp/mvp_db/news7-lv/2009/2009_01_26_19_00/2009_01_26_19_00.mpg;Ichiro OZAWA.jpg;3837;4353;35961;191;217;26
/net/per610a/home/mvp/mvp_db/news7-lv/2009/2009_01_26_19_00/2009_01_26_19_00.mpg;Taro ASO.jpg;3837;4353;35961;191;217;26
/net/per610a/home/mvp/mvp_db/news7-lv/2009/2009_01_26_19_00/2009_01_26_19_00.mpg;Taro ASO.jpg;4921;4957;35961;246;247;1
/net/per610a/home/mvp/mvp_db/news7-lv/2009/2009_01_26_19_00/2009_01_26_19_00.mpg;Taro ASO.jpg;5177;5237;35961;258;261;3
/net/per610a/home/mvp/mvp_db/news7-lv/2009/2009_01_26_19_00/2009_01_26_19_00.mpg;Taro ASO.jpg;8309;8621;35961;415;431;16
/net/per610a/home/mvp/mvp_db/news7-lv/2009/2009_01_27_19_00/2009_01_27_19_00.mpg;Yukio HATOYAMA.jpg;405;785;35961;20;39;19
/net/per610a/home/mvp/mvp_db/news7-lv/2009/2009_01_27_19_00/2009_01_27_19_00.mpg;Yukio HATOYAMA.jpg;11169;11229;35961;558;561;3
/net/per610a/home/mvp/mvp_db/news7-lv/2009/2009_01_27_19_00/2009_01_27_19_00.mpg;Naoto KAN.jpg;15961;16273;35961;798;814;16
/net/per610a/home/mvp/mvp_db/news7-lv/2009/2009_01_27_19_00/2009_01_27_19_00.mpg;Naoto KAN.jpg;16353;16597;35961;818;830;12
/net/per610a/home/mvp/mvp_db/news7-lv/2009/2009_01_28_19_00/2009_01_28_19_00.mpg;Taro ASO.jpg;7301;7665;35961;365;383;18
/net/per610a/home/mvp/mvp_db/news7-lv/2009/2009_01_28_19_00/2009_01_28_19_00.mpg;Taro ASO.jpg;10237;10677;35961;512;534;22
/net/per610a/home/mvp/mvp_db/news7-lv/2009/2009_01_28_19_00/2009_01_28_19_00.mpg;Taro ASO.jpg;13693;14129;35961;685;706;21
/net/per610a/home/mvp/mvp_db/news7-lv/2009/2009_01_28_19_00/2009_01_28_19_00.mpg;Taro ASO.jpg;17145;17421;35961;857;871;14
/net/per610a/home/mvp/mvp_db/news7-lv/2009/2009_01_28_19_00/2009_01_28_19_00.mpg;Yasuo FUKUDA.jpg;10549;10677;35961;527;534;7
/net/per610a/home/mvp/mvp_db/news7-lv/2009/2009_01_29_19_00/2009_01_29_19_00.mpg;Yukio HATOYAMA.jpg;41;293;35961;2;14;12
/net/per610a/home/mvp/mvp_db/news7-lv/2009/2009_01_29_19_00/2009_01_29_19_00.mpg;Yukio HATOYAMA.jpg;1453;1513;35961;72;75;3
/net/per610a/home/mvp/mvp_db/news7-lv/2009/2009_01_29_19_00/2009_01_29_19_00.mpg;Yukio HATOYAMA.jpg;1685;3841;35961;84;192;108
/net/per610a/home/mvp/mvp_db/news7-lv/2009/2009_01_30_19_00/2009_01_30_19_00.mpg;Taro ASO.jpg;24825;25297;35961;1241;1265;24
/net/per610a/home/mvp/mvp_db/news7-lv/2009/2009_02_03_19_00/2009_02_03_19_00.mpg;Taro ASO.jpg;8981;9641;35961;449;482;33
/net/per610a/home/mvp/mvp_db/news7-lv/2009/2009_02_03_19_00/2009_02_03_19_00.mpg;Taro ASO.jpg;9849;10381;35961;492;519;27
/net/per610a/home/mvp/mvp_db/news7-lv/2009/2009_02_06_19_00/2009_02_06_19_00.mpg;Taro ASO.jpg;12569;12805;35961;628;640;12
/net/per610a/home/mvp/mvp_db/news7-lv/2009/2009_02_06_19_00/2009_02_06_19_00.mpg;Taro ASO.jpg;14457;14477;35961;723;724;1
/net/per610a/home/mvp/mvp_db/news7-lv/2009/2009_02_06_19_00/2009_02_06_19_00.mpg;Taro ASO.jpg;17717;18049;35961;886;902;16
/net/per610a/home/mvp/mvp_db/news7-lv/2009/2009_02_06_19_00/2009_02_06_19_00.mpg;Junichiro KOIZUMI.jpg;13457;13617;35961;673;681;8
/net/per610a/home/mvp/mvp_db/news7-lv/2009/2009_02_07_19_00/2009_02_07_19_00.mpg;Taro ASO.jpg;22273;22605;35961;1114;1130;16
/net/per610a/home/mvp/mvp_db/news7-lv/2009/2009_02_08_19_00/2009_02_08_19_00.mpg;Taro ASO.jpg;21285;22421;35961;1064;1121;57
/net/per610a/home/mvp/mvp_db/news7-lv/2009/2009_02_09_19_00/2009_02_09_19_00.mpg;Taro ASO.jpg;13225;13349;35961;661;667;6
/net/per610a/home/mvp/mvp_db/news7-lv/2009/2009_02_09_19_00/2009_02_09_19_00.mpg;Taro ASO.jpg;14681;15201;35961;734;760;26
/net/per610a/home/mvp/mvp_db/news7-lv/2009/2009_02_09_19_00/2009_02_09_19_00.mpg;Taro ASO.jpg;19285;19289;35961;964;964;0
/net/per610a/home/mvp/mvp_db/news7-lv/2009/2009_02_09_19_00/2009_02_09_19_00.mpg;Ichiro OZAWA.jpg;19209;19521;35961;960;976;16
/net/per610a/home/mvp/mvp_db/news7-lv/2009/2009_02_11_19_00/2009_02_11_19_00.mpg;Natsuo YAMAGUCHI.jpg;357;725;35961;17;36;19
/net/per610a/home/mvp/mvp_db/news7-lv/2009/2009_02_11_19_00/2009_02_11_19_00.mpg;Natsuo YAMAGUCHI.jpg;3289;4049;35961;164;202;38
/net/per610a/home/mvp/mvp_db/news7-lv/2009/2009_02_12_19_00/2009_02_12_19_00.mpg;Junichiro KOIZUMI.jpg;2389;2761;35961;119;138;19
/net/per610a/home/mvp/mvp_db/news7-lv/2009/2009_02_12_19_00/2009_02_12_19_00.mpg;Taro ASO.jpg;8865;9477;35961;443;474;31
/net/per610a/home/mvp/mvp_db/news7-lv/2009/2009_02_13_19_00/2009_02_13_19_00.mpg;Junichiro KOIZUMI.jpg;7289;7733;35961;364;386;22
/net/per610a/home/mvp/mvp_db/news7-lv/2009/2009_02_13_19_00/2009_02_13_19_00.mpg;Yukio HATOYAMA.jpg;11381;11773;35961;569;588;19
/net/per610a/home/mvp/mvp_db/news7-lv/2009/2009_02_13_19_00/2009_02_13_19_00.mpg;Taro ASO.jpg;11817;12617;35961;591;631;40
/net/per610a/home/mvp/mvp_db/news7-lv/2009/2009_02_14_19_00/2009_02_14_19_00.mpg;Taro ASO.jpg;4521;4937;35961;226;246;20
/net/per610a/home/mvp/mvp_db/news7-lv/2009/2009_02_14_19_00/2009_02_14_19_00.mpg;Taro ASO.jpg;15169;15589;35961;758;779;21
/net/per610a/home/mvp/mvp_db/news7-lv/2009/2009_02_14_19_00/2009_02_14_19_00.mpg;Taro ASO.jpg;16261;17045;35961;813;852;39
/net/per610a/home/mvp/mvp_db/news7-lv/2009/2009_02_14_19_00/2009_02_14_19_00.mpg;Ichiro OZAWA.jpg;15169;15589;35961;758;779;21
/net/per610a/home/mvp/mvp_db/news7-lv/2009/2009_02_14_19_00/2009_02_14_19_00.mpg;Ichiro OZAWA.jpg;17753;18817;35961;888;941;53
/net/per610a/home/mvp/mvp_db/news7-lv/2009/2009_02_15_19_00/2009_02_15_19_00.mpg;Taro ASO.jpg;2789;3181;35961;139;159;20
/net/per610a/home/mvp/mvp_db/news7-lv/2009/2009_02_16_19_00/2009_02_16_19_00.mpg;Yukio HATOYAMA.jpg;15209;15325;35961;760;766;6
/net/per610a/home/mvp/mvp_db/news7-lv/2009/2009_02_16_19_00/2009_02_16_19_00.mpg;Taro ASO.jpg;17061;17645;35961;853;882;29
/net/per610a/home/mvp/mvp_db/news7-lv/2009/2009_02_17_19_00/2009_02_17_19_00.mpg;Taro ASO.jpg;4857;5845;35961;242;292;50
/net/per610a/home/mvp/mvp_db/news7-lv/2009/2009_02_17_19_00/2009_02_17_19_00.mpg;Taro ASO.jpg;17217;17661;35961;861;883;22
/net/per610a/home/mvp/mvp_db/news7-lv/2009/2009_02_17_19_00/2009_02_17_19_00.mpg;Taro ASO.jpg;25117;25329;35961;1256;1267;11
/net/per610a/home/mvp/mvp_db/news7-lv/2009/2009_02_17_19_00/2009_02_17_19_00.mpg;Ichiro OZAWA.jpg;11025;12897;35961;551;645;94
/net/per610a/home/mvp/mvp_db/news7-lv/2009/2009_02_17_19_00/2009_02_17_19_00.mpg;Taro ASO.jpg;14357;14441;35961;718;722;4
/net/per610a/home/mvp/mvp_db/news7-lv/2009/2009_02_17_19_00/2009_02_17_19_00.mpg;Taro ASO.jpg;14917;14941;35961;746;747;1
/net/per610a/home/mvp/mvp_db/news7-lv/2009/2009_02_17_19_00/2009_02_17_19_00.mpg;Taro ASO.jpg;19825;20045;35961;991;1002;11
/net/per610a/home/mvp/mvp_db/news7-lv/2009/2009_02_18_19_00/2009_02_18_19_00.mpg;Ichiro OZAWA.jpg;4761;5513;35961;238;275;37
/net/per610a/home/mvp/mvp_db/news7-lv/2009/2009_02_18_19_00/2009_02_18_19_00.mpg;Junichiro KOIZUMI.jpg;6813;8069;35961;340;403;63
/net/per610a/home/mvp/mvp_db/news7-lv/2009/2009_02_18_19_00/2009_02_18_19_00.mpg;Junichiro KOIZUMI.jpg;8153;8357;35961;407;418;11
/net/per610a/home/mvp/mvp_db/news7-lv/2009/2009_02_19_19_00/2009_02_19_19_00.mpg;Taro ASO.jpg;3373;3985;35961;168;199;31
/net/per610a/home/mvp/mvp_db/news7-lv/2009/2009_02_19_19_00/2009_02_19_19_00.mpg;Taro ASO.jpg;9241;9353;35961;462;467;5
/net/per610a/home/mvp/mvp_db/news7-lv/2009/2009_02_24_19_00/2009_02_24_19_00.mpg;Taro ASO.jpg;4837;5269;35961;241;263;22
/net/per610a/home/mvp/mvp_db/news7-lv/2009/2009_02_24_19_00/2009_02_24_19_00.mpg;Taro ASO.jpg;5853;6889;35961;292;344;52
/net/per610a/home/mvp/mvp_db/news7-lv/2009/2009_02_24_19_00/2009_02_24_19_00.mpg;Taro ASO.jpg;7269;7281;35961;363;364;1
/net/per610a/home/mvp/mvp_db/news7-lv/2009/2009_02_25_19_00/2009_02_25_19_00.mpg;Taro ASO.jpg;7381;7649;35961;369;382;13
/net/per610a/home/mvp/mvp_db/news7-lv/2009/2009_02_25_19_00/2009_02_25_19_00.mpg;Taro ASO.jpg;7729;7873;35961;386;393;7
/net/per610a/home/mvp/mvp_db/news7-lv/2009/2009_02_26_19_00/2009_02_26_19_00.mpg;Ichiro OZAWA.jpg;7533;8025;35961;376;401;25
/net/per610a/home/mvp/mvp_db/news7-lv/2009/2009_02_26_19_00/2009_02_26_19_00.mpg;Naoto KAN.jpg;11505;11961;35961;575;598;23
/net/per610a/home/mvp/mvp_db/news7-lv/2009/2009_02_27_19_00/2009_02_27_19_00.mpg;Ichiro OZAWA.jpg;1;357;35961;0;17;17
/net/per610a/home/mvp/mvp_db/news7-lv/2009/2009_02_27_19_00/2009_02_27_19_00.mpg;Ichiro OZAWA.jpg;12489;12557;35961;624;628;4
/net/per610a/home/mvp/mvp_db/news7-lv/2009/2009_02_27_19_00/2009_02_27_19_00.mpg;Taro ASO.jpg;1241;1697;35961;62;84;22
/net/per610a/home/mvp/mvp_db/news7-lv/2009/2009_02_27_19_00/2009_02_27_19_00.mpg;Taro ASO.jpg;1821;1885;35961;91;94;3
/net/per610a/home/mvp/mvp_db/news7-lv/2009/2009_02_27_19_00/2009_02_27_19_00.mpg;Taro ASO.jpg;1997;2189;35961;99;109;10
/net/per610a/home/mvp/mvp_db/news7-lv/2009/2009_02_27_19_00/2009_02_27_19_00.mpg;Taro ASO.jpg;2397;2409;35961;119;120;1
/net/per610a/home/mvp/mvp_db/news7-lv/2009/2009_02_27_19_00/2009_02_27_19_00.mpg;Taro ASO.jpg;9837;10521;35961;492;526;34
/net/per610a/home/mvp/mvp_db/news7-lv/2009/2009_02_27_19_00/2009_02_27_19_00.mpg;Taro ASO.jpg;11349;11457;35961;567;573;6
/net/per610a/home/mvp/mvp_db/news7-lv/2009/2009_02_27_19_00/2009_02_27_19_00.mpg;Taro ASO.jpg;11537;11545;35961;577;577;0
/net/per610a/home/mvp/mvp_db/news7-lv/2009/2009_03_01_19_00/2009_03_01_19_00.mpg;Toru Hashimoto.jpg;17321;17545;35961;866;877;11
/net/per610a/home/mvp/mvp_db/news7-lv/2009/2009_03_02_19_00/2009_03_02_19_00.mpg;Taro ASO.jpg;97;405;35961;4;20;16
/net/per610a/home/mvp/mvp_db/news7-lv/2009/2009_03_02_19_00/2009_03_02_19_00.mpg;Taro ASO.jpg;1565;1849;35961;78;92;14
/net/per610a/home/mvp/mvp_db/news7-lv/2009/2009_03_02_19_00/2009_03_02_19_00.mpg;Taro ASO.jpg;2561;3173;35961;128;158;30
/net/per610a/home/mvp/mvp_db/news7-lv/2009/2009_03_02_19_00/2009_03_02_19_00.mpg;Taro ASO.jpg;4189;4213;35961;209;210;1
/net/per610a/home/mvp/mvp_db/news7-lv/2009/2009_03_02_19_00/2009_03_02_19_00.mpg;Yukio HATOYAMA.jpg;4789;5837;35961;239;292;53
/net/per610a/home/mvp/mvp_db/news7-lv/2009/2009_03_02_19_00/2009_03_02_19_00.mpg;Takeo Hiranuma.jpeg;12793;13021;35961;639;651;12
/net/per610a/home/mvp/mvp_db/news7-lv/2009/2009_03_03_19_00/2009_03_03_19_00.mpg;Ichiro OZAWA.jpg;3829;4305;35961;191;215;24
/net/per610a/home/mvp/mvp_db/news7-lv/2009/2009_03_03_19_00/2009_03_03_19_00.mpg;Yukio HATOYAMA.jpg;19541;19605;35961;977;980;3
/net/per610a/home/mvp/mvp_db/news7-lv/2009/2009_03_04_19_00/2009_03_04_19_00.mpg;Taro ASO.jpg;709;769;35961;35;38;3
/net/per610a/home/mvp/mvp_db/news7-lv/2009/2009_03_04_19_00/2009_03_04_19_00.mpg;Taro ASO.jpg;11801;12209;35961;590;610;20
/net/per610a/home/mvp/mvp_db/news7-lv/2009/2009_03_04_19_00/2009_03_04_19_00.mpg;Taro ASO.jpg;19365;19421;35961;968;971;3
/net/per610a/home/mvp/mvp_db/news7-lv/2009/2009_03_04_19_00/2009_03_04_19_00.mpg;Yukio HATOYAMA.jpg;8501;8769;35961;425;438;13
/net/per610a/home/mvp/mvp_db/news7-lv/2009/2009_03_04_19_00/2009_03_04_19_00.mpg;Kazuo SHII.jpg;10581;11757;35961;529;588;59
/net/per610a/home/mvp/mvp_db/news7-lv/2009/2009_03_04_19_00/2009_03_04_19_00.mpg;Yasuo FUKUDA.jpg;19589;19873;35961;979;994;15
/net/per610a/home/mvp/mvp_db/news7-lv/2009/2009_03_05_19_00/2009_03_05_19_00.mpg;Naoto KAN.jpg;873;1033;35961;43;51;8
/net/per610a/home/mvp/mvp_db/news7-lv/2009/2009_03_05_19_00/2009_03_05_19_00.mpg;Ichiro OZAWA.jpg;10653;10989;35961;532;549;17
/net/per610a/home/mvp/mvp_db/news7-lv/2009/2009_03_05_19_00/2009_03_05_19_00.mpg;Taro ASO.jpg;23513;24097;35961;1176;1205;29
/net/per610a/home/mvp/mvp_db/news7-lv/2009/2009_03_06_19_00/2009_03_06_19_00.mpg;Ichiro OZAWA.jpg;1433;1433;35961;71;71;0
/net/per610a/home/mvp/mvp_db/news7-lv/2009/2009_03_06_19_00/2009_03_06_19_00.mpg;Ichiro OZAWA.jpg;1533;1553;35961;76;77;1
/net/per610a/home/mvp/mvp_db/news7-lv/2009/2009_03_06_19_00/2009_03_06_19_00.mpg;Ichiro OZAWA.jpg;1997;1997;35961;99;99;0
/net/per610a/home/mvp/mvp_db/news7-lv/2009/2009_03_06_19_00/2009_03_06_19_00.mpg;Ichiro OZAWA.jpg;9785;10297;35961;489;515;26
/net/per610a/home/mvp/mvp_db/news7-lv/2009/2009_03_06_19_00/2009_03_06_19_00.mpg;Ichiro OZAWA.jpg;6497;8289;35961;325;414;89
/net/per610a/home/mvp/mvp_db/news7-lv/2009/2009_03_06_19_00/2009_03_06_19_00.mpg;Ichiro OZAWA.jpg;10661;10877;35961;533;544;11
/net/per610a/home/mvp/mvp_db/news7-lv/2009/2009_03_06_19_00/2009_03_06_19_00.mpg;Yukio HATOYAMA.jpg;17129;18041;35961;856;902;46
/net/per610a/home/mvp/mvp_db/news7-lv/2009/2009_03_06_19_00/2009_03_06_19_00.mpg;Taro ASO.jpg;26949;27421;35961;1348;1371;23
/net/per610a/home/mvp/mvp_db/news7-lv/2009/2009_03_06_19_00/2009_03_06_19_00.mpg;Shintaro ISHIHARA.jpg;28653;28945;35961;1433;1448;15
/net/per610a/home/mvp/mvp_db/news7-lv/2009/2009_03_07_19_00/2009_03_07_19_00.mpg;Ichiro OZAWA.jpg;4109;4129;35961;205;206;1
/net/per610a/home/mvp/mvp_db/news7-lv/2009/2009_03_07_19_00/2009_03_07_19_00.mpg;Ichiro OZAWA.jpg;5253;5401;35961;262;270;8
/net/per610a/home/mvp/mvp_db/news7-lv/2009/2009_03_08_19_00/2009_03_08_19_00.mpg;Ichiro OZAWA.jpg;4893;5305;35961;244;265;21
/net/per610a/home/mvp/mvp_db/news7-lv/2009/2009_03_09_19_00/2009_03_09_19_00.mpg;Ichiro OZAWA.jpg;12981;14133;35961;649;707;58
/net/per610a/home/mvp/mvp_db/news7-lv/2009/2009_03_09_19_00/2009_03_09_19_00.mpg;Ichiro OZAWA.jpg;15633;16041;35961;782;802;20
/net/per610a/home/mvp/mvp_db/news7-lv/2009/2009_03_09_19_00/2009_03_09_19_00.mpg;Taro ASO.jpg;15633;16041;35961;782;802;20
/net/per610a/home/mvp/mvp_db/news7-lv/2009/2009_03_09_19_00/2009_03_09_19_00.mpg;Taro ASO.jpg;16673;16953;35961;834;848;14
/net/per610a/home/mvp/mvp_db/news7-lv/2009/2009_03_09_19_00/2009_03_09_19_00.mpg;Yukio HATOYAMA.jpg;17001;18029;35961;850;901;51
/net/per610a/home/mvp/mvp_db/news7-lv/2009/2009_03_10_19_00/2009_03_10_19_00.mpg;Ichiro OZAWA.jpg;8205;8437;35961;410;422;12
/net/per610a/home/mvp/mvp_db/news7-lv/2009/2009_03_11_19_00/2009_03_11_19_00.mpg;Taro ASO.jpg;11741;12369;35961;587;618;31
/net/per610a/home/mvp/mvp_db/news7-lv/2009/2009_03_11_19_00/2009_03_11_19_00.mpg;Ichiro OZAWA.jpg;16885;17525;35961;844;876;32
/net/per610a/home/mvp/mvp_db/news7-lv/2009/2009_03_11_19_00/2009_03_11_19_00.mpg;Ichiro OZAWA.jpg;21029;21485;35961;1052;1074;22
/net/per610a/home/mvp/mvp_db/news7-lv/2009/2009_03_11_19_00/2009_03_11_19_00.mpg;Ichiro OZAWA.jpg;22149;22153;35961;1108;1108;0
/net/per610a/home/mvp/mvp_db/news7-lv/2009/2009_03_11_19_00/2009_03_11_19_00.mpg;Ichiro OZAWA.jpg;21781;21893;35961;1089;1095;6
/net/per610a/home/mvp/mvp_db/news7-lv/2009/2009_03_12_19_00/2009_03_12_19_00.mpg;Ichiro OZAWA.jpg;3325;3825;35961;166;191;25
/net/per610a/home/mvp/mvp_db/news7-lv/2009/2009_03_13_19_00/2009_03_13_19_00.mpg;Yukio HATOYAMA.jpg;14161;15321;35961;708;766;58
/net/per610a/home/mvp/mvp_db/news7-lv/2009/2009_03_15_19_00/2009_03_15_19_00.mpg;Taro ASO.jpg;1917;2853;35961;95;142;47
/net/per610a/home/mvp/mvp_db/news7-lv/2009/2009_03_15_19_00/2009_03_15_19_00.mpg;Taro ASO.jpg;4149;4217;35961;207;210;3
/net/per610a/home/mvp/mvp_db/news7-lv/2009/2009_03_15_19_00/2009_03_15_19_00.mpg;Taro ASO.jpg;4285;4769;35961;214;238;24
/net/per610a/home/mvp/mvp_db/news7-lv/2009/2009_03_17_19_00/2009_03_17_19_00.mpg;Ichiro OZAWA.jpg;1793;2517;35961;89;125;36
/net/per610a/home/mvp/mvp_db/news7-lv/2009/2009_03_17_19_00/2009_03_17_19_00.mpg;Taro ASO.jpg;4521;4725;35961;226;236;10
/net/per610a/home/mvp/mvp_db/news7-lv/2009/2009_03_20_19_00/2009_03_20_19_00.mpg;Taro ASO.jpg;14029;14029;35961;701;701;0
/net/per610a/home/mvp/mvp_db/news7-lv/2009/2009_03_20_19_00/2009_03_20_19_00.mpg;Taro ASO.jpg;14293;14325;35961;715;716;1
/net/per610a/home/mvp/mvp_db/news7-lv/2009/2009_03_20_19_00/2009_03_20_19_00.mpg;Taro ASO.jpg;14493;14493;35961;725;725;0
/net/per610a/home/mvp/mvp_db/news7-lv/2009/2009_03_20_19_00/2009_03_20_19_00.mpg;Taro ASO.jpg;16821;16993;35961;841;850;9
/net/per610a/home/mvp/mvp_db/news7-lv/2009/2009_03_24_19_00/2009_03_24_19_00.mpg;Yukio HATOYAMA.jpg;3245;3333;35961;162;166;4
/net/per610a/home/mvp/mvp_db/news7-lv/2009/2009_03_24_19_00/2009_03_24_19_00.mpg;Taro ASO.jpg;6241;6621;35961;312;331;19
/net/per610a/home/mvp/mvp_db/news7-lv/2009/2009_03_25_19_00/2009_03_25_19_00.mpg;Yukio EDANO.jpg;10381;12237;35961;519;612;93
/net/per610a/home/mvp/mvp_db/news7-lv/2009/2009_03_25_19_00/2009_03_25_19_00.mpg;Yukio HATOYAMA.jpg;12313;13725;35961;615;686;71
/net/per610a/home/mvp/mvp_db/news7-lv/2009/2009_03_26_19_00/2009_03_26_19_00.mpg;Taro ASO.jpg;7653;8097;35961;382;405;23
/net/per610a/home/mvp/mvp_db/news7-lv/2009/2009_03_27_19_00/2009_03_27_19_00.mpg;Taro ASO.jpg;2345;2565;35961;117;128;11
/net/per610a/home/mvp/mvp_db/news7-lv/2009/2009_03_27_19_00/2009_03_27_19_00.mpg;Taro ASO.jpg;20257;20557;35961;1013;1028;15
/net/per610a/home/mvp/mvp_db/news7-lv/2009/2009_03_27_19_00/2009_03_27_19_00.mpg;Taro ASO.jpg;23197;23329;35961;1160;1167;7
/net/per610a/home/mvp/mvp_db/news7-lv/2009/2009_03_27_19_00/2009_03_27_19_00.mpg;Shinzo ABE.jpg;12889;13029;35961;644;651;7
/net/per610a/home/mvp/mvp_db/news7-lv/2009/2009_03_27_19_00/2009_03_27_19_00.mpg;Ichiro OZAWA.jpg;24021;24405;35961;1201;1220;19
/net/per610a/home/mvp/mvp_db/news7-lv/2009/2009_03_27_19_00/2009_03_27_19_00.mpg;Ichiro OZAWA.jpg;24525;25241;35961;1226;1262;36
/net/per610a/home/mvp/mvp_db/news7-lv/2009/2009_03_27_19_00/2009_03_27_19_00.mpg;Ichiro OZAWA.jpg;26457;26629;35961;1323;1332;9
/net/per610a/home/mvp/mvp_db/news7-lv/2009/2009_03_28_19_00/2009_03_28_19_00.mpg;Akihiro OHTA.jpg;12781;13433;35961;639;672;33
/net/per610a/home/mvp/mvp_db/news7-lv/2009/2009_03_28_19_00/2009_03_28_19_00.mpg;Yukio HATOYAMA.jpg;17969;19489;35961;898;974;76
/net/per610a/home/mvp/mvp_db/news7-lv/2009/2009_03_28_19_00/2009_03_28_19_00.mpg;Ichiro OZAWA.jpg;17969;18365;35961;898;918;20
/net/per610a/home/mvp/mvp_db/news7-lv/2009/2009_03_29_19_00/2009_03_29_19_00.mpg;Yukio HATOYAMA.jpg;5301;6961;35961;265;348;83
/net/per610a/home/mvp/mvp_db/news7-lv/2009/2009_03_30_19_00/2009_03_30_19_00.mpg;Yukio HATOYAMA.jpg;721;885;35961;36;44;8
/net/per610a/home/mvp/mvp_db/news7-lv/2009/2009_03_30_19_00/2009_03_30_19_00.mpg;Yukio HATOYAMA.jpg;14281;14737;35961;714;737;23
/net/per610a/home/mvp/mvp_db/news7-lv/2009/2009_03_30_19_00/2009_03_30_19_00.mpg;Taro ASO.jpg;10477;11241;35961;524;562;38
/net/per610a/home/mvp/mvp_db/news7-lv/2009/2009_03_31_19_00/2009_03_31_19_00.mpg;Ichiro OZAWA.jpg;6085;6429;35961;304;321;17
/net/per610a/home/mvp/mvp_db/news7-lv/2009/2009_04_01_19_00/2009_04_01_19_00.mpg;Masashi Nakano.jpg;2753;2969;35961;137;148;11
/net/per610a/home/mvp/mvp_db/news7-lv/2009/2009_04_02_19_00/2009_04_02_19_00.mpg;Taro ASO.jpg;18461;19653;35961;923;983;60
/net/per610a/home/mvp/mvp_db/news7-lv/2009/2009_04_02_19_00/2009_04_02_19_00.mpg;Yukio HATOYAMA.jpg;20921;21033;35961;1046;1052;6
/net/per610a/home/mvp/mvp_db/news7-lv/2009/2009_04_02_19_00/2009_04_02_19_00.mpg;Naoto KAN.jpg;21441;21885;35961;1072;1094;22
/net/per610a/home/mvp/mvp_db/news7-lv/2009/2009_04_04_19_00/2009_04_04_19_00.mpg;Yukio HATOYAMA.jpg;24253;24361;35961;1213;1218;5
/net/per610a/home/mvp/mvp_db/news7-lv/2009/2009_04_05_19_00/2009_04_05_19_00.mpg;Taro ASO.jpg;417;561;35961;20;28;8
/net/per610a/home/mvp/mvp_db/news7-lv/2009/2009_04_05_19_00/2009_04_05_19_00.mpg;Taro ASO.jpg;4561;4617;35961;228;230;2
/net/per610a/home/mvp/mvp_db/news7-lv/2009/2009_04_05_19_00/2009_04_05_19_00.mpg;Taro ASO.jpg;20873;21237;35961;1044;1062;18
/net/per610a/home/mvp/mvp_db/news7-lv/2009/2009_04_06_19_00/2009_04_06_19_00.mpg;Taro ASO.jpg;13069;13089;35961;653;654;1
/net/per610a/home/mvp/mvp_db/news7-lv/2009/2009_04_06_19_00/2009_04_06_19_00.mpg;Taro ASO.jpg;13181;13341;35961;659;667;8
/net/per610a/home/mvp/mvp_db/news7-lv/2009/2009_04_06_19_00/2009_04_06_19_00.mpg;Taro ASO.jpg;13465;14077;35961;673;704;31
/net/per610a/home/mvp/mvp_db/news7-lv/2009/2009_04_06_19_00/2009_04_06_19_00.mpg;Taro ASO.jpg;18277;18697;35961;914;935;21
/net/per610a/home/mvp/mvp_db/news7-lv/2009/2009_04_07_19_00/2009_04_07_19_00.mpg;Taro ASO.jpg;11113;11197;35961;555;560;5
/net/per610a/home/mvp/mvp_db/news7-lv/2009/2009_04_07_19_00/2009_04_07_19_00.mpg;Taro ASO.jpg;11325;11637;35961;566;582;16
/net/per610a/home/mvp/mvp_db/news7-lv/2009/2009_04_08_19_00/2009_04_08_19_00.mpg;Taro ASO.jpg;825;1329;35961;41;66;25
/net/per610a/home/mvp/mvp_db/news7-lv/2009/2009_04_08_19_00/2009_04_08_19_00.mpg;Taro ASO.jpg;3537;3617;35961;176;180;4
/net/per610a/home/mvp/mvp_db/news7-lv/2009/2009_04_08_19_00/2009_04_08_19_00.mpg;Natsuo YAMAGUCHI.jpg;2089;2197;35961;104;109;5
/net/per610a/home/mvp/mvp_db/news7-lv/2009/2009_04_08_19_00/2009_04_08_19_00.mpg;Ichiro OZAWA.jpg;7041;7405;35961;352;370;18
/net/per610a/home/mvp/mvp_db/news7-lv/2009/2009_04_08_19_00/2009_04_08_19_00.mpg;Ichiro OZAWA.jpg;7573;7733;35961;378;386;8
/net/per610a/home/mvp/mvp_db/news7-lv/2009/2009_04_09_19_00/2009_04_09_19_00.mpg;Taro ASO.jpg;11949;13081;35961;597;654;57
/net/per610a/home/mvp/mvp_db/news7-lv/2009/2009_04_09_19_00/2009_04_09_19_00.mpg;Naoto KAN.jpg;13301;14041;35961;665;702;37
/net/per610a/home/mvp/mvp_db/news7-lv/2009/2009_04_10_19_00/2009_04_10_19_00.mpg;Taro ASO.jpg;1809;2173;35961;90;108;18
/net/per610a/home/mvp/mvp_db/news7-lv/2009/2009_04_10_19_00/2009_04_10_19_00.mpg;Taro ASO.jpg;3049;3317;35961;152;165;13
/net/per610a/home/mvp/mvp_db/news7-lv/2009/2009_04_10_19_00/2009_04_10_19_00.mpg;Taro ASO.jpg;26349;27393;35961;1318;1370;52
/net/per610a/home/mvp/mvp_db/news7-lv/2009/2009_04_10_19_00/2009_04_10_19_00.mpg;Yukio HATOYAMA.jpg;12489;13425;35961;624;671;47
/net/per610a/home/mvp/mvp_db/news7-lv/2009/2009_04_10_19_00/2009_04_10_19_00.mpg;Taro ASO.jpg;25013;25101;35961;1251;1255;4
/net/per610a/home/mvp/mvp_db/news7-lv/2009/2009_04_10_19_00/2009_04_10_19_00.mpg;Shintaro ISHIHARA.jpg;29421;29577;35961;1471;1479;8
/net/per610a/home/mvp/mvp_db/news7-lv/2009/2009_04_13_19_00/2009_04_13_19_00.mpg;Taro ASO.jpg;10613;10661;35961;530;533;3
/net/per610a/home/mvp/mvp_db/news7-lv/2009/2009_04_13_19_00/2009_04_13_19_00.mpg;Taro ASO.jpg;13905;14289;35961;695;714;19
/net/per610a/home/mvp/mvp_db/news7-lv/2009/2009_04_13_19_00/2009_04_13_19_00.mpg;Ichiro OZAWA.jpg;12125;12589;35961;606;629;23
/net/per610a/home/mvp/mvp_db/news7-lv/2009/2009_04_13_19_00/2009_04_13_19_00.mpg;Ichiro OZAWA.jpg;13905;14289;35961;695;714;19
/net/per610a/home/mvp/mvp_db/news7-lv/2009/2009_04_13_19_00/2009_04_13_19_00.mpg;Shintaro ISHIHARA.jpg;32621;32809;35961;1631;1641;10
/net/per610a/home/mvp/mvp_db/news7-lv/2009/2009_04_17_19_00/2009_04_17_19_00.mpg;Masashi Nakano.jpg;23065;23069;35961;1153;1154;1
/net/per610a/home/mvp/mvp_db/news7-lv/2009/2009_04_17_19_00/2009_04_17_19_00.mpg;Masashi Nakano.jpg;24629;25109;35961;1232;1256;24
/net/per610a/home/mvp/mvp_db/news7-lv/2009/2009_04_18_19_00/2009_04_18_19_00.mpg;Taro ASO.jpg;5577;6833;35961;278;341;63
/net/per610a/home/mvp/mvp_db/news7-lv/2009/2009_04_19_19_00/2009_04_19_19_00.mpg;Shintaro ISHIHARA.jpg;3265;3273;35961;163;163;0
/net/per610a/home/mvp/mvp_db/news7-lv/2009/2009_04_19_19_00/2009_04_19_19_00.mpg;Shintaro ISHIHARA.jpg;5081;5309;35961;254;265;11
/net/per610a/home/mvp/mvp_db/news7-lv/2009/2009_04_19_19_00/2009_04_19_19_00.mpg;Shintaro ISHIHARA.jpg;10513;11581;35961;525;579;54
/net/per610a/home/mvp/mvp_db/news7-lv/2009/2009_04_19_19_00/2009_04_19_19_00.mpg;Shintaro ISHIHARA.jpg;6941;7173;35961;347;358;11
/net/per610a/home/mvp/mvp_db/news7-lv/2009/2009_04_20_19_00/2009_04_20_19_00.mpg;Taro ASO.jpg;17989;18325;35961;899;916;17
/net/per610a/home/mvp/mvp_db/news7-lv/2009/2009_04_20_19_00/2009_04_20_19_00.mpg;Taro ASO.jpg;21157;21569;35961;1058;1079;21
/net/per610a/home/mvp/mvp_db/news7-lv/2009/2009_04_20_19_00/2009_04_20_19_00.mpg;Yukio HATOYAMA.jpg;19693;20253;35961;985;1013;28
/net/per610a/home/mvp/mvp_db/news7-lv/2009/2009_04_21_19_00/2009_04_21_19_00.mpg;Taro ASO.jpg;12725;13057;35961;636;653;17
/net/per610a/home/mvp/mvp_db/news7-lv/2009/2009_04_21_19_00/2009_04_21_19_00.mpg;Taro ASO.jpg;16205;16325;35961;810;816;6
/net/per610a/home/mvp/mvp_db/news7-lv/2009/2009_04_22_19_00/2009_04_22_19_00.mpg;Yukio HATOYAMA.jpg;305;725;35961;15;36;21
/net/per610a/home/mvp/mvp_db/news7-lv/2009/2009_04_22_19_00/2009_04_22_19_00.mpg;Yukio HATOYAMA.jpg;3537;4489;35961;176;224;48
/net/per610a/home/mvp/mvp_db/news7-lv/2009/2009_04_22_19_00/2009_04_22_19_00.mpg;Katsuya OKADA.jpg;5105;5741;35961;255;287;32
/net/per610a/home/mvp/mvp_db/news7-lv/2009/2009_04_24_19_00/2009_04_24_19_00.mpg;Toru Hashimoto.jpg;13237;13525;35961;662;676;14
/net/per610a/home/mvp/mvp_db/news7-lv/2009/2009_04_26_19_00/2009_04_26_19_00.mpg;Taro ASO.jpg;329;465;35961;16;23;7
/net/per610a/home/mvp/mvp_db/news7-lv/2009/2009_04_26_19_00/2009_04_26_19_00.mpg;Taro ASO.jpg;9709;10033;35961;485;501;16
/net/per610a/home/mvp/mvp_db/news7-lv/2009/2009_04_26_19_00/2009_04_26_19_00.mpg;Taro ASO.jpg;17337;17921;35961;867;896;29
/net/per610a/home/mvp/mvp_db/news7-lv/2009/2009_04_27_19_00/2009_04_27_19_00.mpg;Taro ASO.jpg;693;769;35961;34;38;4
/net/per610a/home/mvp/mvp_db/news7-lv/2009/2009_04_27_19_00/2009_04_27_19_00.mpg;Taro ASO.jpg;19477;19809;35961;974;990;16
/net/per610a/home/mvp/mvp_db/news7-lv/2009/2009_04_27_19_00/2009_04_27_19_00.mpg;Taro ASO.jpg;22429;23197;35961;1122;1160;38
/net/per610a/home/mvp/mvp_db/news7-lv/2009/2009_04_27_19_00/2009_04_27_19_00.mpg;Yukio HATOYAMA.jpg;23629;23901;35961;1182;1195;13
/net/per610a/home/mvp/mvp_db/news7-lv/2009/2009_04_28_19_00/2009_04_28_19_00.mpg;Taro ASO.jpg;22409;23229;35961;1121;1162;41
/net/per610a/home/mvp/mvp_db/news7-lv/2009/2009_04_28_19_00/2009_04_28_19_00.mpg;Yukio HATOYAMA.jpg;23749;24205;35961;1188;1210;22
/net/per610a/home/mvp/mvp_db/news7-lv/2009/2009_04_30_19_00/2009_04_30_19_00.mpg;Taro ASO.jpg;18449;18897;35961;922;945;23
/net/per610a/home/mvp/mvp_db/news7-lv/2009/2009_04_30_19_00/2009_04_30_19_00.mpg;Taro ASO.jpg;19073;19109;35961;954;955;1
/net/per610a/home/mvp/mvp_db/news7-lv/2009/2009_04_30_19_00/2009_04_30_19_00.mpg;Taro ASO.jpg;19209;20677;35961;960;1034;74
/net/per610a/home/mvp/mvp_db/news7-lv/2009/2009_04_30_19_00/2009_04_30_19_00.mpg;Taro ASO.jpg;30793;32245;35961;1540;1613;73
/net/per610a/home/mvp/mvp_db/news7-lv/2009/2009_05_02_19_00/2009_05_02_19_00.mpg;Natsuo YAMAGUCHI.jpg;3349;3577;35961;167;178;11
/net/per610a/home/mvp/mvp_db/news7-lv/2009/2009_05_02_19_00/2009_05_02_19_00.mpg;Shintaro ISHIHARA.jpg;28873;29117;35961;1444;1456;12
/net/per610a/home/mvp/mvp_db/news7-lv/2009/2009_05_07_19_00/2009_05_07_19_00.mpg;Taro ASO.jpg;20885;21605;35961;1044;1080;36
/net/per610a/home/mvp/mvp_db/news7-lv/2009/2009_05_10_19_00/2009_05_10_19_00.mpg;Taro ASO.jpg;7025;7777;35961;351;389;38
/net/per610a/home/mvp/mvp_db/news7-lv/2009/2009_05_10_19_00/2009_05_10_19_00.mpg;Yukio HATOYAMA.jpg;14621;15657;35961;731;783;52
/net/per610a/home/mvp/mvp_db/news7-lv/2009/2009_05_11_19_00/2009_05_11_19_00.mpg;Ichiro OZAWA.jpg;1613;2117;35961;80;105;25
/net/per610a/home/mvp/mvp_db/news7-lv/2009/2009_05_11_19_00/2009_05_11_19_00.mpg;Ichiro OZAWA.jpg;4225;4349;35961;211;217;6
/net/per610a/home/mvp/mvp_db/news7-lv/2009/2009_05_11_19_00/2009_05_11_19_00.mpg;Ichiro OZAWA.jpg;5093;5577;35961;254;278;24
/net/per610a/home/mvp/mvp_db/news7-lv/2009/2009_05_11_19_00/2009_05_11_19_00.mpg;Ichiro OZAWA.jpg;6565;7073;35961;328;353;25
/net/per610a/home/mvp/mvp_db/news7-lv/2009/2009_05_11_19_00/2009_05_11_19_00.mpg;Ichiro OZAWA.jpg;7505;7989;35961;375;399;24
/net/per610a/home/mvp/mvp_db/news7-lv/2009/2009_05_11_19_00/2009_05_11_19_00.mpg;Ichiro OZAWA.jpg;18145;20277;35961;907;1014;107
/net/per610a/home/mvp/mvp_db/news7-lv/2009/2009_05_11_19_00/2009_05_11_19_00.mpg;Yukio HATOYAMA.jpg;8817;12381;35961;441;619;178
/net/per610a/home/mvp/mvp_db/news7-lv/2009/2009_05_11_19_00/2009_05_11_19_00.mpg;Taro ASO.jpg;21409;21777;35961;1071;1089;18
/net/per610a/home/mvp/mvp_db/news7-lv/2009/2009_05_11_19_00/2009_05_11_19_00.mpg;Taro ASO.jpg;22125;22209;35961;1106;1111;5
/net/per610a/home/mvp/mvp_db/news7-lv/2009/2009_05_11_19_00/2009_05_11_19_00.mpg;Taro ASO.jpg;22549;23005;35961;1128;1150;22
/net/per610a/home/mvp/mvp_db/news7-lv/2009/2009_05_12_19_00/2009_05_12_19_00.mpg;Yukio HATOYAMA.jpg;2201;2421;35961;110;121;11
/net/per610a/home/mvp/mvp_db/news7-lv/2009/2009_05_12_19_00/2009_05_12_19_00.mpg;Yukio HATOYAMA.jpg;3341;3673;35961;167;183;16
/net/per610a/home/mvp/mvp_db/news7-lv/2009/2009_05_12_19_00/2009_05_12_19_00.mpg;Yukio HATOYAMA.jpg;6401;6421;35961;320;321;1
/net/per610a/home/mvp/mvp_db/news7-lv/2009/2009_05_12_19_00/2009_05_12_19_00.mpg;Yukio HATOYAMA.jpg;7409;7665;35961;370;383;13
/net/per610a/home/mvp/mvp_db/news7-lv/2009/2009_05_12_19_00/2009_05_12_19_00.mpg;Taro ASO.jpg;12573;12937;35961;628;647;19
/net/per610a/home/mvp/mvp_db/news7-lv/2009/2009_05_13_19_00/2009_05_13_19_00.mpg;Yukio HATOYAMA.jpg;1;337;35961;0;16;16
/net/per610a/home/mvp/mvp_db/news7-lv/2009/2009_05_13_19_00/2009_05_13_19_00.mpg;Yukio HATOYAMA.jpg;1749;3005;35961;87;150;63
/net/per610a/home/mvp/mvp_db/news7-lv/2009/2009_05_13_19_00/2009_05_13_19_00.mpg;Yukio HATOYAMA.jpg;4861;6345;35961;243;317;74
/net/per610a/home/mvp/mvp_db/news7-lv/2009/2009_05_13_19_00/2009_05_13_19_00.mpg;Yukio HATOYAMA.jpg;6725;6821;35961;336;341;5
/net/per610a/home/mvp/mvp_db/news7-lv/2009/2009_05_13_19_00/2009_05_13_19_00.mpg;Katsuya OKADA.jpg;1745;1861;35961;87;93;6
/net/per610a/home/mvp/mvp_db/news7-lv/2009/2009_05_13_19_00/2009_05_13_19_00.mpg;Katsuya OKADA.jpg;6725;7309;35961;336;365;29
/net/per610a/home/mvp/mvp_db/news7-lv/2009/2009_05_13_19_00/2009_05_13_19_00.mpg;Ichiro OZAWA.jpg;4481;4693;35961;224;234;10
/net/per610a/home/mvp/mvp_db/news7-lv/2009/2009_05_14_19_00/2009_05_14_19_00.mpg;Naoto KAN.jpg;10777;11269;35961;539;563;24
/net/per610a/home/mvp/mvp_db/news7-lv/2009/2009_05_14_19_00/2009_05_14_19_00.mpg;Taro ASO.jpg;14101;14501;35961;705;725;20
/net/per610a/home/mvp/mvp_db/news7-lv/2009/2009_05_15_19_00/2009_05_15_19_00.mpg;Yukio HATOYAMA.jpg;1;257;35961;0;12;12
/net/per610a/home/mvp/mvp_db/news7-lv/2009/2009_05_15_19_00/2009_05_15_19_00.mpg;Yukio HATOYAMA.jpg;4273;4433;35961;213;221;8
/net/per610a/home/mvp/mvp_db/news7-lv/2009/2009_05_15_19_00/2009_05_15_19_00.mpg;Yukio HATOYAMA.jpg;7173;7321;35961;358;366;8
/net/per610a/home/mvp/mvp_db/news7-lv/2009/2009_05_15_19_00/2009_05_15_19_00.mpg;Yukio HATOYAMA.jpg;4545;4709;35961;227;235;8
/net/per610a/home/mvp/mvp_db/news7-lv/2009/2009_05_15_19_00/2009_05_15_19_00.mpg;Yukio HATOYAMA.jpg;11277;11473;35961;564;573;9
/net/per610a/home/mvp/mvp_db/news7-lv/2009/2009_05_15_19_00/2009_05_15_19_00.mpg;Yukio HATOYAMA.jpg;12609;12929;35961;630;646;16
/net/per610a/home/mvp/mvp_db/news7-lv/2009/2009_05_15_19_00/2009_05_15_19_00.mpg;Yukio HATOYAMA.jpg;14397;14449;35961;720;722;2
/net/per610a/home/mvp/mvp_db/news7-lv/2009/2009_05_15_19_00/2009_05_15_19_00.mpg;Yukio HATOYAMA.jpg;14737;15465;35961;737;773;36
/net/per610a/home/mvp/mvp_db/news7-lv/2009/2009_05_15_19_00/2009_05_15_19_00.mpg;Yukio HATOYAMA.jpg;5785;5825;35961;289;291;2
/net/per610a/home/mvp/mvp_db/news7-lv/2009/2009_05_15_19_00/2009_05_15_19_00.mpg;Yukio HATOYAMA.jpg;8309;9129;35961;415;456;41
/net/per610a/home/mvp/mvp_db/news7-lv/2009/2009_05_16_19_00/2009_05_16_19_00.mpg;Katsuya OKADA.jpg;17129;17773;35961;856;889;33
/net/per610a/home/mvp/mvp_db/news7-lv/2009/2009_05_16_19_00/2009_05_16_19_00.mpg;Katsuya OKADA.jpg;24969;25189;35961;1249;1260;11
/net/per610a/home/mvp/mvp_db/news7-lv/2009/2009_05_16_19_00/2009_05_16_19_00.mpg;Katsuya OKADA.jpg;25805;25921;35961;1290;1296;6
/net/per610a/home/mvp/mvp_db/news7-lv/2009/2009_05_16_19_00/2009_05_16_19_00.mpg;Katsuya OKADA.jpg;25997;26405;35961;1300;1320;20
/net/per610a/home/mvp/mvp_db/news7-lv/2009/2009_05_16_19_00/2009_05_16_19_00.mpg;Yukio HATOYAMA.jpg;23257;24057;35961;1163;1203;40
/net/per610a/home/mvp/mvp_db/news7-lv/2009/2009_05_16_19_00/2009_05_16_19_00.mpg;Yukio HATOYAMA.jpg;24969;25189;35961;1249;1260;11
/net/per610a/home/mvp/mvp_db/news7-lv/2009/2009_05_16_19_00/2009_05_16_19_00.mpg;Taro ASO.jpg;28437;29325;35961;1422;1467;45
/net/per610a/home/mvp/mvp_db/news7-lv/2009/2009_05_17_19_00/2009_05_17_19_00.mpg;Katsuya OKADA.jpg;23729;23845;35961;1187;1192;5
/net/per610a/home/mvp/mvp_db/news7-lv/2009/2009_05_18_19_00/2009_05_18_19_00.mpg;Taro ASO.jpg;19569;20169;35961;978;1008;30
/net/per610a/home/mvp/mvp_db/news7-lv/2009/2009_05_18_19_00/2009_05_18_19_00.mpg;Taro ASO.jpg;26849;26881;35961;1343;1344;1
/net/per610a/home/mvp/mvp_db/news7-lv/2009/2009_05_18_19_00/2009_05_18_19_00.mpg;Taro ASO.jpg;27013;27993;35961;1351;1400;49
/net/per610a/home/mvp/mvp_db/news7-lv/2009/2009_05_18_19_00/2009_05_18_19_00.mpg;Yukio HATOYAMA.jpg;24857;25425;35961;1243;1271;28
/net/per610a/home/mvp/mvp_db/news7-lv/2009/2009_05_18_19_00/2009_05_18_19_00.mpg;Yukio HATOYAMA.jpg;25501;25521;35961;1275;1276;1
/net/per610a/home/mvp/mvp_db/news7-lv/2009/2009_05_18_19_00/2009_05_18_19_00.mpg;Yukio HATOYAMA.jpg;26057;26061;35961;1303;1303;0
/net/per610a/home/mvp/mvp_db/news7-lv/2009/2009_05_18_19_00/2009_05_18_19_00.mpg;Katsuya OKADA.jpg;26201;26573;35961;1310;1329;19
/net/per610a/home/mvp/mvp_db/news7-lv/2009/2009_05_19_19_00/2009_05_19_19_00.mpg;Yukio HATOYAMA.jpg;22525;22885;35961;1126;1144;18
/net/per610a/home/mvp/mvp_db/news7-lv/2009/2009_05_19_19_00/2009_05_19_19_00.mpg;Yukio HATOYAMA.jpg;23045;23125;35961;1152;1156;4
/net/per610a/home/mvp/mvp_db/news7-lv/2009/2009_05_19_19_00/2009_05_19_19_00.mpg;Yukio HATOYAMA.jpg;25849;26345;35961;1293;1317;24
/net/per610a/home/mvp/mvp_db/news7-lv/2009/2009_05_21_19_00/2009_05_21_19_00.mpg;Taro ASO.jpg;15421;15921;35961;771;796;25
/net/per610a/home/mvp/mvp_db/news7-lv/2009/2009_05_22_19_00/2009_05_22_19_00.mpg;Toru Hashimoto.jpg;217;369;35961;10;18;8
/net/per610a/home/mvp/mvp_db/news7-lv/2009/2009_05_24_19_00/2009_05_24_19_00.mpg;Taro ASO.jpg;19629;20173;35961;981;1009;28
/net/per610a/home/mvp/mvp_db/news7-lv/2009/2009_05_24_19_00/2009_05_24_19_00.mpg;Taro ASO.jpg;21689;22285;35961;1085;1114;29
/net/per610a/home/mvp/mvp_db/news7-lv/2009/2009_05_25_19_00/2009_05_25_19_00.mpg;Taro ASO.jpg;16181;16993;35961;809;850;41
/net/per610a/home/mvp/mvp_db/news7-lv/2009/2009_05_26_19_00/2009_05_26_19_00.mpg;Taro ASO.jpg;10913;11409;35961;545;570;25
/net/per610a/home/mvp/mvp_db/news7-lv/2009/2009_05_26_19_00/2009_05_26_19_00.mpg;Taro ASO.jpg;22933;23321;35961;1147;1166;19
/net/per610a/home/mvp/mvp_db/news7-lv/2009/2009_05_26_19_00/2009_05_26_19_00.mpg;Taro ASO.jpg;24733;25201;35961;1237;1260;23
/net/per610a/home/mvp/mvp_db/news7-lv/2009/2009_05_27_19_00/2009_05_27_19_00.mpg;Yukio HATOYAMA.jpg;9577;10749;35961;479;537;58
/net/per610a/home/mvp/mvp_db/news7-lv/2009/2009_05_28_19_00/2009_05_28_19_00.mpg;Taro ASO.jpg;26529;26677;35961;1327;1334;7
/net/per610a/home/mvp/mvp_db/news7-lv/2009/2009_05_29_19_00/2009_05_29_19_00.mpg;Yukio HATOYAMA.jpg;1;201;35961;0;10;10
/net/per610a/home/mvp/mvp_db/news7-lv/2009/2009_05_29_19_00/2009_05_29_19_00.mpg;Yukio HATOYAMA.jpg;8357;8721;35961;418;436;18
/net/per610a/home/mvp/mvp_db/news7-lv/2009/2009_05_29_19_00/2009_05_29_19_00.mpg;Yukio HATOYAMA.jpg;32353;32453;35961;1618;1623;5
/net/per610a/home/mvp/mvp_db/news7-lv/2009/2009_05_30_19_00/2009_05_30_19_00.mpg;Taro ASO.jpg;7937;8429;35961;397;421;24
/net/per610a/home/mvp/mvp_db/news7-lv/2009/2009_05_31_19_00/2009_05_31_19_00.mpg;Yukio HATOYAMA.jpg;1265;1685;35961;63;84;21
/net/per610a/home/mvp/mvp_db/news7-lv/2009/2009_06_01_19_00/2009_06_01_19_00.mpg;Yukio HATOYAMA.jpg;15481;16561;35961;774;828;54
/net/per610a/home/mvp/mvp_db/news7-lv/2009/2009_06_01_19_00/2009_06_01_19_00.mpg;Yukio HATOYAMA.jpg;24317;24793;35961;1216;1240;24
/net/per610a/home/mvp/mvp_db/news7-lv/2009/2009_06_01_19_00/2009_06_01_19_00.mpg;Taro ASO.jpg;20749;21229;35961;1037;1062;25
/net/per610a/home/mvp/mvp_db/news7-lv/2009/2009_06_02_19_00/2009_06_02_19_00.mpg;Taro ASO.jpg;22333;22837;35961;1117;1142;25
/net/per610a/home/mvp/mvp_db/news7-lv/2009/2009_06_03_19_00/2009_06_03_19_00.mpg;Taro ASO.jpg;16421;16869;35961;821;843;22
/net/per610a/home/mvp/mvp_db/news7-lv/2009/2009_06_04_19_00/2009_06_04_19_00.mpg;Taro ASO.jpg;18241;18373;35961;912;919;7
/net/per610a/home/mvp/mvp_db/news7-lv/2009/2009_06_08_19_00/2009_06_08_19_00.mpg;Akihiro OHTA.jpg;3001;3921;35961;150;196;46
/net/per610a/home/mvp/mvp_db/news7-lv/2009/2009_06_08_19_00/2009_06_08_19_00.mpg;Yukio HATOYAMA.jpg;4405;5193;35961;220;259;39
/net/per610a/home/mvp/mvp_db/news7-lv/2009/2009_06_08_19_00/2009_06_08_19_00.mpg;Yukio HATOYAMA.jpg;15205;15649;35961;760;782;22
/net/per610a/home/mvp/mvp_db/news7-lv/2009/2009_06_08_19_00/2009_06_08_19_00.mpg;Yukio HATOYAMA.jpg;18661;19021;35961;933;951;18
/net/per610a/home/mvp/mvp_db/news7-lv/2009/2009_06_08_19_00/2009_06_08_19_00.mpg;Taro ASO.jpg;13853;14409;35961;693;720;27
/net/per610a/home/mvp/mvp_db/news7-lv/2009/2009_06_08_19_00/2009_06_08_19_00.mpg;Taro ASO.jpg;14753;14821;35961;738;741;3
/net/per610a/home/mvp/mvp_db/news7-lv/2009/2009_06_08_19_00/2009_06_08_19_00.mpg;Taro ASO.jpg;18661;19021;35961;933;951;18
/net/per610a/home/mvp/mvp_db/news7-lv/2009/2009_06_09_19_00/2009_06_09_19_00.mpg;Yukio HATOYAMA.jpg;9465;9793;35961;473;489;16
/net/per610a/home/mvp/mvp_db/news7-lv/2009/2009_06_10_19_00/2009_06_10_19_00.mpg;Ichiro OZAWA.jpg;20797;21101;35961;1040;1055;15
/net/per610a/home/mvp/mvp_db/news7-lv/2009/2009_06_11_19_00/2009_06_11_19_00.mpg;Yukio HATOYAMA.jpg;18329;18813;35961;916;941;25
/net/per610a/home/mvp/mvp_db/news7-lv/2009/2009_06_12_19_00/2009_06_12_19_00.mpg;Taro ASO.jpg;2469;2545;35961;123;127;4
/net/per610a/home/mvp/mvp_db/news7-lv/2009/2009_06_12_19_00/2009_06_12_19_00.mpg;Taro ASO.jpg;5061;5569;35961;253;278;25
/net/per610a/home/mvp/mvp_db/news7-lv/2009/2009_06_12_19_00/2009_06_12_19_00.mpg;Taro ASO.jpg;16113;16897;35961;806;845;39
/net/per610a/home/mvp/mvp_db/news7-lv/2009/2009_06_12_19_00/2009_06_12_19_00.mpg;Yukio HATOYAMA.jpg;10989;13093;35961;549;654;105
/net/per610a/home/mvp/mvp_db/news7-lv/2009/2009_06_13_19_00/2009_06_13_19_00.mpg;Yukio HATOYAMA.jpg;6301;6629;35961;315;331;16
/net/per610a/home/mvp/mvp_db/news7-lv/2009/2009_06_13_19_00/2009_06_13_19_00.mpg;Yukio HATOYAMA.jpg;7745;7853;35961;387;392;5
/net/per610a/home/mvp/mvp_db/news7-lv/2009/2009_06_13_19_00/2009_06_13_19_00.mpg;Taro ASO.jpg;9517;10141;35961;476;507;31
/net/per610a/home/mvp/mvp_db/news7-lv/2009/2009_06_15_19_00/2009_06_15_19_00.mpg;Taro ASO.jpg;13221;13529;35961;661;676;15
/net/per610a/home/mvp/mvp_db/news7-lv/2009/2009_06_15_19_00/2009_06_15_19_00.mpg;Taro ASO.jpg;13949;14105;35961;697;705;8
/net/per610a/home/mvp/mvp_db/news7-lv/2009/2009_06_15_19_00/2009_06_15_19_00.mpg;Taro ASO.jpg;14169;14433;35961;708;722;14
/net/per610a/home/mvp/mvp_db/news7-lv/2009/2009_06_15_19_00/2009_06_15_19_00.mpg;Taro ASO.jpg;16421;16765;35961;821;838;17
/net/per610a/home/mvp/mvp_db/news7-lv/2009/2009_06_15_19_00/2009_06_15_19_00.mpg;Taro ASO.jpg;16837;17477;35961;842;874;32
/net/per610a/home/mvp/mvp_db/news7-lv/2009/2009_06_15_19_00/2009_06_15_19_00.mpg;Yukio HATOYAMA.jpg;13949;14441;35961;697;722;25
/net/per610a/home/mvp/mvp_db/news7-lv/2009/2009_06_15_19_00/2009_06_15_19_00.mpg;Yukio HATOYAMA.jpg;15833;16385;35961;792;819;27
/net/per610a/home/mvp/mvp_db/news7-lv/2009/2009_06_16_19_00/2009_06_16_19_00.mpg;Taro ASO.jpg;1653;1749;35961;82;87;5
/net/per610a/home/mvp/mvp_db/news7-lv/2009/2009_06_16_19_00/2009_06_16_19_00.mpg;Yukio HATOYAMA.jpg;2389;2441;35961;119;122;3
/net/per610a/home/mvp/mvp_db/news7-lv/2009/2009_06_16_19_00/2009_06_16_19_00.mpg;Yukio HATOYAMA.jpg;2665;3113;35961;133;155;22
/net/per610a/home/mvp/mvp_db/news7-lv/2009/2009_06_16_19_00/2009_06_16_19_00.mpg;Taro ASO.jpg;4521;4921;35961;226;246;20
/net/per610a/home/mvp/mvp_db/news7-lv/2009/2009_06_16_19_00/2009_06_16_19_00.mpg;Taro ASO.jpg;6149;7577;35961;307;379;72
/net/per610a/home/mvp/mvp_db/news7-lv/2009/2009_06_17_19_00/2009_06_17_19_00.mpg;Taro ASO.jpg;1709;1793;35961;85;89;4
/net/per610a/home/mvp/mvp_db/news7-lv/2009/2009_06_17_19_00/2009_06_17_19_00.mpg;Taro ASO.jpg;1889;2245;35961;94;112;18
/net/per610a/home/mvp/mvp_db/news7-lv/2009/2009_06_17_19_00/2009_06_17_19_00.mpg;Taro ASO.jpg;4229;5873;35961;211;293;82
/net/per610a/home/mvp/mvp_db/news7-lv/2009/2009_06_17_19_00/2009_06_17_19_00.mpg;Taro ASO.jpg;5989;6217;35961;299;311;12
/net/per610a/home/mvp/mvp_db/news7-lv/2009/2009_06_17_19_00/2009_06_17_19_00.mpg;Taro ASO.jpg;8481;8585;35961;424;429;5
/net/per610a/home/mvp/mvp_db/news7-lv/2009/2009_06_17_19_00/2009_06_17_19_00.mpg;Taro ASO.jpg;8797;8949;35961;440;447;7
/net/per610a/home/mvp/mvp_db/news7-lv/2009/2009_06_17_19_00/2009_06_17_19_00.mpg;Katsuya OKADA.jpg;10441;10517;35961;522;526;4
/net/per610a/home/mvp/mvp_db/news7-lv/2009/2009_06_17_19_00/2009_06_17_19_00.mpg;Katsuya OKADA.jpg;10701;10749;35961;535;537;2
/net/per610a/home/mvp/mvp_db/news7-lv/2009/2009_06_19_19_00/2009_06_19_19_00.mpg;Taro ASO.jpg;19261;19269;35961;963;963;0
/net/per610a/home/mvp/mvp_db/news7-lv/2009/2009_06_19_19_00/2009_06_19_19_00.mpg;Taro ASO.jpg;19553;20173;35961;978;1009;31
/net/per610a/home/mvp/mvp_db/news7-lv/2009/2009_06_19_19_00/2009_06_19_19_00.mpg;Taro ASO.jpg;21825;22457;35961;1091;1123;32
/net/per610a/home/mvp/mvp_db/news7-lv/2009/2009_06_19_19_00/2009_06_19_19_00.mpg;Taro ASO.jpg;22665;22761;35961;1133;1138;5
/net/per610a/home/mvp/mvp_db/news7-lv/2009/2009_06_19_19_00/2009_06_19_19_00.mpg;Yukio HATOYAMA.jpg;20217;20837;35961;1011;1042;31
/net/per610a/home/mvp/mvp_db/news7-lv/2009/2009_06_20_19_00/2009_06_20_19_00.mpg;Yukio HATOYAMA.jpg;1341;1993;35961;67;99;32
/net/per610a/home/mvp/mvp_db/news7-lv/2009/2009_06_20_19_00/2009_06_20_19_00.mpg;Taro ASO.jpg;2493;3081;35961;124;154;30
/net/per610a/home/mvp/mvp_db/news7-lv/2009/2009_06_20_19_00/2009_06_20_19_00.mpg;Katsuya OKADA.jpg;4677;4693;35961;233;234;1
/net/per610a/home/mvp/mvp_db/news7-lv/2009/2009_06_20_19_00/2009_06_20_19_00.mpg;Katsuya OKADA.jpg;4781;5301;35961;239;265;26
/net/per610a/home/mvp/mvp_db/news7-lv/2009/2009_06_20_19_00/2009_06_20_19_00.mpg;Katsuya OKADA.jpg;5737;6545;35961;287;327;40
/net/per610a/home/mvp/mvp_db/news7-lv/2009/2009_06_22_19_00/2009_06_22_19_00.mpg;Taro ASO.jpg;8101;8313;35961;405;415;10
/net/per610a/home/mvp/mvp_db/news7-lv/2009/2009_06_23_19_00/2009_06_23_19_00.mpg;Taro ASO.jpg;1185;1693;35961;59;84;25
/net/per610a/home/mvp/mvp_db/news7-lv/2009/2009_06_23_19_00/2009_06_23_19_00.mpg;Taro ASO.jpg;4625;4821;35961;231;241;10
/net/per610a/home/mvp/mvp_db/news7-lv/2009/2009_06_23_19_00/2009_06_23_19_00.mpg;Yukio HATOYAMA.jpg;11869;13037;35961;593;652;59
/net/per610a/home/mvp/mvp_db/news7-lv/2009/2009_06_24_19_00/2009_06_24_19_00.mpg;Taro ASO.jpg;1;101;35961;0;5;5
/net/per610a/home/mvp/mvp_db/news7-lv/2009/2009_06_24_19_00/2009_06_24_19_00.mpg;Taro ASO.jpg;6633;7081;35961;331;354;23
/net/per610a/home/mvp/mvp_db/news7-lv/2009/2009_06_24_19_00/2009_06_24_19_00.mpg;Yukio HATOYAMA.jpg;197;365;35961;9;18;9
/net/per610a/home/mvp/mvp_db/news7-lv/2009/2009_06_24_19_00/2009_06_24_19_00.mpg;Yukio HATOYAMA.jpg;5869;6545;35961;293;327;34
/net/per610a/home/mvp/mvp_db/news7-lv/2009/2009_06_25_19_00/2009_06_25_19_00.mpg;Taro ASO.jpg;5533;7633;35961;276;381;105
/net/per610a/home/mvp/mvp_db/news7-lv/2009/2009_06_25_19_00/2009_06_25_19_00.mpg;Yukio HATOYAMA.jpg;7713;8717;35961;385;436;51
/net/per610a/home/mvp/mvp_db/news7-lv/2009/2009_06_26_19_00/2009_06_26_19_00.mpg;Taro ASO.jpg;1265;1469;35961;63;73;10
/net/per610a/home/mvp/mvp_db/news7-lv/2009/2009_06_26_19_00/2009_06_26_19_00.mpg;Taro ASO.jpg;2353;2713;35961;117;135;18
/net/per610a/home/mvp/mvp_db/news7-lv/2009/2009_06_26_19_00/2009_06_26_19_00.mpg;Akihiro OHTA.jpg;4333;4861;35961;216;243;27
/net/per610a/home/mvp/mvp_db/news7-lv/2009/2009_06_27_19_00/2009_06_27_19_00.mpg;Taro ASO.jpg;953;1501;35961;47;75;28
/net/per610a/home/mvp/mvp_db/news7-lv/2009/2009_06_27_19_00/2009_06_27_19_00.mpg;Yukio HATOYAMA.jpg;4661;6301;35961;233;315;82
/net/per610a/home/mvp/mvp_db/news7-lv/2009/2009_06_28_19_00/2009_06_28_19_00.mpg;Taro ASO.jpg;3249;3321;35961;162;166;4
/net/per610a/home/mvp/mvp_db/news7-lv/2009/2009_06_28_19_00/2009_06_28_19_00.mpg;Taro ASO.jpg;7057;8921;35961;353;446;93
/net/per610a/home/mvp/mvp_db/news7-lv/2009/2009_06_29_19_00/2009_06_29_19_00.mpg;Taro ASO.jpg;117;289;35961;5;14;9
/net/per610a/home/mvp/mvp_db/news7-lv/2009/2009_06_29_19_00/2009_06_29_19_00.mpg;Taro ASO.jpg;1413;1889;35961;70;94;24
/net/per610a/home/mvp/mvp_db/news7-lv/2009/2009_06_29_19_00/2009_06_29_19_00.mpg;Taro ASO.jpg;2501;2569;35961;125;128;3
/net/per610a/home/mvp/mvp_db/news7-lv/2009/2009_06_29_19_00/2009_06_29_19_00.mpg;Yukio HATOYAMA.jpg;421;513;35961;21;25;4
/net/per610a/home/mvp/mvp_db/news7-lv/2009/2009_06_29_19_00/2009_06_29_19_00.mpg;Yukio HATOYAMA.jpg;5421;6389;35961;271;319;48
/net/per610a/home/mvp/mvp_db/news7-lv/2009/2009_06_29_19_00/2009_06_29_19_00.mpg;Taro ASO.jpg;2789;2929;35961;139;146;7
/net/per610a/home/mvp/mvp_db/news7-lv/2009/2009_06_30_19_00/2009_06_30_19_00.mpg;Taro ASO.jpg;277;349;35961;13;17;4
/net/per610a/home/mvp/mvp_db/news7-lv/2009/2009_06_30_19_00/2009_06_30_19_00.mpg;Taro ASO.jpg;3669;4769;35961;183;238;55
/net/per610a/home/mvp/mvp_db/news7-lv/2009/2009_07_01_19_00/2009_07_01_19_00.mpg;Taro ASO.jpg;113;325;35961;5;16;11
/net/per610a/home/mvp/mvp_db/news7-lv/2009/2009_07_01_19_00/2009_07_01_19_00.mpg;Taro ASO.jpg;585;2077;35961;29;103;74
/net/per610a/home/mvp/mvp_db/news7-lv/2009/2009_07_01_19_00/2009_07_01_19_00.mpg;Taro ASO.jpg;10089;10785;35961;504;539;35
/net/per610a/home/mvp/mvp_db/news7-lv/2009/2009_07_01_19_00/2009_07_01_19_00.mpg;Yukio HATOYAMA.jpg;12389;13381;35961;619;669;50
/net/per610a/home/mvp/mvp_db/news7-lv/2009/2009_07_01_19_00/2009_07_01_19_00.mpg;Yukio HATOYAMA.jpg;13449;14245;35961;672;712;40
/net/per610a/home/mvp/mvp_db/news7-lv/2009/2009_07_01_19_00/2009_07_01_19_00.mpg;Yukio HATOYAMA.jpg;16305;16565;35961;815;828;13
/net/per610a/home/mvp/mvp_db/news7-lv/2009/2009_07_02_19_00/2009_07_02_19_00.mpg;Taro ASO.jpg;1;37;35961;0;1;1
/net/per610a/home/mvp/mvp_db/news7-lv/2009/2009_07_02_19_00/2009_07_02_19_00.mpg;Taro ASO.jpg;213;253;35961;10;12;2
/net/per610a/home/mvp/mvp_db/news7-lv/2009/2009_07_02_19_00/2009_07_02_19_00.mpg;Taro ASO.jpg;961;1361;35961;48;68;20
/net/per610a/home/mvp/mvp_db/news7-lv/2009/2009_07_02_19_00/2009_07_02_19_00.mpg;Yukio HATOYAMA.jpg;961;1493;35961;48;74;26
/net/per610a/home/mvp/mvp_db/news7-lv/2009/2009_07_02_19_00/2009_07_02_19_00.mpg;Yukio HATOYAMA.jpg;6653;7601;35961;332;380;48
/net/per610a/home/mvp/mvp_db/news7-lv/2009/2009_07_02_19_00/2009_07_02_19_00.mpg;Yukio HATOYAMA.jpg;8681;9009;35961;434;450;16
/net/per610a/home/mvp/mvp_db/news7-lv/2009/2009_07_02_19_00/2009_07_02_19_00.mpg;Yukio HATOYAMA.jpg;9085;9177;35961;454;459;5
/net/per610a/home/mvp/mvp_db/news7-lv/2009/2009_07_02_19_00/2009_07_02_19_00.mpg;Sadakazu TANIGAKI.jpg;7877;8585;35961;394;429;35
/net/per610a/home/mvp/mvp_db/news7-lv/2009/2009_07_02_19_00/2009_07_02_19_00.mpg;Kazuo SHII.jpg;20613;21673;35961;1031;1084;53
/net/per610a/home/mvp/mvp_db/news7-lv/2009/2009_07_03_19_00/2009_07_03_19_00.mpg;Yukio HATOYAMA.jpg;3817;3921;35961;190;196;6
/net/per610a/home/mvp/mvp_db/news7-lv/2009/2009_07_03_19_00/2009_07_03_19_00.mpg;Yukio HATOYAMA.jpg;18145;18657;35961;907;933;26
/net/per610a/home/mvp/mvp_db/news7-lv/2009/2009_07_03_19_00/2009_07_03_19_00.mpg;Akihiro OHTA.jpg;4337;5033;35961;216;251;35
/net/per610a/home/mvp/mvp_db/news7-lv/2009/2009_07_06_19_00/2009_07_06_19_00.mpg;Yukio HATOYAMA.jpg;1969;2113;35961;98;105;7
/net/per610a/home/mvp/mvp_db/news7-lv/2009/2009_07_06_19_00/2009_07_06_19_00.mpg;Yukio HATOYAMA.jpg;5041;6045;35961;252;302;50
/net/per610a/home/mvp/mvp_db/news7-lv/2009/2009_07_06_19_00/2009_07_06_19_00.mpg;Taro ASO.jpg;2677;3305;35961;133;165;32
/net/per610a/home/mvp/mvp_db/news7-lv/2009/2009_07_06_19_00/2009_07_06_19_00.mpg;Taro ASO.jpg;6533;7125;35961;326;356;30
/net/per610a/home/mvp/mvp_db/news7-lv/2009/2009_07_07_19_00/2009_07_07_19_00.mpg;Yukio HATOYAMA.jpg;12133;12617;35961;606;631;25
/net/per610a/home/mvp/mvp_db/news7-lv/2009/2009_07_07_19_00/2009_07_07_19_00.mpg;Yukio HATOYAMA.jpg;15093;15529;35961;755;776;21
/net/per610a/home/mvp/mvp_db/news7-lv/2009/2009_07_08_19_00/2009_07_08_19_00.mpg;Yukio HATOYAMA.jpg;18205;19269;35961;910;963;53
/net/per610a/home/mvp/mvp_db/news7-lv/2009/2009_07_09_19_00/2009_07_09_19_00.mpg;Taro ASO.jpg;1381;1425;35961;69;71;2
/net/per610a/home/mvp/mvp_db/news7-lv/2009/2009_07_09_19_00/2009_07_09_19_00.mpg;Taro ASO.jpg;3389;3389;35961;169;169;0
/net/per610a/home/mvp/mvp_db/news7-lv/2009/2009_07_09_19_00/2009_07_09_19_00.mpg;Taro ASO.jpg;3465;3533;35961;173;176;3
/net/per610a/home/mvp/mvp_db/news7-lv/2009/2009_07_09_19_00/2009_07_09_19_00.mpg;Taro ASO.jpg;5177;5529;35961;258;276;18
/net/per610a/home/mvp/mvp_db/news7-lv/2009/2009_07_09_19_00/2009_07_09_19_00.mpg;Naoto KAN.jpg;10889;11513;35961;544;575;31
/net/per610a/home/mvp/mvp_db/news7-lv/2009/2009_07_10_19_00/2009_07_10_19_00.mpg;Taro ASO.jpg;1673;1741;35961;83;87;4
/net/per610a/home/mvp/mvp_db/news7-lv/2009/2009_07_10_19_00/2009_07_10_19_00.mpg;Taro ASO.jpg;11905;12061;35961;595;603;8
/net/per610a/home/mvp/mvp_db/news7-lv/2009/2009_07_10_19_00/2009_07_10_19_00.mpg;Taro ASO.jpg;14077;14269;35961;704;713;9
/net/per610a/home/mvp/mvp_db/news7-lv/2009/2009_07_10_19_00/2009_07_10_19_00.mpg;Junichiro KOIZUMI.jpg;1821;3489;35961;91;174;83
/net/per610a/home/mvp/mvp_db/news7-lv/2009/2009_07_10_19_00/2009_07_10_19_00.mpg;Yukio HATOYAMA.jpg;5693;6525;35961;284;326;42
/net/per610a/home/mvp/mvp_db/news7-lv/2009/2009_07_12_19_00/2009_07_12_19_00.mpg;Natsuo YAMAGUCHI.jpg;8597;8893;35961;430;444;14
/net/per610a/home/mvp/mvp_db/news7-lv/2009/2009_07_13_19_00/2009_07_13_19_00.mpg;Katsuya OKADA.jpg;10745;12329;35961;537;616;79
/net/per610a/home/mvp/mvp_db/news7-lv/2009/2009_07_13_19_00/2009_07_13_19_00.mpg;Yukio HATOYAMA.jpg;21017;21429;35961;1051;1072;21
/net/per610a/home/mvp/mvp_db/news7-lv/2009/2009_07_14_19_00/2009_07_14_19_00.mpg;Taro ASO.jpg;1;445;35961;0;22;22
/net/per610a/home/mvp/mvp_db/news7-lv/2009/2009_07_14_19_00/2009_07_14_19_00.mpg;Taro ASO.jpg;6545;7589;35961;327;379;52
/net/per610a/home/mvp/mvp_db/news7-lv/2009/2009_07_14_19_00/2009_07_14_19_00.mpg;Taro ASO.jpg;11793;11837;35961;589;592;3
/net/per610a/home/mvp/mvp_db/news7-lv/2009/2009_07_14_19_00/2009_07_14_19_00.mpg;Taro ASO.jpg;11949;11989;35961;597;599;2
/net/per610a/home/mvp/mvp_db/news7-lv/2009/2009_07_14_19_00/2009_07_14_19_00.mpg;Taro ASO.jpg;16133;16153;35961;807;808;1
/net/per610a/home/mvp/mvp_db/news7-lv/2009/2009_07_14_19_00/2009_07_14_19_00.mpg;Taro ASO.jpg;16257;17073;35961;813;854;41
/net/per610a/home/mvp/mvp_db/news7-lv/2009/2009_07_14_19_00/2009_07_14_19_00.mpg;Yukio HATOYAMA.jpg;8325;8345;35961;416;417;1
/net/per610a/home/mvp/mvp_db/news7-lv/2009/2009_07_14_19_00/2009_07_14_19_00.mpg;Yukio HATOYAMA.jpg;8533;8845;35961;426;442;16
/net/per610a/home/mvp/mvp_db/news7-lv/2009/2009_07_14_19_00/2009_07_14_19_00.mpg;Yukio HATOYAMA.jpg;8941;8969;35961;447;448;1
/net/per610a/home/mvp/mvp_db/news7-lv/2009/2009_07_14_19_00/2009_07_14_19_00.mpg;Yukio HATOYAMA.jpg;9129;9285;35961;456;464;8
/net/per610a/home/mvp/mvp_db/news7-lv/2009/2009_07_14_19_00/2009_07_14_19_00.mpg;Ichiro OZAWA.jpg;8981;9069;35961;449;453;4
/net/per610a/home/mvp/mvp_db/news7-lv/2009/2009_07_15_19_00/2009_07_15_19_00.mpg;Taro ASO.jpg;9489;10033;35961;474;501;27
/net/per610a/home/mvp/mvp_db/news7-lv/2009/2009_07_15_19_00/2009_07_15_19_00.mpg;Taro ASO.jpg;14049;14601;35961;702;730;28
/net/per610a/home/mvp/mvp_db/news7-lv/2009/2009_07_15_19_00/2009_07_15_19_00.mpg;Taro ASO.jpg;15017;16441;35961;751;822;71
/net/per610a/home/mvp/mvp_db/news7-lv/2009/2009_07_16_19_00/2009_07_16_19_00.mpg;Taro ASO.jpg;8113;9825;35961;405;491;86
/net/per610a/home/mvp/mvp_db/news7-lv/2009/2009_07_17_19_00/2009_07_17_19_00.mpg;Taro ASO.jpg;13989;14601;35961;699;730;31
/net/per610a/home/mvp/mvp_db/news7-lv/2009/2009_07_17_19_00/2009_07_17_19_00.mpg;Taro ASO.jpg;14689;15157;35961;734;758;24
/net/per610a/home/mvp/mvp_db/news7-lv/2009/2009_07_17_19_00/2009_07_17_19_00.mpg;Taro ASO.jpg;19769;20417;35961;988;1021;33
/net/per610a/home/mvp/mvp_db/news7-lv/2009/2009_07_17_19_00/2009_07_17_19_00.mpg;Akihiro OHTA.jpg;18521;19281;35961;926;964;38
/net/per610a/home/mvp/mvp_db/news7-lv/2009/2009_07_21_19_00/2009_07_21_19_00.mpg;Yukio HATOYAMA.jpg;5133;5569;35961;256;278;22
/net/per610a/home/mvp/mvp_db/news7-lv/2009/2009_07_21_19_00/2009_07_21_19_00.mpg;Yukio HATOYAMA.jpg;7629;7877;35961;381;394;13
/net/per610a/home/mvp/mvp_db/news7-lv/2009/2009_07_21_19_00/2009_07_21_19_00.mpg;Akihiro OHTA.jpg;7933;8117;35961;396;406;10
/net/per610a/home/mvp/mvp_db/news7-lv/2009/2009_07_21_19_00/2009_07_21_19_00.mpg;Kazuo SHII.jpg;8149;8329;35961;407;416;9
/net/per610a/home/mvp/mvp_db/news7-lv/2009/2009_07_21_19_00/2009_07_21_19_00.mpg;Junichiro KOIZUMI.jpg;21169;21369;35961;1059;1069;10
/net/per610a/home/mvp/mvp_db/news7-lv/2009/2009_07_22_19_00/2009_07_22_19_00.mpg;Taro ASO.jpg;24045;24581;35961;1202;1229;27
/net/per610a/home/mvp/mvp_db/news7-lv/2009/2009_07_22_19_00/2009_07_22_19_00.mpg;Taro ASO.jpg;24689;25101;35961;1235;1255;20
/net/per610a/home/mvp/mvp_db/news7-lv/2009/2009_07_22_19_00/2009_07_22_19_00.mpg;Taro ASO.jpg;25401;25581;35961;1270;1279;9
/net/per610a/home/mvp/mvp_db/news7-lv/2009/2009_07_22_19_00/2009_07_22_19_00.mpg;Yukio HATOYAMA.jpg;26041;27189;35961;1302;1360;58
/net/per610a/home/mvp/mvp_db/news7-lv/2009/2009_07_22_19_00/2009_07_22_19_00.mpg;Yukio HATOYAMA.jpg;27449;27725;35961;1373;1386;13
/net/per610a/home/mvp/mvp_db/news7-lv/2009/2009_07_22_19_00/2009_07_22_19_00.mpg;Yukio HATOYAMA.jpg;27817;27821;35961;1391;1391;0
/net/per610a/home/mvp/mvp_db/news7-lv/2009/2009_07_25_19_00/2009_07_25_19_00.mpg;Taro ASO.jpg;549;721;35961;27;36;9
/net/per610a/home/mvp/mvp_db/news7-lv/2009/2009_07_25_19_00/2009_07_25_19_00.mpg;Taro ASO.jpg;13173;14073;35961;658;704;46
/net/per610a/home/mvp/mvp_db/news7-lv/2009/2009_07_27_19_00/2009_07_27_19_00.mpg;Yukio HATOYAMA.jpg;18417;19013;35961;921;951;30
/net/per610a/home/mvp/mvp_db/news7-lv/2009/2009_07_27_19_00/2009_07_27_19_00.mpg;Yukio HATOYAMA.jpg;19841;20237;35961;992;1012;20
/net/per610a/home/mvp/mvp_db/news7-lv/2009/2009_07_27_19_00/2009_07_27_19_00.mpg;Yukio HATOYAMA.jpg;23117;23641;35961;1156;1182;26
/net/per610a/home/mvp/mvp_db/news7-lv/2009/2009_07_28_19_00/2009_07_28_19_00.mpg;Yukio HATOYAMA.jpg;11621;12033;35961;581;601;20
/net/per610a/home/mvp/mvp_db/news7-lv/2009/2009_07_28_19_00/2009_07_28_19_00.mpg;Yukio HATOYAMA.jpg;12821;13297;35961;641;665;24
/net/per610a/home/mvp/mvp_db/news7-lv/2009/2009_07_30_19_00/2009_07_30_19_00.mpg;Taro ASO.jpg;6945;7413;35961;347;370;23
/net/per610a/home/mvp/mvp_db/news7-lv/2009/2009_07_30_19_00/2009_07_30_19_00.mpg;Taro ASO.jpg;7877;8197;35961;394;410;16
/net/per610a/home/mvp/mvp_db/news7-lv/2009/2009_07_30_19_00/2009_07_30_19_00.mpg;Yukio HATOYAMA.jpg;6945;7413;35961;347;370;23
/net/per610a/home/mvp/mvp_db/news7-lv/2009/2009_07_31_19_00/2009_07_31_19_00.mpg;Taro ASO.jpg;1789;2461;35961;89;123;34
/net/per610a/home/mvp/mvp_db/news7-lv/2009/2009_07_31_19_00/2009_07_31_19_00.mpg;Taro ASO.jpg;6985;7813;35961;349;390;41
/net/per610a/home/mvp/mvp_db/news7-lv/2009/2009_08_01_19_00/2009_08_01_19_00.mpg;Yukio HATOYAMA.jpg;1233;1685;35961;61;84;23
/net/per610a/home/mvp/mvp_db/news7-lv/2009/2009_08_01_19_00/2009_08_01_19_00.mpg;Taro ASO.jpg;1853;1857;35961;92;92;0
/net/per610a/home/mvp/mvp_db/news7-lv/2009/2009_08_01_19_00/2009_08_01_19_00.mpg;Taro ASO.jpg;2873;3221;35961;143;161;18
/net/per610a/home/mvp/mvp_db/news7-lv/2009/2009_08_02_19_00/2009_08_02_19_00.mpg;Taro ASO.jpg;1921;2025;35961;96;101;5
/net/per610a/home/mvp/mvp_db/news7-lv/2009/2009_08_03_19_00/2009_08_03_19_00.mpg;Yukio HATOYAMA.jpg;20093;21021;35961;1005;1051;46
/net/per610a/home/mvp/mvp_db/news7-lv/2009/2009_08_04_19_00/2009_08_04_19_00.mpg;Yukio HATOYAMA.jpg;14517;15193;35961;726;760;34
/net/per610a/home/mvp/mvp_db/news7-lv/2009/2009_08_04_19_00/2009_08_04_19_00.mpg;Katsuya OKADA.jpg;15365;15701;35961;768;785;17
/net/per610a/home/mvp/mvp_db/news7-lv/2009/2009_08_04_19_00/2009_08_04_19_00.mpg;Kazuo SHII.jpg;15961;16549;35961;798;827;29
/net/per610a/home/mvp/mvp_db/news7-lv/2009/2009_08_09_19_00/2009_08_09_19_00.mpg;Kazuo SHII.jpg;16705;18905;35961;835;945;110
/net/per610a/home/mvp/mvp_db/news7-lv/2009/2009_08_10_19_00/2009_08_10_19_00.mpg;Akihiro OHTA.jpg;26369;26537;35961;1319;1327;8
/net/per610a/home/mvp/mvp_db/news7-lv/2009/2009_08_10_19_00/2009_08_10_19_00.mpg;Yukio HATOYAMA.jpg;28501;28941;35961;1425;1447;22
/net/per610a/home/mvp/mvp_db/news7-lv/2009/2009_08_10_19_00/2009_08_10_19_00.mpg;Taro ASO.jpg;28501;28941;35961;1425;1447;22
/net/per610a/home/mvp/mvp_db/news7-lv/2009/2009_08_11_19_00/2009_08_11_19_00.mpg;Ichiro OZAWA.jpg;30721;31065;35961;1536;1554;18
/net/per610a/home/mvp/mvp_db/news7-lv/2009/2009_08_12_19_00/2009_08_12_19_00.mpg;Yukio HATOYAMA.jpg;649;857;35961;32;42;10
/net/per610a/home/mvp/mvp_db/news7-lv/2009/2009_08_12_19_00/2009_08_12_19_00.mpg;Taro ASO.jpg;649;781;35961;32;39;7
/net/per610a/home/mvp/mvp_db/news7-lv/2009/2009_08_12_19_00/2009_08_12_19_00.mpg;Taro ASO.jpg;13565;14001;35961;678;700;22
/net/per610a/home/mvp/mvp_db/news7-lv/2009/2009_08_12_19_00/2009_08_12_19_00.mpg;Taro ASO.jpg;15113;17409;35961;756;870;114
/net/per610a/home/mvp/mvp_db/news7-lv/2009/2009_08_12_19_00/2009_08_12_19_00.mpg;Taro ASO.jpg;17609;18933;35961;880;947;67
/net/per610a/home/mvp/mvp_db/news7-lv/2009/2009_08_17_19_00/2009_08_17_19_00.mpg;Taro ASO.jpg;53;289;35961;2;14;12
/net/per610a/home/mvp/mvp_db/news7-lv/2009/2009_08_17_19_00/2009_08_17_19_00.mpg;Taro ASO.jpg;1737;1965;35961;86;98;12
/net/per610a/home/mvp/mvp_db/news7-lv/2009/2009_08_17_19_00/2009_08_17_19_00.mpg;Taro ASO.jpg;4009;4273;35961;200;213;13
/net/per610a/home/mvp/mvp_db/news7-lv/2009/2009_08_17_19_00/2009_08_17_19_00.mpg;Taro ASO.jpg;8521;9273;35961;426;463;37
/net/per610a/home/mvp/mvp_db/news7-lv/2009/2009_08_18_19_00/2009_08_18_19_00.mpg;Yukio HATOYAMA.jpg;3333;3409;35961;166;170;4
/net/per610a/home/mvp/mvp_db/news7-lv/2009/2009_08_18_19_00/2009_08_18_19_00.mpg;Kazuo SHII.jpg;5697;6557;35961;285;328;43
/net/per610a/home/mvp/mvp_db/news7-lv/2009/2009_08_18_19_00/2009_08_18_19_00.mpg;YUriko Koike.jpg;10385;11717;35961;519;586;67
/net/per610a/home/mvp/mvp_db/news7-lv/2009/2009_08_18_19_00/2009_08_18_19_00.mpg;Taro ASO.jpg;24861;24909;35961;1243;1246;3
/net/per610a/home/mvp/mvp_db/news7-lv/2009/2009_08_18_19_00/2009_08_18_19_00.mpg;Taro ASO.jpg;26529;27033;35961;1327;1352;25
/net/per610a/home/mvp/mvp_db/news7-lv/2009/2009_08_18_19_00/2009_08_18_19_00.mpg;Taro ASO.jpg;27289;35957;35961;1365;1798;433
/net/per610a/home/mvp/mvp_db/news7-lv/2009/2009_08_22_19_00/2009_08_22_19_00.mpg;Yoshimi WATANABE.jpg;6349;6689;35961;317;334;17
/net/per610a/home/mvp/mvp_db/news7-lv/2009/2009_08_22_19_00/2009_08_22_19_00.mpg;Naoto KAN.jpg;20281;20541;35961;1014;1027;13
/net/per610a/home/mvp/mvp_db/news7-lv/2009/2009_08_23_19_00/2009_08_23_19_00.mpg;Yukio HATOYAMA.jpg;15093;15309;35961;755;765;10
/net/per610a/home/mvp/mvp_db/news7-lv/2009/2009_08_31_19_00/2009_08_31_19_00.mpg;Yukio HATOYAMA.jpg;1;109;35961;0;5;5
/net/per610a/home/mvp/mvp_db/news7-lv/2009/2009_08_31_19_00/2009_08_31_19_00.mpg;Yukio HATOYAMA.jpg;6693;6697;35961;334;335;1
/net/per610a/home/mvp/mvp_db/news7-lv/2009/2009_08_31_19_00/2009_08_31_19_00.mpg;Yukio HATOYAMA.jpg;12253;12833;35961;612;641;29
/net/per610a/home/mvp/mvp_db/news7-lv/2009/2009_08_31_19_00/2009_08_31_19_00.mpg;Yukio HATOYAMA.jpg;15961;16005;35961;798;800;2
/net/per610a/home/mvp/mvp_db/news7-lv/2009/2009_08_31_19_00/2009_08_31_19_00.mpg;Taro ASO.jpg;141;381;35961;7;19;12
/net/per610a/home/mvp/mvp_db/news7-lv/2009/2009_08_31_19_00/2009_08_31_19_00.mpg;Taro ASO.jpg;9401;10213;35961;470;510;40
/net/per610a/home/mvp/mvp_db/news7-lv/2009/2009_08_31_19_00/2009_08_31_19_00.mpg;Yukio HATOYAMA.jpg;3933;4325;35961;196;216;20
/net/per610a/home/mvp/mvp_db/news7-lv/2009/2009_08_31_19_00/2009_08_31_19_00.mpg;Yukio HATOYAMA.jpg;5957;6577;35961;298;329;31
/net/per610a/home/mvp/mvp_db/news7-lv/2009/2009_08_31_19_00/2009_08_31_19_00.mpg;Yukio HATOYAMA.jpg;6657;6685;35961;333;334;1
/net/per610a/home/mvp/mvp_db/news7-lv/2009/2009_08_31_19_00/2009_08_31_19_00.mpg;Ichiro OZAWA.jpg;6781;6805;35961;339;340;1
/net/per610a/home/mvp/mvp_db/news7-lv/2009/2009_08_31_19_00/2009_08_31_19_00.mpg;Ichiro OZAWA.jpg;19605;19665;35961;980;983;3
/net/per610a/home/mvp/mvp_db/news7-lv/2009/2009_08_31_19_00/2009_08_31_19_00.mpg;Taro ASO.jpg;9061;9329;35961;453;466;13
/net/per610a/home/mvp/mvp_db/news7-lv/2009/2009_08_31_19_00/2009_08_31_19_00.mpg;Taro ASO.jpg;10369;10445;35961;518;522;4
/net/per610a/home/mvp/mvp_db/news7-lv/2009/2009_09_01_19_00/2009_09_01_19_00.mpg;Yukio HATOYAMA.jpg;125;201;35961;6;10;4
/net/per610a/home/mvp/mvp_db/news7-lv/2009/2009_09_01_19_00/2009_09_01_19_00.mpg;Yukio HATOYAMA.jpg;1789;1861;35961;89;93;4
/net/per610a/home/mvp/mvp_db/news7-lv/2009/2009_09_01_19_00/2009_09_01_19_00.mpg;Yukio HATOYAMA.jpg;2121;2165;35961;106;108;2
/net/per610a/home/mvp/mvp_db/news7-lv/2009/2009_09_01_19_00/2009_09_01_19_00.mpg;Yukio HATOYAMA.jpg;6517;6869;35961;326;343;17
/net/per610a/home/mvp/mvp_db/news7-lv/2009/2009_09_01_19_00/2009_09_01_19_00.mpg;Yukio HATOYAMA.jpg;8521;8573;35961;426;428;2
/net/per610a/home/mvp/mvp_db/news7-lv/2009/2009_09_01_19_00/2009_09_01_19_00.mpg;Yukio HATOYAMA.jpg;18581;18649;35961;929;932;3
/net/per610a/home/mvp/mvp_db/news7-lv/2009/2009_09_01_19_00/2009_09_01_19_00.mpg;Mizuho FUKUSHIMA.jpg;4221;4417;35961;211;220;9
/net/per610a/home/mvp/mvp_db/news7-lv/2009/2009_09_02_19_00/2009_09_02_19_00.mpg;Sadakazu TANIGAKI.jpg;14841;15137;35961;742;757;15
/net/per610a/home/mvp/mvp_db/news7-lv/2009/2009_09_03_19_00/2009_09_03_19_00.mpg;Yukio HATOYAMA.jpg;1157;1677;35961;57;83;26
/net/per610a/home/mvp/mvp_db/news7-lv/2009/2009_09_03_19_00/2009_09_03_19_00.mpg;Yukio HATOYAMA.jpg;2117;2457;35961;105;122;17
/net/per610a/home/mvp/mvp_db/news7-lv/2009/2009_09_03_19_00/2009_09_03_19_00.mpg;Yukio HATOYAMA.jpg;3181;3421;35961;159;171;12
/net/per610a/home/mvp/mvp_db/news7-lv/2009/2009_09_03_19_00/2009_09_03_19_00.mpg;Yukio HATOYAMA.jpg;4893;5177;35961;244;258;14
/net/per610a/home/mvp/mvp_db/news7-lv/2009/2009_09_03_19_00/2009_09_03_19_00.mpg;Akihiro OHTA.jpg;15797;16517;35961;790;826;36
/net/per610a/home/mvp/mvp_db/news7-lv/2009/2009_09_04_19_00/2009_09_04_19_00.mpg;Natsuo YAMAGUCHI.jpg;5;5;35961;0;0;0
/net/per610a/home/mvp/mvp_db/news7-lv/2009/2009_09_04_19_00/2009_09_04_19_00.mpg;Natsuo YAMAGUCHI.jpg;5409;5597;35961;270;279;9
/net/per610a/home/mvp/mvp_db/news7-lv/2009/2009_09_04_19_00/2009_09_04_19_00.mpg;Ichiro OZAWA.jpg;1109;1497;35961;55;74;19
/net/per610a/home/mvp/mvp_db/news7-lv/2009/2009_09_04_19_00/2009_09_04_19_00.mpg;Ichiro OZAWA.jpg;11573;11889;35961;578;594;16
/net/per610a/home/mvp/mvp_db/news7-lv/2009/2009_09_04_19_00/2009_09_04_19_00.mpg;Yukio HATOYAMA.jpg;2501;2913;35961;125;145;20
/net/per610a/home/mvp/mvp_db/news7-lv/2009/2009_09_04_19_00/2009_09_04_19_00.mpg;Yukio HATOYAMA.jpg;12357;12409;35961;618;620;2
/net/per610a/home/mvp/mvp_db/news7-lv/2009/2009_09_04_19_00/2009_09_04_19_00.mpg;Taro ASO.jpg;13949;14273;35961;697;714;17
/net/per610a/home/mvp/mvp_db/news7-lv/2009/2009_09_04_19_00/2009_09_04_19_00.mpg;Taro ASO.jpg;14413;14597;35961;721;730;9
/net/per610a/home/mvp/mvp_db/news7-lv/2009/2009_09_05_19_00/2009_09_05_19_00.mpg;Yukio HATOYAMA.jpg;129;421;35961;6;21;15
/net/per610a/home/mvp/mvp_db/news7-lv/2009/2009_09_05_19_00/2009_09_05_19_00.mpg;Ichiro OZAWA.jpg;2149;2341;35961;107;117;10
/net/per610a/home/mvp/mvp_db/news7-lv/2009/2009_09_05_19_00/2009_09_05_19_00.mpg;Ichiro OZAWA.jpg;2413;2837;35961;120;141;21
/net/per610a/home/mvp/mvp_db/news7-lv/2009/2009_09_06_19_00/2009_09_06_19_00.mpg;Yukio HATOYAMA.jpg;1;33;35961;0;1;1
/net/per610a/home/mvp/mvp_db/news7-lv/2009/2009_09_06_19_00/2009_09_06_19_00.mpg;Yukio HATOYAMA.jpg;1113;1621;35961;55;81;26
/net/per610a/home/mvp/mvp_db/news7-lv/2009/2009_09_06_19_00/2009_09_06_19_00.mpg;Yukio HATOYAMA.jpg;2649;2701;35961;132;135;3
/net/per610a/home/mvp/mvp_db/news7-lv/2009/2009_09_06_19_00/2009_09_06_19_00.mpg;Yukio HATOYAMA.jpg;3053;3065;35961;152;153;1
/net/per610a/home/mvp/mvp_db/news7-lv/2009/2009_09_06_19_00/2009_09_06_19_00.mpg;Yukio HATOYAMA.jpg;5813;5917;35961;290;296;6
/net/per610a/home/mvp/mvp_db/news7-lv/2009/2009_09_06_19_00/2009_09_06_19_00.mpg;Naoto KAN.jpg;5965;6117;35961;298;306;8
/net/per610a/home/mvp/mvp_db/news7-lv/2009/2009_09_06_19_00/2009_09_06_19_00.mpg;Taro ASO.jpg;8909;8933;35961;445;446;1
/net/per610a/home/mvp/mvp_db/news7-lv/2009/2009_09_06_19_00/2009_09_06_19_00.mpg;Taro ASO.jpg;9141;9549;35961;457;477;20
/net/per610a/home/mvp/mvp_db/news7-lv/2009/2009_09_07_19_00/2009_09_07_19_00.mpg;Ichiro OZAWA.jpg;1;9;35961;0;0;0
/net/per610a/home/mvp/mvp_db/news7-lv/2009/2009_09_07_19_00/2009_09_07_19_00.mpg;Ichiro OZAWA.jpg;2361;3161;35961;118;158;40
/net/per610a/home/mvp/mvp_db/news7-lv/2009/2009_09_07_19_00/2009_09_07_19_00.mpg;Ichiro OZAWA.jpg;3257;3289;35961;162;164;2
/net/per610a/home/mvp/mvp_db/news7-lv/2009/2009_09_07_19_00/2009_09_07_19_00.mpg;Yukio HATOYAMA.jpg;4973;5889;35961;248;294;46
/net/per610a/home/mvp/mvp_db/news7-lv/2009/2009_09_07_19_00/2009_09_07_19_00.mpg;Taro ASO.jpg;14909;15349;35961;745;767;22
/net/per610a/home/mvp/mvp_db/news7-lv/2009/2009_09_08_19_00/2009_09_08_19_00.mpg;Katsuya OKADA.jpg;3893;4169;35961;194;208;14
/net/per610a/home/mvp/mvp_db/news7-lv/2009/2009_09_08_19_00/2009_09_08_19_00.mpg;Yukio HATOYAMA.jpg;6845;7205;35961;342;360;18
/net/per610a/home/mvp/mvp_db/news7-lv/2009/2009_09_08_19_00/2009_09_08_19_00.mpg;Yukio HATOYAMA.jpg;7277;7541;35961;364;377;13
/net/per610a/home/mvp/mvp_db/news7-lv/2009/2009_09_08_19_00/2009_09_08_19_00.mpg;Taro ASO.jpg;12477;12477;35961;624;624;0
/net/per610a/home/mvp/mvp_db/news7-lv/2009/2009_09_08_19_00/2009_09_08_19_00.mpg;Taro ASO.jpg;14053;14221;35961;703;711;8
/net/per610a/home/mvp/mvp_db/news7-lv/2009/2009_09_08_19_00/2009_09_08_19_00.mpg;Natsuo YAMAGUCHI.jpg;17605;17605;35961;880;880;0
/net/per610a/home/mvp/mvp_db/news7-lv/2009/2009_09_08_19_00/2009_09_08_19_00.mpg;Natsuo YAMAGUCHI.jpg;17741;18133;35961;887;907;20
/net/per610a/home/mvp/mvp_db/news7-lv/2009/2009_09_09_19_00/2009_09_09_19_00.mpg;Shizuka KAMEI.jpg;117;125;35961;5;6;1
/net/per610a/home/mvp/mvp_db/news7-lv/2009/2009_09_09_19_00/2009_09_09_19_00.mpg;Shizuka KAMEI.jpg;2017;2025;35961;100;101;1
/net/per610a/home/mvp/mvp_db/news7-lv/2009/2009_09_09_19_00/2009_09_09_19_00.mpg;Shizuka KAMEI.jpg;2773;2837;35961;138;141;3
/net/per610a/home/mvp/mvp_db/news7-lv/2009/2009_09_09_19_00/2009_09_09_19_00.mpg;Shizuka KAMEI.jpg;5009;5037;35961;250;251;1
/net/per610a/home/mvp/mvp_db/news7-lv/2009/2009_09_09_19_00/2009_09_09_19_00.mpg;Shizuka KAMEI.jpg;5841;5885;35961;292;294;2
/net/per610a/home/mvp/mvp_db/news7-lv/2009/2009_09_09_19_00/2009_09_09_19_00.mpg;Shizuka KAMEI.jpg;8061;8453;35961;403;422;19
/net/per610a/home/mvp/mvp_db/news7-lv/2009/2009_09_09_19_00/2009_09_09_19_00.mpg;Yukio HATOYAMA.jpg;149;277;35961;7;13;6
/net/per610a/home/mvp/mvp_db/news7-lv/2009/2009_09_09_19_00/2009_09_09_19_00.mpg;Yukio HATOYAMA.jpg;1609;1873;35961;80;93;13
/net/per610a/home/mvp/mvp_db/news7-lv/2009/2009_09_09_19_00/2009_09_09_19_00.mpg;Yukio HATOYAMA.jpg;1997;2101;35961;99;105;6
/net/per610a/home/mvp/mvp_db/news7-lv/2009/2009_09_09_19_00/2009_09_09_19_00.mpg;Yukio HATOYAMA.jpg;12737;13233;35961;637;661;24
/net/per610a/home/mvp/mvp_db/news7-lv/2009/2009_09_09_19_00/2009_09_09_19_00.mpg;Yukio EDANO.jpg;2669;2753;35961;133;137;4
/net/per610a/home/mvp/mvp_db/news7-lv/2009/2009_09_09_19_00/2009_09_09_19_00.mpg;Yukio EDANO.jpg;5277;5305;35961;263;265;2
/net/per610a/home/mvp/mvp_db/news7-lv/2009/2009_09_09_19_00/2009_09_09_19_00.mpg;Katsuya OKADA.jpg;4261;4613;35961;213;230;17
/net/per610a/home/mvp/mvp_db/news7-lv/2009/2009_09_10_19_00/2009_09_10_19_00.mpg;Yukio HATOYAMA.jpg;1113;1593;35961;55;79;24
/net/per610a/home/mvp/mvp_db/news7-lv/2009/2009_09_10_19_00/2009_09_10_19_00.mpg;Yukio HATOYAMA.jpg;1801;1845;35961;90;92;2
/net/per610a/home/mvp/mvp_db/news7-lv/2009/2009_09_10_19_00/2009_09_10_19_00.mpg;Yukio HATOYAMA.jpg;2641;2713;35961;132;135;3
/net/per610a/home/mvp/mvp_db/news7-lv/2009/2009_09_10_19_00/2009_09_10_19_00.mpg;Yukio HATOYAMA.jpg;5285;5345;35961;264;267;3
/net/per610a/home/mvp/mvp_db/news7-lv/2009/2009_09_10_19_00/2009_09_10_19_00.mpg;Yukio HATOYAMA.jpg;8229;8249;35961;411;412;1
/net/per610a/home/mvp/mvp_db/news7-lv/2009/2009_09_10_19_00/2009_09_10_19_00.mpg;Shizuka KAMEI.jpg;3165;3393;35961;158;169;11
/net/per610a/home/mvp/mvp_db/news7-lv/2009/2009_09_10_19_00/2009_09_10_19_00.mpg;Kazuo SHII.jpg;4973;5113;35961;248;255;7
/net/per610a/home/mvp/mvp_db/news7-lv/2009/2009_09_12_19_00/2009_09_12_19_00.mpg;Yukio HATOYAMA.jpg;501;705;35961;25;35;10
/net/per610a/home/mvp/mvp_db/news7-lv/2009/2009_09_12_19_00/2009_09_12_19_00.mpg;Yukio HATOYAMA.jpg;11461;11797;35961;573;590;17
/net/per610a/home/mvp/mvp_db/news7-lv/2009/2009_09_12_19_00/2009_09_12_19_00.mpg;Shintaro ISHIHARA.jpg;28697;28897;35961;1435;1445;10
/net/per610a/home/mvp/mvp_db/news7-lv/2009/2009_09_13_19_00/2009_09_13_19_00.mpg;Yukio HATOYAMA.jpg;1705;1769;35961;85;88;3
/net/per610a/home/mvp/mvp_db/news7-lv/2009/2009_09_13_19_00/2009_09_13_19_00.mpg;Sadakazu TANIGAKI.jpg;3677;6101;35961;183;305;122
/net/per610a/home/mvp/mvp_db/news7-lv/2009/2009_09_14_19_00/2009_09_14_19_00.mpg;Yukio HATOYAMA.jpg;897;937;35961;44;46;2
/net/per610a/home/mvp/mvp_db/news7-lv/2009/2009_09_14_19_00/2009_09_14_19_00.mpg;Yukio HATOYAMA.jpg;14425;14457;35961;721;723;2
/net/per610a/home/mvp/mvp_db/news7-lv/2009/2009_09_14_19_00/2009_09_14_19_00.mpg;Yukio HATOYAMA.jpg;15577;15645;35961;779;782;3
/net/per610a/home/mvp/mvp_db/news7-lv/2009/2009_09_14_19_00/2009_09_14_19_00.mpg;Yukio HATOYAMA.jpg;16185;17301;35961;809;865;56
/net/per610a/home/mvp/mvp_db/news7-lv/2009/2009_09_14_19_00/2009_09_14_19_00.mpg;Akihiro OHTA.jpg;19445;19717;35961;972;986;14
/net/per610a/home/mvp/mvp_db/news7-lv/2009/2009_09_15_19_00/2009_09_15_19_00.mpg;Yukio HATOYAMA.jpg;481;761;35961;24;38;14
/net/per610a/home/mvp/mvp_db/news7-lv/2009/2009_09_15_19_00/2009_09_15_19_00.mpg;Yukio HATOYAMA.jpg;1481;1629;35961;74;81;7
/net/per610a/home/mvp/mvp_db/news7-lv/2009/2009_09_15_19_00/2009_09_15_19_00.mpg;Yukio HATOYAMA.jpg;1845;2233;35961;92;111;19
/net/per610a/home/mvp/mvp_db/news7-lv/2009/2009_09_15_19_00/2009_09_15_19_00.mpg;Yukio HATOYAMA.jpg;3233;3389;35961;161;169;8
/net/per610a/home/mvp/mvp_db/news7-lv/2009/2009_09_15_19_00/2009_09_15_19_00.mpg;Yukio HATOYAMA.jpg;4189;4229;35961;209;211;2
/net/per610a/home/mvp/mvp_db/news7-lv/2009/2009_09_15_19_00/2009_09_15_19_00.mpg;Yukio HATOYAMA.jpg;18445;18593;35961;922;930;8
/net/per610a/home/mvp/mvp_db/news7-lv/2009/2009_09_15_19_00/2009_09_15_19_00.mpg;Yukio HATOYAMA.jpg;18865;18865;35961;943;943;0
/net/per610a/home/mvp/mvp_db/news7-lv/2009/2009_09_15_19_00/2009_09_15_19_00.mpg;Yukio HATOYAMA.jpg;19717;19813;35961;986;991;5
/net/per610a/home/mvp/mvp_db/news7-lv/2009/2009_09_15_19_00/2009_09_15_19_00.mpg;Katsuya OKADA.jpg;2465;2557;35961;123;127;4
/net/per610a/home/mvp/mvp_db/news7-lv/2009/2009_09_15_19_00/2009_09_15_19_00.mpg;Shizuka KAMEI.jpg;6421;6497;35961;321;325;4
/net/per610a/home/mvp/mvp_db/news7-lv/2009/2009_09_15_19_00/2009_09_15_19_00.mpg;Shizuka KAMEI.jpg;12357;12401;35961;618;620;2
/net/per610a/home/mvp/mvp_db/news7-lv/2009/2009_09_15_19_00/2009_09_15_19_00.mpg;Naoto KAN.jpg;7577;7617;35961;379;381;2
/net/per610a/home/mvp/mvp_db/news7-lv/2009/2009_09_15_19_00/2009_09_15_19_00.mpg;Naoto KAN.jpg;7957;8017;35961;398;401;3
/net/per610a/home/mvp/mvp_db/news7-lv/2009/2009_09_15_19_00/2009_09_15_19_00.mpg;Naoto KAN.jpg;9457;9521;35961;473;476;3
/net/per610a/home/mvp/mvp_db/news7-lv/2009/2009_09_15_19_00/2009_09_15_19_00.mpg;Naoto KAN.jpg;19357;19425;35961;968;971;3
/net/per610a/home/mvp/mvp_db/news7-lv/2009/2009_09_15_19_00/2009_09_15_19_00.mpg;Ichiro OZAWA.jpg;9461;10005;35961;473;500;27
/net/per610a/home/mvp/mvp_db/news7-lv/2009/2009_09_15_19_00/2009_09_15_19_00.mpg;Ichiro OZAWA.jpg;19365;19713;35961;968;986;18
/net/per610a/home/mvp/mvp_db/news7-lv/2009/2009_09_15_19_00/2009_09_15_19_00.mpg;Sadakazu TANIGAKI.jpg;20133;21349;35961;1007;1068;61
/net/per610a/home/mvp/mvp_db/news7-lv/2009/2009_09_16_19_00/2009_09_16_19_00.mpg;Yukio HATOYAMA.jpg;45;81;35961;2;4;2
/net/per610a/home/mvp/mvp_db/news7-lv/2009/2009_09_16_19_00/2009_09_16_19_00.mpg;Yukio HATOYAMA.jpg;153;213;35961;7;10;3
/net/per610a/home/mvp/mvp_db/news7-lv/2009/2009_09_16_19_00/2009_09_16_19_00.mpg;Yukio HATOYAMA.jpg;17121;17341;35961;856;867;11
/net/per610a/home/mvp/mvp_db/news7-lv/2009/2009_09_16_19_00/2009_09_16_19_00.mpg;Yukio HATOYAMA.jpg;19477;21513;35961;974;1076;102
/net/per610a/home/mvp/mvp_db/news7-lv/2009/2009_09_16_19_00/2009_09_16_19_00.mpg;Naoto KAN.jpg;337;393;35961;16;19;3
/net/per610a/home/mvp/mvp_db/news7-lv/2009/2009_09_16_19_00/2009_09_16_19_00.mpg;Naoto KAN.jpg;9857;10141;35961;493;507;14
/net/per610a/home/mvp/mvp_db/news7-lv/2009/2009_09_16_19_00/2009_09_16_19_00.mpg;Naoto KAN.jpg;25945;26189;35961;1297;1310;13
/net/per610a/home/mvp/mvp_db/news7-lv/2009/2009_09_16_19_00/2009_09_16_19_00.mpg;Naoto KAN.jpg;31249;31397;35961;1563;1570;7
/net/per610a/home/mvp/mvp_db/news7-lv/2009/2009_09_16_19_00/2009_09_16_19_00.mpg;Taro ASO.jpg;4921;5297;35961;246;264;18
/net/per610a/home/mvp/mvp_db/news7-lv/2009/2009_09_16_19_00/2009_09_16_19_00.mpg;Seiji MAEHARA.jpg;5309;5309;35961;265;265;0
/net/per610a/home/mvp/mvp_db/news7-lv/2009/2009_09_16_19_00/2009_09_16_19_00.mpg;Seiji MAEHARA.jpg;5373;5393;35961;268;269;1
/net/per610a/home/mvp/mvp_db/news7-lv/2009/2009_09_16_19_00/2009_09_16_19_00.mpg;Seiji MAEHARA.jpg;28017;28301;35961;1401;1415;14
/net/per610a/home/mvp/mvp_db/news7-lv/2009/2009_09_16_19_00/2009_09_16_19_00.mpg;Shizuka KAMEI.jpg;12357;12473;35961;618;623;5
/net/per610a/home/mvp/mvp_db/news7-lv/2009/2009_09_16_19_00/2009_09_16_19_00.mpg;Shizuka KAMEI.jpg;29277;29629;35961;1464;1482;18
/net/per610a/home/mvp/mvp_db/news7-lv/2009/2009_09_16_19_00/2009_09_16_19_00.mpg;Katsuya OKADA.jpg;26565;26781;35961;1328;1339;11
/net/per610a/home/mvp/mvp_db/news7-lv/2009/2009_09_16_19_00/2009_09_16_19_00.mpg;Yukio HATOYAMA.jpg;32769;33213;35961;1639;1661;22
/net/per610a/home/mvp/mvp_db/news7-lv/2009/2009_09_16_19_00/2009_09_16_19_00.mpg;Yukio HATOYAMA.jpg;35141;35313;35961;1757;1766;9
/net/per610a/home/mvp/mvp_db/news7-lv/2009/2009_09_17_19_00/2009_09_17_19_00.mpg;Yukio HATOYAMA.jpg;1745;1877;35961;87;93;6
/net/per610a/home/mvp/mvp_db/news7-lv/2009/2009_09_17_19_00/2009_09_17_19_00.mpg;Yukio HATOYAMA.jpg;5953;6533;35961;297;326;29
/net/per610a/home/mvp/mvp_db/news7-lv/2009/2009_09_17_19_00/2009_09_17_19_00.mpg;Seiji MAEHARA.jpg;6937;7185;35961;347;359;12
/net/per610a/home/mvp/mvp_db/news7-lv/2009/2009_09_17_19_00/2009_09_17_19_00.mpg;Seiji MAEHARA.jpg;9325;9601;35961;466;480;14
/net/per610a/home/mvp/mvp_db/news7-lv/2009/2009_09_17_19_00/2009_09_17_19_00.mpg;Sadakazu TANIGAKI.jpg;14921;15273;35961;746;764;18
/net/per610a/home/mvp/mvp_db/news7-lv/2009/2009_09_17_19_00/2009_09_17_19_00.mpg;Shintaro ISHIHARA.jpg;28541;28545;35961;1427;1428;1
/net/per610a/home/mvp/mvp_db/news7-lv/2009/2009_09_17_19_00/2009_09_17_19_00.mpg;Shintaro ISHIHARA.jpg;28657;28969;35961;1433;1449;16
/net/per610a/home/mvp/mvp_db/news7-lv/2009/2009_09_18_19_00/2009_09_18_19_00.mpg;Yukio HATOYAMA.jpg;129;137;35961;6;6;0
/net/per610a/home/mvp/mvp_db/news7-lv/2009/2009_09_18_19_00/2009_09_18_19_00.mpg;Yukio HATOYAMA.jpg;2141;2185;35961;107;109;2
/net/per610a/home/mvp/mvp_db/news7-lv/2009/2009_09_18_19_00/2009_09_18_19_00.mpg;Yukio HATOYAMA.jpg;3357;3501;35961;167;175;8
/net/per610a/home/mvp/mvp_db/news7-lv/2009/2009_09_18_19_00/2009_09_18_19_00.mpg;Yukio HATOYAMA.jpg;8641;8669;35961;432;433;1
/net/per610a/home/mvp/mvp_db/news7-lv/2009/2009_09_18_19_00/2009_09_18_19_00.mpg;Yukio HATOYAMA.jpg;9065;9117;35961;453;456;3
/net/per610a/home/mvp/mvp_db/news7-lv/2009/2009_09_18_19_00/2009_09_18_19_00.mpg;Yukio HATOYAMA.jpg;1337;1901;35961;66;95;29
/net/per610a/home/mvp/mvp_db/news7-lv/2009/2009_09_18_19_00/2009_09_18_19_00.mpg;Yukio HATOYAMA.jpg;2337;2477;35961;116;123;7
/net/per610a/home/mvp/mvp_db/news7-lv/2009/2009_09_18_19_00/2009_09_18_19_00.mpg;Yukio HATOYAMA.jpg;2581;2661;35961;129;133;4
/net/per610a/home/mvp/mvp_db/news7-lv/2009/2009_09_18_19_00/2009_09_18_19_00.mpg;Yukio HATOYAMA.jpg;10981;11377;35961;549;569;20
/net/per610a/home/mvp/mvp_db/news7-lv/2009/2009_09_18_19_00/2009_09_18_19_00.mpg;Naoto KAN.jpg;2673;2753;35961;133;137;4
/net/per610a/home/mvp/mvp_db/news7-lv/2009/2009_09_18_19_00/2009_09_18_19_00.mpg;Naoto KAN.jpg;9877;10629;35961;494;531;37
/net/per610a/home/mvp/mvp_db/news7-lv/2009/2009_09_18_19_00/2009_09_18_19_00.mpg;Ichiro OZAWA.jpg;2841;3353;35961;142;167;25
/net/per610a/home/mvp/mvp_db/news7-lv/2009/2009_09_18_19_00/2009_09_18_19_00.mpg;Sadakazu TANIGAKI.jpg;12681;12797;35961;634;640;6
/net/per610a/home/mvp/mvp_db/news7-lv/2009/2009_09_18_19_00/2009_09_18_19_00.mpg;Sadakazu TANIGAKI.jpg;12917;12917;35961;646;646;0
/net/per610a/home/mvp/mvp_db/news7-lv/2009/2009_09_18_19_00/2009_09_18_19_00.mpg;Sadakazu TANIGAKI.jpg;13097;13401;35961;655;670;15
/net/per610a/home/mvp/mvp_db/news7-lv/2009/2009_09_18_19_00/2009_09_18_19_00.mpg;Sadakazu TANIGAKI.jpg;20665;21229;35961;1033;1062;29
/net/per610a/home/mvp/mvp_db/news7-lv/2009/2009_09_19_19_00/2009_09_19_19_00.mpg;Yukio HATOYAMA.jpg;4401;4761;35961;220;238;18
/net/per610a/home/mvp/mvp_db/news7-lv/2009/2009_09_19_19_00/2009_09_19_19_00.mpg;Yukio HATOYAMA.jpg;5249;5297;35961;262;264;2
/net/per610a/home/mvp/mvp_db/news7-lv/2009/2009_09_19_19_00/2009_09_19_19_00.mpg;Yukio HATOYAMA.jpg;6709;6973;35961;335;348;13
/net/per610a/home/mvp/mvp_db/news7-lv/2009/2009_09_19_19_00/2009_09_19_19_00.mpg;Yukio HATOYAMA.jpg;10433;10777;35961;521;539;18
/net/per610a/home/mvp/mvp_db/news7-lv/2009/2009_09_19_19_00/2009_09_19_19_00.mpg;Sadakazu TANIGAKI.jpg;10901;11209;35961;545;560;15
/net/per610a/home/mvp/mvp_db/news7-lv/2009/2009_09_19_19_00/2009_09_19_19_00.mpg;Sadakazu TANIGAKI.jpg;11753;11973;35961;587;598;11
/net/per610a/home/mvp/mvp_db/news7-lv/2009/2009_09_19_19_00/2009_09_19_19_00.mpg;Sadakazu TANIGAKI.jpg;13945;14125;35961;697;706;9
/net/per610a/home/mvp/mvp_db/news7-lv/2009/2009_09_21_19_00/2009_09_21_19_00.mpg;Yukio HATOYAMA.jpg;353;465;35961;17;23;6
/net/per610a/home/mvp/mvp_db/news7-lv/2009/2009_09_21_19_00/2009_09_21_19_00.mpg;Yukio HATOYAMA.jpg;1717;2165;35961;85;108;23
/net/per610a/home/mvp/mvp_db/news7-lv/2009/2009_09_21_19_00/2009_09_21_19_00.mpg;Yukio HATOYAMA.jpg;2997;3129;35961;149;156;7
/net/per610a/home/mvp/mvp_db/news7-lv/2009/2009_09_21_19_00/2009_09_21_19_00.mpg;Yukio HATOYAMA.jpg;3829;4005;35961;191;200;9
/net/per610a/home/mvp/mvp_db/news7-lv/2009/2009_09_21_19_00/2009_09_21_19_00.mpg;Yukio HATOYAMA.jpg;4261;4449;35961;213;222;9
/net/per610a/home/mvp/mvp_db/news7-lv/2009/2009_09_21_19_00/2009_09_21_19_00.mpg;Yukio HATOYAMA.jpg;8197;9041;35961;410;452;42
/net/per610a/home/mvp/mvp_db/news7-lv/2009/2009_09_21_19_00/2009_09_21_19_00.mpg;Yukio HATOYAMA.jpg;16241;16773;35961;812;839;27
/net/per610a/home/mvp/mvp_db/news7-lv/2009/2009_09_21_19_00/2009_09_21_19_00.mpg;Seiji MAEHARA.jpg;10117;10569;35961;506;528;22
/net/per610a/home/mvp/mvp_db/news7-lv/2009/2009_09_21_19_00/2009_09_21_19_00.mpg;Seiji MAEHARA.jpg;13361;13449;35961;668;672;4
/net/per610a/home/mvp/mvp_db/news7-lv/2009/2009_09_22_19_00/2009_09_22_19_00.mpg;Yukio HATOYAMA.jpg;85;297;35961;4;14;10
/net/per610a/home/mvp/mvp_db/news7-lv/2009/2009_09_22_19_00/2009_09_22_19_00.mpg;Yukio HATOYAMA.jpg;6821;7421;35961;341;371;30
/net/per610a/home/mvp/mvp_db/news7-lv/2009/2009_09_22_19_00/2009_09_22_19_00.mpg;Yukio HATOYAMA.jpg;7945;8149;35961;397;407;10
/net/per610a/home/mvp/mvp_db/news7-lv/2009/2009_09_22_19_00/2009_09_22_19_00.mpg;Yukio HATOYAMA.jpg;9137;9189;35961;457;459;2
/net/per610a/home/mvp/mvp_db/news7-lv/2009/2009_09_22_19_00/2009_09_22_19_00.mpg;Natsuo YAMAGUCHI.jpg;10553;10557;35961;527;528;1
/net/per610a/home/mvp/mvp_db/news7-lv/2009/2009_09_22_19_00/2009_09_22_19_00.mpg;Natsuo YAMAGUCHI.jpg;10825;11069;35961;541;553;12
/net/per610a/home/mvp/mvp_db/news7-lv/2009/2009_09_22_19_00/2009_09_22_19_00.mpg;Seiji MAEHARA.jpg;11637;12081;35961;582;604;22
/net/per610a/home/mvp/mvp_db/news7-lv/2009/2009_09_22_19_00/2009_09_22_19_00.mpg;Seiji MAEHARA.jpg;12161;12301;35961;608;615;7
/net/per610a/home/mvp/mvp_db/news7-lv/2009/2009_09_23_19_00/2009_09_23_19_00.mpg;Seiji MAEHARA.jpg;37;177;35961;1;8;7
/net/per610a/home/mvp/mvp_db/news7-lv/2009/2009_09_23_19_00/2009_09_23_19_00.mpg;Seiji MAEHARA.jpg;6341;6449;35961;317;322;5
/net/per610a/home/mvp/mvp_db/news7-lv/2009/2009_09_23_19_00/2009_09_23_19_00.mpg;Seiji MAEHARA.jpg;7177;7249;35961;359;362;3
/net/per610a/home/mvp/mvp_db/news7-lv/2009/2009_09_23_19_00/2009_09_23_19_00.mpg;Seiji MAEHARA.jpg;7617;8209;35961;381;410;29
/net/per610a/home/mvp/mvp_db/news7-lv/2009/2009_09_23_19_00/2009_09_23_19_00.mpg;Yukio HATOYAMA.jpg;9885;11141;35961;494;557;63
/net/per610a/home/mvp/mvp_db/news7-lv/2009/2009_09_23_19_00/2009_09_23_19_00.mpg;Yukio HATOYAMA.jpg;14873;15117;35961;744;756;12
/net/per610a/home/mvp/mvp_db/news7-lv/2009/2009_09_23_19_00/2009_09_23_19_00.mpg;Yukio HATOYAMA.jpg;15393;15757;35961;770;788;18
/net/per610a/home/mvp/mvp_db/news7-lv/2009/2009_09_23_19_00/2009_09_23_19_00.mpg;Yukio HATOYAMA.jpg;15897;16193;35961;795;810;15
/net/per610a/home/mvp/mvp_db/news7-lv/2009/2009_09_24_19_00/2009_09_24_19_00.mpg;Yukio HATOYAMA.jpg;149;285;35961;7;14;7
/net/per610a/home/mvp/mvp_db/news7-lv/2009/2009_09_24_19_00/2009_09_24_19_00.mpg;Yukio HATOYAMA.jpg;19273;19393;35961;964;970;6
/net/per610a/home/mvp/mvp_db/news7-lv/2009/2009_09_24_19_00/2009_09_24_19_00.mpg;Yukio HATOYAMA.jpg;20253;20513;35961;1013;1026;13
/net/per610a/home/mvp/mvp_db/news7-lv/2009/2009_09_24_19_00/2009_09_24_19_00.mpg;Shizuka KAMEI.jpg;1077;1297;35961;53;64;11
/net/per610a/home/mvp/mvp_db/news7-lv/2009/2009_09_24_19_00/2009_09_24_19_00.mpg;Shizuka KAMEI.jpg;2145;2497;35961;107;124;17
/net/per610a/home/mvp/mvp_db/news7-lv/2009/2009_09_24_19_00/2009_09_24_19_00.mpg;Shizuka KAMEI.jpg;2681;3357;35961;134;167;33
/net/per610a/home/mvp/mvp_db/news7-lv/2009/2009_09_24_19_00/2009_09_24_19_00.mpg;Shizuka KAMEI.jpg;17513;17921;35961;876;896;20
/net/per610a/home/mvp/mvp_db/news7-lv/2009/2009_09_24_19_00/2009_09_24_19_00.mpg;Seiji MAEHARA.jpg;9985;10225;35961;499;511;12
/net/per610a/home/mvp/mvp_db/news7-lv/2009/2009_09_24_19_00/2009_09_24_19_00.mpg;Ichiro OZAWA.jpg;13721;14569;35961;686;728;42
/net/per610a/home/mvp/mvp_db/news7-lv/2009/2009_09_25_19_00/2009_09_25_19_00.mpg;Seiji MAEHARA.jpg;8641;9325;35961;432;466;34
/net/per610a/home/mvp/mvp_db/news7-lv/2009/2009_09_25_19_00/2009_09_25_19_00.mpg;Seiji MAEHARA.jpg;13629;13661;35961;681;683;2
/net/per610a/home/mvp/mvp_db/news7-lv/2009/2009_09_25_19_00/2009_09_25_19_00.mpg;Seiji MAEHARA.jpg;16217;16585;35961;811;829;18
/net/per610a/home/mvp/mvp_db/news7-lv/2009/2009_09_25_19_00/2009_09_25_19_00.mpg;Yukio HATOYAMA.jpg;26217;26241;35961;1311;1312;1
/net/per610a/home/mvp/mvp_db/news7-lv/2009/2009_09_25_19_00/2009_09_25_19_00.mpg;Yukio HATOYAMA.jpg;27065;27129;35961;1353;1357;4
/net/per610a/home/mvp/mvp_db/news7-lv/2009/2009_09_25_19_00/2009_09_25_19_00.mpg;Yukio HATOYAMA.jpg;27237;27333;35961;1362;1367;5
/net/per610a/home/mvp/mvp_db/news7-lv/2009/2009_09_26_19_00/2009_09_26_19_00.mpg;Yukio HATOYAMA.jpg;9;29;35961;0;1;1
/net/per610a/home/mvp/mvp_db/news7-lv/2009/2009_09_26_19_00/2009_09_26_19_00.mpg;Yukio HATOYAMA.jpg;2501;2817;35961;125;140;15
/net/per610a/home/mvp/mvp_db/news7-lv/2009/2009_09_26_19_00/2009_09_26_19_00.mpg;Yukio HATOYAMA.jpg;4717;4841;35961;235;242;7
/net/per610a/home/mvp/mvp_db/news7-lv/2009/2009_09_26_19_00/2009_09_26_19_00.mpg;Yukio HATOYAMA.jpg;6853;7389;35961;342;369;27
/net/per610a/home/mvp/mvp_db/news7-lv/2009/2009_09_26_19_00/2009_09_26_19_00.mpg;Yukio HATOYAMA.jpg;9741;9757;35961;487;488;1
/net/per610a/home/mvp/mvp_db/news7-lv/2009/2009_09_26_19_00/2009_09_26_19_00.mpg;Yukio HATOYAMA.jpg;9905;10413;35961;495;520;25
/net/per610a/home/mvp/mvp_db/news7-lv/2009/2009_09_26_19_00/2009_09_26_19_00.mpg;Seiji MAEHARA.jpg;829;985;35961;41;49;8
/net/per610a/home/mvp/mvp_db/news7-lv/2009/2009_09_26_19_00/2009_09_26_19_00.mpg;Seiji MAEHARA.jpg;17897;18769;35961;895;938;43
/net/per610a/home/mvp/mvp_db/news7-lv/2009/2009_09_26_19_00/2009_09_26_19_00.mpg;Sadakazu TANIGAKI.jpg;21577;21761;35961;1079;1088;9
/net/per610a/home/mvp/mvp_db/news7-lv/2009/2009_09_27_19_00/2009_09_27_19_00.mpg;Seiji MAEHARA.jpg;9725;10657;35961;486;533;47
/net/per610a/home/mvp/mvp_db/news7-lv/2009/2009_09_27_19_00/2009_09_27_19_00.mpg;Shizuka KAMEI.jpg;10669;10733;35961;533;536;3
/net/per610a/home/mvp/mvp_db/news7-lv/2009/2009_09_28_19_00/2009_09_28_19_00.mpg;Sadakazu TANIGAKI.jpg;169;437;35961;8;21;13
/net/per610a/home/mvp/mvp_db/news7-lv/2009/2009_09_28_19_00/2009_09_28_19_00.mpg;Sadakazu TANIGAKI.jpg;1813;1953;35961;90;97;7
/net/per610a/home/mvp/mvp_db/news7-lv/2009/2009_09_28_19_00/2009_09_28_19_00.mpg;Sadakazu TANIGAKI.jpg;4425;4449;35961;221;222;1
/net/per610a/home/mvp/mvp_db/news7-lv/2009/2009_09_28_19_00/2009_09_28_19_00.mpg;Sadakazu TANIGAKI.jpg;1321;1613;35961;66;80;14
/net/per610a/home/mvp/mvp_db/news7-lv/2009/2009_09_28_19_00/2009_09_28_19_00.mpg;Sadakazu TANIGAKI.jpg;11953;12033;35961;597;601;4
/net/per610a/home/mvp/mvp_db/news7-lv/2009/2009_09_28_19_00/2009_09_28_19_00.mpg;Yukio HATOYAMA.jpg;10081;10113;35961;504;505;1
/net/per610a/home/mvp/mvp_db/news7-lv/2009/2009_09_28_19_00/2009_09_28_19_00.mpg;Yukio HATOYAMA.jpg;14193;14269;35961;710;713;3
/net/per610a/home/mvp/mvp_db/news7-lv/2009/2009_09_28_19_00/2009_09_28_19_00.mpg;Yukio HATOYAMA.jpg;15113;15193;35961;756;760;4
/net/per610a/home/mvp/mvp_db/news7-lv/2009/2009_09_28_19_00/2009_09_28_19_00.mpg;Naoto KAN.jpg;13305;13697;35961;665;685;20
/net/per610a/home/mvp/mvp_db/news7-lv/2009/2009_09_29_19_00/2009_09_29_19_00.mpg;Yukio HATOYAMA.jpg;1549;1773;35961;77;88;11
/net/per610a/home/mvp/mvp_db/news7-lv/2009/2009_09_29_19_00/2009_09_29_19_00.mpg;Seiji MAEHARA.jpg;4057;4129;35961;202;206;4
/net/per610a/home/mvp/mvp_db/news7-lv/2009/2009_09_29_19_00/2009_09_29_19_00.mpg;Seiji MAEHARA.jpg;5917;6525;35961;296;326;30
/net/per610a/home/mvp/mvp_db/news7-lv/2009/2009_09_29_19_00/2009_09_29_19_00.mpg;Naoto KAN.jpg;6821;6993;35961;341;349;8
/net/per610a/home/mvp/mvp_db/news7-lv/2009/2009_09_29_19_00/2009_09_29_19_00.mpg;Kohei Otsuka.jpg;12281;12369;35961;614;618;4
/net/per610a/home/mvp/mvp_db/news7-lv/2009/2009_09_29_19_00/2009_09_29_19_00.mpg;Sadakazu TANIGAKI.jpg;18057;18073;35961;903;904;1
/net/per610a/home/mvp/mvp_db/news7-lv/2009/2009_09_29_19_00/2009_09_29_19_00.mpg;Sadakazu TANIGAKI.jpg;18389;18409;35961;919;920;1
/net/per610a/home/mvp/mvp_db/news7-lv/2009/2009_09_29_19_00/2009_09_29_19_00.mpg;Sadakazu TANIGAKI.jpg;19893;20305;35961;995;1015;20
/net/per610a/home/mvp/mvp_db/news7-lv/2009/2009_09_30_19_00/2009_09_30_19_00.mpg;Shizuka KAMEI.jpg;15501;15645;35961;775;782;7
/net/per610a/home/mvp/mvp_db/news7-lv/2009/2009_09_30_19_00/2009_09_30_19_00.mpg;Sadakazu TANIGAKI.jpg;23009;23529;35961;1151;1177;26
/net/per610a/home/mvp/mvp_db/news7-lv/2009/2009_09_30_19_00/2009_09_30_19_00.mpg;Takeo Hiranuma.jpeg;24457;24853;35961;1223;1243;20
/net/per610a/home/mvp/mvp_db/news7-lv/2009/2009_09_30_19_00/2009_09_30_19_00.mpg;Naoto KAN.jpg;24961;25485;35961;1248;1274;26
/net/per610a/home/mvp/mvp_db/news7-lv/2009/2009_09_30_19_00/2009_09_30_19_00.mpg;Ichiro OZAWA.jpg;24961;25485;35961;1248;1274;26
/net/per610a/home/mvp/mvp_db/news7-lv/2009/2009_10_01_19_00/2009_10_01_19_00.mpg;Yukio HATOYAMA.jpg;7957;8853;35961;398;442;44
/net/per610a/home/mvp/mvp_db/news7-lv/2009/2009_10_01_19_00/2009_10_01_19_00.mpg;Yukio HATOYAMA.jpg;10829;10973;35961;541;548;7
/net/per610a/home/mvp/mvp_db/news7-lv/2009/2009_10_01_19_00/2009_10_01_19_00.mpg;Yukio HATOYAMA.jpg;31689;31977;35961;1585;1599;14
/net/per610a/home/mvp/mvp_db/news7-lv/2009/2009_10_01_19_00/2009_10_01_19_00.mpg;Yukio HATOYAMA.jpg;11821;12457;35961;591;623;32
/net/per610a/home/mvp/mvp_db/news7-lv/2009/2009_10_01_19_00/2009_10_01_19_00.mpg;Yukio HATOYAMA.jpg;13853;13945;35961;693;697;4
/net/per610a/home/mvp/mvp_db/news7-lv/2009/2009_10_01_19_00/2009_10_01_19_00.mpg;Natsuo YAMAGUCHI.jpg;14901;15757;35961;745;788;43
/net/per610a/home/mvp/mvp_db/news7-lv/2009/2009_10_02_19_00/2009_10_02_19_00.mpg;Yukio HATOYAMA.jpg;2165;2201;35961;108;110;2
/net/per610a/home/mvp/mvp_db/news7-lv/2009/2009_10_02_19_00/2009_10_02_19_00.mpg;Yukio HATOYAMA.jpg;7105;7109;35961;355;355;0
/net/per610a/home/mvp/mvp_db/news7-lv/2009/2009_10_02_19_00/2009_10_02_19_00.mpg;Yukio HATOYAMA.jpg;7329;7357;35961;366;368;2
/net/per610a/home/mvp/mvp_db/news7-lv/2009/2009_10_02_19_00/2009_10_02_19_00.mpg;Yukio HATOYAMA.jpg;17705;17793;35961;885;890;5
/net/per610a/home/mvp/mvp_db/news7-lv/2009/2009_10_02_19_00/2009_10_02_19_00.mpg;Sadakazu TANIGAKI.jpg;19429;19829;35961;971;991;20
/net/per610a/home/mvp/mvp_db/news7-lv/2009/2009_10_02_19_00/2009_10_02_19_00.mpg;Natsuo YAMAGUCHI.jpg;29609;30153;35961;1481;1508;27
/net/per610a/home/mvp/mvp_db/news7-lv/2009/2009_10_03_19_00/2009_10_03_19_00.mpg;Yukio HATOYAMA.jpg;4069;4073;35961;203;203;0
/net/per610a/home/mvp/mvp_db/news7-lv/2009/2009_10_03_19_00/2009_10_03_19_00.mpg;Yukio HATOYAMA.jpg;11661;11845;35961;583;592;9
/net/per610a/home/mvp/mvp_db/news7-lv/2009/2009_10_03_19_00/2009_10_03_19_00.mpg;Shintaro ISHIHARA.jpg;5853;6697;35961;292;335;43
/net/per610a/home/mvp/mvp_db/news7-lv/2009/2009_10_03_19_00/2009_10_03_19_00.mpg;Seiji MAEHARA.jpg;9381;9505;35961;469;475;6
/net/per610a/home/mvp/mvp_db/news7-lv/2009/2009_10_04_19_00/2009_10_04_19_00.mpg;Shintaro ISHIHARA.jpg;18721;19497;35961;936;975;39
/net/per610a/home/mvp/mvp_db/news7-lv/2009/2009_10_04_19_00/2009_10_04_19_00.mpg;Shintaro ISHIHARA.jpg;19833;20205;35961;992;1010;18
/net/per610a/home/mvp/mvp_db/news7-lv/2009/2009_10_04_19_00/2009_10_04_19_00.mpg;Shintaro ISHIHARA.jpg;20501;20993;35961;1025;1050;25
/net/per610a/home/mvp/mvp_db/news7-lv/2009/2009_10_05_19_00/2009_10_05_19_00.mpg;Naoto KAN.jpg;73;81;35961;3;4;1
/net/per610a/home/mvp/mvp_db/news7-lv/2009/2009_10_05_19_00/2009_10_05_19_00.mpg;Naoto KAN.jpg;1193;1653;35961;59;82;23
/net/per610a/home/mvp/mvp_db/news7-lv/2009/2009_10_05_19_00/2009_10_05_19_00.mpg;Naoto KAN.jpg;2145;3129;35961;107;156;49
/net/per610a/home/mvp/mvp_db/news7-lv/2009/2009_10_05_19_00/2009_10_05_19_00.mpg;Kohei Otsuka.jpg;81;333;35961;4;16;12
/net/per610a/home/mvp/mvp_db/news7-lv/2009/2009_10_05_19_00/2009_10_05_19_00.mpg;Kohei Otsuka.jpg;22657;22749;35961;1133;1138;5
/net/per610a/home/mvp/mvp_db/news7-lv/2009/2009_10_05_19_00/2009_10_05_19_00.mpg;Kohei Otsuka.jpg;24249;24577;35961;1213;1229;16
/net/per610a/home/mvp/mvp_db/news7-lv/2009/2009_10_05_19_00/2009_10_05_19_00.mpg;Kohei Otsuka.jpg;25337;25441;35961;1267;1272;5
/net/per610a/home/mvp/mvp_db/news7-lv/2009/2009_10_05_19_00/2009_10_05_19_00.mpg;Yukio HATOYAMA.jpg;5517;5953;35961;275;297;22
/net/per610a/home/mvp/mvp_db/news7-lv/2009/2009_10_05_19_00/2009_10_05_19_00.mpg;Yukio HATOYAMA.jpg;8709;10141;35961;435;507;72
/net/per610a/home/mvp/mvp_db/news7-lv/2009/2009_10_05_19_00/2009_10_05_19_00.mpg;Yukio HATOYAMA.jpg;10529;10565;35961;526;528;2
/net/per610a/home/mvp/mvp_db/news7-lv/2009/2009_10_05_19_00/2009_10_05_19_00.mpg;Yukio HATOYAMA.jpg;14101;14493;35961;705;725;20
/net/per610a/home/mvp/mvp_db/news7-lv/2009/2009_10_05_19_00/2009_10_05_19_00.mpg;Sadakazu TANIGAKI.jpg;14497;14981;35961;725;749;24
/net/per610a/home/mvp/mvp_db/news7-lv/2009/2009_10_05_19_00/2009_10_05_19_00.mpg;Sadakazu TANIGAKI.jpg;15393;15429;35961;770;771;1
/net/per610a/home/mvp/mvp_db/news7-lv/2009/2009_10_05_19_00/2009_10_05_19_00.mpg;Sadakazu TANIGAKI.jpg;16529;16529;35961;826;826;0
/net/per610a/home/mvp/mvp_db/news7-lv/2009/2009_10_05_19_00/2009_10_05_19_00.mpg;Sadakazu TANIGAKI.jpg;16817;16829;35961;841;841;0
/net/per610a/home/mvp/mvp_db/news7-lv/2009/2009_10_06_19_00/2009_10_06_19_00.mpg;Yukio HATOYAMA.jpg;45;421;35961;2;21;19
/net/per610a/home/mvp/mvp_db/news7-lv/2009/2009_10_06_19_00/2009_10_06_19_00.mpg;Yukio HATOYAMA.jpg;1509;1765;35961;75;88;13
/net/per610a/home/mvp/mvp_db/news7-lv/2009/2009_10_06_19_00/2009_10_06_19_00.mpg;Seiji MAEHARA.jpg;3333;5381;35961;166;269;103
/net/per610a/home/mvp/mvp_db/news7-lv/2009/2009_10_07_19_00/2009_10_07_19_00.mpg;Yukio HATOYAMA.jpg;22349;22885;35961;1118;1144;26
/net/per610a/home/mvp/mvp_db/news7-lv/2009/2009_10_07_19_00/2009_10_07_19_00.mpg;Yukio HATOYAMA.jpg;25397;25797;35961;1270;1290;20
/net/per610a/home/mvp/mvp_db/news7-lv/2009/2009_10_07_19_00/2009_10_07_19_00.mpg;Yukio HATOYAMA.jpg;27553;28589;35961;1378;1430;52
/net/per610a/home/mvp/mvp_db/news7-lv/2009/2009_10_07_19_00/2009_10_07_19_00.mpg;Naoto KAN.jpg;26749;26817;35961;1338;1341;3
/net/per610a/home/mvp/mvp_db/news7-lv/2009/2009_10_07_19_00/2009_10_07_19_00.mpg;Naoto KAN.jpg;27117;27341;35961;1356;1367;11
/net/per610a/home/mvp/mvp_db/news7-lv/2009/2009_10_08_19_00/2009_10_08_19_00.mpg;Yukio HATOYAMA.jpg;24265;24761;35961;1213;1238;25
/net/per610a/home/mvp/mvp_db/news7-lv/2009/2009_10_11_19_00/2009_10_11_19_00.mpg;Yukio HATOYAMA.jpg;11957;12829;35961;598;641;43
/net/per610a/home/mvp/mvp_db/news7-lv/2009/2009_10_12_19_00/2009_10_12_19_00.mpg;Seiji MAEHARA.jpg;285;437;35961;14;21;7
/net/per610a/home/mvp/mvp_db/news7-lv/2009/2009_10_12_19_00/2009_10_12_19_00.mpg;Seiji MAEHARA.jpg;1397;1701;35961;69;85;16
/net/per610a/home/mvp/mvp_db/news7-lv/2009/2009_10_12_19_00/2009_10_12_19_00.mpg;Seiji MAEHARA.jpg;2649;3361;35961;132;168;36
/net/per610a/home/mvp/mvp_db/news7-lv/2009/2009_10_12_19_00/2009_10_12_19_00.mpg;Seiji MAEHARA.jpg;5033;6261;35961;251;313;62
/net/per610a/home/mvp/mvp_db/news7-lv/2009/2009_10_12_19_00/2009_10_12_19_00.mpg;Seiji MAEHARA.jpg;8057;8169;35961;403;408;5
/net/per610a/home/mvp/mvp_db/news7-lv/2009/2009_10_12_19_00/2009_10_12_19_00.mpg;Yukio HATOYAMA.jpg;8529;8977;35961;426;449;23
/net/per610a/home/mvp/mvp_db/news7-lv/2009/2009_10_12_19_00/2009_10_12_19_00.mpg;Katsuya OKADA.jpg;19345;19597;35961;967;980;13
/net/per610a/home/mvp/mvp_db/news7-lv/2009/2009_10_12_19_00/2009_10_12_19_00.mpg;Katsuya OKADA.jpg;20057;20341;35961;1003;1017;14
/net/per610a/home/mvp/mvp_db/news7-lv/2009/2009_10_12_19_00/2009_10_12_19_00.mpg;Katsuya OKADA.jpg;20461;20637;35961;1023;1032;9
/net/per610a/home/mvp/mvp_db/news7-lv/2009/2009_10_13_19_00/2009_10_13_19_00.mpg;Ichiro OZAWA.jpg;12817;12873;35961;641;643;2
/net/per610a/home/mvp/mvp_db/news7-lv/2009/2009_10_13_19_00/2009_10_13_19_00.mpg;Ichiro OZAWA.jpg;13121;14349;35961;656;717;61
/net/per610a/home/mvp/mvp_db/news7-lv/2009/2009_10_13_19_00/2009_10_13_19_00.mpg;Yukio HATOYAMA.jpg;16097;16897;35961;805;845;40
/net/per610a/home/mvp/mvp_db/news7-lv/2009/2009_10_13_19_00/2009_10_13_19_00.mpg;Yukio HATOYAMA.jpg;17217;17373;35961;861;869;8
/net/per610a/home/mvp/mvp_db/news7-lv/2009/2009_10_13_19_00/2009_10_13_19_00.mpg;Yukio HATOYAMA.jpg;17601;18061;35961;880;903;23
/net/per610a/home/mvp/mvp_db/news7-lv/2009/2009_10_13_19_00/2009_10_13_19_00.mpg;Yukio HATOYAMA.jpg;18185;18377;35961;909;919;10
/net/per610a/home/mvp/mvp_db/news7-lv/2009/2009_10_13_19_00/2009_10_13_19_00.mpg;Yukio HATOYAMA.jpg;18505;18653;35961;925;933;8
/net/per610a/home/mvp/mvp_db/news7-lv/2009/2009_10_13_19_00/2009_10_13_19_00.mpg;Yukio HATOYAMA.jpg;19261;19785;35961;963;989;26
/net/per610a/home/mvp/mvp_db/news7-lv/2009/2009_10_14_19_00/2009_10_14_19_00.mpg;Mizuho FUKUSHIMA.jpg;3013;3293;35961;150;164;14
/net/per610a/home/mvp/mvp_db/news7-lv/2009/2009_10_14_19_00/2009_10_14_19_00.mpg;Mizuho FUKUSHIMA.jpg;19173;19529;35961;959;976;17
/net/per610a/home/mvp/mvp_db/news7-lv/2009/2009_10_14_19_00/2009_10_14_19_00.mpg;Mizuho FUKUSHIMA.jpg;20597;20601;35961;1030;1030;0
/net/per610a/home/mvp/mvp_db/news7-lv/2009/2009_10_14_19_00/2009_10_14_19_00.mpg;Mizuho FUKUSHIMA.jpg;20749;21297;35961;1037;1065;28
/net/per610a/home/mvp/mvp_db/news7-lv/2009/2009_10_14_19_00/2009_10_14_19_00.mpg;Shizuka KAMEI.jpg;8297;9077;35961;415;454;39
/net/per610a/home/mvp/mvp_db/news7-lv/2009/2009_10_14_19_00/2009_10_14_19_00.mpg;Shizuka KAMEI.jpg;9541;9869;35961;477;493;16
/net/per610a/home/mvp/mvp_db/news7-lv/2009/2009_10_14_19_00/2009_10_14_19_00.mpg;Shizuka KAMEI.jpg;21373;21777;35961;1069;1089;20
/net/per610a/home/mvp/mvp_db/news7-lv/2009/2009_10_14_19_00/2009_10_14_19_00.mpg;Yukio HATOYAMA.jpg;12697;14237;35961;635;712;77
/net/per610a/home/mvp/mvp_db/news7-lv/2009/2009_10_14_19_00/2009_10_14_19_00.mpg;Seiji MAEHARA.jpg;18437;18913;35961;922;946;24
/net/per610a/home/mvp/mvp_db/news7-lv/2009/2009_10_15_19_00/2009_10_15_19_00.mpg;Yukio HATOYAMA.jpg;189;529;35961;9;26;17
/net/per610a/home/mvp/mvp_db/news7-lv/2009/2009_10_15_19_00/2009_10_15_19_00.mpg;Yukio HATOYAMA.jpg;1601;2029;35961;80;101;21
/net/per610a/home/mvp/mvp_db/news7-lv/2009/2009_10_15_19_00/2009_10_15_19_00.mpg;Yukio HATOYAMA.jpg;2697;2793;35961;134;139;5
/net/per610a/home/mvp/mvp_db/news7-lv/2009/2009_10_15_19_00/2009_10_15_19_00.mpg;Yukio HATOYAMA.jpg;5237;6561;35961;261;328;67
/net/per610a/home/mvp/mvp_db/news7-lv/2009/2009_10_15_19_00/2009_10_15_19_00.mpg;Yukio HATOYAMA.jpg;15389;15609;35961;769;780;11
/net/per610a/home/mvp/mvp_db/news7-lv/2009/2009_10_15_19_00/2009_10_15_19_00.mpg;Yukio HATOYAMA.jpg;19025;19849;35961;951;992;41
/net/per610a/home/mvp/mvp_db/news7-lv/2009/2009_10_15_19_00/2009_10_15_19_00.mpg;Natsuo YAMAGUCHI.jpg;6609;6993;35961;330;349;19
/net/per610a/home/mvp/mvp_db/news7-lv/2009/2009_10_16_19_00/2009_10_16_19_00.mpg;Yukio HATOYAMA.jpg;1913;2205;35961;95;110;15
/net/per610a/home/mvp/mvp_db/news7-lv/2009/2009_10_16_19_00/2009_10_16_19_00.mpg;Yukio HATOYAMA.jpg;15393;16585;35961;770;829;59
/net/per610a/home/mvp/mvp_db/news7-lv/2009/2009_10_16_19_00/2009_10_16_19_00.mpg;Yukio HATOYAMA.jpg;17577;17649;35961;879;882;3
/net/per610a/home/mvp/mvp_db/news7-lv/2009/2009_10_16_19_00/2009_10_16_19_00.mpg;Yoshihiko Noda.jpg;9537;9949;35961;477;497;20
/net/per610a/home/mvp/mvp_db/news7-lv/2009/2009_10_16_19_00/2009_10_16_19_00.mpg;Naoto KAN.jpg;24849;24969;35961;1243;1249;6
/net/per610a/home/mvp/mvp_db/news7-lv/2009/2009_10_17_19_00/2009_10_17_19_00.mpg;Ichiro OZAWA.jpg;6225;6773;35961;311;338;27
/net/per610a/home/mvp/mvp_db/news7-lv/2009/2009_10_18_19_00/2009_10_18_19_00.mpg;Seiji MAEHARA.jpg;11357;11705;35961;568;585;17
/net/per610a/home/mvp/mvp_db/news7-lv/2009/2009_10_19_19_00/2009_10_19_19_00.mpg;Yukio HATOYAMA.jpg;19673;19701;35961;984;985;1
/net/per610a/home/mvp/mvp_db/news7-lv/2009/2009_10_19_19_00/2009_10_19_19_00.mpg;Yukio HATOYAMA.jpg;22141;22881;35961;1107;1144;37
/net/per610a/home/mvp/mvp_db/news7-lv/2009/2009_10_19_19_00/2009_10_19_19_00.mpg;Shintaro ISHIHARA.jpg;24429;24853;35961;1222;1243;21
/net/per610a/home/mvp/mvp_db/news7-lv/2009/2009_10_19_19_00/2009_10_19_19_00.mpg;Ichiro OZAWA.jpg;29761;30433;35961;1488;1522;34
/net/per610a/home/mvp/mvp_db/news7-lv/2009/2009_10_20_19_00/2009_10_20_19_00.mpg;Shizuka KAMEI.jpg;4253;5489;35961;212;274;62
/net/per610a/home/mvp/mvp_db/news7-lv/2009/2009_10_20_19_00/2009_10_20_19_00.mpg;Yukio HATOYAMA.jpg;8105;8161;35961;405;408;3
/net/per610a/home/mvp/mvp_db/news7-lv/2009/2009_10_20_19_00/2009_10_20_19_00.mpg;Yukio HATOYAMA.jpg;8357;8553;35961;418;427;9
/net/per610a/home/mvp/mvp_db/news7-lv/2009/2009_10_20_19_00/2009_10_20_19_00.mpg;Yukio HATOYAMA.jpg;8881;9333;35961;444;466;22
/net/per610a/home/mvp/mvp_db/news7-lv/2009/2009_10_20_19_00/2009_10_20_19_00.mpg;Yukio HATOYAMA.jpg;19029;19853;35961;951;993;42
/net/per610a/home/mvp/mvp_db/news7-lv/2009/2009_10_21_19_00/2009_10_21_19_00.mpg;Shizuka KAMEI.jpg;4637;5037;35961;231;251;20
/net/per610a/home/mvp/mvp_db/news7-lv/2009/2009_10_21_19_00/2009_10_21_19_00.mpg;Yukio HATOYAMA.jpg;8877;9109;35961;444;455;11
/net/per610a/home/mvp/mvp_db/news7-lv/2009/2009_10_21_19_00/2009_10_21_19_00.mpg;Yukio HATOYAMA.jpg;10825;11393;35961;541;569;28
/net/per610a/home/mvp/mvp_db/news7-lv/2009/2009_10_21_19_00/2009_10_21_19_00.mpg;Yukio EDANO.jpg;25021;25261;35961;1251;1263;12
/net/per610a/home/mvp/mvp_db/news7-lv/2009/2009_10_21_19_00/2009_10_21_19_00.mpg;Yukio EDANO.jpg;26201;26409;35961;1310;1321;11
/net/per610a/home/mvp/mvp_db/news7-lv/2009/2009_10_21_19_00/2009_10_21_19_00.mpg;Yukio EDANO.jpg;26753;27645;35961;1338;1382;44
/net/per610a/home/mvp/mvp_db/news7-lv/2009/2009_10_22_19_00/2009_10_22_19_00.mpg;Yukio HATOYAMA.jpg;177;489;35961;8;24;16
/net/per610a/home/mvp/mvp_db/news7-lv/2009/2009_10_22_19_00/2009_10_22_19_00.mpg;Yukio HATOYAMA.jpg;1913;1961;35961;95;98;3
/net/per610a/home/mvp/mvp_db/news7-lv/2009/2009_10_22_19_00/2009_10_22_19_00.mpg;Yukio HATOYAMA.jpg;2505;3113;35961;125;155;30
/net/per610a/home/mvp/mvp_db/news7-lv/2009/2009_10_22_19_00/2009_10_22_19_00.mpg;Yukio HATOYAMA.jpg;10573;11017;35961;528;551;23
/net/per610a/home/mvp/mvp_db/news7-lv/2009/2009_10_22_19_00/2009_10_22_19_00.mpg;Yukio HATOYAMA.jpg;4477;4657;35961;223;232;9
/net/per610a/home/mvp/mvp_db/news7-lv/2009/2009_10_22_19_00/2009_10_22_19_00.mpg;Yukio HATOYAMA.jpg;8549;8717;35961;427;436;9
/net/per610a/home/mvp/mvp_db/news7-lv/2009/2009_10_22_19_00/2009_10_22_19_00.mpg;Renho.jpg;9841;9985;35961;492;499;7
/net/per610a/home/mvp/mvp_db/news7-lv/2009/2009_10_23_19_00/2009_10_23_19_00.mpg;Yukio HATOYAMA.jpg;10933;11213;35961;546;560;14
/net/per610a/home/mvp/mvp_db/news7-lv/2009/2009_10_23_19_00/2009_10_23_19_00.mpg;Yukio HATOYAMA.jpg;11393;11513;35961;569;575;6
/net/per610a/home/mvp/mvp_db/news7-lv/2009/2009_10_23_19_00/2009_10_23_19_00.mpg;Yukio HATOYAMA.jpg;24033;24177;35961;1202;1209;7
/net/per610a/home/mvp/mvp_db/news7-lv/2009/2009_10_23_19_00/2009_10_23_19_00.mpg;Yukio HATOYAMA.jpg;14397;14801;35961;720;740;20
/net/per610a/home/mvp/mvp_db/news7-lv/2009/2009_10_23_19_00/2009_10_23_19_00.mpg;Yukio HATOYAMA.jpg;24969;25461;35961;1249;1273;24
/net/per610a/home/mvp/mvp_db/news7-lv/2009/2009_10_23_19_00/2009_10_23_19_00.mpg;Yukio HATOYAMA.jpg;32201;32525;35961;1610;1627;17
/net/per610a/home/mvp/mvp_db/news7-lv/2009/2009_10_23_19_00/2009_10_23_19_00.mpg;Naoto KAN.jpg;17833;18269;35961;892;913;21
/net/per610a/home/mvp/mvp_db/news7-lv/2009/2009_10_23_19_00/2009_10_23_19_00.mpg;Katsuya OKADA.jpg;19465;20777;35961;973;1039;66
/net/per610a/home/mvp/mvp_db/news7-lv/2009/2009_10_23_19_00/2009_10_23_19_00.mpg;Shizuka KAMEI.jpg;23917;23933;35961;1196;1197;1
/net/per610a/home/mvp/mvp_db/news7-lv/2009/2009_10_23_19_00/2009_10_23_19_00.mpg;Shizuka KAMEI.jpg;26441;27277;35961;1322;1364;42
/net/per610a/home/mvp/mvp_db/news7-lv/2009/2009_10_24_19_00/2009_10_24_19_00.mpg;Katsuya OKADA.jpg;505;909;35961;25;45;20
/net/per610a/home/mvp/mvp_db/news7-lv/2009/2009_10_24_19_00/2009_10_24_19_00.mpg;Katsuya OKADA.jpg;6053;6409;35961;302;320;18
/net/per610a/home/mvp/mvp_db/news7-lv/2009/2009_10_24_19_00/2009_10_24_19_00.mpg;Katsuya OKADA.jpg;8069;8489;35961;403;424;21
/net/per610a/home/mvp/mvp_db/news7-lv/2009/2009_10_24_19_00/2009_10_24_19_00.mpg;Yukio HATOYAMA.jpg;4133;4249;35961;206;212;6
/net/per610a/home/mvp/mvp_db/news7-lv/2009/2009_10_24_19_00/2009_10_24_19_00.mpg;Yukio HATOYAMA.jpg;4957;5153;35961;247;257;10
/net/per610a/home/mvp/mvp_db/news7-lv/2009/2009_10_24_19_00/2009_10_24_19_00.mpg;Kazuo SHII.jpg;12773;13721;35961;638;686;48
/net/per610a/home/mvp/mvp_db/news7-lv/2009/2009_10_25_19_00/2009_10_25_19_00.mpg;Yukio HATOYAMA.jpg;193;309;35961;9;15;6
/net/per610a/home/mvp/mvp_db/news7-lv/2009/2009_10_25_19_00/2009_10_25_19_00.mpg;Yukio HATOYAMA.jpg;1057;1573;35961;52;78;26
/net/per610a/home/mvp/mvp_db/news7-lv/2009/2009_10_25_19_00/2009_10_25_19_00.mpg;Yukio HATOYAMA.jpg;1641;2069;35961;82;103;21
/net/per610a/home/mvp/mvp_db/news7-lv/2009/2009_10_25_19_00/2009_10_25_19_00.mpg;Yukio HATOYAMA.jpg;4717;5233;35961;235;261;26
/net/per610a/home/mvp/mvp_db/news7-lv/2009/2009_10_26_19_00/2009_10_26_19_00.mpg;Yukio HATOYAMA.jpg;81;129;35961;4;6;2
/net/per610a/home/mvp/mvp_db/news7-lv/2009/2009_10_26_19_00/2009_10_26_19_00.mpg;Yukio HATOYAMA.jpg;5493;5577;35961;274;278;4
/net/per610a/home/mvp/mvp_db/news7-lv/2009/2009_10_26_19_00/2009_10_26_19_00.mpg;Yukio HATOYAMA.jpg;15309;15481;35961;765;774;9
/net/per610a/home/mvp/mvp_db/news7-lv/2009/2009_10_26_19_00/2009_10_26_19_00.mpg;Yukio HATOYAMA.jpg;1601;1773;35961;80;88;8
/net/per610a/home/mvp/mvp_db/news7-lv/2009/2009_10_26_19_00/2009_10_26_19_00.mpg;Yukio HATOYAMA.jpg;16905;17153;35961;845;858;13
/net/per610a/home/mvp/mvp_db/news7-lv/2009/2009_10_26_19_00/2009_10_26_19_00.mpg;Sadakazu TANIGAKI.jpg;12217;13845;35961;611;692;81
/net/per610a/home/mvp/mvp_db/news7-lv/2009/2009_10_26_19_00/2009_10_26_19_00.mpg;Sadakazu TANIGAKI.jpg;17773;18141;35961;889;907;18
/net/per610a/home/mvp/mvp_db/news7-lv/2009/2009_10_27_19_00/2009_10_27_19_00.mpg;Seiji MAEHARA.jpg;237;513;35961;11;25;14
/net/per610a/home/mvp/mvp_db/news7-lv/2009/2009_10_27_19_00/2009_10_27_19_00.mpg;Seiji MAEHARA.jpg;8569;8889;35961;428;444;16
/net/per610a/home/mvp/mvp_db/news7-lv/2009/2009_10_27_19_00/2009_10_27_19_00.mpg;Yukio HATOYAMA.jpg;7109;7729;35961;355;386;31
/net/per610a/home/mvp/mvp_db/news7-lv/2009/2009_10_27_19_00/2009_10_27_19_00.mpg;Toru Hashimoto.jpg;19425;19909;35961;971;995;24
/net/per610a/home/mvp/mvp_db/news7-lv/2009/2009_10_27_19_00/2009_10_27_19_00.mpg;Toru Hashimoto.jpg;20365;20421;35961;1018;1021;3
/net/per610a/home/mvp/mvp_db/news7-lv/2009/2009_10_27_19_00/2009_10_27_19_00.mpg;Toru Hashimoto.jpg;21245;21273;35961;1062;1064;2
/net/per610a/home/mvp/mvp_db/news7-lv/2009/2009_10_27_19_00/2009_10_27_19_00.mpg;Toru Hashimoto.jpg;21821;21917;35961;1091;1096;5
/net/per610a/home/mvp/mvp_db/news7-lv/2009/2009_10_27_19_00/2009_10_27_19_00.mpg;Toru Hashimoto.jpg;22217;22237;35961;1111;1112;1
/net/per610a/home/mvp/mvp_db/news7-lv/2009/2009_10_27_19_00/2009_10_27_19_00.mpg;Toru Hashimoto.jpg;22621;23349;35961;1131;1168;37
/net/per610a/home/mvp/mvp_db/news7-lv/2009/2009_10_28_19_00/2009_10_28_19_00.mpg;Sadakazu TANIGAKI.jpg;19797;20173;35961;990;1009;19
/net/per610a/home/mvp/mvp_db/news7-lv/2009/2009_10_28_19_00/2009_10_28_19_00.mpg;Shizuka KAMEI.jpg;29205;29849;35961;1461;1493;32
/net/per610a/home/mvp/mvp_db/news7-lv/2009/2009_10_29_19_00/2009_10_29_19_00.mpg;Seiji MAEHARA.jpg;205;369;35961;10;18;8
/net/per610a/home/mvp/mvp_db/news7-lv/2009/2009_10_29_19_00/2009_10_29_19_00.mpg;Seiji MAEHARA.jpg;3429;4089;35961;171;204;33
/net/per610a/home/mvp/mvp_db/news7-lv/2009/2009_10_29_19_00/2009_10_29_19_00.mpg;Kazuo SHII.jpg;17721;18113;35961;886;906;20
/net/per610a/home/mvp/mvp_db/news7-lv/2009/2009_10_31_19_00/2009_10_31_19_00.mpg;Seiji MAEHARA.jpg;26045;26205;35961;1302;1310;8
/net/per610a/home/mvp/mvp_db/news7-lv/2009/2009_11_02_19_00/2009_11_02_19_00.mpg;Katsuya OKADA.jpg;5337;5837;35961;266;292;26
/net/per610a/home/mvp/mvp_db/news7-lv/2009/2009_11_02_19_00/2009_11_02_19_00.mpg;Renho.jpg;12445;12753;35961;622;637;15
/net/per610a/home/mvp/mvp_db/news7-lv/2009/2009_11_06_19_00/2009_11_06_19_00.mpg;Katsuya OKADA.jpg;26989;27665;35961;1350;1383;33
/net/per610a/home/mvp/mvp_db/news7-lv/2009/2009_11_07_19_00/2009_11_07_19_00.mpg;Yukio HATOYAMA.jpg;15117;15633;35961;756;782;26
/net/per610a/home/mvp/mvp_db/news7-lv/2009/2009_11_07_19_00/2009_11_07_19_00.mpg;Yukio HATOYAMA.jpg;16277;16477;35961;814;824;10
/net/per610a/home/mvp/mvp_db/news7-lv/2009/2009_11_07_19_00/2009_11_07_19_00.mpg;Yukio HATOYAMA.jpg;16561;16581;35961;828;829;1
/net/per610a/home/mvp/mvp_db/news7-lv/2009/2009_11_07_19_00/2009_11_07_19_00.mpg;Yukio HATOYAMA.jpg;16981;17197;35961;849;860;11
/net/per610a/home/mvp/mvp_db/news7-lv/2009/2009_11_07_19_00/2009_11_07_19_00.mpg;Yukio HATOYAMA.jpg;17405;18109;35961;870;905;35
/net/per610a/home/mvp/mvp_db/news7-lv/2009/2009_11_08_19_00/2009_11_08_19_00.mpg;Yukio HATOYAMA.jpg;18617;18677;35961;931;934;3
/net/per610a/home/mvp/mvp_db/news7-lv/2009/2009_11_08_19_00/2009_11_08_19_00.mpg;Yukio HATOYAMA.jpg;19649;19705;35961;982;985;3
/net/per610a/home/mvp/mvp_db/news7-lv/2009/2009_11_08_19_00/2009_11_08_19_00.mpg;Yukio HATOYAMA.jpg;27317;27765;35961;1366;1388;22
/net/per610a/home/mvp/mvp_db/news7-lv/2009/2009_11_09_19_00/2009_11_09_19_00.mpg;Yukio HATOYAMA.jpg;1153;2045;35961;57;102;45
/net/per610a/home/mvp/mvp_db/news7-lv/2009/2009_11_09_19_00/2009_11_09_19_00.mpg;Yukio HATOYAMA.jpg;20069;20153;35961;1003;1008;5
/net/per610a/home/mvp/mvp_db/news7-lv/2009/2009_11_09_19_00/2009_11_09_19_00.mpg;Yukio HATOYAMA.jpg;2189;2261;35961;109;113;4
/net/per610a/home/mvp/mvp_db/news7-lv/2009/2009_11_09_19_00/2009_11_09_19_00.mpg;Yukio HATOYAMA.jpg;14905;15185;35961;745;759;14
/net/per610a/home/mvp/mvp_db/news7-lv/2009/2009_11_09_19_00/2009_11_09_19_00.mpg;Yukio HATOYAMA.jpg;16321;16381;35961;816;819;3
/net/per610a/home/mvp/mvp_db/news7-lv/2009/2009_11_09_19_00/2009_11_09_19_00.mpg;Yukio HATOYAMA.jpg;17213;17221;35961;861;861;0
/net/per610a/home/mvp/mvp_db/news7-lv/2009/2009_11_09_19_00/2009_11_09_19_00.mpg;Yukio HATOYAMA.jpg;18465;18901;35961;923;945;22
/net/per610a/home/mvp/mvp_db/news7-lv/2009/2009_11_09_19_00/2009_11_09_19_00.mpg;Yukio HATOYAMA.jpg;20453;20945;35961;1023;1047;24
/net/per610a/home/mvp/mvp_db/news7-lv/2009/2009_11_09_19_00/2009_11_09_19_00.mpg;Yukio HATOYAMA.jpg;21265;21545;35961;1063;1077;14
/net/per610a/home/mvp/mvp_db/news7-lv/2009/2009_11_09_19_00/2009_11_09_19_00.mpg;Yukio HATOYAMA.jpg;23349;23853;35961;1168;1193;25
/net/per610a/home/mvp/mvp_db/news7-lv/2009/2009_11_10_19_00/2009_11_10_19_00.mpg;Yukio HATOYAMA.jpg;9093;9229;35961;454;461;7
/net/per610a/home/mvp/mvp_db/news7-lv/2009/2009_11_10_19_00/2009_11_10_19_00.mpg;Yukio HATOYAMA.jpg;9465;9973;35961;473;498;25
/net/per610a/home/mvp/mvp_db/news7-lv/2009/2009_11_10_19_00/2009_11_10_19_00.mpg;Yukio HATOYAMA.jpg;19573;20069;35961;979;1003;24
/net/per610a/home/mvp/mvp_db/news7-lv/2009/2009_11_11_19_00/2009_11_11_19_00.mpg;Yukio HATOYAMA.jpg;2121;2377;35961;106;118;12
/net/per610a/home/mvp/mvp_db/news7-lv/2009/2009_11_12_19_00/2009_11_12_19_00.mpg;Yukio HATOYAMA.jpg;18977;19109;35961;949;955;6
/net/per610a/home/mvp/mvp_db/news7-lv/2009/2009_11_12_19_00/2009_11_12_19_00.mpg;Yukio HATOYAMA.jpg;23597;23817;35961;1180;1191;11
/net/per610a/home/mvp/mvp_db/news7-lv/2009/2009_11_12_19_00/2009_11_12_19_00.mpg;Yukio HATOYAMA.jpg;25525;26465;35961;1276;1323;47
/net/per610a/home/mvp/mvp_db/news7-lv/2009/2009_11_12_19_00/2009_11_12_19_00.mpg;Taro ASO.jpg;24893;25441;35961;1245;1272;27
/net/per610a/home/mvp/mvp_db/news7-lv/2009/2009_11_14_19_00/2009_11_14_19_00.mpg;Yukio HATOYAMA.jpg;25021;25969;35961;1251;1299;48
/net/per610a/home/mvp/mvp_db/news7-lv/2009/2009_11_15_19_00/2009_11_15_19_00.mpg;Yukio HATOYAMA.jpg;11425;11613;35961;571;580;9
/net/per610a/home/mvp/mvp_db/news7-lv/2009/2009_11_15_19_00/2009_11_15_19_00.mpg;Yukio HATOYAMA.jpg;12573;12709;35961;628;635;7
/net/per610a/home/mvp/mvp_db/news7-lv/2009/2009_11_15_19_00/2009_11_15_19_00.mpg;Yukio HATOYAMA.jpg;14009;14421;35961;700;721;21
/net/per610a/home/mvp/mvp_db/news7-lv/2009/2009_11_15_19_00/2009_11_15_19_00.mpg;Yukio HATOYAMA.jpg;14489;14909;35961;724;745;21
/net/per610a/home/mvp/mvp_db/news7-lv/2009/2009_11_15_19_00/2009_11_15_19_00.mpg;Yukio HATOYAMA.jpg;16321;16613;35961;816;831;15
/net/per610a/home/mvp/mvp_db/news7-lv/2009/2009_11_15_19_00/2009_11_15_19_00.mpg;Yukio HATOYAMA.jpg;15037;16025;35961;752;801;49
/net/per610a/home/mvp/mvp_db/news7-lv/2009/2009_11_16_19_00/2009_11_16_19_00.mpg;Naoto KAN.jpg;14685;14857;35961;734;743;9
/net/per610a/home/mvp/mvp_db/news7-lv/2009/2009_11_16_19_00/2009_11_16_19_00.mpg;Shizuka KAMEI.jpg;15209;15225;35961;760;761;1
/net/per610a/home/mvp/mvp_db/news7-lv/2009/2009_11_16_19_00/2009_11_16_19_00.mpg;Shizuka KAMEI.jpg;15585;15657;35961;779;783;4
/net/per610a/home/mvp/mvp_db/news7-lv/2009/2009_11_16_19_00/2009_11_16_19_00.mpg;Shizuka KAMEI.jpg;15777;16041;35961;789;802;13
/net/per610a/home/mvp/mvp_db/news7-lv/2009/2009_11_16_19_00/2009_11_16_19_00.mpg;Yukio HATOYAMA.jpg;16081;16781;35961;804;839;35
/net/per610a/home/mvp/mvp_db/news7-lv/2009/2009_11_16_19_00/2009_11_16_19_00.mpg;Katsuya OKADA.jpg;23253;24341;35961;1163;1217;54
/net/per610a/home/mvp/mvp_db/news7-lv/2009/2009_11_17_19_00/2009_11_17_19_00.mpg;Naoto KAN.jpg;145;173;35961;7;8;1
/net/per610a/home/mvp/mvp_db/news7-lv/2009/2009_11_17_19_00/2009_11_17_19_00.mpg;Naoto KAN.jpg;1461;1649;35961;73;82;9
/net/per610a/home/mvp/mvp_db/news7-lv/2009/2009_11_17_19_00/2009_11_17_19_00.mpg;Naoto KAN.jpg;2849;3525;35961;142;176;34
/net/per610a/home/mvp/mvp_db/news7-lv/2009/2009_11_17_19_00/2009_11_17_19_00.mpg;Yukio HATOYAMA.jpg;2465;2641;35961;123;132;9
/net/per610a/home/mvp/mvp_db/news7-lv/2009/2009_11_17_19_00/2009_11_17_19_00.mpg;Yukio HATOYAMA.jpg;5233;5273;35961;261;263;2
/net/per610a/home/mvp/mvp_db/news7-lv/2009/2009_11_17_19_00/2009_11_17_19_00.mpg;Yukio HATOYAMA.jpg;20737;21553;35961;1037;1078;41
/net/per610a/home/mvp/mvp_db/news7-lv/2009/2009_11_17_19_00/2009_11_17_19_00.mpg;Seiji MAEHARA.jpg;3869;4273;35961;193;213;20
/net/per610a/home/mvp/mvp_db/news7-lv/2009/2009_11_18_19_00/2009_11_18_19_00.mpg;Yukio HATOYAMA.jpg;8817;9485;35961;441;474;33
/net/per610a/home/mvp/mvp_db/news7-lv/2009/2009_11_18_19_00/2009_11_18_19_00.mpg;Masashi Nakano.jpg;14221;15245;35961;711;762;51
/net/per610a/home/mvp/mvp_db/news7-lv/2009/2009_11_18_19_00/2009_11_18_19_00.mpg;Seiji MAEHARA.jpg;25801;26453;35961;1290;1323;33
/net/per610a/home/mvp/mvp_db/news7-lv/2009/2009_11_19_19_00/2009_11_19_19_00.mpg;Shizuka KAMEI.jpg;545;809;35961;27;40;13
/net/per610a/home/mvp/mvp_db/news7-lv/2009/2009_11_19_19_00/2009_11_19_19_00.mpg;Shizuka KAMEI.jpg;5953;6021;35961;297;301;4
/net/per610a/home/mvp/mvp_db/news7-lv/2009/2009_11_19_19_00/2009_11_19_19_00.mpg;Yukio HATOYAMA.jpg;24017;24897;35961;1201;1245;44
/net/per610a/home/mvp/mvp_db/news7-lv/2009/2009_11_20_19_00/2009_11_20_19_00.mpg;Naoto KAN.jpg;1841;1845;35961;92;92;0
/net/per610a/home/mvp/mvp_db/news7-lv/2009/2009_11_20_19_00/2009_11_20_19_00.mpg;Naoto KAN.jpg;4869;5201;35961;243;260;17
/net/per610a/home/mvp/mvp_db/news7-lv/2009/2009_11_20_19_00/2009_11_20_19_00.mpg;Yukio HATOYAMA.jpg;4477;4617;35961;223;230;7
/net/per610a/home/mvp/mvp_db/news7-lv/2009/2009_11_20_19_00/2009_11_20_19_00.mpg;Yukio HATOYAMA.jpg;15597;16401;35961;780;820;40
/net/per610a/home/mvp/mvp_db/news7-lv/2009/2009_11_24_19_00/2009_11_24_19_00.mpg;Yukio HATOYAMA.jpg;2021;2529;35961;101;126;25
/net/per610a/home/mvp/mvp_db/news7-lv/2009/2009_11_24_19_00/2009_11_24_19_00.mpg;Yukio HATOYAMA.jpg;10197;10577;35961;510;529;19
/net/per610a/home/mvp/mvp_db/news7-lv/2009/2009_11_24_19_00/2009_11_24_19_00.mpg;Ichiro OZAWA.jpg;12809;13405;35961;640;670;30
/net/per610a/home/mvp/mvp_db/news7-lv/2009/2009_11_24_19_00/2009_11_24_19_00.mpg;Ichiro OZAWA.jpg;13413;14097;35961;671;705;34
/net/per610a/home/mvp/mvp_db/news7-lv/2009/2009_11_24_19_00/2009_11_24_19_00.mpg;Yukio HATOYAMA.jpg;27241;27561;35961;1362;1378;16
/net/per610a/home/mvp/mvp_db/news7-lv/2009/2009_11_25_19_00/2009_11_25_19_00.mpg;Yukio HATOYAMA.jpg;8213;8293;35961;410;414;4
/net/per610a/home/mvp/mvp_db/news7-lv/2009/2009_11_25_19_00/2009_11_25_19_00.mpg;Yukio HATOYAMA.jpg;12241;12297;35961;612;615;3
/net/per610a/home/mvp/mvp_db/news7-lv/2009/2009_11_25_19_00/2009_11_25_19_00.mpg;Yukio HATOYAMA.jpg;13845;13893;35961;692;695;3
/net/per610a/home/mvp/mvp_db/news7-lv/2009/2009_11_25_19_00/2009_11_25_19_00.mpg;Yukio HATOYAMA.jpg;15421;16057;35961;771;803;32
/net/per610a/home/mvp/mvp_db/news7-lv/2009/2009_11_25_19_00/2009_11_25_19_00.mpg;Yukio HATOYAMA.jpg;20097;20577;35961;1005;1029;24
/net/per610a/home/mvp/mvp_db/news7-lv/2009/2009_11_26_19_00/2009_11_26_19_00.mpg;Yukio HATOYAMA.jpg;11433;12061;35961;571;603;32
/net/per610a/home/mvp/mvp_db/news7-lv/2009/2009_11_26_19_00/2009_11_26_19_00.mpg;Yukio HATOYAMA.jpg;16225;16661;35961;811;833;22
/net/per610a/home/mvp/mvp_db/news7-lv/2009/2009_11_26_19_00/2009_11_26_19_00.mpg;Shizuka KAMEI.jpg;19989;20197;35961;999;1010;11
/net/per610a/home/mvp/mvp_db/news7-lv/2009/2009_11_27_19_00/2009_11_27_19_00.mpg;Yukio EDANO.jpg;5177;5269;35961;258;263;5
/net/per610a/home/mvp/mvp_db/news7-lv/2009/2009_11_27_19_00/2009_11_27_19_00.mpg;Yukio HATOYAMA.jpg;8665;9173;35961;433;458;25
/net/per610a/home/mvp/mvp_db/news7-lv/2009/2009_11_27_19_00/2009_11_27_19_00.mpg;Yukio HATOYAMA.jpg;11281;11601;35961;564;580;16
/net/per610a/home/mvp/mvp_db/news7-lv/2009/2009_11_28_19_00/2009_11_28_19_00.mpg;Yukio HATOYAMA.jpg;1873;2505;35961;93;125;32
/net/per610a/home/mvp/mvp_db/news7-lv/2009/2009_11_28_19_00/2009_11_28_19_00.mpg;Sadakazu TANIGAKI.jpg;3921;5325;35961;196;266;70
/net/per610a/home/mvp/mvp_db/news7-lv/2009/2009_11_29_19_00/2009_11_29_19_00.mpg;Yukio HATOYAMA.jpg;2453;2729;35961;122;136;14
/net/per610a/home/mvp/mvp_db/news7-lv/2009/2009_11_29_19_00/2009_11_29_19_00.mpg;Yukio HATOYAMA.jpg;3365;3529;35961;168;176;8
/net/per610a/home/mvp/mvp_db/news7-lv/2009/2009_11_29_19_00/2009_11_29_19_00.mpg;Yukio HATOYAMA.jpg;7469;7833;35961;373;391;18
/net/per610a/home/mvp/mvp_db/news7-lv/2009/2009_11_29_19_00/2009_11_29_19_00.mpg;Ichiro OZAWA.jpg;3877;4957;35961;193;247;54
/net/per610a/home/mvp/mvp_db/news7-lv/2009/2009_11_29_19_00/2009_11_29_19_00.mpg;Mizuho FUKUSHIMA.jpg;6277;6673;35961;314;333;19
/net/per610a/home/mvp/mvp_db/news7-lv/2009/2009_11_30_19_00/2009_11_30_19_00.mpg;Yukio HATOYAMA.jpg;1809;1937;35961;90;96;6
/net/per610a/home/mvp/mvp_db/news7-lv/2009/2009_11_30_19_00/2009_11_30_19_00.mpg;Yukio HATOYAMA.jpg;10265;10801;35961;513;540;27
/net/per610a/home/mvp/mvp_db/news7-lv/2009/2009_11_30_19_00/2009_11_30_19_00.mpg;Sadakazu TANIGAKI.jpg;4169;4489;35961;208;224;16
/net/per610a/home/mvp/mvp_db/news7-lv/2009/2009_11_30_19_00/2009_11_30_19_00.mpg;Yukio HATOYAMA.jpg;7953;8021;35961;397;401;4
/net/per610a/home/mvp/mvp_db/news7-lv/2009/2009_11_30_19_00/2009_11_30_19_00.mpg;Yukio HATOYAMA.jpg;11017;11261;35961;551;563;12
/net/per610a/home/mvp/mvp_db/news7-lv/2009/2009_11_30_19_00/2009_11_30_19_00.mpg;Yukio HATOYAMA.jpg;17913;18737;35961;896;937;41
/net/per610a/home/mvp/mvp_db/news7-lv/2009/2009_11_30_19_00/2009_11_30_19_00.mpg;Naoto KAN.jpg;16529;17225;35961;826;861;35
/net/per610a/home/mvp/mvp_db/news7-lv/2009/2009_12_01_19_00/2009_12_01_19_00.mpg;Shizuka KAMEI.jpg;6121;6429;35961;306;321;15
/net/per610a/home/mvp/mvp_db/news7-lv/2009/2009_12_01_19_00/2009_12_01_19_00.mpg;Shizuka KAMEI.jpg;7109;7929;35961;355;396;41
/net/per610a/home/mvp/mvp_db/news7-lv/2009/2009_12_01_19_00/2009_12_01_19_00.mpg;Shizuka KAMEI.jpg;12233;12329;35961;611;616;5
/net/per610a/home/mvp/mvp_db/news7-lv/2009/2009_12_02_19_00/2009_12_02_19_00.mpg;Yukio HATOYAMA.jpg;13133;13433;35961;656;672;16
/net/per610a/home/mvp/mvp_db/news7-lv/2009/2009_12_03_19_00/2009_12_03_19_00.mpg;Yukio HATOYAMA.jpg;1369;1821;35961;68;91;23
/net/per610a/home/mvp/mvp_db/news7-lv/2009/2009_12_03_19_00/2009_12_03_19_00.mpg;Yukio HATOYAMA.jpg;6621;7209;35961;331;360;29
/net/per610a/home/mvp/mvp_db/news7-lv/2009/2009_12_03_19_00/2009_12_03_19_00.mpg;Yoshihiko Noda.jpg;11365;12429;35961;568;621;53
/net/per610a/home/mvp/mvp_db/news7-lv/2009/2009_12_04_19_00/2009_12_04_19_00.mpg;Yukio HATOYAMA.jpg;117;257;35961;5;12;7
/net/per610a/home/mvp/mvp_db/news7-lv/2009/2009_12_04_19_00/2009_12_04_19_00.mpg;Yukio HATOYAMA.jpg;1637;2409;35961;81;120;39
/net/per610a/home/mvp/mvp_db/news7-lv/2009/2009_12_04_19_00/2009_12_04_19_00.mpg;Shizuka KAMEI.jpg;14745;14825;35961;737;741;4
/net/per610a/home/mvp/mvp_db/news7-lv/2009/2009_12_06_19_00/2009_12_06_19_00.mpg;Katsuya OKADA.jpg;7061;7313;35961;353;365;12
/net/per610a/home/mvp/mvp_db/news7-lv/2009/2009_12_06_19_00/2009_12_06_19_00.mpg;Yukio HATOYAMA.jpg;7061;7313;35961;353;365;12
/net/per610a/home/mvp/mvp_db/news7-lv/2009/2009_12_07_19_00/2009_12_07_19_00.mpg;Yukio HATOYAMA.jpg;3853;4245;35961;192;212;20
/net/per610a/home/mvp/mvp_db/news7-lv/2009/2009_12_07_19_00/2009_12_07_19_00.mpg;Yukio HATOYAMA.jpg;11441;11985;35961;572;599;27
/net/per610a/home/mvp/mvp_db/news7-lv/2009/2009_12_07_19_00/2009_12_07_19_00.mpg;Yukio HATOYAMA.jpg;16213;18209;35961;811;910;99
/net/per610a/home/mvp/mvp_db/news7-lv/2009/2009_12_07_19_00/2009_12_07_19_00.mpg;Renho.jpg;19565;19729;35961;978;986;8
/net/per610a/home/mvp/mvp_db/news7-lv/2009/2009_12_08_19_00/2009_12_08_19_00.mpg;Yukio HATOYAMA.jpg;1209;1781;35961;60;89;29
/net/per610a/home/mvp/mvp_db/news7-lv/2009/2009_12_08_19_00/2009_12_08_19_00.mpg;Yukio HATOYAMA.jpg;1853;2321;35961;92;116;24
/net/per610a/home/mvp/mvp_db/news7-lv/2009/2009_12_08_19_00/2009_12_08_19_00.mpg;Yukio HATOYAMA.jpg;2925;4837;35961;146;241;95
/net/per610a/home/mvp/mvp_db/news7-lv/2009/2009_12_08_19_00/2009_12_08_19_00.mpg;Yukio HATOYAMA.jpg;11429;12457;35961;571;623;52
/net/per610a/home/mvp/mvp_db/news7-lv/2009/2009_12_08_19_00/2009_12_08_19_00.mpg;Yukio HATOYAMA.jpg;17145;18089;35961;857;904;47
/net/per610a/home/mvp/mvp_db/news7-lv/2009/2009_12_08_19_00/2009_12_08_19_00.mpg;Yukio HATOYAMA.jpg;20185;20589;35961;1009;1029;20
/net/per610a/home/mvp/mvp_db/news7-lv/2009/2009_12_08_19_00/2009_12_08_19_00.mpg;Yukio HATOYAMA.jpg;20781;20989;35961;1039;1050;11
/net/per610a/home/mvp/mvp_db/news7-lv/2009/2009_12_08_19_00/2009_12_08_19_00.mpg;Yukio HATOYAMA.jpg;25537;25937;35961;1277;1297;20
/net/per610a/home/mvp/mvp_db/news7-lv/2009/2009_12_09_19_00/2009_12_09_19_00.mpg;Mizuho FUKUSHIMA.jpg;105;273;35961;5;13;8
/net/per610a/home/mvp/mvp_db/news7-lv/2009/2009_12_09_19_00/2009_12_09_19_00.mpg;Mizuho FUKUSHIMA.jpg;2825;3161;35961;141;158;17
/net/per610a/home/mvp/mvp_db/news7-lv/2009/2009_12_09_19_00/2009_12_09_19_00.mpg;Yorihisa Matsuno.png;5737;6341;35961;287;317;30
/net/per610a/home/mvp/mvp_db/news7-lv/2009/2009_12_09_19_00/2009_12_09_19_00.mpg;Shizuka KAMEI.jpg;27817;28593;35961;1391;1430;39
/net/per610a/home/mvp/mvp_db/news7-lv/2009/2009_12_10_19_00/2009_12_10_19_00.mpg;Yukio HATOYAMA.jpg;93;357;35961;4;17;13
/net/per610a/home/mvp/mvp_db/news7-lv/2009/2009_12_10_19_00/2009_12_10_19_00.mpg;Yukio HATOYAMA.jpg;3341;4337;35961;167;216;49
/net/per610a/home/mvp/mvp_db/news7-lv/2009/2009_12_10_19_00/2009_12_10_19_00.mpg;Yukio HATOYAMA.jpg;1761;1805;35961;88;90;2
/net/per610a/home/mvp/mvp_db/news7-lv/2009/2009_12_10_19_00/2009_12_10_19_00.mpg;Yukio HATOYAMA.jpg;13633;13829;35961;682;691;9
/net/per610a/home/mvp/mvp_db/news7-lv/2009/2009_12_10_19_00/2009_12_10_19_00.mpg;Ichiro OZAWA.jpg;10121;10449;35961;506;522;16
/net/per610a/home/mvp/mvp_db/news7-lv/2009/2009_12_10_19_00/2009_12_10_19_00.mpg;Ichiro OZAWA.jpg;14065;15497;35961;703;775;72
/net/per610a/home/mvp/mvp_db/news7-lv/2009/2009_12_11_19_00/2009_12_11_19_00.mpg;Yukio HATOYAMA.jpg;4825;5049;35961;241;252;11
/net/per610a/home/mvp/mvp_db/news7-lv/2009/2009_12_11_19_00/2009_12_11_19_00.mpg;Shizuka KAMEI.jpg;6357;6753;35961;318;337;19
/net/per610a/home/mvp/mvp_db/news7-lv/2009/2009_12_11_19_00/2009_12_11_19_00.mpg;Shizuka KAMEI.jpg;8025;8905;35961;401;445;44
/net/per610a/home/mvp/mvp_db/news7-lv/2009/2009_12_11_19_00/2009_12_11_19_00.mpg;Katsuya OKADA.jpg;28437;29149;35961;1422;1458;36
/net/per610a/home/mvp/mvp_db/news7-lv/2009/2009_12_12_19_00/2009_12_12_19_00.mpg;Seiji MAEHARA.jpg;2641;3345;35961;132;167;35
/net/per610a/home/mvp/mvp_db/news7-lv/2009/2009_12_13_19_00/2009_12_13_19_00.mpg;Seiji MAEHARA.jpg;373;553;35961;18;27;9
/net/per610a/home/mvp/mvp_db/news7-lv/2009/2009_12_13_19_00/2009_12_13_19_00.mpg;Seiji MAEHARA.jpg;3501;4181;35961;175;209;34
/net/per610a/home/mvp/mvp_db/news7-lv/2009/2009_12_13_19_00/2009_12_13_19_00.mpg;Seiji MAEHARA.jpg;6565;8477;35961;328;424;96
/net/per610a/home/mvp/mvp_db/news7-lv/2009/2009_12_13_19_00/2009_12_13_19_00.mpg;Mizuho FUKUSHIMA.jpg;8945;9645;35961;447;482;35
/net/per610a/home/mvp/mvp_db/news7-lv/2009/2009_12_14_19_00/2009_12_14_19_00.mpg;Yukio HATOYAMA.jpg;20481;20949;35961;1024;1048;24
/net/per610a/home/mvp/mvp_db/news7-lv/2009/2009_12_15_19_00/2009_12_15_19_00.mpg;Yukio HATOYAMA.jpg;5185;6013;35961;259;300;41
/net/per610a/home/mvp/mvp_db/news7-lv/2009/2009_12_15_19_00/2009_12_15_19_00.mpg;Yukio HATOYAMA.jpg;6089;6769;35961;304;338;34
/net/per610a/home/mvp/mvp_db/news7-lv/2009/2009_12_15_19_00/2009_12_15_19_00.mpg;Yukio HATOYAMA.jpg;20989;22225;35961;1050;1111;61
/net/per610a/home/mvp/mvp_db/news7-lv/2009/2009_12_16_19_00/2009_12_16_19_00.mpg;Ichiro OZAWA.jpg;137;661;35961;6;33;27
/net/per610a/home/mvp/mvp_db/news7-lv/2009/2009_12_16_19_00/2009_12_16_19_00.mpg;Ichiro OZAWA.jpg;2001;2017;35961;100;100;0
/net/per610a/home/mvp/mvp_db/news7-lv/2009/2009_12_16_19_00/2009_12_16_19_00.mpg;Ichiro OZAWA.jpg;2821;3065;35961;141;153;12
/net/per610a/home/mvp/mvp_db/news7-lv/2009/2009_12_16_19_00/2009_12_16_19_00.mpg;Shizuka KAMEI.jpg;5973;6533;35961;298;326;28
/net/per610a/home/mvp/mvp_db/news7-lv/2009/2009_12_17_19_00/2009_12_17_19_00.mpg;Yukio HATOYAMA.jpg;273;389;35961;13;19;6
/net/per610a/home/mvp/mvp_db/news7-lv/2009/2009_12_17_19_00/2009_12_17_19_00.mpg;Yukio HATOYAMA.jpg;2309;2449;35961;115;122;7
/net/per610a/home/mvp/mvp_db/news7-lv/2009/2009_12_17_19_00/2009_12_17_19_00.mpg;Yukio HATOYAMA.jpg;4745;4997;35961;237;249;12
/net/per610a/home/mvp/mvp_db/news7-lv/2009/2009_12_17_19_00/2009_12_17_19_00.mpg;Yukio HATOYAMA.jpg;8201;9213;35961;410;460;50
/net/per610a/home/mvp/mvp_db/news7-lv/2009/2009_12_17_19_00/2009_12_17_19_00.mpg;Yukio HATOYAMA.jpg;15689;16589;35961;784;829;45
/net/per610a/home/mvp/mvp_db/news7-lv/2009/2009_12_17_19_00/2009_12_17_19_00.mpg;Shintaro ISHIHARA.jpg;4053;4601;35961;202;230;28
/net/per610a/home/mvp/mvp_db/news7-lv/2009/2009_12_18_19_00/2009_12_18_19_00.mpg;Yukio HATOYAMA.jpg;13777;13845;35961;689;692;3
/net/per610a/home/mvp/mvp_db/news7-lv/2009/2009_12_18_19_00/2009_12_18_19_00.mpg;Yukio HATOYAMA.jpg;15269;15277;35961;763;764;1
/net/per610a/home/mvp/mvp_db/news7-lv/2009/2009_12_19_19_00/2009_12_19_19_00.mpg;Yukio HATOYAMA.jpg;2245;2717;35961;112;135;23
/net/per610a/home/mvp/mvp_db/news7-lv/2009/2009_12_20_19_00/2009_12_20_19_00.mpg;Ichiro OZAWA.jpg;3909;6113;35961;195;305;110
/net/per610a/home/mvp/mvp_db/news7-lv/2009/2009_12_21_19_00/2009_12_21_19_00.mpg;Yukio HATOYAMA.jpg;193;269;35961;9;13;4
/net/per610a/home/mvp/mvp_db/news7-lv/2009/2009_12_21_19_00/2009_12_21_19_00.mpg;Yukio HATOYAMA.jpg;1577;2197;35961;78;109;31
/net/per610a/home/mvp/mvp_db/news7-lv/2009/2009_12_21_19_00/2009_12_21_19_00.mpg;Yukio HATOYAMA.jpg;9373;9709;35961;468;485;17
/net/per610a/home/mvp/mvp_db/news7-lv/2009/2009_12_21_19_00/2009_12_21_19_00.mpg;Yukio HATOYAMA.jpg;12633;12857;35961;631;643;12
/net/per610a/home/mvp/mvp_db/news7-lv/2009/2009_12_21_19_00/2009_12_21_19_00.mpg;Yukio HATOYAMA.jpg;13485;13981;35961;674;699;25
/net/per610a/home/mvp/mvp_db/news7-lv/2009/2009_12_22_19_00/2009_12_22_19_00.mpg;Yukio HATOYAMA.jpg;1241;1917;35961;62;95;33
/net/per610a/home/mvp/mvp_db/news7-lv/2009/2009_12_22_19_00/2009_12_22_19_00.mpg;Yukio HATOYAMA.jpg;6225;6269;35961;311;313;2
/net/per610a/home/mvp/mvp_db/news7-lv/2009/2009_12_22_19_00/2009_12_22_19_00.mpg;Yukio HATOYAMA.jpg;6993;7217;35961;349;361;12
/net/per610a/home/mvp/mvp_db/news7-lv/2009/2009_12_22_19_00/2009_12_22_19_00.mpg;Katsuya OKADA.jpg;16225;16737;35961;811;837;26
/net/per610a/home/mvp/mvp_db/news7-lv/2009/2009_12_23_19_00/2009_12_23_19_00.mpg;Yukio HATOYAMA.jpg;7213;7737;35961;360;387;27
/net/per610a/home/mvp/mvp_db/news7-lv/2009/2009_12_23_19_00/2009_12_23_19_00.mpg;Yukio HATOYAMA.jpg;8905;8933;35961;445;446;1
/net/per610a/home/mvp/mvp_db/news7-lv/2009/2009_12_23_19_00/2009_12_23_19_00.mpg;Yukio HATOYAMA.jpg;9489;9617;35961;474;481;7
/net/per610a/home/mvp/mvp_db/news7-lv/2009/2009_12_23_19_00/2009_12_23_19_00.mpg;Naoto KAN.jpg;9145;9293;35961;457;464;7
/net/per610a/home/mvp/mvp_db/news7-lv/2009/2009_12_24_19_00/2009_12_24_19_00.mpg;Sadakazu TANIGAKI.jpg;14989;17317;35961;749;866;117
/net/per610a/home/mvp/mvp_db/news7-lv/2009/2009_12_24_19_00/2009_12_24_19_00.mpg;Shizuka KAMEI.jpg;26573;26921;35961;1329;1346;17
/net/per610a/home/mvp/mvp_db/news7-lv/2009/2009_12_25_19_00/2009_12_25_19_00.mpg;Yukio HATOYAMA.jpg;1;1;35961;0;0;0
/net/per610a/home/mvp/mvp_db/news7-lv/2009/2009_12_25_19_00/2009_12_25_19_00.mpg;Yukio HATOYAMA.jpg;14157;14985;35961;708;749;41
/net/per610a/home/mvp/mvp_db/news7-lv/2009/2009_12_25_19_00/2009_12_25_19_00.mpg;Yukio HATOYAMA.jpg;17253;18121;35961;863;906;43
/net/per610a/home/mvp/mvp_db/news7-lv/2009/2009_12_26_19_00/2009_12_26_19_00.mpg;Yukio HATOYAMA.jpg;1;245;35961;0;12;12
/net/per610a/home/mvp/mvp_db/news7-lv/2009/2009_12_26_19_00/2009_12_26_19_00.mpg;Yukio HATOYAMA.jpg;1997;3417;35961;99;170;71
/net/per610a/home/mvp/mvp_db/news7-lv/2009/2009_12_27_19_00/2009_12_27_19_00.mpg;Yukio HATOYAMA.jpg;1;225;35961;0;11;11
/net/per610a/home/mvp/mvp_db/news7-lv/2009/2009_12_27_19_00/2009_12_27_19_00.mpg;Yukio HATOYAMA.jpg;1541;2261;35961;77;113;36
/net/per610a/home/mvp/mvp_db/news7-lv/2009/2009_12_27_19_00/2009_12_27_19_00.mpg;Yukio HATOYAMA.jpg;2621;5873;35961;131;293;162
/net/per610a/home/mvp/mvp_db/news7-lv/2009/2009_12_27_19_00/2009_12_27_19_00.mpg;Yukio HATOYAMA.jpg;6033;6157;35961;301;308;7
/net/per610a/home/mvp/mvp_db/news7-lv/2009/2009_12_27_19_00/2009_12_27_19_00.mpg;Yukio HATOYAMA.jpg;6417;8101;35961;321;405;84
/net/per610a/home/mvp/mvp_db/news7-lv/2009/2009_12_28_19_00/2009_12_28_19_00.mpg;Yukio HATOYAMA.jpg;1945;2025;35961;97;101;4
/net/per610a/home/mvp/mvp_db/news7-lv/2009/2009_12_28_19_00/2009_12_28_19_00.mpg;Yukio HATOYAMA.jpg;15121;16017;35961;756;801;45
/net/per610a/home/mvp/mvp_db/news7-lv/2009/2009_12_29_19_00/2009_12_29_19_00.mpg;Katsuya OKADA.jpg;5025;6821;35961;251;341;90
/net/per610a/home/mvp/mvp_db/news7-lv/2009/2009_12_30_19_00/2009_12_30_19_00.mpg;Yukio HATOYAMA.jpg;53;89;35961;2;4;2
/net/per610a/home/mvp/mvp_db/news7-lv/2009/2009_12_30_19_00/2009_12_30_19_00.mpg;Yukio HATOYAMA.jpg;225;333;35961;11;16;5
/net/per610a/home/mvp/mvp_db/news7-lv/2009/2009_12_30_19_00/2009_12_30_19_00.mpg;Yukio HATOYAMA.jpg;1257;1673;35961;62;83;21
/net/per610a/home/mvp/mvp_db/news7-lv/2009/2009_12_30_19_00/2009_12_30_19_00.mpg;Yukio HATOYAMA.jpg;4201;4301;35961;210;215;5
/net/per610a/home/mvp/mvp_db/news7-lv/2009/2009_12_30_19_00/2009_12_30_19_00.mpg;Yukio HATOYAMA.jpg;23353;23701;35961;1168;1185;17
/net/per610a/home/mvp/mvp_db/news7-lv/2009/2009_12_30_19_00/2009_12_30_19_00.mpg;Yukio HATOYAMA.jpg;26257;26425;35961;1313;1321;8
/net/per610a/home/mvp/mvp_db/news7-lv/2009/2009_12_30_19_00/2009_12_30_19_00.mpg;Yukio HATOYAMA.jpg;26673;27297;35961;1334;1365;31
/net/per610a/home/mvp/mvp_db/news7-lv/2009/2009_12_30_19_00/2009_12_30_19_00.mpg;Seiji MAEHARA.jpg;7617;7713;35961;381;385;4
/net/per610a/home/mvp/mvp_db/news7-lv/2009/2009_12_30_19_00/2009_12_30_19_00.mpg;Seiji MAEHARA.jpg;9825;10029;35961;491;501;10
/net/per610a/home/mvp/mvp_db/news7-lv/2009/2009_12_30_19_00/2009_12_30_19_00.mpg;Ichiro OZAWA.jpg;18385;18481;35961;919;924;5
/net/per610a/home/mvp/mvp_db/news7-lv/2010/2010_01_01_19_00/2010_01_01_19_00.mpg;Yukio HATOYAMA.jpg;9929;10197;23865;496;510;14
/net/per610a/home/mvp/mvp_db/news7-lv/2010/2010_01_01_19_00/2010_01_01_19_00.mpg;Natsuo YAMAGUCHI.jpg;10253;10569;23865;512;528;16
/net/per610a/home/mvp/mvp_db/news7-lv/2010/2010_01_02_19_00/2010_01_02_19_00.mpg;Katsuya OKADA.jpg;21541;21877;35961;1077;1094;17
/net/per610a/home/mvp/mvp_db/news7-lv/2010/2010_01_03_19_00/2010_01_03_19_00.mpg;Seiji MAEHARA.jpg;245;365;35961;12;18;6
/net/per610a/home/mvp/mvp_db/news7-lv/2010/2010_01_03_19_00/2010_01_03_19_00.mpg;Seiji MAEHARA.jpg;2369;2565;35961;118;128;10
/net/per610a/home/mvp/mvp_db/news7-lv/2010/2010_01_03_19_00/2010_01_03_19_00.mpg;Seiji MAEHARA.jpg;4089;4157;35961;204;207;3
/net/per610a/home/mvp/mvp_db/news7-lv/2010/2010_01_03_19_00/2010_01_03_19_00.mpg;Seiji MAEHARA.jpg;5845;6265;35961;292;313;21
/net/per610a/home/mvp/mvp_db/news7-lv/2010/2010_01_04_19_00/2010_01_04_19_00.mpg;Yukio HATOYAMA.jpg;77;257;35961;3;12;9
/net/per610a/home/mvp/mvp_db/news7-lv/2010/2010_01_04_19_00/2010_01_04_19_00.mpg;Yukio HATOYAMA.jpg;1505;1625;35961;75;81;6
/net/per610a/home/mvp/mvp_db/news7-lv/2010/2010_01_04_19_00/2010_01_04_19_00.mpg;Yukio HATOYAMA.jpg;2077;2345;35961;103;117;14
/net/per610a/home/mvp/mvp_db/news7-lv/2010/2010_01_04_19_00/2010_01_04_19_00.mpg;Yukio HATOYAMA.jpg;2805;3833;35961;140;191;51
/net/per610a/home/mvp/mvp_db/news7-lv/2010/2010_01_04_19_00/2010_01_04_19_00.mpg;Sadakazu TANIGAKI.jpg;5565;6097;35961;278;305;27
/net/per610a/home/mvp/mvp_db/news7-lv/2010/2010_01_04_19_00/2010_01_04_19_00.mpg;Sadakazu TANIGAKI.jpg;6229;6441;35961;311;322;11
/net/per610a/home/mvp/mvp_db/news7-lv/2010/2010_01_04_19_00/2010_01_04_19_00.mpg;Natsuo YAMAGUCHI.jpg;6605;7193;35961;330;359;29
/net/per610a/home/mvp/mvp_db/news7-lv/2010/2010_01_04_19_00/2010_01_04_19_00.mpg;Yoshimi WATANABE.jpg;7889;7921;35961;394;396;2
/net/per610a/home/mvp/mvp_db/news7-lv/2010/2010_01_04_19_00/2010_01_04_19_00.mpg;Yoshimi WATANABE.jpg;7985;8353;35961;399;417;18
/net/per610a/home/mvp/mvp_db/news7-lv/2010/2010_01_04_19_00/2010_01_04_19_00.mpg;Toru Hashimoto.jpg;13597;14065;35961;680;703;23
/net/per610a/home/mvp/mvp_db/news7-lv/2010/2010_01_05_19_00/2010_01_05_19_00.mpg;Yukio HATOYAMA.jpg;15089;15233;35957;754;762;8
/net/per610a/home/mvp/mvp_db/news7-lv/2010/2010_01_06_19_00/2010_01_06_19_00.mpg;Yukio HATOYAMA.jpg;149;321;35961;7;16;9
/net/per610a/home/mvp/mvp_db/news7-lv/2010/2010_01_06_19_00/2010_01_06_19_00.mpg;Yukio HATOYAMA.jpg;1697;1973;35961;84;98;14
/net/per610a/home/mvp/mvp_db/news7-lv/2010/2010_01_06_19_00/2010_01_06_19_00.mpg;Yukio HATOYAMA.jpg;2081;2109;35961;104;105;1
/net/per610a/home/mvp/mvp_db/news7-lv/2010/2010_01_06_19_00/2010_01_06_19_00.mpg;Ichiro OZAWA.jpg;7717;7821;35961;386;391;5
/net/per610a/home/mvp/mvp_db/news7-lv/2010/2010_01_06_19_00/2010_01_06_19_00.mpg;Ichiro OZAWA.jpg;8389;8541;35961;419;427;8
/net/per610a/home/mvp/mvp_db/news7-lv/2010/2010_01_07_19_00/2010_01_07_19_00.mpg;Naoto KAN.jpg;1;305;35961;0;15;15
/net/per610a/home/mvp/mvp_db/news7-lv/2010/2010_01_07_19_00/2010_01_07_19_00.mpg;Naoto KAN.jpg;4997;5565;35961;249;278;29
/net/per610a/home/mvp/mvp_db/news7-lv/2010/2010_01_07_19_00/2010_01_07_19_00.mpg;Naoto KAN.jpg;6437;6525;35961;322;326;4
/net/per610a/home/mvp/mvp_db/news7-lv/2010/2010_01_07_19_00/2010_01_07_19_00.mpg;Naoto KAN.jpg;6625;6661;35961;331;333;2
/net/per610a/home/mvp/mvp_db/news7-lv/2010/2010_01_07_19_00/2010_01_07_19_00.mpg;Naoto KAN.jpg;8377;8481;35961;419;424;5
/net/per610a/home/mvp/mvp_db/news7-lv/2010/2010_01_07_19_00/2010_01_07_19_00.mpg;Naoto KAN.jpg;8685;10573;35961;434;528;94
/net/per610a/home/mvp/mvp_db/news7-lv/2010/2010_01_07_19_00/2010_01_07_19_00.mpg;Yukio HATOYAMA.jpg;10649;11129;35961;532;556;24
/net/per610a/home/mvp/mvp_db/news7-lv/2010/2010_01_07_19_00/2010_01_07_19_00.mpg;Natsuo YAMAGUCHI.jpg;11741;11881;35961;587;594;7
/net/per610a/home/mvp/mvp_db/news7-lv/2010/2010_01_07_19_00/2010_01_07_19_00.mpg;Ichiro OZAWA.jpg;12033;12693;35961;601;634;33
/net/per610a/home/mvp/mvp_db/news7-lv/2010/2010_01_07_19_00/2010_01_07_19_00.mpg;Ichiro OZAWA.jpg;14769;15089;35961;738;754;16
/net/per610a/home/mvp/mvp_db/news7-lv/2010/2010_01_08_19_00/2010_01_08_19_00.mpg;Yukio HATOYAMA.jpg;1625;1861;35961;81;93;12
/net/per610a/home/mvp/mvp_db/news7-lv/2010/2010_01_08_19_00/2010_01_08_19_00.mpg;Yukio HATOYAMA.jpg;8361;8853;35961;418;442;24
/net/per610a/home/mvp/mvp_db/news7-lv/2010/2010_01_08_19_00/2010_01_08_19_00.mpg;Yukio EDANO.jpg;15701;15801;35961;785;790;5
/net/per610a/home/mvp/mvp_db/news7-lv/2010/2010_01_08_19_00/2010_01_08_19_00.mpg;Yukio EDANO.jpg;24853;24865;35961;1243;1243;0
/net/per610a/home/mvp/mvp_db/news7-lv/2010/2010_01_08_19_00/2010_01_08_19_00.mpg;Yukio EDANO.jpg;25101;25181;35961;1255;1259;4
/net/per610a/home/mvp/mvp_db/news7-lv/2010/2010_01_08_19_00/2010_01_08_19_00.mpg;Katsuya OKADA.jpg;19185;19605;35961;959;980;21
/net/per610a/home/mvp/mvp_db/news7-lv/2010/2010_01_08_19_00/2010_01_08_19_00.mpg;Shintaro ISHIHARA.jpg;28241;28361;35961;1412;1418;6
/net/per610a/home/mvp/mvp_db/news7-lv/2010/2010_01_09_19_00/2010_01_09_19_00.mpg;Kenji Eda.jpg;16729;17589;35961;836;879;43
/net/per610a/home/mvp/mvp_db/news7-lv/2010/2010_01_10_19_00/2010_01_10_19_00.mpg;Natsuo YAMAGUCHI.jpg;1089;1581;35961;54;79;25
/net/per610a/home/mvp/mvp_db/news7-lv/2010/2010_01_10_19_00/2010_01_10_19_00.mpg;Natsuo YAMAGUCHI.jpg;3477;3969;35961;173;198;25
/net/per610a/home/mvp/mvp_db/news7-lv/2010/2010_01_10_19_00/2010_01_10_19_00.mpg;Natsuo YAMAGUCHI.jpg;4333;4705;35961;216;235;19
/net/per610a/home/mvp/mvp_db/news7-lv/2010/2010_01_11_19_00/2010_01_11_19_00.mpg;Ichiro OZAWA.jpg;1245;1629;35961;62;81;19
/net/per610a/home/mvp/mvp_db/news7-lv/2010/2010_01_12_19_00/2010_01_12_19_00.mpg;Naoto KAN.jpg;21905;21985;35961;1095;1099;4
/net/per610a/home/mvp/mvp_db/news7-lv/2010/2010_01_12_19_00/2010_01_12_19_00.mpg;Naoto KAN.jpg;22141;22293;35961;1107;1115;8
/net/per610a/home/mvp/mvp_db/news7-lv/2010/2010_01_13_19_00/2010_01_13_19_00.mpg;Ichiro OZAWA.jpg;4657;4901;35961;232;245;13
/net/per610a/home/mvp/mvp_db/news7-lv/2010/2010_01_13_19_00/2010_01_13_19_00.mpg;Yukio HATOYAMA.jpg;11969;12701;35961;598;635;37
/net/per610a/home/mvp/mvp_db/news7-lv/2010/2010_01_13_19_00/2010_01_13_19_00.mpg;Taro ASO.jpg;22021;22425;35961;1101;1121;20
/net/per610a/home/mvp/mvp_db/news7-lv/2010/2010_01_13_19_00/2010_01_13_19_00.mpg;Katsuya OKADA.jpg;25037;25461;35961;1252;1273;21
/net/per610a/home/mvp/mvp_db/news7-lv/2010/2010_01_14_19_00/2010_01_14_19_00.mpg;Ichiro OZAWA.jpg;4721;5349;35961;236;267;31
/net/per610a/home/mvp/mvp_db/news7-lv/2010/2010_01_14_19_00/2010_01_14_19_00.mpg;Ichiro OZAWA.jpg;7853;8505;35961;392;425;33
/net/per610a/home/mvp/mvp_db/news7-lv/2010/2010_01_14_19_00/2010_01_14_19_00.mpg;Naoto KAN.jpg;9969;10761;35961;498;538;40
/net/per610a/home/mvp/mvp_db/news7-lv/2010/2010_01_14_19_00/2010_01_14_19_00.mpg;Seiji Mataichi.jpg;10849;11213;35961;542;560;18
/net/per610a/home/mvp/mvp_db/news7-lv/2010/2010_01_15_19_00/2010_01_15_19_00.mpg;Katsuya OKADA.jpg;4709;4985;35961;235;249;14
/net/per610a/home/mvp/mvp_db/news7-lv/2010/2010_01_15_19_00/2010_01_15_19_00.mpg;Katsuya OKADA.jpg;5053;6289;35961;252;314;62
/net/per610a/home/mvp/mvp_db/news7-lv/2010/2010_01_15_19_00/2010_01_15_19_00.mpg;Ichiro OZAWA.jpg;6321;6377;35961;316;319;3
/net/per610a/home/mvp/mvp_db/news7-lv/2010/2010_01_15_19_00/2010_01_15_19_00.mpg;Naoto KAN.jpg;6821;7861;35961;341;393;52
/net/per610a/home/mvp/mvp_db/news7-lv/2010/2010_01_15_19_00/2010_01_15_19_00.mpg;Yukio HATOYAMA.jpg;11145;11981;35961;557;599;42
/net/per610a/home/mvp/mvp_db/news7-lv/2010/2010_01_15_19_00/2010_01_15_19_00.mpg;Yukio HATOYAMA.jpg;28853;29081;35961;1443;1454;11
/net/per610a/home/mvp/mvp_db/news7-lv/2010/2010_01_15_19_00/2010_01_15_19_00.mpg;Seiji MAEHARA.jpg;28853;29297;35961;1443;1465;22
/net/per610a/home/mvp/mvp_db/news7-lv/2010/2010_01_16_19_00/2010_01_16_19_00.mpg;Ichiro OZAWA.jpg;1873;1881;35961;93;94;1
/net/per610a/home/mvp/mvp_db/news7-lv/2010/2010_01_16_19_00/2010_01_16_19_00.mpg;Ichiro OZAWA.jpg;6757;8805;35961;338;440;102
/net/per610a/home/mvp/mvp_db/news7-lv/2010/2010_01_16_19_00/2010_01_16_19_00.mpg;Ichiro OZAWA.jpg;11457;12221;35961;573;611;38
/net/per610a/home/mvp/mvp_db/news7-lv/2010/2010_01_16_19_00/2010_01_16_19_00.mpg;Ichiro OZAWA.jpg;15713;16321;35961;786;816;30
/net/per610a/home/mvp/mvp_db/news7-lv/2010/2010_01_16_19_00/2010_01_16_19_00.mpg;Ichiro OZAWA.jpg;4849;5389;35961;242;269;27
/net/per610a/home/mvp/mvp_db/news7-lv/2010/2010_01_16_19_00/2010_01_16_19_00.mpg;Yukio HATOYAMA.jpg;9025;9441;35961;451;472;21
/net/per610a/home/mvp/mvp_db/news7-lv/2010/2010_01_16_19_00/2010_01_16_19_00.mpg;Yukio HATOYAMA.jpg;17409;17537;35961;870;877;7
/net/per610a/home/mvp/mvp_db/news7-lv/2010/2010_01_16_19_00/2010_01_16_19_00.mpg;Seiji MAEHARA.jpg;13189;13693;35961;659;685;26
/net/per610a/home/mvp/mvp_db/news7-lv/2010/2010_01_17_19_00/2010_01_17_19_00.mpg;Kazuo SHII.jpg;4397;4969;35961;219;248;29
/net/per610a/home/mvp/mvp_db/news7-lv/2010/2010_01_18_19_00/2010_01_18_19_00.mpg;Ichiro OZAWA.jpg;4105;4145;35961;205;207;2
/net/per610a/home/mvp/mvp_db/news7-lv/2010/2010_01_18_19_00/2010_01_18_19_00.mpg;Ichiro OZAWA.jpg;7513;8333;35961;375;416;41
/net/per610a/home/mvp/mvp_db/news7-lv/2010/2010_01_18_19_00/2010_01_18_19_00.mpg;Ichiro OZAWA.jpg;19429;19965;35961;971;998;27
/net/per610a/home/mvp/mvp_db/news7-lv/2010/2010_01_18_19_00/2010_01_18_19_00.mpg;Yukio HATOYAMA.jpg;8413;9333;35961;420;466;46
/net/per610a/home/mvp/mvp_db/news7-lv/2010/2010_01_18_19_00/2010_01_18_19_00.mpg;Yukio HATOYAMA.jpg;12149;12189;35961;607;609;2
/net/per610a/home/mvp/mvp_db/news7-lv/2010/2010_01_18_19_00/2010_01_18_19_00.mpg;Yukio HATOYAMA.jpg;14169;14481;35961;708;724;16
/net/per610a/home/mvp/mvp_db/news7-lv/2010/2010_01_18_19_00/2010_01_18_19_00.mpg;Natsuo YAMAGUCHI.jpg;13121;13465;35961;656;673;17
/net/per610a/home/mvp/mvp_db/news7-lv/2010/2010_01_18_19_00/2010_01_18_19_00.mpg;Naoto KAN.jpg;14597;14613;35961;730;731;1
/net/per610a/home/mvp/mvp_db/news7-lv/2010/2010_01_18_19_00/2010_01_18_19_00.mpg;Naoto KAN.jpg;29017;29165;35961;1451;1459;8
/net/per610a/home/mvp/mvp_db/news7-lv/2010/2010_01_18_19_00/2010_01_18_19_00.mpg;Katsuya OKADA.jpg;14777;15129;35961;739;756;17
/net/per610a/home/mvp/mvp_db/news7-lv/2010/2010_01_19_19_00/2010_01_19_19_00.mpg;Ichiro OZAWA.jpg;1;189;35961;0;9;9
/net/per610a/home/mvp/mvp_db/news7-lv/2010/2010_01_19_19_00/2010_01_19_19_00.mpg;Ichiro OZAWA.jpg;2125;2389;35961;106;119;13
/net/per610a/home/mvp/mvp_db/news7-lv/2010/2010_01_19_19_00/2010_01_19_19_00.mpg;Ichiro OZAWA.jpg;7993;8257;35961;399;413;14
/net/per610a/home/mvp/mvp_db/news7-lv/2010/2010_01_19_19_00/2010_01_19_19_00.mpg;Yukio HATOYAMA.jpg;10589;11153;35961;529;557;28
/net/per610a/home/mvp/mvp_db/news7-lv/2010/2010_01_19_19_00/2010_01_19_19_00.mpg;Naoto KAN.jpg;18197;18557;35961;910;928;18
/net/per610a/home/mvp/mvp_db/news7-lv/2010/2010_01_20_19_00/2010_01_20_19_00.mpg;Ichiro OZAWA.jpg;1;117;35961;0;5;5
/net/per610a/home/mvp/mvp_db/news7-lv/2010/2010_01_20_19_00/2010_01_20_19_00.mpg;Ichiro OZAWA.jpg;6005;6017;35961;300;301;1
/net/per610a/home/mvp/mvp_db/news7-lv/2010/2010_01_20_19_00/2010_01_20_19_00.mpg;Ichiro OZAWA.jpg;2037;2321;35961;101;116;15
/net/per610a/home/mvp/mvp_db/news7-lv/2010/2010_01_20_19_00/2010_01_20_19_00.mpg;Yukio HATOYAMA.jpg;2329;2813;35961;116;140;24
/net/per610a/home/mvp/mvp_db/news7-lv/2010/2010_01_20_19_00/2010_01_20_19_00.mpg;Yukio HATOYAMA.jpg;8333;9221;35961;416;461;45
/net/per610a/home/mvp/mvp_db/news7-lv/2010/2010_01_20_19_00/2010_01_20_19_00.mpg;Ichiro OZAWA.jpg;6081;6309;35961;304;315;11
/net/per610a/home/mvp/mvp_db/news7-lv/2010/2010_01_21_19_00/2010_01_21_19_00.mpg;Ichiro OZAWA.jpg;1;133;35961;0;6;6
/net/per610a/home/mvp/mvp_db/news7-lv/2010/2010_01_21_19_00/2010_01_21_19_00.mpg;Yukio HATOYAMA.jpg;4081;4609;35961;204;230;26
/net/per610a/home/mvp/mvp_db/news7-lv/2010/2010_01_21_19_00/2010_01_21_19_00.mpg;Yukio HATOYAMA.jpg;4693;4789;35961;234;239;5
/net/per610a/home/mvp/mvp_db/news7-lv/2010/2010_01_21_19_00/2010_01_21_19_00.mpg;Yukio HATOYAMA.jpg;5589;5609;35961;279;280;1
/net/per610a/home/mvp/mvp_db/news7-lv/2010/2010_01_21_19_00/2010_01_21_19_00.mpg;Yukio HATOYAMA.jpg;7721;7833;35961;386;391;5
/net/per610a/home/mvp/mvp_db/news7-lv/2010/2010_01_21_19_00/2010_01_21_19_00.mpg;Yukio HATOYAMA.jpg;14313;14869;35961;716;743;27
/net/per610a/home/mvp/mvp_db/news7-lv/2010/2010_01_21_19_00/2010_01_21_19_00.mpg;Yukio HATOYAMA.jpg;15157;15613;35961;758;781;23
/net/per610a/home/mvp/mvp_db/news7-lv/2010/2010_01_21_19_00/2010_01_21_19_00.mpg;Kazuo SHII.jpg;12465;12921;35961;623;646;23
/net/per610a/home/mvp/mvp_db/news7-lv/2010/2010_01_21_19_00/2010_01_21_19_00.mpg;Yukio HATOYAMA.jpg;12941;13865;35961;647;693;46
/net/per610a/home/mvp/mvp_db/news7-lv/2010/2010_01_22_19_00/2010_01_22_19_00.mpg;Takenori KANZAKI.jpg;8809;9041;35957;440;452;12
/net/per610a/home/mvp/mvp_db/news7-lv/2010/2010_01_22_19_00/2010_01_22_19_00.mpg;Yukio HATOYAMA.jpg;11877;12709;35957;594;635;41
/net/per610a/home/mvp/mvp_db/news7-lv/2010/2010_01_22_19_00/2010_01_22_19_00.mpg;Yukio HATOYAMA.jpg;12845;13361;35957;642;668;26
/net/per610a/home/mvp/mvp_db/news7-lv/2010/2010_01_22_19_00/2010_01_22_19_00.mpg;Yukio HATOYAMA.jpg;13817;14485;35957;691;724;33
/net/per610a/home/mvp/mvp_db/news7-lv/2010/2010_01_23_19_00/2010_01_23_19_00.mpg;Ichiro OZAWA.jpg;2769;2797;35961;138;139;1
/net/per610a/home/mvp/mvp_db/news7-lv/2010/2010_01_23_19_00/2010_01_23_19_00.mpg;Ichiro OZAWA.jpg;3421;3433;35961;171;171;0
/net/per610a/home/mvp/mvp_db/news7-lv/2010/2010_01_23_19_00/2010_01_23_19_00.mpg;Ichiro OZAWA.jpg;5133;5409;35961;256;270;14
/net/per610a/home/mvp/mvp_db/news7-lv/2010/2010_01_23_19_00/2010_01_23_19_00.mpg;Ichiro OZAWA.jpg;6473;6589;35961;323;329;6
/net/per610a/home/mvp/mvp_db/news7-lv/2010/2010_01_23_19_00/2010_01_23_19_00.mpg;Ichiro OZAWA.jpg;8361;8697;35961;418;435;17
/net/per610a/home/mvp/mvp_db/news7-lv/2010/2010_01_23_19_00/2010_01_23_19_00.mpg;Ichiro OZAWA.jpg;13161;17069;35961;658;853;195
/net/per610a/home/mvp/mvp_db/news7-lv/2010/2010_01_23_19_00/2010_01_23_19_00.mpg;Ichiro OZAWA.jpg;18517;19137;35961;926;957;31
/net/per610a/home/mvp/mvp_db/news7-lv/2010/2010_01_23_19_00/2010_01_23_19_00.mpg;Yukio HATOYAMA.jpg;18517;19161;35961;926;958;32
/net/per610a/home/mvp/mvp_db/news7-lv/2010/2010_01_24_19_00/2010_01_24_19_00.mpg;Ichiro OZAWA.jpg;1;461;35961;0;23;23
/net/per610a/home/mvp/mvp_db/news7-lv/2010/2010_01_24_19_00/2010_01_24_19_00.mpg;Ichiro OZAWA.jpg;1825;2313;35961;91;115;24
/net/per610a/home/mvp/mvp_db/news7-lv/2010/2010_01_24_19_00/2010_01_24_19_00.mpg;Sadakazu TANIGAKI.jpg;5845;6121;35961;292;306;14
/net/per610a/home/mvp/mvp_db/news7-lv/2010/2010_01_24_19_00/2010_01_24_19_00.mpg;Sadakazu TANIGAKI.jpg;15737;16741;35961;787;837;50
/net/per610a/home/mvp/mvp_db/news7-lv/2010/2010_01_24_19_00/2010_01_24_19_00.mpg;Sadakazu TANIGAKI.jpg;17637;17953;35961;882;898;16
/net/per610a/home/mvp/mvp_db/news7-lv/2010/2010_01_24_19_00/2010_01_24_19_00.mpg;Sadakazu TANIGAKI.jpg;14201;14725;35961;710;736;26
/net/per610a/home/mvp/mvp_db/news7-lv/2010/2010_01_24_19_00/2010_01_24_19_00.mpg;Sadakazu TANIGAKI.jpg;15577;15581;35961;779;779;0
/net/per610a/home/mvp/mvp_db/news7-lv/2010/2010_01_24_19_00/2010_01_24_19_00.mpg;Sadakazu TANIGAKI.jpg;18213;18529;35961;911;926;15
/net/per610a/home/mvp/mvp_db/news7-lv/2010/2010_01_25_19_00/2010_01_25_19_00.mpg;Katsuya OKADA.jpg;10189;10401;35961;509;520;11
/net/per610a/home/mvp/mvp_db/news7-lv/2010/2010_01_25_19_00/2010_01_25_19_00.mpg;Ichiro OZAWA.jpg;12149;13141;35961;607;657;50
/net/per610a/home/mvp/mvp_db/news7-lv/2010/2010_01_25_19_00/2010_01_25_19_00.mpg;Ichiro OZAWA.jpg;13361;14001;35961;668;700;32
/net/per610a/home/mvp/mvp_db/news7-lv/2010/2010_01_25_19_00/2010_01_25_19_00.mpg;Ichiro OZAWA.jpg;15141;15673;35961;757;784;27
/net/per610a/home/mvp/mvp_db/news7-lv/2010/2010_01_27_19_00/2010_01_27_19_00.mpg;Natsuo YAMAGUCHI.jpg;8929;9309;35957;446;465;19
/net/per610a/home/mvp/mvp_db/news7-lv/2010/2010_01_27_19_00/2010_01_27_19_00.mpg;Natsuo YAMAGUCHI.jpg;10165;10189;35957;508;509;1
/net/per610a/home/mvp/mvp_db/news7-lv/2010/2010_01_27_19_00/2010_01_27_19_00.mpg;Natsuo YAMAGUCHI.jpg;10393;10601;35957;519;530;11
/net/per610a/home/mvp/mvp_db/news7-lv/2010/2010_01_27_19_00/2010_01_27_19_00.mpg;Natsuo YAMAGUCHI.jpg;15985;16069;35957;799;803;4
/net/per610a/home/mvp/mvp_db/news7-lv/2010/2010_01_29_19_00/2010_01_29_19_00.mpg;Ichiro OZAWA.jpg;19673;19961;35961;984;998;14
/net/per610a/home/mvp/mvp_db/news7-lv/2010/2010_01_29_19_00/2010_01_29_19_00.mpg;Toranosuke Katayama.jpg;21941;22521;35961;1097;1126;29
/net/per610a/home/mvp/mvp_db/news7-lv/2010/2010_01_29_19_00/2010_01_29_19_00.mpg;Sadakazu TANIGAKI.jpg;24069;24649;35961;1204;1233;29
/net/per610a/home/mvp/mvp_db/news7-lv/2010/2010_01_30_19_00/2010_01_30_19_00.mpg;Yukio HATOYAMA.jpg;3797;4341;35961;189;217;28
/net/per610a/home/mvp/mvp_db/news7-lv/2010/2010_01_30_19_00/2010_01_30_19_00.mpg;Yukio HATOYAMA.jpg;26429;26485;35961;1322;1324;2
/net/per610a/home/mvp/mvp_db/news7-lv/2010/2010_01_31_19_00/2010_01_31_19_00.mpg;Yoshihiko Noda.jpg;3385;3713;35961;169;185;16
/net/per610a/home/mvp/mvp_db/news7-lv/2010/2010_02_01_19_00/2010_02_01_19_00.mpg;Ichiro OZAWA.jpg;6757;6997;35961;338;350;12
/net/per610a/home/mvp/mvp_db/news7-lv/2010/2010_02_01_19_00/2010_02_01_19_00.mpg;Ichiro OZAWA.jpg;7473;8125;35961;373;406;33
/net/per610a/home/mvp/mvp_db/news7-lv/2010/2010_02_02_19_00/2010_02_02_19_00.mpg;Seiji MAEHARA.jpg;8201;8485;35961;410;424;14
/net/per610a/home/mvp/mvp_db/news7-lv/2010/2010_02_02_19_00/2010_02_02_19_00.mpg;Ichiro OZAWA.jpg;19565;20481;35961;978;1024;46
/net/per610a/home/mvp/mvp_db/news7-lv/2010/2010_02_03_19_00/2010_02_03_19_00.mpg;Ichiro OZAWA.jpg;1817;1953;35961;90;97;7
/net/per610a/home/mvp/mvp_db/news7-lv/2010/2010_02_04_19_00/2010_02_04_19_00.mpg;Ichiro OZAWA.jpg;3461;3541;35961;173;177;4
/net/per610a/home/mvp/mvp_db/news7-lv/2010/2010_02_04_19_00/2010_02_04_19_00.mpg;Ichiro OZAWA.jpg;3625;3781;35961;181;189;8
/net/per610a/home/mvp/mvp_db/news7-lv/2010/2010_02_04_19_00/2010_02_04_19_00.mpg;Ichiro OZAWA.jpg;6929;6997;35961;346;350;4
/net/per610a/home/mvp/mvp_db/news7-lv/2010/2010_02_04_19_00/2010_02_04_19_00.mpg;Ichiro OZAWA.jpg;10169;10529;35961;508;526;18
/net/per610a/home/mvp/mvp_db/news7-lv/2010/2010_02_04_19_00/2010_02_04_19_00.mpg;Sadakazu TANIGAKI.jpg;13445;15637;35961;672;782;110
/net/per610a/home/mvp/mvp_db/news7-lv/2010/2010_02_05_19_00/2010_02_05_19_00.mpg;Yukio HATOYAMA.jpg;24365;24513;35961;1218;1226;8
/net/per610a/home/mvp/mvp_db/news7-lv/2010/2010_02_07_19_00/2010_02_07_19_00.mpg;Yukio HATOYAMA.jpg;29461;29633;35961;1473;1482;9
/net/per610a/home/mvp/mvp_db/news7-lv/2010/2010_02_08_19_00/2010_02_08_19_00.mpg;Ichiro OZAWA.jpg;8001;8001;35961;400;400;0
/net/per610a/home/mvp/mvp_db/news7-lv/2010/2010_02_08_19_00/2010_02_08_19_00.mpg;Ichiro OZAWA.jpg;10629;11509;35961;531;575;44
/net/per610a/home/mvp/mvp_db/news7-lv/2010/2010_02_08_19_00/2010_02_08_19_00.mpg;Ichiro OZAWA.jpg;20541;20845;35961;1027;1042;15
/net/per610a/home/mvp/mvp_db/news7-lv/2010/2010_02_08_19_00/2010_02_08_19_00.mpg;Yukio HATOYAMA.jpg;9941;10513;35961;497;525;28
/net/per610a/home/mvp/mvp_db/news7-lv/2010/2010_02_08_19_00/2010_02_08_19_00.mpg;Yukio HATOYAMA.jpg;19705;19741;35961;985;987;2
/net/per610a/home/mvp/mvp_db/news7-lv/2010/2010_02_08_19_00/2010_02_08_19_00.mpg;Yukio HATOYAMA.jpg;19837;20537;35961;992;1027;35
/net/per610a/home/mvp/mvp_db/news7-lv/2010/2010_02_08_19_00/2010_02_08_19_00.mpg;Yukio HATOYAMA.jpg;22037;22421;35961;1102;1121;19
/net/per610a/home/mvp/mvp_db/news7-lv/2010/2010_02_08_19_00/2010_02_08_19_00.mpg;Ichiro OZAWA.jpg;12345;13473;35961;617;674;57
/net/per610a/home/mvp/mvp_db/news7-lv/2010/2010_02_09_19_00/2010_02_09_19_00.mpg;Masashi Nakano.jpg;23713;24221;35961;1186;1211;25
/net/per610a/home/mvp/mvp_db/news7-lv/2010/2010_02_10_19_00/2010_02_10_19_00.mpg;Yukio HATOYAMA.jpg;3909;5013;35961;195;250;55
/net/per610a/home/mvp/mvp_db/news7-lv/2010/2010_02_10_19_00/2010_02_10_19_00.mpg;Yukio HATOYAMA.jpg;6957;6993;35961;348;349;1
/net/per610a/home/mvp/mvp_db/news7-lv/2010/2010_02_10_19_00/2010_02_10_19_00.mpg;Yukio HATOYAMA.jpg;10605;10805;35961;530;540;10
/net/per610a/home/mvp/mvp_db/news7-lv/2010/2010_02_11_19_00/2010_02_11_19_00.mpg;Ichiro OZAWA.jpg;3245;4209;35961;162;210;48
/net/per610a/home/mvp/mvp_db/news7-lv/2010/2010_02_12_19_00/2010_02_12_19_00.mpg;Yukio HATOYAMA.jpg;20989;21089;35957;1050;1055;5
/net/per610a/home/mvp/mvp_db/news7-lv/2010/2010_02_12_19_00/2010_02_12_19_00.mpg;Shintaro ISHIHARA.jpg;31213;31365;35957;1561;1569;8
/net/per610a/home/mvp/mvp_db/news7-lv/2010/2010_02_13_19_00/2010_02_13_19_00.mpg;Ichiro OZAWA.jpg;19089;20661;35961;954;1033;79
/net/per610a/home/mvp/mvp_db/news7-lv/2010/2010_02_13_19_00/2010_02_13_19_00.mpg;Ichiro OZAWA.jpg;20781;21153;35961;1039;1058;19
/net/per610a/home/mvp/mvp_db/news7-lv/2010/2010_02_13_19_00/2010_02_13_19_00.mpg;Sadakazu TANIGAKI.jpg;21257;22609;35961;1063;1131;68
/net/per610a/home/mvp/mvp_db/news7-lv/2010/2010_02_14_19_00/2010_02_14_19_00.mpg;Yukio HATOYAMA.jpg;19461;19521;35961;973;976;3
/net/per610a/home/mvp/mvp_db/news7-lv/2010/2010_02_14_19_00/2010_02_14_19_00.mpg;Yukio HATOYAMA.jpg;20081;20161;35961;1004;1008;4
/net/per610a/home/mvp/mvp_db/news7-lv/2010/2010_02_14_19_00/2010_02_14_19_00.mpg;Yukio HATOYAMA.jpg;20501;20517;35961;1025;1026;1
/net/per610a/home/mvp/mvp_db/news7-lv/2010/2010_02_14_19_00/2010_02_14_19_00.mpg;Yukio HATOYAMA.jpg;20881;22157;35961;1044;1108;64
/net/per610a/home/mvp/mvp_db/news7-lv/2010/2010_02_14_19_00/2010_02_14_19_00.mpg;Sadakazu TANIGAKI.jpg;22201;23301;35961;1110;1165;55
/net/per610a/home/mvp/mvp_db/news7-lv/2010/2010_02_15_19_00/2010_02_15_19_00.mpg;Yukio HATOYAMA.jpg;28357;28889;35961;1418;1445;27
/net/per610a/home/mvp/mvp_db/news7-lv/2010/2010_02_16_19_00/2010_02_16_19_00.mpg;Shizuka KAMEI.jpg;25953;26265;35961;1298;1313;15
/net/per610a/home/mvp/mvp_db/news7-lv/2010/2010_02_16_19_00/2010_02_16_19_00.mpg;Kazuo SHII.jpg;26877;26985;35961;1344;1349;5
/net/per610a/home/mvp/mvp_db/news7-lv/2010/2010_02_16_19_00/2010_02_16_19_00.mpg;Yukio HATOYAMA.jpg;28497;29081;35961;1425;1454;29
/net/per610a/home/mvp/mvp_db/news7-lv/2010/2010_02_17_19_00/2010_02_17_19_00.mpg;Yukio HATOYAMA.jpg;23765;24013;35961;1188;1201;13
/net/per610a/home/mvp/mvp_db/news7-lv/2010/2010_02_17_19_00/2010_02_17_19_00.mpg;Mizuho FUKUSHIMA.jpg;29513;29625;35961;1476;1482;6
/net/per610a/home/mvp/mvp_db/news7-lv/2010/2010_02_17_19_00/2010_02_17_19_00.mpg;Mizuho FUKUSHIMA.jpg;29709;29961;35961;1486;1498;12
/net/per610a/home/mvp/mvp_db/news7-lv/2010/2010_02_18_19_00/2010_02_18_19_00.mpg;Sadakazu TANIGAKI.jpg;23109;23193;35961;1156;1160;4
/net/per610a/home/mvp/mvp_db/news7-lv/2010/2010_02_18_19_00/2010_02_18_19_00.mpg;Yukio HATOYAMA.jpg;23593;24737;35961;1180;1237;57
/net/per610a/home/mvp/mvp_db/news7-lv/2010/2010_02_22_19_00/2010_02_22_19_00.mpg;Sadakazu TANIGAKI.jpg;1333;1585;35961;66;79;13
/net/per610a/home/mvp/mvp_db/news7-lv/2010/2010_02_22_19_00/2010_02_22_19_00.mpg;Yukio HATOYAMA.jpg;2349;2801;35961;117;140;23
/net/per610a/home/mvp/mvp_db/news7-lv/2010/2010_02_22_19_00/2010_02_22_19_00.mpg;Yukio HATOYAMA.jpg;3229;3493;35961;161;174;13
/net/per610a/home/mvp/mvp_db/news7-lv/2010/2010_02_22_19_00/2010_02_22_19_00.mpg;Yukio HATOYAMA.jpg;7817;8773;35961;391;438;47
/net/per610a/home/mvp/mvp_db/news7-lv/2010/2010_02_22_19_00/2010_02_22_19_00.mpg;Yukio HATOYAMA.jpg;10117;10609;35961;506;530;24
/net/per610a/home/mvp/mvp_db/news7-lv/2010/2010_02_22_19_00/2010_02_22_19_00.mpg;Ichiro OZAWA.jpg;8809;9169;35961;440;458;18
/net/per610a/home/mvp/mvp_db/news7-lv/2010/2010_02_25_19_00/2010_02_25_19_00.mpg;Sadakazu TANIGAKI.jpg;27773;27825;35961;1389;1391;2
/net/per610a/home/mvp/mvp_db/news7-lv/2010/2010_02_25_19_00/2010_02_25_19_00.mpg;Sadakazu TANIGAKI.jpg;29189;29769;35961;1460;1489;29
/net/per610a/home/mvp/mvp_db/news7-lv/2010/2010_02_26_19_00/2010_02_26_19_00.mpg;Yukio EDANO.jpg;28985;29261;35961;1450;1463;13
/net/per610a/home/mvp/mvp_db/news7-lv/2010/2010_03_02_19_00/2010_03_02_19_00.mpg;Ichiro OZAWA.jpg;6213;6773;35961;310;338;28
/net/per610a/home/mvp/mvp_db/news7-lv/2010/2010_03_03_19_00/2010_03_03_19_00.mpg;Yukio HATOYAMA.jpg;2405;2417;35961;120;120;0
/net/per610a/home/mvp/mvp_db/news7-lv/2010/2010_03_03_19_00/2010_03_03_19_00.mpg;Yukio HATOYAMA.jpg;4745;4905;35961;237;245;8
/net/per610a/home/mvp/mvp_db/news7-lv/2010/2010_03_03_19_00/2010_03_03_19_00.mpg;Yukio HATOYAMA.jpg;5049;5857;35961;252;293;41
/net/per610a/home/mvp/mvp_db/news7-lv/2010/2010_03_03_19_00/2010_03_03_19_00.mpg;Yukio HATOYAMA.jpg;7633;8233;35961;381;411;30
/net/per610a/home/mvp/mvp_db/news7-lv/2010/2010_03_04_19_00/2010_03_04_19_00.mpg;Yukio HATOYAMA.jpg;201;353;35961;10;17;7
/net/per610a/home/mvp/mvp_db/news7-lv/2010/2010_03_04_19_00/2010_03_04_19_00.mpg;Yukio HATOYAMA.jpg;1161;1401;35961;58;70;12
/net/per610a/home/mvp/mvp_db/news7-lv/2010/2010_03_04_19_00/2010_03_04_19_00.mpg;Yukio HATOYAMA.jpg;4685;4757;35961;234;237;3
/net/per610a/home/mvp/mvp_db/news7-lv/2010/2010_03_04_19_00/2010_03_04_19_00.mpg;Yukio HATOYAMA.jpg;4837;6625;35961;241;331;90
/net/per610a/home/mvp/mvp_db/news7-lv/2010/2010_03_04_19_00/2010_03_04_19_00.mpg;Yukio HATOYAMA.jpg;10437;10973;35961;522;548;26
/net/per610a/home/mvp/mvp_db/news7-lv/2010/2010_03_04_19_00/2010_03_04_19_00.mpg;Yukio HATOYAMA.jpg;11757;12149;35961;588;607;19
/net/per610a/home/mvp/mvp_db/news7-lv/2010/2010_03_04_19_00/2010_03_04_19_00.mpg;Yukio HATOYAMA.jpg;12649;13117;35961;632;656;24
/net/per610a/home/mvp/mvp_db/news7-lv/2010/2010_03_04_19_00/2010_03_04_19_00.mpg;Taro ASO.jpg;6209;6625;35961;310;331;21
/net/per610a/home/mvp/mvp_db/news7-lv/2010/2010_03_04_19_00/2010_03_04_19_00.mpg;Taro ASO.jpg;8053;8077;35961;402;404;2
/net/per610a/home/mvp/mvp_db/news7-lv/2010/2010_03_04_19_00/2010_03_04_19_00.mpg;Taro ASO.jpg;8173;9021;35961;408;451;43
/net/per610a/home/mvp/mvp_db/news7-lv/2010/2010_03_04_19_00/2010_03_04_19_00.mpg;Ichiro OZAWA.jpg;6241;6613;35961;312;330;18
/net/per610a/home/mvp/mvp_db/news7-lv/2010/2010_03_04_19_00/2010_03_04_19_00.mpg;Ichiro OZAWA.jpg;6901;7009;35961;345;350;5
/net/per610a/home/mvp/mvp_db/news7-lv/2010/2010_03_04_19_00/2010_03_04_19_00.mpg;Ichiro OZAWA.jpg;7333;7393;35961;366;369;3
/net/per610a/home/mvp/mvp_db/news7-lv/2010/2010_03_04_19_00/2010_03_04_19_00.mpg;Ichiro OZAWA.jpg;7401;7949;35961;370;397;27
/net/per610a/home/mvp/mvp_db/news7-lv/2010/2010_03_05_19_00/2010_03_05_19_00.mpg;Shizuka KAMEI.jpg;3053;3433;35961;152;171;19
/net/per610a/home/mvp/mvp_db/news7-lv/2010/2010_03_05_19_00/2010_03_05_19_00.mpg;Mizuho FUKUSHIMA.jpg;3701;4509;35961;185;225;40
/net/per610a/home/mvp/mvp_db/news7-lv/2010/2010_03_06_19_00/2010_03_06_19_00.mpg;Yukio HATOYAMA.jpg;33;381;35961;1;19;18
/net/per610a/home/mvp/mvp_db/news7-lv/2010/2010_03_06_19_00/2010_03_06_19_00.mpg;Yukio HATOYAMA.jpg;1205;1541;35961;60;77;17
/net/per610a/home/mvp/mvp_db/news7-lv/2010/2010_03_06_19_00/2010_03_06_19_00.mpg;Yukio HATOYAMA.jpg;28725;28921;35961;1437;1446;9
/net/per610a/home/mvp/mvp_db/news7-lv/2010/2010_03_07_19_00/2010_03_07_19_00.mpg;Seiji MAEHARA.jpg;13517;15373;35961;676;769;93
/net/per610a/home/mvp/mvp_db/news7-lv/2010/2010_03_07_19_00/2010_03_07_19_00.mpg;Yoshihiko Noda.jpg;15541;15897;35961;777;795;18
/net/per610a/home/mvp/mvp_db/news7-lv/2010/2010_03_07_19_00/2010_03_07_19_00.mpg;Katsuya OKADA.jpg;28133;28549;35961;1407;1428;21
/net/per610a/home/mvp/mvp_db/news7-lv/2010/2010_03_08_19_00/2010_03_08_19_00.mpg;Yukio HATOYAMA.jpg;8529;8885;35961;426;444;18
/net/per610a/home/mvp/mvp_db/news7-lv/2010/2010_03_08_19_00/2010_03_08_19_00.mpg;Yukio HATOYAMA.jpg;10801;11197;35961;540;560;20
/net/per610a/home/mvp/mvp_db/news7-lv/2010/2010_03_08_19_00/2010_03_08_19_00.mpg;Yukio HATOYAMA.jpg;11545;11853;35961;577;592;15
/net/per610a/home/mvp/mvp_db/news7-lv/2010/2010_03_08_19_00/2010_03_08_19_00.mpg;Yukio HATOYAMA.jpg;12369;12413;35961;618;620;2
/net/per610a/home/mvp/mvp_db/news7-lv/2010/2010_03_08_19_00/2010_03_08_19_00.mpg;Yukio HATOYAMA.jpg;12901;13121;35961;645;656;11
/net/per610a/home/mvp/mvp_db/news7-lv/2010/2010_03_08_19_00/2010_03_08_19_00.mpg;Yukio HATOYAMA.jpg;15565;15913;35961;778;796;18
/net/per610a/home/mvp/mvp_db/news7-lv/2010/2010_03_09_19_00/2010_03_09_19_00.mpg;Katsuya OKADA.jpg;301;441;35961;15;22;7
/net/per610a/home/mvp/mvp_db/news7-lv/2010/2010_03_09_19_00/2010_03_09_19_00.mpg;Katsuya OKADA.jpg;8329;8361;35961;416;418;2
/net/per610a/home/mvp/mvp_db/news7-lv/2010/2010_03_09_19_00/2010_03_09_19_00.mpg;Katsuya OKADA.jpg;13717;14033;35961;686;702;16
/net/per610a/home/mvp/mvp_db/news7-lv/2010/2010_03_09_19_00/2010_03_09_19_00.mpg;Katsuya OKADA.jpg;8373;8753;35961;418;437;19
/net/per610a/home/mvp/mvp_db/news7-lv/2010/2010_03_09_19_00/2010_03_09_19_00.mpg;Shinzo ABE.jpg;9061;10521;35961;453;526;73
/net/per610a/home/mvp/mvp_db/news7-lv/2010/2010_03_09_19_00/2010_03_09_19_00.mpg;Yukio HATOYAMA.jpg;11173;11689;35961;558;584;26
/net/per610a/home/mvp/mvp_db/news7-lv/2010/2010_03_09_19_00/2010_03_09_19_00.mpg;Yukio HATOYAMA.jpg;14645;16085;35961;732;804;72
/net/per610a/home/mvp/mvp_db/news7-lv/2010/2010_03_10_19_00/2010_03_10_19_00.mpg;Yukio HATOYAMA.jpg;9961;11149;35961;498;557;59
/net/per610a/home/mvp/mvp_db/news7-lv/2010/2010_03_11_19_00/2010_03_11_19_00.mpg;Seiji MAEHARA.jpg;8201;8397;35961;410;420;10
/net/per610a/home/mvp/mvp_db/news7-lv/2010/2010_03_11_19_00/2010_03_11_19_00.mpg;Sadakazu TANIGAKI.jpg;15533;15973;35961;777;799;22
/net/per610a/home/mvp/mvp_db/news7-lv/2010/2010_03_12_19_00/2010_03_12_19_00.mpg;Yukio HATOYAMA.jpg;14885;15261;35961;744;763;19
/net/per610a/home/mvp/mvp_db/news7-lv/2010/2010_03_13_19_00/2010_03_13_19_00.mpg;Yukio HATOYAMA.jpg;10049;11729;35961;502;586;84
/net/per610a/home/mvp/mvp_db/news7-lv/2010/2010_03_13_19_00/2010_03_13_19_00.mpg;Yukio HATOYAMA.jpg;11893;12545;35961;594;627;33
/net/per610a/home/mvp/mvp_db/news7-lv/2010/2010_03_14_19_00/2010_03_14_19_00.mpg;Katsuya OKADA.jpg;4121;4597;35961;206;229;23
/net/per610a/home/mvp/mvp_db/news7-lv/2010/2010_03_14_19_00/2010_03_14_19_00.mpg;Katsuya OKADA.jpg;4897;5889;35961;244;294;50
/net/per610a/home/mvp/mvp_db/news7-lv/2010/2010_03_15_19_00/2010_03_15_19_00.mpg;Yukio HATOYAMA.jpg;6553;7133;35961;327;356;29
/net/per610a/home/mvp/mvp_db/news7-lv/2010/2010_03_15_19_00/2010_03_15_19_00.mpg;Seiji MAEHARA.jpg;29561;29817;35961;1478;1491;13
/net/per610a/home/mvp/mvp_db/news7-lv/2010/2010_03_16_19_00/2010_03_16_19_00.mpg;Seiji MAEHARA.jpg;2549;3353;35961;127;167;40
/net/per610a/home/mvp/mvp_db/news7-lv/2010/2010_03_17_19_00/2010_03_17_19_00.mpg;Yukio HATOYAMA.jpg;11785;11937;35961;589;597;8
/net/per610a/home/mvp/mvp_db/news7-lv/2010/2010_03_17_19_00/2010_03_17_19_00.mpg;Yukio HATOYAMA.jpg;12305;12929;35961;615;646;31
/net/per610a/home/mvp/mvp_db/news7-lv/2010/2010_03_17_19_00/2010_03_17_19_00.mpg;Shizuka KAMEI.jpg;11785;11937;35961;589;597;8
/net/per610a/home/mvp/mvp_db/news7-lv/2010/2010_03_17_19_00/2010_03_17_19_00.mpg;Katsuya OKADA.jpg;27733;28589;35961;1387;1430;43
/net/per610a/home/mvp/mvp_db/news7-lv/2010/2010_03_18_19_00/2010_03_18_19_00.mpg;Yukio HATOYAMA.jpg;16489;17053;35961;824;853;29
/net/per610a/home/mvp/mvp_db/news7-lv/2010/2010_03_18_19_00/2010_03_18_19_00.mpg;Yukio HATOYAMA.jpg;29005;30133;35961;1451;1507;56
/net/per610a/home/mvp/mvp_db/news7-lv/2010/2010_03_18_19_00/2010_03_18_19_00.mpg;Seiji MAEHARA.jpg;26877;27649;35961;1344;1383;39
/net/per610a/home/mvp/mvp_db/news7-lv/2010/2010_03_19_19_00/2010_03_19_19_00.mpg;Yukio HATOYAMA.jpg;15725;16477;35961;786;824;38
/net/per610a/home/mvp/mvp_db/news7-lv/2010/2010_03_23_19_00/2010_03_23_19_00.mpg;Ichiro OZAWA.jpg;10737;11061;35961;537;553;16
/net/per610a/home/mvp/mvp_db/news7-lv/2010/2010_03_23_19_00/2010_03_23_19_00.mpg;Yukio HATOYAMA.jpg;14969;15901;35961;748;795;47
/net/per610a/home/mvp/mvp_db/news7-lv/2010/2010_03_23_19_00/2010_03_23_19_00.mpg;Yukio HATOYAMA.jpg;16201;16709;35961;810;835;25
/net/per610a/home/mvp/mvp_db/news7-lv/2010/2010_03_23_19_00/2010_03_23_19_00.mpg;Katsuya OKADA.jpg;20285;20741;35961;1014;1037;23
/net/per610a/home/mvp/mvp_db/news7-lv/2010/2010_03_24_19_00/2010_03_24_19_00.mpg;Sadakazu TANIGAKI.jpg;285;465;35961;14;23;9
/net/per610a/home/mvp/mvp_db/news7-lv/2010/2010_03_24_19_00/2010_03_24_19_00.mpg;Sadakazu TANIGAKI.jpg;4409;4741;35961;220;237;17
/net/per610a/home/mvp/mvp_db/news7-lv/2010/2010_03_24_19_00/2010_03_24_19_00.mpg;Yukio HATOYAMA.jpg;541;561;35961;27;28;1
/net/per610a/home/mvp/mvp_db/news7-lv/2010/2010_03_24_19_00/2010_03_24_19_00.mpg;Yukio HATOYAMA.jpg;1293;1757;35961;64;87;23
/net/per610a/home/mvp/mvp_db/news7-lv/2010/2010_03_24_19_00/2010_03_24_19_00.mpg;Yukio HATOYAMA.jpg;2437;2453;35961;121;122;1
/net/per610a/home/mvp/mvp_db/news7-lv/2010/2010_03_24_19_00/2010_03_24_19_00.mpg;Yukio HATOYAMA.jpg;7069;7413;35961;353;370;17
/net/per610a/home/mvp/mvp_db/news7-lv/2010/2010_03_24_19_00/2010_03_24_19_00.mpg;Yukio HATOYAMA.jpg;2297;2361;35961;114;118;4
/net/per610a/home/mvp/mvp_db/news7-lv/2010/2010_03_24_19_00/2010_03_24_19_00.mpg;Yukio HATOYAMA.jpg;10801;11105;35961;540;555;15
/net/per610a/home/mvp/mvp_db/news7-lv/2010/2010_03_24_19_00/2010_03_24_19_00.mpg;Yukio EDANO.jpg;11757;11853;35961;588;592;4
/net/per610a/home/mvp/mvp_db/news7-lv/2010/2010_03_24_19_00/2010_03_24_19_00.mpg;Shintaro ISHIHARA.jpg;14553;14725;35961;728;736;8
/net/per610a/home/mvp/mvp_db/news7-lv/2010/2010_03_25_19_00/2010_03_25_19_00.mpg;Yukio HATOYAMA.jpg;249;601;35961;12;30;18
/net/per610a/home/mvp/mvp_db/news7-lv/2010/2010_03_25_19_00/2010_03_25_19_00.mpg;Yukio HATOYAMA.jpg;6417;6921;35961;321;346;25
/net/per610a/home/mvp/mvp_db/news7-lv/2010/2010_03_25_19_00/2010_03_25_19_00.mpg;Katsuya OKADA.jpg;5845;6149;35961;292;307;15
/net/per610a/home/mvp/mvp_db/news7-lv/2010/2010_03_26_19_00/2010_03_26_19_00.mpg;Mizuho FUKUSHIMA.jpg;12841;13225;35961;642;661;19
/net/per610a/home/mvp/mvp_db/news7-lv/2010/2010_03_26_19_00/2010_03_26_19_00.mpg;Mizuho FUKUSHIMA.jpg;22293;22845;35961;1115;1142;27
/net/per610a/home/mvp/mvp_db/news7-lv/2010/2010_03_26_19_00/2010_03_26_19_00.mpg;Katsuya OKADA.jpg;14085;14905;35961;704;745;41
/net/per610a/home/mvp/mvp_db/news7-lv/2010/2010_03_26_19_00/2010_03_26_19_00.mpg;Yukio HATOYAMA.jpg;14969;15753;35961;748;788;40
/net/per610a/home/mvp/mvp_db/news7-lv/2010/2010_03_26_19_00/2010_03_26_19_00.mpg;Yukio HATOYAMA.jpg;22857;22893;35961;1143;1145;2
/net/per610a/home/mvp/mvp_db/news7-lv/2010/2010_03_28_19_00/2010_03_28_19_00.mpg;Sadakazu TANIGAKI.jpg;12061;12581;35961;603;629;26
/net/per610a/home/mvp/mvp_db/news7-lv/2010/2010_03_29_19_00/2010_03_29_19_00.mpg;Yukio HATOYAMA.jpg;27697;28481;35961;1385;1424;39
/net/per610a/home/mvp/mvp_db/news7-lv/2010/2010_03_30_19_00/2010_03_30_19_00.mpg;Yukio HATOYAMA.jpg;1;45;35961;0;2;2
/net/per610a/home/mvp/mvp_db/news7-lv/2010/2010_03_30_19_00/2010_03_30_19_00.mpg;Yukio HATOYAMA.jpg;257;285;35961;12;14;2
/net/per610a/home/mvp/mvp_db/news7-lv/2010/2010_03_30_19_00/2010_03_30_19_00.mpg;Yukio HATOYAMA.jpg;1421;1869;35961;71;93;22
/net/per610a/home/mvp/mvp_db/news7-lv/2010/2010_03_30_19_00/2010_03_30_19_00.mpg;Yukio HATOYAMA.jpg;4733;4781;35961;236;239;3
/net/per610a/home/mvp/mvp_db/news7-lv/2010/2010_03_30_19_00/2010_03_30_19_00.mpg;Yukio HATOYAMA.jpg;5109;5593;35961;255;279;24
/net/per610a/home/mvp/mvp_db/news7-lv/2010/2010_03_30_19_00/2010_03_30_19_00.mpg;Shizuka KAMEI.jpg;2621;2753;35961;131;137;6
/net/per610a/home/mvp/mvp_db/news7-lv/2010/2010_03_30_19_00/2010_03_30_19_00.mpg;Shizuka KAMEI.jpg;4549;4637;35961;227;231;4
/net/per610a/home/mvp/mvp_db/news7-lv/2010/2010_03_30_19_00/2010_03_30_19_00.mpg;Naoto KAN.jpg;4789;4945;35961;239;247;8
/net/per610a/home/mvp/mvp_db/news7-lv/2010/2010_03_31_19_00/2010_03_31_19_00.mpg;Yukio HATOYAMA.jpg;5417;6013;35961;270;300;30
/net/per610a/home/mvp/mvp_db/news7-lv/2010/2010_03_31_19_00/2010_03_31_19_00.mpg;Katsuya OKADA.jpg;9637;10373;35961;482;518;36
/net/per610a/home/mvp/mvp_db/news7-lv/2010/2010_04_01_19_00/2010_04_01_19_00.mpg;Sadakazu TANIGAKI.jpg;17197;17693;35961;860;885;25
/net/per610a/home/mvp/mvp_db/news7-lv/2010/2010_04_01_19_00/2010_04_01_19_00.mpg;Sadakazu TANIGAKI.jpg;19061;19969;35961;953;998;45
/net/per610a/home/mvp/mvp_db/news7-lv/2010/2010_04_01_19_00/2010_04_01_19_00.mpg;Sadakazu TANIGAKI.jpg;17909;18017;35961;895;901;6
/net/per610a/home/mvp/mvp_db/news7-lv/2010/2010_04_01_19_00/2010_04_01_19_00.mpg;Sadakazu TANIGAKI.jpg;20825;21521;35961;1041;1076;35
/net/per610a/home/mvp/mvp_db/news7-lv/2010/2010_04_01_19_00/2010_04_01_19_00.mpg;Yukio HATOYAMA.jpg;28537;29357;35961;1427;1468;41
/net/per610a/home/mvp/mvp_db/news7-lv/2010/2010_04_02_19_00/2010_04_02_19_00.mpg;Yukio HATOYAMA.jpg;9325;10045;35961;466;502;36
/net/per610a/home/mvp/mvp_db/news7-lv/2010/2010_04_02_19_00/2010_04_02_19_00.mpg;Yukio HATOYAMA.jpg;18313;18837;35961;916;942;26
/net/per610a/home/mvp/mvp_db/news7-lv/2010/2010_04_02_19_00/2010_04_02_19_00.mpg;Mizuho FUKUSHIMA.jpg;10369;10981;35961;518;549;31
/net/per610a/home/mvp/mvp_db/news7-lv/2010/2010_04_02_19_00/2010_04_02_19_00.mpg;Katsuya OKADA.jpg;27153;27165;35961;1358;1358;0
/net/per610a/home/mvp/mvp_db/news7-lv/2010/2010_04_02_19_00/2010_04_02_19_00.mpg;Katsuya OKADA.jpg;27477;27697;35961;1374;1385;11
/net/per610a/home/mvp/mvp_db/news7-lv/2010/2010_04_03_19_00/2010_04_03_19_00.mpg;Sadakazu TANIGAKI.jpg;1841;1969;35961;92;98;6
/net/per610a/home/mvp/mvp_db/news7-lv/2010/2010_04_03_19_00/2010_04_03_19_00.mpg;Sadakazu TANIGAKI.jpg;6533;7073;35961;326;353;27
/net/per610a/home/mvp/mvp_db/news7-lv/2010/2010_04_04_19_00/2010_04_04_19_00.mpg;Masashi Nakano.jpg;9597;9873;35961;480;493;13
/net/per610a/home/mvp/mvp_db/news7-lv/2010/2010_04_05_19_00/2010_04_05_19_00.mpg;Takeo Hiranuma.jpeg;7333;8005;35961;366;400;34
/net/per610a/home/mvp/mvp_db/news7-lv/2010/2010_04_05_19_00/2010_04_05_19_00.mpg;Takeo Hiranuma.jpeg;9741;9937;35961;487;497;10
/net/per610a/home/mvp/mvp_db/news7-lv/2010/2010_04_05_19_00/2010_04_05_19_00.mpg;Takeo Hiranuma.jpeg;10293;10429;35961;514;521;7
/net/per610a/home/mvp/mvp_db/news7-lv/2010/2010_04_05_19_00/2010_04_05_19_00.mpg;Takeo Hiranuma.jpeg;10609;10665;35961;530;533;3
/net/per610a/home/mvp/mvp_db/news7-lv/2010/2010_04_05_19_00/2010_04_05_19_00.mpg;Takeo Hiranuma.jpeg;11781;12025;35961;589;601;12
/net/per610a/home/mvp/mvp_db/news7-lv/2010/2010_04_05_19_00/2010_04_05_19_00.mpg;Masashi Nakano.jpg;8473;8969;35961;423;448;25
/net/per610a/home/mvp/mvp_db/news7-lv/2010/2010_04_06_19_00/2010_04_06_19_00.mpg;Yukio HATOYAMA.jpg;13885;14281;35961;694;714;20
/net/per610a/home/mvp/mvp_db/news7-lv/2010/2010_04_07_19_00/2010_04_07_19_00.mpg;Katsuya OKADA.jpg;12237;12853;35961;612;642;30
/net/per610a/home/mvp/mvp_db/news7-lv/2010/2010_04_07_19_00/2010_04_07_19_00.mpg;Yukio HATOYAMA.jpg;15269;16177;35961;763;809;46
/net/per610a/home/mvp/mvp_db/news7-lv/2010/2010_04_08_19_00/2010_04_08_19_00.mpg;Yukio HATOYAMA.jpg;12745;13125;35961;637;656;19
/net/per610a/home/mvp/mvp_db/news7-lv/2010/2010_04_09_19_00/2010_04_09_19_00.mpg;Seiji MAEHARA.jpg;12593;13181;35961;629;659;30
/net/per610a/home/mvp/mvp_db/news7-lv/2010/2010_04_09_19_00/2010_04_09_19_00.mpg;Yukio HATOYAMA.jpg;24949;25205;35961;1248;1260;12
/net/per610a/home/mvp/mvp_db/news7-lv/2010/2010_04_09_19_00/2010_04_09_19_00.mpg;Katsuya OKADA.jpg;28273;28653;35961;1414;1433;19
/net/per610a/home/mvp/mvp_db/news7-lv/2010/2010_04_10_19_00/2010_04_10_19_00.mpg;Takeo Hiranuma.jpeg;117;173;35961;5;8;3
/net/per610a/home/mvp/mvp_db/news7-lv/2010/2010_04_10_19_00/2010_04_10_19_00.mpg;Takeo Hiranuma.jpeg;3621;3673;35961;181;183;2
/net/per610a/home/mvp/mvp_db/news7-lv/2010/2010_04_10_19_00/2010_04_10_19_00.mpg;Takeo Hiranuma.jpeg;3801;3801;35961;190;190;0
/net/per610a/home/mvp/mvp_db/news7-lv/2010/2010_04_10_19_00/2010_04_10_19_00.mpg;Takeo Hiranuma.jpeg;7861;8081;35961;393;404;11
/net/per610a/home/mvp/mvp_db/news7-lv/2010/2010_04_10_19_00/2010_04_10_19_00.mpg;Shintaro ISHIHARA.jpg;225;457;35961;11;22;11
/net/per610a/home/mvp/mvp_db/news7-lv/2010/2010_04_10_19_00/2010_04_10_19_00.mpg;Shintaro ISHIHARA.jpg;3057;3569;35961;152;178;26
/net/per610a/home/mvp/mvp_db/news7-lv/2010/2010_04_10_19_00/2010_04_10_19_00.mpg;Shintaro ISHIHARA.jpg;8329;8557;35961;416;428;12
/net/per610a/home/mvp/mvp_db/news7-lv/2010/2010_04_10_19_00/2010_04_10_19_00.mpg;Sadakazu TANIGAKI.jpg;5673;6913;35961;283;345;62
/net/per610a/home/mvp/mvp_db/news7-lv/2010/2010_04_10_19_00/2010_04_10_19_00.mpg;Katsuya OKADA.jpg;12793;13129;35961;639;656;17
/net/per610a/home/mvp/mvp_db/news7-lv/2010/2010_04_10_19_00/2010_04_10_19_00.mpg;Katsuya OKADA.jpg;13265;13445;35961;663;672;9
/net/per610a/home/mvp/mvp_db/news7-lv/2010/2010_04_10_19_00/2010_04_10_19_00.mpg;Katsuya OKADA.jpg;13897;15253;35961;695;763;68
/net/per610a/home/mvp/mvp_db/news7-lv/2010/2010_04_10_19_00/2010_04_10_19_00.mpg;Yukio HATOYAMA.jpg;13265;13445;35961;663;672;9
/net/per610a/home/mvp/mvp_db/news7-lv/2010/2010_04_10_19_00/2010_04_10_19_00.mpg;Yukio HATOYAMA.jpg;16801;17413;35961;840;871;31
/net/per610a/home/mvp/mvp_db/news7-lv/2010/2010_04_11_19_00/2010_04_11_19_00.mpg;Katsuya OKADA.jpg;6733;7149;35961;336;357;21
/net/per610a/home/mvp/mvp_db/news7-lv/2010/2010_04_12_19_00/2010_04_12_19_00.mpg;Yukio HATOYAMA.jpg;9245;9553;35961;462;477;15
/net/per610a/home/mvp/mvp_db/news7-lv/2010/2010_04_12_19_00/2010_04_12_19_00.mpg;Yukio HATOYAMA.jpg;9933;10113;35961;496;505;9
/net/per610a/home/mvp/mvp_db/news7-lv/2010/2010_04_12_19_00/2010_04_12_19_00.mpg;Yukio HATOYAMA.jpg;10593;10669;35961;529;533;4
/net/per610a/home/mvp/mvp_db/news7-lv/2010/2010_04_12_19_00/2010_04_12_19_00.mpg;Yukio HATOYAMA.jpg;10805;11009;35961;540;550;10
/net/per610a/home/mvp/mvp_db/news7-lv/2010/2010_04_12_19_00/2010_04_12_19_00.mpg;Yukio HATOYAMA.jpg;13633;13657;35961;682;683;1
/net/per610a/home/mvp/mvp_db/news7-lv/2010/2010_04_12_19_00/2010_04_12_19_00.mpg;Yukio HATOYAMA.jpg;12357;13205;35961;618;660;42
/net/per610a/home/mvp/mvp_db/news7-lv/2010/2010_04_12_19_00/2010_04_12_19_00.mpg;Ichiro OZAWA.jpg;13217;13593;35961;661;680;19
/net/per610a/home/mvp/mvp_db/news7-lv/2010/2010_04_13_19_00/2010_04_13_19_00.mpg;Yukio HATOYAMA.jpg;9181;9249;35961;459;462;3
/net/per610a/home/mvp/mvp_db/news7-lv/2010/2010_04_13_19_00/2010_04_13_19_00.mpg;Yukio HATOYAMA.jpg;10165;10997;35961;508;550;42
/net/per610a/home/mvp/mvp_db/news7-lv/2010/2010_04_13_19_00/2010_04_13_19_00.mpg;Yukio HATOYAMA.jpg;11085;11625;35961;554;581;27
/net/per610a/home/mvp/mvp_db/news7-lv/2010/2010_04_13_19_00/2010_04_13_19_00.mpg;Yukio HATOYAMA.jpg;9785;9785;35961;489;489;0
/net/per610a/home/mvp/mvp_db/news7-lv/2010/2010_04_13_19_00/2010_04_13_19_00.mpg;Yukio HATOYAMA.jpg;9881;9989;35961;494;499;5
/net/per610a/home/mvp/mvp_db/news7-lv/2010/2010_04_15_19_00/2010_04_15_19_00.mpg;Yukio HATOYAMA.jpg;8401;9173;35961;420;458;38
/net/per610a/home/mvp/mvp_db/news7-lv/2010/2010_04_15_19_00/2010_04_15_19_00.mpg;Yukio HATOYAMA.jpg;9293;10109;35961;464;505;41
/net/per610a/home/mvp/mvp_db/news7-lv/2010/2010_04_15_19_00/2010_04_15_19_00.mpg;Yukio HATOYAMA.jpg;13577;13869;35961;679;693;14
/net/per610a/home/mvp/mvp_db/news7-lv/2010/2010_04_16_19_00/2010_04_16_19_00.mpg;Yukio HATOYAMA.jpg;18357;18409;35961;918;920;2
/net/per610a/home/mvp/mvp_db/news7-lv/2010/2010_04_16_19_00/2010_04_16_19_00.mpg;Yukio HATOYAMA.jpg;18501;18605;35961;925;930;5
/net/per610a/home/mvp/mvp_db/news7-lv/2010/2010_04_18_19_00/2010_04_18_19_00.mpg;Yukio HATOYAMA.jpg;3509;3985;35961;175;199;24
/net/per610a/home/mvp/mvp_db/news7-lv/2010/2010_04_18_19_00/2010_04_18_19_00.mpg;Natsuo YAMAGUCHI.jpg;25105;25269;35961;1255;1264;9
/net/per610a/home/mvp/mvp_db/news7-lv/2010/2010_04_20_19_00/2010_04_20_19_00.mpg;Yukio EDANO.jpg;517;593;35961;25;29;4
/net/per610a/home/mvp/mvp_db/news7-lv/2010/2010_04_20_19_00/2010_04_20_19_00.mpg;Yukio EDANO.jpg;6137;6269;35961;307;313;6
/net/per610a/home/mvp/mvp_db/news7-lv/2010/2010_04_20_19_00/2010_04_20_19_00.mpg;Yukio EDANO.jpg;7561;7949;35961;378;397;19
/net/per610a/home/mvp/mvp_db/news7-lv/2010/2010_04_20_19_00/2010_04_20_19_00.mpg;Yukio HATOYAMA.jpg;1805;2121;35961;90;106;16
/net/per610a/home/mvp/mvp_db/news7-lv/2010/2010_04_20_19_00/2010_04_20_19_00.mpg;Yukio HATOYAMA.jpg;4765;5721;35961;238;286;48
/net/per610a/home/mvp/mvp_db/news7-lv/2010/2010_04_20_19_00/2010_04_20_19_00.mpg;Renho.jpg;6277;6325;35961;314;316;2
/net/per610a/home/mvp/mvp_db/news7-lv/2010/2010_04_20_19_00/2010_04_20_19_00.mpg;Renho.jpg;7713;7757;35961;385;388;3
/net/per610a/home/mvp/mvp_db/news7-lv/2010/2010_04_20_19_00/2010_04_20_19_00.mpg;Renho.jpg;7997;8233;35961;400;411;11
/net/per610a/home/mvp/mvp_db/news7-lv/2010/2010_04_20_19_00/2010_04_20_19_00.mpg;Shizuka KAMEI.jpg;31141;31477;35961;1557;1574;17
/net/per610a/home/mvp/mvp_db/news7-lv/2010/2010_04_21_19_00/2010_04_21_19_00.mpg;Yukio HATOYAMA.jpg;6041;6461;35961;302;323;21
/net/per610a/home/mvp/mvp_db/news7-lv/2010/2010_04_21_19_00/2010_04_21_19_00.mpg;Yukio HATOYAMA.jpg;28721;28873;35961;1436;1444;8
/net/per610a/home/mvp/mvp_db/news7-lv/2010/2010_04_22_19_00/2010_04_22_19_00.mpg;Yukio HATOYAMA.jpg;4633;4973;35961;231;248;17
/net/per610a/home/mvp/mvp_db/news7-lv/2010/2010_04_22_19_00/2010_04_22_19_00.mpg;Yukio HATOYAMA.jpg;5073;5149;35961;253;257;4
/net/per610a/home/mvp/mvp_db/news7-lv/2010/2010_04_22_19_00/2010_04_22_19_00.mpg;Ichiro OZAWA.jpg;5101;5209;35961;255;260;5
/net/per610a/home/mvp/mvp_db/news7-lv/2010/2010_04_22_19_00/2010_04_22_19_00.mpg;Ichiro OZAWA.jpg;6261;6625;35961;313;331;18
/net/per610a/home/mvp/mvp_db/news7-lv/2010/2010_04_22_19_00/2010_04_22_19_00.mpg;Ichiro OZAWA.jpg;5529;5565;35961;276;278;2
/net/per610a/home/mvp/mvp_db/news7-lv/2010/2010_04_22_19_00/2010_04_22_19_00.mpg;Seiji MAEHARA.jpg;5793;6257;35961;289;313;24
/net/per610a/home/mvp/mvp_db/news7-lv/2010/2010_04_22_19_00/2010_04_22_19_00.mpg;Sadakazu TANIGAKI.jpg;7261;7801;35961;363;390;27
/net/per610a/home/mvp/mvp_db/news7-lv/2010/2010_04_23_19_00/2010_04_23_19_00.mpg;Yukio HATOYAMA.jpg;2333;2529;35961;116;126;10
/net/per610a/home/mvp/mvp_db/news7-lv/2010/2010_04_23_19_00/2010_04_23_19_00.mpg;Seiji MAEHARA.jpg;9825;10353;35961;491;517;26
/net/per610a/home/mvp/mvp_db/news7-lv/2010/2010_04_23_19_00/2010_04_23_19_00.mpg;Seiji MAEHARA.jpg;10521;10717;35961;526;536;10
/net/per610a/home/mvp/mvp_db/news7-lv/2010/2010_04_23_19_00/2010_04_23_19_00.mpg;Seiji MAEHARA.jpg;12105;13689;35961;605;684;79
/net/per610a/home/mvp/mvp_db/news7-lv/2010/2010_04_23_19_00/2010_04_23_19_00.mpg;Ichiro OZAWA.jpg;11417;12009;35961;571;600;29
/net/per610a/home/mvp/mvp_db/news7-lv/2010/2010_04_23_19_00/2010_04_23_19_00.mpg;Ichiro OZAWA.jpg;29645;30081;35961;1483;1504;21
/net/per610a/home/mvp/mvp_db/news7-lv/2010/2010_04_24_19_00/2010_04_24_19_00.mpg;Yukio HATOYAMA.jpg;1113;1445;35961;55;72;17
/net/per610a/home/mvp/mvp_db/news7-lv/2010/2010_04_24_19_00/2010_04_24_19_00.mpg;Yukio HATOYAMA.jpg;6189;7041;35961;309;352;43
/net/per610a/home/mvp/mvp_db/news7-lv/2010/2010_04_25_19_00/2010_04_25_19_00.mpg;Seiji MAEHARA.jpg;9797;9845;35961;490;492;2
/net/per610a/home/mvp/mvp_db/news7-lv/2010/2010_04_25_19_00/2010_04_25_19_00.mpg;Seiji MAEHARA.jpg;9909;9933;35961;495;496;1
/net/per610a/home/mvp/mvp_db/news7-lv/2010/2010_04_25_19_00/2010_04_25_19_00.mpg;Seiji MAEHARA.jpg;12697;12861;35961;635;643;8
/net/per610a/home/mvp/mvp_db/news7-lv/2010/2010_04_26_19_00/2010_04_26_19_00.mpg;Yukio HATOYAMA.jpg;273;373;35961;13;18;5
/net/per610a/home/mvp/mvp_db/news7-lv/2010/2010_04_26_19_00/2010_04_26_19_00.mpg;Yukio HATOYAMA.jpg;1841;2117;35961;92;105;13
/net/per610a/home/mvp/mvp_db/news7-lv/2010/2010_04_26_19_00/2010_04_26_19_00.mpg;Yukio HATOYAMA.jpg;3377;3477;35961;168;173;5
/net/per610a/home/mvp/mvp_db/news7-lv/2010/2010_04_26_19_00/2010_04_26_19_00.mpg;Yukio HATOYAMA.jpg;4801;5289;35961;240;264;24
/net/per610a/home/mvp/mvp_db/news7-lv/2010/2010_04_26_19_00/2010_04_26_19_00.mpg;Yukio HATOYAMA.jpg;11793;12177;35961;589;609;20
/net/per610a/home/mvp/mvp_db/news7-lv/2010/2010_04_26_19_00/2010_04_26_19_00.mpg;Yukio EDANO.jpg;14949;15229;35961;747;761;14
/net/per610a/home/mvp/mvp_db/news7-lv/2010/2010_04_26_19_00/2010_04_26_19_00.mpg;Kazuo SHII.jpg;27301;27553;35961;1365;1378;13
/net/per610a/home/mvp/mvp_db/news7-lv/2010/2010_04_27_19_00/2010_04_27_19_00.mpg;Ichiro OZAWA.jpg;2801;3193;35961;140;159;19
/net/per610a/home/mvp/mvp_db/news7-lv/2010/2010_04_27_19_00/2010_04_27_19_00.mpg;Ichiro OZAWA.jpg;19345;20625;35961;967;1031;64
/net/per610a/home/mvp/mvp_db/news7-lv/2010/2010_04_27_19_00/2010_04_27_19_00.mpg;Yukio HATOYAMA.jpg;12145;12797;35961;607;640;33
/net/per610a/home/mvp/mvp_db/news7-lv/2010/2010_04_28_19_00/2010_04_28_19_00.mpg;Yukio HATOYAMA.jpg;253;657;35961;12;32;20
/net/per610a/home/mvp/mvp_db/news7-lv/2010/2010_04_28_19_00/2010_04_28_19_00.mpg;Yukio HATOYAMA.jpg;1241;1905;35961;62;95;33
/net/per610a/home/mvp/mvp_db/news7-lv/2010/2010_04_28_19_00/2010_04_28_19_00.mpg;Yukio HATOYAMA.jpg;2485;2537;35961;124;126;2
/net/per610a/home/mvp/mvp_db/news7-lv/2010/2010_04_28_19_00/2010_04_28_19_00.mpg;Yukio HATOYAMA.jpg;2969;3533;35961;148;176;28
/net/per610a/home/mvp/mvp_db/news7-lv/2010/2010_04_28_19_00/2010_04_28_19_00.mpg;Yukio HATOYAMA.jpg;10077;10369;35961;504;518;14
/net/per610a/home/mvp/mvp_db/news7-lv/2010/2010_04_28_19_00/2010_04_28_19_00.mpg;Yukio HATOYAMA.jpg;10757;11005;35961;538;550;12
/net/per610a/home/mvp/mvp_db/news7-lv/2010/2010_04_30_19_00/2010_04_30_19_00.mpg;Yukio HATOYAMA.jpg;7785;8241;35961;389;412;23
/net/per610a/home/mvp/mvp_db/news7-lv/2010/2010_04_30_19_00/2010_04_30_19_00.mpg;Yukio HATOYAMA.jpg;12133;12857;35961;606;643;37
/net/per610a/home/mvp/mvp_db/news7-lv/2010/2010_04_30_19_00/2010_04_30_19_00.mpg;Yukio HATOYAMA.jpg;26457;27121;35961;1323;1356;33
/net/per610a/home/mvp/mvp_db/news7-lv/2010/2010_05_01_19_00/2010_05_01_19_00.mpg;Yukio HATOYAMA.jpg;1509;1601;35961;75;80;5
/net/per610a/home/mvp/mvp_db/news7-lv/2010/2010_05_01_19_00/2010_05_01_19_00.mpg;Yukio HATOYAMA.jpg;9889;10109;35961;494;505;11
/net/per610a/home/mvp/mvp_db/news7-lv/2010/2010_05_02_19_00/2010_05_02_19_00.mpg;Yukio HATOYAMA.jpg;10381;10817;35961;519;541;22
/net/per610a/home/mvp/mvp_db/news7-lv/2010/2010_05_02_19_00/2010_05_02_19_00.mpg;Yukio HATOYAMA.jpg;12205;12441;35961;610;622;12
/net/per610a/home/mvp/mvp_db/news7-lv/2010/2010_05_02_19_00/2010_05_02_19_00.mpg;Yukio HATOYAMA.jpg;12985;13581;35961;649;679;30
/net/per610a/home/mvp/mvp_db/news7-lv/2010/2010_05_03_19_00/2010_05_03_19_00.mpg;Mizuho FUKUSHIMA.jpg;21037;21037;35961;1052;1052;0
/net/per610a/home/mvp/mvp_db/news7-lv/2010/2010_05_03_19_00/2010_05_03_19_00.mpg;Mizuho FUKUSHIMA.jpg;21101;21565;35961;1055;1078;23
/net/per610a/home/mvp/mvp_db/news7-lv/2010/2010_05_04_19_00/2010_05_04_19_00.mpg;Yukio HATOYAMA.jpg;305;453;35961;15;22;7
/net/per610a/home/mvp/mvp_db/news7-lv/2010/2010_05_04_19_00/2010_05_04_19_00.mpg;Yukio HATOYAMA.jpg;1541;1545;35961;77;77;0
/net/per610a/home/mvp/mvp_db/news7-lv/2010/2010_05_04_19_00/2010_05_04_19_00.mpg;Yukio HATOYAMA.jpg;17321;19257;35961;866;963;97
/net/per610a/home/mvp/mvp_db/news7-lv/2010/2010_05_04_19_00/2010_05_04_19_00.mpg;Yukio HATOYAMA.jpg;1733;1877;35961;86;93;7
/net/per610a/home/mvp/mvp_db/news7-lv/2010/2010_05_04_19_00/2010_05_04_19_00.mpg;Yorihisa Matsuno.png;17397;17397;35961;870;870;0
/net/per610a/home/mvp/mvp_db/news7-lv/2010/2010_05_04_19_00/2010_05_04_19_00.mpg;Yorihisa Matsuno.png;18289;18553;35961;914;928;14
/net/per610a/home/mvp/mvp_db/news7-lv/2010/2010_05_06_19_00/2010_05_06_19_00.mpg;Yukio HATOYAMA.jpg;8289;8949;35961;414;447;33
/net/per610a/home/mvp/mvp_db/news7-lv/2010/2010_05_07_19_00/2010_05_07_19_00.mpg;Yukio HATOYAMA.jpg;181;309;35961;9;15;6
/net/per610a/home/mvp/mvp_db/news7-lv/2010/2010_05_07_19_00/2010_05_07_19_00.mpg;Yukio HATOYAMA.jpg;1341;1361;35961;67;68;1
/net/per610a/home/mvp/mvp_db/news7-lv/2010/2010_05_07_19_00/2010_05_07_19_00.mpg;Yukio HATOYAMA.jpg;3397;3533;35961;169;176;7
/net/per610a/home/mvp/mvp_db/news7-lv/2010/2010_05_07_19_00/2010_05_07_19_00.mpg;Yukio HATOYAMA.jpg;4097;4305;35961;204;215;11
/net/per610a/home/mvp/mvp_db/news7-lv/2010/2010_05_07_19_00/2010_05_07_19_00.mpg;Yukio HATOYAMA.jpg;5817;5865;35961;291;293;2
/net/per610a/home/mvp/mvp_db/news7-lv/2010/2010_05_07_19_00/2010_05_07_19_00.mpg;Yukio HATOYAMA.jpg;10545;11197;35961;527;560;33
/net/per610a/home/mvp/mvp_db/news7-lv/2010/2010_05_07_19_00/2010_05_07_19_00.mpg;Yukio HATOYAMA.jpg;4961;5197;35961;248;259;11
/net/per610a/home/mvp/mvp_db/news7-lv/2010/2010_05_08_19_00/2010_05_08_19_00.mpg;Yukio HATOYAMA.jpg;453;637;35961;22;31;9
/net/per610a/home/mvp/mvp_db/news7-lv/2010/2010_05_08_19_00/2010_05_08_19_00.mpg;Yukio HATOYAMA.jpg;3181;3241;35961;159;162;3
/net/per610a/home/mvp/mvp_db/news7-lv/2010/2010_05_08_19_00/2010_05_08_19_00.mpg;Yukio HATOYAMA.jpg;7605;7749;35961;380;387;7
/net/per610a/home/mvp/mvp_db/news7-lv/2010/2010_05_08_19_00/2010_05_08_19_00.mpg;Sadakazu TANIGAKI.jpg;6857;7453;35961;343;372;29
/net/per610a/home/mvp/mvp_db/news7-lv/2010/2010_05_09_19_00/2010_05_09_19_00.mpg;Seiji MAEHARA.jpg;4817;5237;35961;240;261;21
/net/per610a/home/mvp/mvp_db/news7-lv/2010/2010_05_10_19_00/2010_05_10_19_00.mpg;Yukio HATOYAMA.jpg;1;165;35961;0;8;8
/net/per610a/home/mvp/mvp_db/news7-lv/2010/2010_05_10_19_00/2010_05_10_19_00.mpg;Yukio HATOYAMA.jpg;1465;1841;35961;73;92;19
/net/per610a/home/mvp/mvp_db/news7-lv/2010/2010_05_10_19_00/2010_05_10_19_00.mpg;Yukio HATOYAMA.jpg;4913;5593;35961;245;279;34
/net/per610a/home/mvp/mvp_db/news7-lv/2010/2010_05_10_19_00/2010_05_10_19_00.mpg;Yukio HATOYAMA.jpg;6409;6469;35961;320;323;3
/net/per610a/home/mvp/mvp_db/news7-lv/2010/2010_05_10_19_00/2010_05_10_19_00.mpg;Yukio HATOYAMA.jpg;9001;9397;35961;450;470;20
/net/per610a/home/mvp/mvp_db/news7-lv/2010/2010_05_10_19_00/2010_05_10_19_00.mpg;Ichiro OZAWA.jpg;9469;10161;35961;473;508;35
/net/per610a/home/mvp/mvp_db/news7-lv/2010/2010_05_11_19_00/2010_05_11_19_00.mpg;Shizuka KAMEI.jpg;10089;10609;35961;504;530;26
/net/per610a/home/mvp/mvp_db/news7-lv/2010/2010_05_12_19_00/2010_05_12_19_00.mpg;Ichiro OZAWA.jpg;6989;7013;35961;349;350;1
/net/per610a/home/mvp/mvp_db/news7-lv/2010/2010_05_12_19_00/2010_05_12_19_00.mpg;Ichiro OZAWA.jpg;7157;7481;35961;358;374;16
/net/per610a/home/mvp/mvp_db/news7-lv/2010/2010_05_13_19_00/2010_05_13_19_00.mpg;Ichiro OZAWA.jpg;33;65;35961;1;3;2
/net/per610a/home/mvp/mvp_db/news7-lv/2010/2010_05_13_19_00/2010_05_13_19_00.mpg;Ichiro OZAWA.jpg;1489;1829;35961;74;91;17
/net/per610a/home/mvp/mvp_db/news7-lv/2010/2010_05_13_19_00/2010_05_13_19_00.mpg;Ichiro OZAWA.jpg;1969;2813;35961;98;140;42
/net/per610a/home/mvp/mvp_db/news7-lv/2010/2010_05_14_19_00/2010_05_14_19_00.mpg;Ichiro OZAWA.jpg;16981;17445;35961;849;872;23
/net/per610a/home/mvp/mvp_db/news7-lv/2010/2010_05_14_19_00/2010_05_14_19_00.mpg;Ichiro OZAWA.jpg;17925;18489;35961;896;924;28
/net/per610a/home/mvp/mvp_db/news7-lv/2010/2010_05_14_19_00/2010_05_14_19_00.mpg;Seiji MAEHARA.jpg;19721;20025;35961;986;1001;15
/net/per610a/home/mvp/mvp_db/news7-lv/2010/2010_05_16_19_00/2010_05_16_19_00.mpg;Yukio HATOYAMA.jpg;6609;6773;35961;330;338;8
/net/per610a/home/mvp/mvp_db/news7-lv/2010/2010_05_17_19_00/2010_05_17_19_00.mpg;Yukio HATOYAMA.jpg;309;485;35961;15;24;9
/net/per610a/home/mvp/mvp_db/news7-lv/2010/2010_05_17_19_00/2010_05_17_19_00.mpg;Yukio HATOYAMA.jpg;6825;7253;35961;341;362;21
/net/per610a/home/mvp/mvp_db/news7-lv/2010/2010_05_17_19_00/2010_05_17_19_00.mpg;Yukio HATOYAMA.jpg;8489;8841;35961;424;442;18
/net/per610a/home/mvp/mvp_db/news7-lv/2010/2010_05_17_19_00/2010_05_17_19_00.mpg;Yukio HATOYAMA.jpg;15025;16505;35961;751;825;74
/net/per610a/home/mvp/mvp_db/news7-lv/2010/2010_05_17_19_00/2010_05_17_19_00.mpg;Ichiro OZAWA.jpg;1209;1685;35961;60;84;24
/net/per610a/home/mvp/mvp_db/news7-lv/2010/2010_05_17_19_00/2010_05_17_19_00.mpg;Ichiro OZAWA.jpg;5261;5813;35961;263;290;27
/net/per610a/home/mvp/mvp_db/news7-lv/2010/2010_05_17_19_00/2010_05_17_19_00.mpg;Ichiro OZAWA.jpg;3777;4193;35961;188;209;21
/net/per610a/home/mvp/mvp_db/news7-lv/2010/2010_05_17_19_00/2010_05_17_19_00.mpg;Yukio HATOYAMA.jpg;18633;19325;35961;932;966;34
/net/per610a/home/mvp/mvp_db/news7-lv/2010/2010_05_18_19_00/2010_05_18_19_00.mpg;Yukio HATOYAMA.jpg;10105;11121;35961;505;556;51
/net/per610a/home/mvp/mvp_db/news7-lv/2010/2010_05_18_19_00/2010_05_18_19_00.mpg;Yukio HATOYAMA.jpg;15477;15817;35961;774;791;17
/net/per610a/home/mvp/mvp_db/news7-lv/2010/2010_05_18_19_00/2010_05_18_19_00.mpg;Yukio EDANO.jpg;20809;21025;35961;1040;1051;11
/net/per610a/home/mvp/mvp_db/news7-lv/2010/2010_05_18_19_00/2010_05_18_19_00.mpg;Yukio EDANO.jpg;22125;22177;35961;1106;1109;3
/net/per610a/home/mvp/mvp_db/news7-lv/2010/2010_05_19_19_00/2010_05_19_19_00.mpg;Yukio HATOYAMA.jpg;3097;3341;35961;154;167;13
/net/per610a/home/mvp/mvp_db/news7-lv/2010/2010_05_20_19_00/2010_05_20_19_00.mpg;Yukio HATOYAMA.jpg;7553;8217;35961;377;411;34
/net/per610a/home/mvp/mvp_db/news7-lv/2010/2010_05_20_19_00/2010_05_20_19_00.mpg;Ichiro OZAWA.jpg;23249;23497;35961;1163;1175;12
/net/per610a/home/mvp/mvp_db/news7-lv/2010/2010_05_21_19_00/2010_05_21_19_00.mpg;Yukio HATOYAMA.jpg;7705;8145;35961;385;407;22
/net/per610a/home/mvp/mvp_db/news7-lv/2010/2010_05_21_19_00/2010_05_21_19_00.mpg;Yukio HATOYAMA.jpg;19481;19785;35961;974;989;15
/net/per610a/home/mvp/mvp_db/news7-lv/2010/2010_05_21_19_00/2010_05_21_19_00.mpg;Ichiro OZAWA.jpg;8873;9393;35961;443;469;26
/net/per610a/home/mvp/mvp_db/news7-lv/2010/2010_05_21_19_00/2010_05_21_19_00.mpg;Ichiro OZAWA.jpg;9805;10145;35961;490;507;17
/net/per610a/home/mvp/mvp_db/news7-lv/2010/2010_05_21_19_00/2010_05_21_19_00.mpg;Naoto KAN.jpg;19561;19785;35961;978;989;11
/net/per610a/home/mvp/mvp_db/news7-lv/2010/2010_05_22_19_00/2010_05_22_19_00.mpg;Yukio HATOYAMA.jpg;1789;2601;35961;89;130;41
/net/per610a/home/mvp/mvp_db/news7-lv/2010/2010_05_23_19_00/2010_05_23_19_00.mpg;Yukio HATOYAMA.jpg;2681;2737;35961;134;136;2
/net/per610a/home/mvp/mvp_db/news7-lv/2010/2010_05_23_19_00/2010_05_23_19_00.mpg;Yukio HATOYAMA.jpg;11261;11985;35961;563;599;36
/net/per610a/home/mvp/mvp_db/news7-lv/2010/2010_05_23_19_00/2010_05_23_19_00.mpg;Yukio HATOYAMA.jpg;18793;19245;35961;940;962;22
/net/per610a/home/mvp/mvp_db/news7-lv/2010/2010_05_23_19_00/2010_05_23_19_00.mpg;Yorihisa Matsuno.png;18793;19105;35961;940;955;15
/net/per610a/home/mvp/mvp_db/news7-lv/2010/2010_05_24_19_00/2010_05_24_19_00.mpg;Yukio HATOYAMA.jpg;2133;2581;35961;106;129;23
/net/per610a/home/mvp/mvp_db/news7-lv/2010/2010_05_24_19_00/2010_05_24_19_00.mpg;Yukio HATOYAMA.jpg;8393;8397;35961;419;420;1
/net/per610a/home/mvp/mvp_db/news7-lv/2010/2010_05_24_19_00/2010_05_24_19_00.mpg;Yukio HATOYAMA.jpg;15885;16265;35961;794;813;19
/net/per610a/home/mvp/mvp_db/news7-lv/2010/2010_05_24_19_00/2010_05_24_19_00.mpg;Ichiro OZAWA.jpg;6173;6509;35961;308;325;17
/net/per610a/home/mvp/mvp_db/news7-lv/2010/2010_05_24_19_00/2010_05_24_19_00.mpg;Sadakazu TANIGAKI.jpg;6613;7021;35961;330;351;21
/net/per610a/home/mvp/mvp_db/news7-lv/2010/2010_05_24_19_00/2010_05_24_19_00.mpg;Sadakazu TANIGAKI.jpg;7085;7289;35961;354;364;10
/net/per610a/home/mvp/mvp_db/news7-lv/2010/2010_05_25_19_00/2010_05_25_19_00.mpg;Yukio HATOYAMA.jpg;7869;8069;35961;393;403;10
/net/per610a/home/mvp/mvp_db/news7-lv/2010/2010_05_25_19_00/2010_05_25_19_00.mpg;Masashi Nakano.jpg;31001;31097;35961;1550;1555;5
/net/per610a/home/mvp/mvp_db/news7-lv/2010/2010_05_26_19_00/2010_05_26_19_00.mpg;Yukio HATOYAMA.jpg;1121;1589;35961;56;79;23
/net/per610a/home/mvp/mvp_db/news7-lv/2010/2010_05_26_19_00/2010_05_26_19_00.mpg;Yukio HATOYAMA.jpg;7893;8241;35961;394;412;18
/net/per610a/home/mvp/mvp_db/news7-lv/2010/2010_05_27_19_00/2010_05_27_19_00.mpg;Yukio HATOYAMA.jpg;1209;1761;35961;60;88;28
/net/per610a/home/mvp/mvp_db/news7-lv/2010/2010_05_27_19_00/2010_05_27_19_00.mpg;Kenji Eda.jpg;4133;4197;35961;206;209;3
/net/per610a/home/mvp/mvp_db/news7-lv/2010/2010_05_27_19_00/2010_05_27_19_00.mpg;Kenji Eda.jpg;4305;4541;35961;215;227;12
/net/per610a/home/mvp/mvp_db/news7-lv/2010/2010_05_27_19_00/2010_05_27_19_00.mpg;Taro ASO.jpg;5777;5921;35961;289;296;7
/net/per610a/home/mvp/mvp_db/news7-lv/2010/2010_05_28_19_00/2010_05_28_19_00.mpg;Natsuo YAMAGUCHI.jpg;11349;12441;35961;567;622;55
/net/per610a/home/mvp/mvp_db/news7-lv/2010/2010_05_28_19_00/2010_05_28_19_00.mpg;Yukio HATOYAMA.jpg;22973;23057;35961;1149;1153;4
/net/per610a/home/mvp/mvp_db/news7-lv/2010/2010_05_28_19_00/2010_05_28_19_00.mpg;Yukio HATOYAMA.jpg;23969;24533;35961;1199;1227;28
/net/per610a/home/mvp/mvp_db/news7-lv/2010/2010_05_28_19_00/2010_05_28_19_00.mpg;Yukio HATOYAMA.jpg;24625;24837;35961;1231;1242;11
/net/per610a/home/mvp/mvp_db/news7-lv/2010/2010_05_29_19_00/2010_05_29_19_00.mpg;Yukio HATOYAMA.jpg;1681;1681;35961;84;84;0
/net/per610a/home/mvp/mvp_db/news7-lv/2010/2010_05_29_19_00/2010_05_29_19_00.mpg;Yukio HATOYAMA.jpg;1785;2017;35961;89;100;11
/net/per610a/home/mvp/mvp_db/news7-lv/2010/2010_05_29_19_00/2010_05_29_19_00.mpg;Yukio HATOYAMA.jpg;3073;3093;35961;153;154;1
/net/per610a/home/mvp/mvp_db/news7-lv/2010/2010_05_29_19_00/2010_05_29_19_00.mpg;Yukio HATOYAMA.jpg;4417;4453;35961;220;222;2
/net/per610a/home/mvp/mvp_db/news7-lv/2010/2010_05_29_19_00/2010_05_29_19_00.mpg;Yukio HATOYAMA.jpg;5409;5737;35961;270;287;17
/net/per610a/home/mvp/mvp_db/news7-lv/2010/2010_05_29_19_00/2010_05_29_19_00.mpg;Yukio HATOYAMA.jpg;10237;10785;35961;512;539;27
/net/per610a/home/mvp/mvp_db/news7-lv/2010/2010_05_29_19_00/2010_05_29_19_00.mpg;Yukio HATOYAMA.jpg;14377;14801;35961;719;740;21
/net/per610a/home/mvp/mvp_db/news7-lv/2010/2010_05_30_19_00/2010_05_30_19_00.mpg;Mizuho FUKUSHIMA.jpg;2429;2637;35961;121;131;10
/net/per610a/home/mvp/mvp_db/news7-lv/2010/2010_05_30_19_00/2010_05_30_19_00.mpg;Mizuho FUKUSHIMA.jpg;4241;4489;35961;212;224;12
/net/per610a/home/mvp/mvp_db/news7-lv/2010/2010_05_30_19_00/2010_05_30_19_00.mpg;Mizuho FUKUSHIMA.jpg;5405;6053;35961;270;302;32
/net/per610a/home/mvp/mvp_db/news7-lv/2010/2010_05_30_19_00/2010_05_30_19_00.mpg;Mizuho FUKUSHIMA.jpg;9721;9857;35961;486;493;7
/net/per610a/home/mvp/mvp_db/news7-lv/2010/2010_05_30_19_00/2010_05_30_19_00.mpg;Seiji Mataichi.jpg;2673;3161;35961;133;158;25
/net/per610a/home/mvp/mvp_db/news7-lv/2010/2010_05_30_19_00/2010_05_30_19_00.mpg;Sadakazu TANIGAKI.jpg;11809;12285;35961;590;614;24
/net/per610a/home/mvp/mvp_db/news7-lv/2010/2010_05_31_19_00/2010_05_31_19_00.mpg;Yukio HATOYAMA.jpg;5085;5157;35961;254;257;3
/net/per610a/home/mvp/mvp_db/news7-lv/2010/2010_05_31_19_00/2010_05_31_19_00.mpg;Yukio HATOYAMA.jpg;5793;6509;35961;289;325;36
/net/per610a/home/mvp/mvp_db/news7-lv/2010/2010_05_31_19_00/2010_05_31_19_00.mpg;Yukio HATOYAMA.jpg;10949;11717;35961;547;586;39
/net/per610a/home/mvp/mvp_db/news7-lv/2010/2010_05_31_19_00/2010_05_31_19_00.mpg;Yukio HATOYAMA.jpg;18901;18941;35961;945;947;2
/net/per610a/home/mvp/mvp_db/news7-lv/2010/2010_05_31_19_00/2010_05_31_19_00.mpg;Ichiro OZAWA.jpg;6625;6737;35961;331;337;6
/net/per610a/home/mvp/mvp_db/news7-lv/2010/2010_05_31_19_00/2010_05_31_19_00.mpg;Ichiro OZAWA.jpg;11841;12005;35961;592;600;8
/net/per610a/home/mvp/mvp_db/news7-lv/2010/2010_06_01_19_00/2010_06_01_19_00.mpg;Yukio HATOYAMA.jpg;309;433;35961;15;21;6
/net/per610a/home/mvp/mvp_db/news7-lv/2010/2010_06_01_19_00/2010_06_01_19_00.mpg;Yukio HATOYAMA.jpg;1217;2113;35961;60;105;45
/net/per610a/home/mvp/mvp_db/news7-lv/2010/2010_06_01_19_00/2010_06_01_19_00.mpg;Yukio HATOYAMA.jpg;3189;3249;35961;159;162;3
/net/per610a/home/mvp/mvp_db/news7-lv/2010/2010_06_01_19_00/2010_06_01_19_00.mpg;Yukio HATOYAMA.jpg;8613;9337;35961;430;467;37
/net/per610a/home/mvp/mvp_db/news7-lv/2010/2010_06_01_19_00/2010_06_01_19_00.mpg;Yukio HATOYAMA.jpg;24349;24357;35961;1218;1218;0
/net/per610a/home/mvp/mvp_db/news7-lv/2010/2010_06_01_19_00/2010_06_01_19_00.mpg;Seiji Mataichi.jpg;6625;6769;35961;331;338;7
/net/per610a/home/mvp/mvp_db/news7-lv/2010/2010_06_01_19_00/2010_06_01_19_00.mpg;Ichiro OZAWA.jpg;10129;10185;35961;506;509;3
/net/per610a/home/mvp/mvp_db/news7-lv/2010/2010_06_01_19_00/2010_06_01_19_00.mpg;Ichiro OZAWA.jpg;10269;10305;35961;513;515;2
/net/per610a/home/mvp/mvp_db/news7-lv/2010/2010_06_01_19_00/2010_06_01_19_00.mpg;Ichiro OZAWA.jpg;32829;33465;35961;1642;1674;32
/net/per610a/home/mvp/mvp_db/news7-lv/2010/2010_06_01_19_00/2010_06_01_19_00.mpg;Yukio HATOYAMA.jpg;10945;10989;35961;547;549;2
/net/per610a/home/mvp/mvp_db/news7-lv/2010/2010_06_01_19_00/2010_06_01_19_00.mpg;Yukio HATOYAMA.jpg;22813;23685;35961;1141;1184;43
/net/per610a/home/mvp/mvp_db/news7-lv/2010/2010_06_01_19_00/2010_06_01_19_00.mpg;Ichiro OZAWA.jpg;11277;11321;35961;564;566;2
/net/per610a/home/mvp/mvp_db/news7-lv/2010/2010_06_01_19_00/2010_06_01_19_00.mpg;Ichiro OZAWA.jpg;24209;24253;35961;1211;1213;2
/net/per610a/home/mvp/mvp_db/news7-lv/2010/2010_06_01_19_00/2010_06_01_19_00.mpg;Ichiro OZAWA.jpg;34349;34393;35961;1718;1720;2
/net/per610a/home/mvp/mvp_db/news7-lv/2010/2010_06_02_19_00/2010_06_02_19_00.mpg;Yukio HATOYAMA.jpg;1385;1569;35961;69;78;9
/net/per610a/home/mvp/mvp_db/news7-lv/2010/2010_06_02_19_00/2010_06_02_19_00.mpg;Yukio HATOYAMA.jpg;5205;5765;35961;260;288;28
/net/per610a/home/mvp/mvp_db/news7-lv/2010/2010_06_02_19_00/2010_06_02_19_00.mpg;Yukio HATOYAMA.jpg;2289;2821;35961;114;141;27
/net/per610a/home/mvp/mvp_db/news7-lv/2010/2010_06_02_19_00/2010_06_02_19_00.mpg;Yukio HATOYAMA.jpg;3413;3469;35961;170;173;3
/net/per610a/home/mvp/mvp_db/news7-lv/2010/2010_06_02_19_00/2010_06_02_19_00.mpg;Yukio HATOYAMA.jpg;16093;16185;35961;805;809;4
/net/per610a/home/mvp/mvp_db/news7-lv/2010/2010_06_02_19_00/2010_06_02_19_00.mpg;Yukio HATOYAMA.jpg;25345;25473;35961;1267;1274;7
/net/per610a/home/mvp/mvp_db/news7-lv/2010/2010_06_02_19_00/2010_06_02_19_00.mpg;Yukio HATOYAMA.jpg;25977;26085;35961;1299;1304;5
/net/per610a/home/mvp/mvp_db/news7-lv/2010/2010_06_02_19_00/2010_06_02_19_00.mpg;Yukio HATOYAMA.jpg;29389;29473;35961;1470;1474;4
/net/per610a/home/mvp/mvp_db/news7-lv/2010/2010_06_02_19_00/2010_06_02_19_00.mpg;Ichiro OZAWA.jpg;16657;16693;35961;833;835;2
/net/per610a/home/mvp/mvp_db/news7-lv/2010/2010_06_02_19_00/2010_06_02_19_00.mpg;Ichiro OZAWA.jpg;18425;21413;35961;921;1071;150
/net/per610a/home/mvp/mvp_db/news7-lv/2010/2010_06_02_19_00/2010_06_02_19_00.mpg;Ichiro OZAWA.jpg;27445;27549;35961;1372;1378;6
/net/per610a/home/mvp/mvp_db/news7-lv/2010/2010_06_02_19_00/2010_06_02_19_00.mpg;Sadakazu TANIGAKI.jpg;22077;24873;35961;1104;1244;140
/net/per610a/home/mvp/mvp_db/news7-lv/2010/2010_06_02_19_00/2010_06_02_19_00.mpg;Yukio HATOYAMA.jpg;25117;25253;35961;1256;1263;7
/net/per610a/home/mvp/mvp_db/news7-lv/2010/2010_06_02_19_00/2010_06_02_19_00.mpg;Yukio HATOYAMA.jpg;26433;26449;35961;1322;1323;1
/net/per610a/home/mvp/mvp_db/news7-lv/2010/2010_06_02_19_00/2010_06_02_19_00.mpg;Yukio HATOYAMA.jpg;29561;29773;35961;1478;1489;11
/net/per610a/home/mvp/mvp_db/news7-lv/2010/2010_06_03_19_00/2010_06_03_19_00.mpg;Seiji MAEHARA.jpg;2537;2597;35961;126;129;3
/net/per610a/home/mvp/mvp_db/news7-lv/2010/2010_06_03_19_00/2010_06_03_19_00.mpg;Seiji MAEHARA.jpg;2673;3101;35961;133;155;22
/net/per610a/home/mvp/mvp_db/news7-lv/2010/2010_06_03_19_00/2010_06_03_19_00.mpg;Taro ASO.jpg;10357;11049;35961;518;552;34
/net/per610a/home/mvp/mvp_db/news7-lv/2010/2010_06_03_19_00/2010_06_03_19_00.mpg;Naoto KAN.jpg;12013;13669;35961;600;683;83
/net/per610a/home/mvp/mvp_db/news7-lv/2010/2010_06_04_19_00/2010_06_04_19_00.mpg;Sadakazu TANIGAKI.jpg;25289;28097;35961;1265;1405;140
/net/per610a/home/mvp/mvp_db/news7-lv/2010/2010_06_04_19_00/2010_06_04_19_00.mpg;Ichiro OZAWA.jpg;30197;30389;35961;1510;1520;10
/net/per610a/home/mvp/mvp_db/news7-lv/2010/2010_06_04_19_00/2010_06_04_19_00.mpg;Naoto KAN.jpg;32133;32225;35961;1607;1612;5
/net/per610a/home/mvp/mvp_db/news7-lv/2010/2010_06_05_19_00/2010_06_05_19_00.mpg;Yukio EDANO.jpg;189;377;35961;9;18;9
/net/per610a/home/mvp/mvp_db/news7-lv/2010/2010_06_05_19_00/2010_06_05_19_00.mpg;Yukio HATOYAMA.jpg;5785;5805;35961;289;290;1
/net/per610a/home/mvp/mvp_db/news7-lv/2010/2010_06_05_19_00/2010_06_05_19_00.mpg;Yukio HATOYAMA.jpg;5969;7369;35961;298;368;70
/net/per610a/home/mvp/mvp_db/news7-lv/2010/2010_06_05_19_00/2010_06_05_19_00.mpg;Sadakazu TANIGAKI.jpg;7377;9025;35961;369;451;82
/net/per610a/home/mvp/mvp_db/news7-lv/2010/2010_06_06_19_00/2010_06_06_19_00.mpg;Naoto KAN.jpg;13;201;35961;0;10;10
/net/per610a/home/mvp/mvp_db/news7-lv/2010/2010_06_06_19_00/2010_06_06_19_00.mpg;Naoto KAN.jpg;1085;1549;35961;54;77;23
/net/per610a/home/mvp/mvp_db/news7-lv/2010/2010_06_06_19_00/2010_06_06_19_00.mpg;Naoto KAN.jpg;5137;5137;35961;256;256;0
/net/per610a/home/mvp/mvp_db/news7-lv/2010/2010_06_06_19_00/2010_06_06_19_00.mpg;Naoto KAN.jpg;9365;10561;35961;468;528;60
/net/per610a/home/mvp/mvp_db/news7-lv/2010/2010_06_06_19_00/2010_06_06_19_00.mpg;Yoshihiko Noda.jpg;3909;4585;35961;195;229;34
/net/per610a/home/mvp/mvp_db/news7-lv/2010/2010_06_06_19_00/2010_06_06_19_00.mpg;Katsuya OKADA.jpg;4589;4801;35961;229;240;11
/net/per610a/home/mvp/mvp_db/news7-lv/2010/2010_06_06_19_00/2010_06_06_19_00.mpg;Shizuka KAMEI.jpg;4589;4801;35961;229;240;11
/net/per610a/home/mvp/mvp_db/news7-lv/2010/2010_06_06_19_00/2010_06_06_19_00.mpg;Shizuka KAMEI.jpg;6337;6577;35961;317;329;12
/net/per610a/home/mvp/mvp_db/news7-lv/2010/2010_06_06_19_00/2010_06_06_19_00.mpg;Shizuka KAMEI.jpg;6645;6717;35961;332;336;4
/net/per610a/home/mvp/mvp_db/news7-lv/2010/2010_06_06_19_00/2010_06_06_19_00.mpg;Yukio EDANO.jpg;9365;9669;35961;468;483;15
/net/per610a/home/mvp/mvp_db/news7-lv/2010/2010_06_06_19_00/2010_06_06_19_00.mpg;Sadakazu TANIGAKI.jpg;10953;11225;35961;547;561;14
/net/per610a/home/mvp/mvp_db/news7-lv/2010/2010_06_07_19_00/2010_06_07_19_00.mpg;Yukio EDANO.jpg;3781;3785;35961;189;189;0
/net/per610a/home/mvp/mvp_db/news7-lv/2010/2010_06_07_19_00/2010_06_07_19_00.mpg;Yukio EDANO.jpg;7409;8481;35961;370;424;54
/net/per610a/home/mvp/mvp_db/news7-lv/2010/2010_06_07_19_00/2010_06_07_19_00.mpg;Yukio HATOYAMA.jpg;16861;17181;35961;843;859;16
/net/per610a/home/mvp/mvp_db/news7-lv/2010/2010_06_07_19_00/2010_06_07_19_00.mpg;Yukio HATOYAMA.jpg;18153;18257;35961;908;913;5
/net/per610a/home/mvp/mvp_db/news7-lv/2010/2010_06_08_19_00/2010_06_08_19_00.mpg;Renho.jpg;1989;2133;35961;99;106;7
/net/per610a/home/mvp/mvp_db/news7-lv/2010/2010_06_08_19_00/2010_06_08_19_00.mpg;Renho.jpg;25325;25397;35961;1266;1270;4
/net/per610a/home/mvp/mvp_db/news7-lv/2010/2010_06_08_19_00/2010_06_08_19_00.mpg;Shizuka KAMEI.jpg;2853;2877;35961;142;143;1
/net/per610a/home/mvp/mvp_db/news7-lv/2010/2010_06_08_19_00/2010_06_08_19_00.mpg;Shizuka KAMEI.jpg;3109;3305;35961;155;165;10
/net/per610a/home/mvp/mvp_db/news7-lv/2010/2010_06_08_19_00/2010_06_08_19_00.mpg;Shizuka KAMEI.jpg;6677;6893;35961;334;344;10
/net/per610a/home/mvp/mvp_db/news7-lv/2010/2010_06_08_19_00/2010_06_08_19_00.mpg;Shizuka KAMEI.jpg;8597;8725;35961;430;436;6
/net/per610a/home/mvp/mvp_db/news7-lv/2010/2010_06_08_19_00/2010_06_08_19_00.mpg;Shizuka KAMEI.jpg;25181;25261;35961;1259;1263;4
/net/per610a/home/mvp/mvp_db/news7-lv/2010/2010_06_08_19_00/2010_06_08_19_00.mpg;Yoshihiko Noda.jpg;4881;4913;35961;244;245;1
/net/per610a/home/mvp/mvp_db/news7-lv/2010/2010_06_08_19_00/2010_06_08_19_00.mpg;Yoshihiko Noda.jpg;19069;19145;35961;953;957;4
/net/per610a/home/mvp/mvp_db/news7-lv/2010/2010_06_08_19_00/2010_06_08_19_00.mpg;Yoshihiko Noda.jpg;20757;20829;35961;1038;1042;4
/net/per610a/home/mvp/mvp_db/news7-lv/2010/2010_06_08_19_00/2010_06_08_19_00.mpg;Yoshihiko Noda.jpg;21289;21709;35961;1065;1086;21
/net/per610a/home/mvp/mvp_db/news7-lv/2010/2010_06_08_19_00/2010_06_08_19_00.mpg;Seiji MAEHARA.jpg;5849;6209;35961;292;310;18
/net/per610a/home/mvp/mvp_db/news7-lv/2010/2010_06_08_19_00/2010_06_08_19_00.mpg;Yoshihiko Noda.jpg;20245;20657;35961;1012;1033;21
/net/per610a/home/mvp/mvp_db/news7-lv/2010/2010_06_08_19_00/2010_06_08_19_00.mpg;Sadakazu TANIGAKI.jpg;29997;32201;35961;1500;1610;110
/net/per610a/home/mvp/mvp_db/news7-lv/2010/2010_06_09_19_00/2010_06_09_19_00.mpg;Ichiro OZAWA.jpg;565;857;35961;28;42;14
/net/per610a/home/mvp/mvp_db/news7-lv/2010/2010_06_09_19_00/2010_06_09_19_00.mpg;Ichiro OZAWA.jpg;9601;10045;35961;480;502;22
/net/per610a/home/mvp/mvp_db/news7-lv/2010/2010_06_09_19_00/2010_06_09_19_00.mpg;Renho.jpg;4873;5157;35961;243;257;14
/net/per610a/home/mvp/mvp_db/news7-lv/2010/2010_06_09_19_00/2010_06_09_19_00.mpg;Yoshihiko Noda.jpg;6177;7257;35961;309;363;54
/net/per610a/home/mvp/mvp_db/news7-lv/2010/2010_06_10_19_00/2010_06_10_19_00.mpg;Yukio EDANO.jpg;709;845;35961;35;42;7
/net/per610a/home/mvp/mvp_db/news7-lv/2010/2010_06_10_19_00/2010_06_10_19_00.mpg;Yukio EDANO.jpg;6269;6345;35961;313;317;4
/net/per610a/home/mvp/mvp_db/news7-lv/2010/2010_06_10_19_00/2010_06_10_19_00.mpg;Yukio EDANO.jpg;6709;7093;35961;335;354;19
/net/per610a/home/mvp/mvp_db/news7-lv/2010/2010_06_10_19_00/2010_06_10_19_00.mpg;Yukio EDANO.jpg;1397;3269;35961;69;163;94
/net/per610a/home/mvp/mvp_db/news7-lv/2010/2010_06_10_19_00/2010_06_10_19_00.mpg;Naoto KAN.jpg;4033;4181;35961;201;209;8
/net/per610a/home/mvp/mvp_db/news7-lv/2010/2010_06_10_19_00/2010_06_10_19_00.mpg;Naoto KAN.jpg;8481;9013;35961;424;450;26
/net/per610a/home/mvp/mvp_db/news7-lv/2010/2010_06_11_19_00/2010_06_11_19_00.mpg;Sadakazu TANIGAKI.jpg;2833;3285;35961;141;164;23
/net/per610a/home/mvp/mvp_db/news7-lv/2010/2010_06_11_19_00/2010_06_11_19_00.mpg;Yukio HATOYAMA.jpg;7749;8157;35961;387;408;21
/net/per610a/home/mvp/mvp_db/news7-lv/2010/2010_06_11_19_00/2010_06_11_19_00.mpg;Yukio EDANO.jpg;9705;12505;35961;485;625;140
/net/per610a/home/mvp/mvp_db/news7-lv/2010/2010_06_12_19_00/2010_06_12_19_00.mpg;Yukio HATOYAMA.jpg;24629;25309;35961;1232;1266;34
/net/per610a/home/mvp/mvp_db/news7-lv/2010/2010_06_13_19_00/2010_06_13_19_00.mpg;Sadakazu TANIGAKI.jpg;4145;4989;35961;207;249;42
/net/per610a/home/mvp/mvp_db/news7-lv/2010/2010_06_14_19_00/2010_06_14_19_00.mpg;Yukio EDANO.jpg;14693;15129;35961;735;756;21
/net/per610a/home/mvp/mvp_db/news7-lv/2010/2010_06_14_19_00/2010_06_14_19_00.mpg;Naoto KAN.jpg;15869;16377;35961;793;819;26
/net/per610a/home/mvp/mvp_db/news7-lv/2010/2010_06_14_19_00/2010_06_14_19_00.mpg;Shizuka KAMEI.jpg;31349;31945;35961;1568;1598;30
/net/per610a/home/mvp/mvp_db/news7-lv/2010/2010_06_16_19_00/2010_06_16_19_00.mpg;Sadakazu TANIGAKI.jpg;6457;9633;35961;323;481;158
/net/per610a/home/mvp/mvp_db/news7-lv/2010/2010_06_16_19_00/2010_06_16_19_00.mpg;Sadakazu TANIGAKI.jpg;11105;11305;35961;555;565;10
/net/per610a/home/mvp/mvp_db/news7-lv/2010/2010_06_17_19_00/2010_06_17_19_00.mpg;Shizuka KAMEI.jpg;10069;10209;35961;503;510;7
/net/per610a/home/mvp/mvp_db/news7-lv/2010/2010_06_17_19_00/2010_06_17_19_00.mpg;Sadakazu TANIGAKI.jpg;13061;13513;35961;653;676;23
/net/per610a/home/mvp/mvp_db/news7-lv/2010/2010_06_17_19_00/2010_06_17_19_00.mpg;Sadakazu TANIGAKI.jpg;16537;17897;35961;827;895;68
/net/per610a/home/mvp/mvp_db/news7-lv/2010/2010_06_18_19_00/2010_06_18_19_00.mpg;Shizuka KAMEI.jpg;11281;11729;35957;564;586;22
/net/per610a/home/mvp/mvp_db/news7-lv/2010/2010_06_22_19_00/2010_06_22_19_00.mpg;Naoto KAN.jpg;373;625;35961;18;31;13
/net/per610a/home/mvp/mvp_db/news7-lv/2010/2010_06_22_19_00/2010_06_22_19_00.mpg;Naoto KAN.jpg;7305;8861;35961;365;443;78
/net/per610a/home/mvp/mvp_db/news7-lv/2010/2010_06_22_19_00/2010_06_22_19_00.mpg;Naoto KAN.jpg;12785;13081;35961;639;654;15
/net/per610a/home/mvp/mvp_db/news7-lv/2010/2010_06_22_19_00/2010_06_22_19_00.mpg;Sadakazu TANIGAKI.jpg;7573;7637;35961;378;382;4
/net/per610a/home/mvp/mvp_db/news7-lv/2010/2010_06_22_19_00/2010_06_22_19_00.mpg;Sadakazu TANIGAKI.jpg;12969;13289;35961;648;664;16
/net/per610a/home/mvp/mvp_db/news7-lv/2010/2010_06_22_19_00/2010_06_22_19_00.mpg;Kazuo SHII.jpg;9705;12705;35961;485;635;150
/net/per610a/home/mvp/mvp_db/news7-lv/2010/2010_06_22_19_00/2010_06_22_19_00.mpg;Sadakazu TANIGAKI.jpg;13733;14029;35961;687;701;14
/net/per610a/home/mvp/mvp_db/news7-lv/2010/2010_06_23_19_00/2010_06_23_19_00.mpg;Shizuka KAMEI.jpg;14641;14769;35961;732;738;6
/net/per610a/home/mvp/mvp_db/news7-lv/2010/2010_06_24_19_00/2010_06_24_19_00.mpg;Mizuho FUKUSHIMA.jpg;6113;6713;35961;305;335;30
/net/per610a/home/mvp/mvp_db/news7-lv/2010/2010_06_24_19_00/2010_06_24_19_00.mpg;Naoto KAN.jpg;29857;30149;35961;1493;1508;15
/net/per610a/home/mvp/mvp_db/news7-lv/2010/2010_06_25_19_00/2010_06_25_19_00.mpg;Naoto KAN.jpg;19769;20089;35961;988;1004;16
/net/per610a/home/mvp/mvp_db/news7-lv/2010/2010_06_25_19_00/2010_06_25_19_00.mpg;Naoto KAN.jpg;20245;20473;35961;1012;1024;12
/net/per610a/home/mvp/mvp_db/news7-lv/2010/2010_06_26_19_00/2010_06_26_19_00.mpg;Naoto KAN.jpg;6689;6961;35961;334;348;14
/net/per610a/home/mvp/mvp_db/news7-lv/2010/2010_06_26_19_00/2010_06_26_19_00.mpg;Yukio EDANO.jpg;11029;11845;35961;551;592;41
/net/per610a/home/mvp/mvp_db/news7-lv/2010/2010_06_26_19_00/2010_06_26_19_00.mpg;Kazuo SHII.jpg;14509;14697;35961;725;735;10
/net/per610a/home/mvp/mvp_db/news7-lv/2010/2010_06_28_19_00/2010_06_28_19_00.mpg;Naoto KAN.jpg;18205;18237;35961;910;912;2
/net/per610a/home/mvp/mvp_db/news7-lv/2010/2010_06_28_19_00/2010_06_28_19_00.mpg;Naoto KAN.jpg;18485;19549;35961;924;977;53
/net/per610a/home/mvp/mvp_db/news7-lv/2010/2010_06_28_19_00/2010_06_28_19_00.mpg;Naoto KAN.jpg;20789;21229;35961;1039;1062;23
/net/per610a/home/mvp/mvp_db/news7-lv/2010/2010_06_28_19_00/2010_06_28_19_00.mpg;Naoto KAN.jpg;23989;24349;35961;1200;1218;18
/net/per610a/home/mvp/mvp_db/news7-lv/2010/2010_06_30_19_00/2010_06_30_19_00.mpg;Sadakazu TANIGAKI.jpg;22345;22637;35961;1117;1132;15
/net/per610a/home/mvp/mvp_db/news7-lv/2010/2010_07_03_19_00/2010_07_03_19_00.mpg;Naoto KAN.jpg;6625;7081;35961;331;354;23
/net/per610a/home/mvp/mvp_db/news7-lv/2010/2010_07_03_19_00/2010_07_03_19_00.mpg;Naoto KAN.jpg;7693;7733;35961;384;386;2
/net/per610a/home/mvp/mvp_db/news7-lv/2010/2010_07_05_19_00/2010_07_05_19_00.mpg;Ichiro OZAWA.jpg;27665;27665;35957;1384;1384;0
/net/per610a/home/mvp/mvp_db/news7-lv/2010/2010_07_05_19_00/2010_07_05_19_00.mpg;Ichiro OZAWA.jpg;27757;28525;35957;1388;1427;39
/net/per610a/home/mvp/mvp_db/news7-lv/2010/2010_07_07_19_00/2010_07_07_19_00.mpg;Yoshihiko Noda.jpg;29445;30297;35961;1473;1515;42
/net/per610a/home/mvp/mvp_db/news7-lv/2010/2010_07_10_19_00/2010_07_10_19_00.mpg;Sadakazu TANIGAKI.jpg;2841;3005;35961;142;150;8
/net/per610a/home/mvp/mvp_db/news7-lv/2010/2010_07_10_19_00/2010_07_10_19_00.mpg;Kazuo SHII.jpg;4813;5421;35961;240;271;31
/net/per610a/home/mvp/mvp_db/news7-lv/2010/2010_07_12_19_00/2010_07_12_19_00.mpg;Naoto KAN.jpg;1;205;35961;0;10;10
/net/per610a/home/mvp/mvp_db/news7-lv/2010/2010_07_12_19_00/2010_07_12_19_00.mpg;Naoto KAN.jpg;1521;1725;35961;76;86;10
/net/per610a/home/mvp/mvp_db/news7-lv/2010/2010_07_12_19_00/2010_07_12_19_00.mpg;Naoto KAN.jpg;5721;5745;35961;286;287;1
/net/per610a/home/mvp/mvp_db/news7-lv/2010/2010_07_12_19_00/2010_07_12_19_00.mpg;Naoto KAN.jpg;5901;6037;35961;295;302;7
/net/per610a/home/mvp/mvp_db/news7-lv/2010/2010_07_12_19_00/2010_07_12_19_00.mpg;Naoto KAN.jpg;14849;15241;35961;742;762;20
/net/per610a/home/mvp/mvp_db/news7-lv/2010/2010_07_12_19_00/2010_07_12_19_00.mpg;Naoto KAN.jpg;15873;15929;35961;794;796;2
/net/per610a/home/mvp/mvp_db/news7-lv/2010/2010_07_12_19_00/2010_07_12_19_00.mpg;Yukio EDANO.jpg;7101;7689;35961;355;384;29
/net/per610a/home/mvp/mvp_db/news7-lv/2010/2010_07_12_19_00/2010_07_12_19_00.mpg;Yukio EDANO.jpg;13621;14173;35961;681;709;28
/net/per610a/home/mvp/mvp_db/news7-lv/2010/2010_07_12_19_00/2010_07_12_19_00.mpg;Yoshimi WATANABE.jpg;10905;11301;35961;545;565;20
/net/per610a/home/mvp/mvp_db/news7-lv/2010/2010_07_12_19_00/2010_07_12_19_00.mpg;Yoshimi WATANABE.jpg;11565;11965;35961;578;598;20
/net/per610a/home/mvp/mvp_db/news7-lv/2010/2010_07_13_19_00/2010_07_13_19_00.mpg;Renho.jpg;8409;9257;35961;420;463;43
/net/per610a/home/mvp/mvp_db/news7-lv/2010/2010_07_13_19_00/2010_07_13_19_00.mpg;Seiji MAEHARA.jpg;12117;12817;35961;606;641;35
/net/per610a/home/mvp/mvp_db/news7-lv/2010/2010_07_13_19_00/2010_07_13_19_00.mpg;Kenji Eda.jpg;15021;15293;35961;751;765;14
/net/per610a/home/mvp/mvp_db/news7-lv/2010/2010_07_18_19_00/2010_07_18_19_00.mpg;Naoto KAN.jpg;541;629;35957;27;31;4
/net/per610a/home/mvp/mvp_db/news7-lv/2010/2010_07_20_19_00/2010_07_20_19_00.mpg;Seiji MAEHARA.jpg;12633;13069;35961;631;653;22
/net/per610a/home/mvp/mvp_db/news7-lv/2010/2010_07_20_19_00/2010_07_20_19_00.mpg;Yukio EDANO.jpg;13813;14061;35961;691;703;12
/net/per610a/home/mvp/mvp_db/news7-lv/2010/2010_07_20_19_00/2010_07_20_19_00.mpg;Naoto KAN.jpg;18845;19201;35961;942;960;18
/net/per610a/home/mvp/mvp_db/news7-lv/2010/2010_07_20_19_00/2010_07_20_19_00.mpg;Naoto KAN.jpg;19881;19953;35961;994;998;4
/net/per610a/home/mvp/mvp_db/news7-lv/2010/2010_07_20_19_00/2010_07_20_19_00.mpg;Sadakazu TANIGAKI.jpg;29197;29253;35961;1460;1463;3
/net/per610a/home/mvp/mvp_db/news7-lv/2010/2010_07_20_19_00/2010_07_20_19_00.mpg;Sadakazu TANIGAKI.jpg;29377;29413;35961;1469;1471;2
/net/per610a/home/mvp/mvp_db/news7-lv/2010/2010_07_21_19_00/2010_07_21_19_00.mpg;Natsuo YAMAGUCHI.jpg;11533;11709;35961;576;585;9
/net/per610a/home/mvp/mvp_db/news7-lv/2010/2010_07_21_19_00/2010_07_21_19_00.mpg;Natsuo YAMAGUCHI.jpg;11805;11833;35961;590;591;1
/net/per610a/home/mvp/mvp_db/news7-lv/2010/2010_07_21_19_00/2010_07_21_19_00.mpg;Natsuo YAMAGUCHI.jpg;14237;14545;35961;712;727;15
/net/per610a/home/mvp/mvp_db/news7-lv/2010/2010_07_21_19_00/2010_07_21_19_00.mpg;Shizuka KAMEI.jpg;18553;19149;35961;928;957;29
/net/per610a/home/mvp/mvp_db/news7-lv/2010/2010_07_22_19_00/2010_07_22_19_00.mpg;Sadakazu TANIGAKI.jpg;9577;10617;35961;479;531;52
/net/per610a/home/mvp/mvp_db/news7-lv/2010/2010_07_22_19_00/2010_07_22_19_00.mpg;Yukio HATOYAMA.jpg;17013;17777;35961;851;889;38
/net/per610a/home/mvp/mvp_db/news7-lv/2010/2010_07_22_19_00/2010_07_22_19_00.mpg;Naoto KAN.jpg;20317;20441;35961;1016;1022;6
/net/per610a/home/mvp/mvp_db/news7-lv/2010/2010_07_22_19_00/2010_07_22_19_00.mpg;Naoto KAN.jpg;20821;20865;35961;1041;1043;2
/net/per610a/home/mvp/mvp_db/news7-lv/2010/2010_07_27_19_00/2010_07_27_19_00.mpg;Seiji MAEHARA.jpg;12065;12161;35961;603;608;5
/net/per610a/home/mvp/mvp_db/news7-lv/2010/2010_07_27_19_00/2010_07_27_19_00.mpg;Seiji MAEHARA.jpg;12281;13337;35961;614;667;53
/net/per610a/home/mvp/mvp_db/news7-lv/2010/2010_07_28_19_00/2010_07_28_19_00.mpg;Naoto KAN.jpg;6437;6645;35961;322;332;10
/net/per610a/home/mvp/mvp_db/news7-lv/2010/2010_07_29_19_00/2010_07_29_19_00.mpg;Naoto KAN.jpg;1;305;35961;0;15;15
/net/per610a/home/mvp/mvp_db/news7-lv/2010/2010_07_29_19_00/2010_07_29_19_00.mpg;Naoto KAN.jpg;1461;2013;35961;73;100;27
/net/per610a/home/mvp/mvp_db/news7-lv/2010/2010_07_29_19_00/2010_07_29_19_00.mpg;Naoto KAN.jpg;7445;7637;35961;372;382;10
/net/per610a/home/mvp/mvp_db/news7-lv/2010/2010_07_30_19_00/2010_07_30_19_00.mpg;Sadakazu TANIGAKI.jpg;137;397;35961;6;19;13
/net/per610a/home/mvp/mvp_db/news7-lv/2010/2010_07_30_19_00/2010_07_30_19_00.mpg;Sadakazu TANIGAKI.jpg;4705;5729;35961;235;286;51
/net/per610a/home/mvp/mvp_db/news7-lv/2010/2010_07_30_19_00/2010_07_30_19_00.mpg;Naoto KAN.jpg;9469;10121;35961;473;506;33
/net/per610a/home/mvp/mvp_db/news7-lv/2010/2010_07_30_19_00/2010_07_30_19_00.mpg;Naoto KAN.jpg;11437;11477;35961;572;574;2
/net/per610a/home/mvp/mvp_db/news7-lv/2010/2010_07_30_19_00/2010_07_30_19_00.mpg;Naoto KAN.jpg;12125;12325;35961;606;616;10
/net/per610a/home/mvp/mvp_db/news7-lv/2010/2010_08_03_19_00/2010_08_03_19_00.mpg;Seiji MAEHARA.jpg;15737;16261;35961;787;813;26
/net/per610a/home/mvp/mvp_db/news7-lv/2010/2010_08_04_19_00/2010_08_04_19_00.mpg;Toru Hashimoto.jpg;737;893;35961;36;44;8
/net/per610a/home/mvp/mvp_db/news7-lv/2010/2010_08_04_19_00/2010_08_04_19_00.mpg;Toru Hashimoto.jpg;27045;27289;35961;1352;1365;13
/net/per610a/home/mvp/mvp_db/news7-lv/2010/2010_08_08_19_00/2010_08_08_19_00.mpg;Seiji MAEHARA.jpg;26357;26897;35961;1318;1345;27
/net/per610a/home/mvp/mvp_db/news7-lv/2010/2010_08_09_19_00/2010_08_09_19_00.mpg;Sadakazu TANIGAKI.jpg;3697;4621;35961;184;231;47
/net/per610a/home/mvp/mvp_db/news7-lv/2010/2010_08_09_19_00/2010_08_09_19_00.mpg;Naoto KAN.jpg;4625;5077;35961;231;253;22
/net/per610a/home/mvp/mvp_db/news7-lv/2010/2010_08_09_19_00/2010_08_09_19_00.mpg;Naoto KAN.jpg;19693;20329;35961;985;1016;31
/net/per610a/home/mvp/mvp_db/news7-lv/2010/2010_08_09_19_00/2010_08_09_19_00.mpg;Naoto KAN.jpg;20497;21673;35961;1025;1084;59
/net/per610a/home/mvp/mvp_db/news7-lv/2010/2010_08_09_19_00/2010_08_09_19_00.mpg;Naoto KAN.jpg;27637;27841;35961;1382;1392;10
/net/per610a/home/mvp/mvp_db/news7-lv/2010/2010_08_09_19_00/2010_08_09_19_00.mpg;Naoto KAN.jpg;27953;27993;35961;1398;1400;2
/net/per610a/home/mvp/mvp_db/news7-lv/2010/2010_08_09_19_00/2010_08_09_19_00.mpg;Naoto KAN.jpg;30005;30117;35961;1501;1506;5
/net/per610a/home/mvp/mvp_db/news7-lv/2010/2010_08_09_19_00/2010_08_09_19_00.mpg;Naoto KAN.jpg;30489;31041;35961;1525;1552;27
/net/per610a/home/mvp/mvp_db/news7-lv/2010/2010_08_10_19_00/2010_08_10_19_00.mpg;Sadakazu TANIGAKI.jpg;14577;15665;35961;729;783;54
/net/per610a/home/mvp/mvp_db/news7-lv/2010/2010_08_11_19_00/2010_08_11_19_00.mpg;Katsuya OKADA.jpg;15221;15489;35961;761;774;13
/net/per610a/home/mvp/mvp_db/news7-lv/2010/2010_08_11_19_00/2010_08_11_19_00.mpg;Sadakazu TANIGAKI.jpg;20373;21161;35961;1019;1058;39
/net/per610a/home/mvp/mvp_db/news7-lv/2010/2010_08_12_19_00/2010_08_12_19_00.mpg;Naoto KAN.jpg;15169;15609;35961;758;780;22
/net/per610a/home/mvp/mvp_db/news7-lv/2010/2010_08_15_19_00/2010_08_15_19_00.mpg;Mizuho FUKUSHIMA.jpg;14837;15205;35961;742;760;18
/net/per610a/home/mvp/mvp_db/news7-lv/2010/2010_08_16_19_00/2010_08_16_19_00.mpg;Naoto KAN.jpg;5537;6381;35961;276;319;43
/net/per610a/home/mvp/mvp_db/news7-lv/2010/2010_08_18_19_00/2010_08_18_19_00.mpg;Yukio HATOYAMA.jpg;22509;22549;35961;1126;1128;2
/net/per610a/home/mvp/mvp_db/news7-lv/2010/2010_08_18_19_00/2010_08_18_19_00.mpg;Yukio HATOYAMA.jpg;22961;23637;35961;1148;1182;34
/net/per610a/home/mvp/mvp_db/news7-lv/2010/2010_08_19_19_00/2010_08_19_19_00.mpg;Yukio HATOYAMA.jpg;1917;2013;35957;95;100;5
/net/per610a/home/mvp/mvp_db/news7-lv/2010/2010_08_19_19_00/2010_08_19_19_00.mpg;Yukio HATOYAMA.jpg;5629;5717;35957;281;286;5
/net/per610a/home/mvp/mvp_db/news7-lv/2010/2010_08_20_19_00/2010_08_20_19_00.mpg;Naoto KAN.jpg;5577;5741;35961;278;287;9
/net/per610a/home/mvp/mvp_db/news7-lv/2010/2010_08_20_19_00/2010_08_20_19_00.mpg;Ichiro OZAWA.jpg;5581;5741;35961;279;287;8
/net/per610a/home/mvp/mvp_db/news7-lv/2010/2010_08_20_19_00/2010_08_20_19_00.mpg;Katsuya OKADA.jpg;27197;27817;35961;1360;1391;31
/net/per610a/home/mvp/mvp_db/news7-lv/2010/2010_08_21_19_00/2010_08_21_19_00.mpg;Naoto KAN.jpg;8477;8857;35961;424;443;19
/net/per610a/home/mvp/mvp_db/news7-lv/2010/2010_08_21_19_00/2010_08_21_19_00.mpg;Naoto KAN.jpg;9341;10097;35961;467;505;38
/net/per610a/home/mvp/mvp_db/news7-lv/2010/2010_08_21_19_00/2010_08_21_19_00.mpg;Ichiro OZAWA.jpg;9841;10097;35961;492;505;13
/net/per610a/home/mvp/mvp_db/news7-lv/2010/2010_08_22_19_00/2010_08_22_19_00.mpg;Ichiro OZAWA.jpg;10529;10913;35961;526;545;19
/net/per610a/home/mvp/mvp_db/news7-lv/2010/2010_08_22_19_00/2010_08_22_19_00.mpg;Seiji MAEHARA.jpg;29177;29461;35961;1459;1473;14
/net/per610a/home/mvp/mvp_db/news7-lv/2010/2010_08_23_19_00/2010_08_23_19_00.mpg;Naoto KAN.jpg;3477;3709;35961;173;185;12
/net/per610a/home/mvp/mvp_db/news7-lv/2010/2010_08_23_19_00/2010_08_23_19_00.mpg;Naoto KAN.jpg;8493;9005;35961;424;450;26
/net/per610a/home/mvp/mvp_db/news7-lv/2010/2010_08_23_19_00/2010_08_23_19_00.mpg;Ichiro OZAWA.jpg;3477;3709;35961;173;185;12
/net/per610a/home/mvp/mvp_db/news7-lv/2010/2010_08_24_19_00/2010_08_24_19_00.mpg;Yoshihiko Noda.jpg;6313;6705;35961;315;335;20
/net/per610a/home/mvp/mvp_db/news7-lv/2010/2010_08_25_19_00/2010_08_25_19_00.mpg;Naoto KAN.jpg;1;69;35961;0;3;3
/net/per610a/home/mvp/mvp_db/news7-lv/2010/2010_08_25_19_00/2010_08_25_19_00.mpg;Naoto KAN.jpg;12021;12265;35961;601;613;12
/net/per610a/home/mvp/mvp_db/news7-lv/2010/2010_08_25_19_00/2010_08_25_19_00.mpg;Ichiro OZAWA.jpg;4273;5221;35961;213;261;48
/net/per610a/home/mvp/mvp_db/news7-lv/2010/2010_08_25_19_00/2010_08_25_19_00.mpg;Naoto KAN.jpg;7453;7685;35961;372;384;12
/net/per610a/home/mvp/mvp_db/news7-lv/2010/2010_08_25_19_00/2010_08_25_19_00.mpg;Naoto KAN.jpg;12809;12901;35961;640;645;5
/net/per610a/home/mvp/mvp_db/news7-lv/2010/2010_08_25_19_00/2010_08_25_19_00.mpg;Yukio HATOYAMA.jpg;7769;8353;35961;388;417;29
/net/per610a/home/mvp/mvp_db/news7-lv/2010/2010_08_25_19_00/2010_08_25_19_00.mpg;Yoshihiko Noda.jpg;9617;9985;35961;481;499;18
/net/per610a/home/mvp/mvp_db/news7-lv/2010/2010_08_25_19_00/2010_08_25_19_00.mpg;Yoshihiko Noda.jpg;11701;11997;35961;585;600;15
/net/per610a/home/mvp/mvp_db/news7-lv/2010/2010_08_26_19_00/2010_08_26_19_00.mpg;Yukio HATOYAMA.jpg;2185;2653;35961;109;132;23
/net/per610a/home/mvp/mvp_db/news7-lv/2010/2010_08_26_19_00/2010_08_26_19_00.mpg;Ichiro OZAWA.jpg;5841;6033;35961;292;301;9
/net/per610a/home/mvp/mvp_db/news7-lv/2010/2010_08_26_19_00/2010_08_26_19_00.mpg;Ichiro OZAWA.jpg;19049;19425;35961;952;971;19
/net/per610a/home/mvp/mvp_db/news7-lv/2010/2010_08_26_19_00/2010_08_26_19_00.mpg;Sadakazu TANIGAKI.jpg;10509;13773;35961;525;689;164
/net/per610a/home/mvp/mvp_db/news7-lv/2010/2010_08_27_19_00/2010_08_27_19_00.mpg;Ichiro OZAWA.jpg;5325;5677;35961;266;283;17
/net/per610a/home/mvp/mvp_db/news7-lv/2010/2010_08_28_19_00/2010_08_28_19_00.mpg;Ichiro OZAWA.jpg;1561;1905;35961;78;95;17
/net/per610a/home/mvp/mvp_db/news7-lv/2010/2010_08_28_19_00/2010_08_28_19_00.mpg;Ichiro OZAWA.jpg;3605;5701;35961;180;285;105
/net/per610a/home/mvp/mvp_db/news7-lv/2010/2010_08_28_19_00/2010_08_28_19_00.mpg;Naoto KAN.jpg;2565;3573;35961;128;178;50
/net/per610a/home/mvp/mvp_db/news7-lv/2010/2010_08_29_19_00/2010_08_29_19_00.mpg;Naoto KAN.jpg;1;137;35961;0;6;6
/net/per610a/home/mvp/mvp_db/news7-lv/2010/2010_08_30_19_00/2010_08_30_19_00.mpg;Ichiro OZAWA.jpg;1149;1153;35961;57;57;0
/net/per610a/home/mvp/mvp_db/news7-lv/2010/2010_08_30_19_00/2010_08_30_19_00.mpg;Ichiro OZAWA.jpg;1753;2053;35961;87;102;15
/net/per610a/home/mvp/mvp_db/news7-lv/2010/2010_08_31_19_00/2010_08_31_19_00.mpg;Naoto KAN.jpg;1901;5153;35961;95;257;162
/net/per610a/home/mvp/mvp_db/news7-lv/2010/2010_08_31_19_00/2010_08_31_19_00.mpg;Naoto KAN.jpg;8809;8977;35961;440;449;9
/net/per610a/home/mvp/mvp_db/news7-lv/2010/2010_08_31_19_00/2010_08_31_19_00.mpg;Naoto KAN.jpg;12081;12233;35961;604;611;7
/net/per610a/home/mvp/mvp_db/news7-lv/2010/2010_08_31_19_00/2010_08_31_19_00.mpg;Yukio HATOYAMA.jpg;10401;10985;35961;520;549;29
/net/per610a/home/mvp/mvp_db/news7-lv/2010/2010_09_01_19_00/2010_09_01_19_00.mpg;Ichiro OZAWA.jpg;2081;2501;35961;104;125;21
/net/per610a/home/mvp/mvp_db/news7-lv/2010/2010_09_01_19_00/2010_09_01_19_00.mpg;Ichiro OZAWA.jpg;4685;6573;35961;234;328;94
/net/per610a/home/mvp/mvp_db/news7-lv/2010/2010_09_01_19_00/2010_09_01_19_00.mpg;Ichiro OZAWA.jpg;7785;9341;35961;389;467;78
/net/per610a/home/mvp/mvp_db/news7-lv/2010/2010_09_01_19_00/2010_09_01_19_00.mpg;Ichiro OZAWA.jpg;9421;10429;35961;471;521;50
/net/per610a/home/mvp/mvp_db/news7-lv/2010/2010_09_01_19_00/2010_09_01_19_00.mpg;Ichiro OZAWA.jpg;17569;17881;35961;878;894;16
/net/per610a/home/mvp/mvp_db/news7-lv/2010/2010_09_02_19_00/2010_09_02_19_00.mpg;Ichiro OZAWA.jpg;1;93;35961;0;4;4
/net/per610a/home/mvp/mvp_db/news7-lv/2010/2010_09_02_19_00/2010_09_02_19_00.mpg;Ichiro OZAWA.jpg;2549;2925;35961;127;146;19
/net/per610a/home/mvp/mvp_db/news7-lv/2010/2010_09_02_19_00/2010_09_02_19_00.mpg;Ichiro OZAWA.jpg;3293;3877;35961;164;193;29
/net/per610a/home/mvp/mvp_db/news7-lv/2010/2010_09_02_19_00/2010_09_02_19_00.mpg;Ichiro OZAWA.jpg;4101;4117;35961;205;205;0
/net/per610a/home/mvp/mvp_db/news7-lv/2010/2010_09_02_19_00/2010_09_02_19_00.mpg;Ichiro OZAWA.jpg;6081;6137;35961;304;307;3
/net/per610a/home/mvp/mvp_db/news7-lv/2010/2010_09_02_19_00/2010_09_02_19_00.mpg;Ichiro OZAWA.jpg;6385;6785;35961;319;339;20
/net/per610a/home/mvp/mvp_db/news7-lv/2010/2010_09_02_19_00/2010_09_02_19_00.mpg;Ichiro OZAWA.jpg;6873;7545;35961;343;377;34
/net/per610a/home/mvp/mvp_db/news7-lv/2010/2010_09_02_19_00/2010_09_02_19_00.mpg;Ichiro OZAWA.jpg;8833;9129;35961;441;456;15
/net/per610a/home/mvp/mvp_db/news7-lv/2010/2010_09_02_19_00/2010_09_02_19_00.mpg;Ichiro OZAWA.jpg;9193;10021;35961;459;501;42
/net/per610a/home/mvp/mvp_db/news7-lv/2010/2010_09_02_19_00/2010_09_02_19_00.mpg;Naoto KAN.jpg;1537;1553;35961;76;77;1
/net/per610a/home/mvp/mvp_db/news7-lv/2010/2010_09_02_19_00/2010_09_02_19_00.mpg;Naoto KAN.jpg;2229;2293;35961;111;114;3
/net/per610a/home/mvp/mvp_db/news7-lv/2010/2010_09_02_19_00/2010_09_02_19_00.mpg;Naoto KAN.jpg;4293;4601;35961;214;230;16
/net/per610a/home/mvp/mvp_db/news7-lv/2010/2010_09_02_19_00/2010_09_02_19_00.mpg;Naoto KAN.jpg;5081;6033;35961;254;301;47
/net/per610a/home/mvp/mvp_db/news7-lv/2010/2010_09_02_19_00/2010_09_02_19_00.mpg;Naoto KAN.jpg;8561;8757;35961;428;438;10
/net/per610a/home/mvp/mvp_db/news7-lv/2010/2010_09_02_19_00/2010_09_02_19_00.mpg;Sadakazu TANIGAKI.jpg;10069;10925;35961;503;546;43
/net/per610a/home/mvp/mvp_db/news7-lv/2010/2010_09_03_19_00/2010_09_03_19_00.mpg;Ichiro OZAWA.jpg;8413;8425;35961;420;421;1
/net/per610a/home/mvp/mvp_db/news7-lv/2010/2010_09_03_19_00/2010_09_03_19_00.mpg;Ichiro OZAWA.jpg;14425;14625;35961;721;731;10
/net/per610a/home/mvp/mvp_db/news7-lv/2010/2010_09_03_19_00/2010_09_03_19_00.mpg;Naoto KAN.jpg;10865;11477;35961;543;574;31
/net/per610a/home/mvp/mvp_db/news7-lv/2010/2010_09_03_19_00/2010_09_03_19_00.mpg;Naoto KAN.jpg;12345;12769;35961;617;638;21
/net/per610a/home/mvp/mvp_db/news7-lv/2010/2010_09_03_19_00/2010_09_03_19_00.mpg;Naoto KAN.jpg;14425;14625;35961;721;731;10
/net/per610a/home/mvp/mvp_db/news7-lv/2010/2010_09_03_19_00/2010_09_03_19_00.mpg;Seiji MAEHARA.jpg;29213;29817;35961;1461;1491;30
/net/per610a/home/mvp/mvp_db/news7-lv/2010/2010_09_04_19_00/2010_09_04_19_00.mpg;Ichiro OZAWA.jpg;7397;7521;35961;370;376;6
/net/per610a/home/mvp/mvp_db/news7-lv/2010/2010_09_04_19_00/2010_09_04_19_00.mpg;Ichiro OZAWA.jpg;7637;7753;35961;382;387;5
/net/per610a/home/mvp/mvp_db/news7-lv/2010/2010_09_06_19_00/2010_09_06_19_00.mpg;Taro ASO.jpg;13849;14057;35961;692;703;11
/net/per610a/home/mvp/mvp_db/news7-lv/2010/2010_09_07_19_00/2010_09_07_19_00.mpg;Ichiro OZAWA.jpg;17957;18461;35961;898;923;25
/net/per610a/home/mvp/mvp_db/news7-lv/2010/2010_09_07_19_00/2010_09_07_19_00.mpg;Ichiro OZAWA.jpg;19417;19861;35961;971;993;22
/net/per610a/home/mvp/mvp_db/news7-lv/2010/2010_09_08_19_00/2010_09_08_19_00.mpg;Naoto KAN.jpg;26545;26813;35961;1327;1341;14
/net/per610a/home/mvp/mvp_db/news7-lv/2010/2010_09_08_19_00/2010_09_08_19_00.mpg;Ichiro OZAWA.jpg;27517;27933;35961;1376;1397;21
/net/per610a/home/mvp/mvp_db/news7-lv/2010/2010_09_08_19_00/2010_09_08_19_00.mpg;Sadakazu TANIGAKI.jpg;30449;30861;35961;1523;1543;20
/net/per610a/home/mvp/mvp_db/news7-lv/2010/2010_09_08_19_00/2010_09_08_19_00.mpg;Sadakazu TANIGAKI.jpg;31741;31817;35961;1587;1591;4
/net/per610a/home/mvp/mvp_db/news7-lv/2010/2010_09_09_19_00/2010_09_09_19_00.mpg;Naoto KAN.jpg;6813;7229;35961;340;361;21
/net/per610a/home/mvp/mvp_db/news7-lv/2010/2010_09_09_19_00/2010_09_09_19_00.mpg;Sadakazu TANIGAKI.jpg;8685;9617;35961;434;481;47
/net/per610a/home/mvp/mvp_db/news7-lv/2010/2010_09_09_19_00/2010_09_09_19_00.mpg;Sadakazu TANIGAKI.jpg;11181;11269;35961;559;563;4
/net/per610a/home/mvp/mvp_db/news7-lv/2010/2010_09_09_19_00/2010_09_09_19_00.mpg;Sadakazu TANIGAKI.jpg;11821;12137;35961;591;607;16
/net/per610a/home/mvp/mvp_db/news7-lv/2010/2010_09_10_19_00/2010_09_10_19_00.mpg;Ichiro OZAWA.jpg;20129;20133;35961;1006;1007;1
/net/per610a/home/mvp/mvp_db/news7-lv/2010/2010_09_10_19_00/2010_09_10_19_00.mpg;Ichiro OZAWA.jpg;20325;20489;35961;1016;1024;8
/net/per610a/home/mvp/mvp_db/news7-lv/2010/2010_09_10_19_00/2010_09_10_19_00.mpg;Ichiro OZAWA.jpg;20729;22861;35961;1036;1143;107
/net/per610a/home/mvp/mvp_db/news7-lv/2010/2010_09_10_19_00/2010_09_10_19_00.mpg;Naoto KAN.jpg;20169;20229;35961;1008;1011;3
/net/per610a/home/mvp/mvp_db/news7-lv/2010/2010_09_10_19_00/2010_09_10_19_00.mpg;Naoto KAN.jpg;20513;20593;35961;1026;1030;4
/net/per610a/home/mvp/mvp_db/news7-lv/2010/2010_09_10_19_00/2010_09_10_19_00.mpg;Naoto KAN.jpg;22905;24941;35961;1145;1247;102
/net/per610a/home/mvp/mvp_db/news7-lv/2010/2010_09_11_19_00/2010_09_11_19_00.mpg;Ichiro OZAWA.jpg;1;13;35961;0;0;0
/net/per610a/home/mvp/mvp_db/news7-lv/2010/2010_09_11_19_00/2010_09_11_19_00.mpg;Ichiro OZAWA.jpg;2153;2173;35961;107;108;1
/net/per610a/home/mvp/mvp_db/news7-lv/2010/2010_09_11_19_00/2010_09_11_19_00.mpg;Ichiro OZAWA.jpg;2705;3113;35961;135;155;20
/net/per610a/home/mvp/mvp_db/news7-lv/2010/2010_09_11_19_00/2010_09_11_19_00.mpg;Yukio HATOYAMA.jpg;5581;6037;35961;279;302;23
/net/per610a/home/mvp/mvp_db/news7-lv/2010/2010_09_12_19_00/2010_09_12_19_00.mpg;Ichiro OZAWA.jpg;2897;3133;35961;144;156;12
/net/per610a/home/mvp/mvp_db/news7-lv/2010/2010_09_12_19_00/2010_09_12_19_00.mpg;Ichiro OZAWA.jpg;5461;5661;35961;273;283;10
/net/per610a/home/mvp/mvp_db/news7-lv/2010/2010_09_12_19_00/2010_09_12_19_00.mpg;Naoto KAN.jpg;5465;5661;35961;273;283;10
/net/per610a/home/mvp/mvp_db/news7-lv/2010/2010_09_13_19_00/2010_09_13_19_00.mpg;Naoto KAN.jpg;10369;10613;35961;518;530;12
/net/per610a/home/mvp/mvp_db/news7-lv/2010/2010_09_13_19_00/2010_09_13_19_00.mpg;Seiji MAEHARA.jpg;10781;11045;35961;539;552;13
/net/per610a/home/mvp/mvp_db/news7-lv/2010/2010_09_14_19_00/2010_09_14_19_00.mpg;Ichiro OZAWA.jpg;3429;3549;35961;171;177;6
/net/per610a/home/mvp/mvp_db/news7-lv/2010/2010_09_14_19_00/2010_09_14_19_00.mpg;Ichiro OZAWA.jpg;27561;27577;35961;1378;1379;1
/net/per610a/home/mvp/mvp_db/news7-lv/2010/2010_09_14_19_00/2010_09_14_19_00.mpg;Shintaro ISHIHARA.jpg;6729;9633;35961;336;481;145
/net/per610a/home/mvp/mvp_db/news7-lv/2010/2010_09_15_19_00/2010_09_15_19_00.mpg;Yoshihiko Noda.jpg;117;245;35961;5;12;7
/net/per610a/home/mvp/mvp_db/news7-lv/2010/2010_09_15_19_00/2010_09_15_19_00.mpg;Yoshihiko Noda.jpg;1777;1929;35961;88;96;8
/net/per610a/home/mvp/mvp_db/news7-lv/2010/2010_09_15_19_00/2010_09_15_19_00.mpg;Yoshihiko Noda.jpg;4513;4989;35961;225;249;24
/net/per610a/home/mvp/mvp_db/news7-lv/2010/2010_09_15_19_00/2010_09_15_19_00.mpg;Kenji Eda.jpg;117;205;35961;5;10;5
/net/per610a/home/mvp/mvp_db/news7-lv/2010/2010_09_15_19_00/2010_09_15_19_00.mpg;Kenji Eda.jpg;1777;1929;35961;88;96;8
/net/per610a/home/mvp/mvp_db/news7-lv/2010/2010_09_15_19_00/2010_09_15_19_00.mpg;Yukio HATOYAMA.jpg;117;205;35961;5;10;5
/net/per610a/home/mvp/mvp_db/news7-lv/2010/2010_09_15_19_00/2010_09_15_19_00.mpg;Yukio HATOYAMA.jpg;605;641;35961;30;32;2
/net/per610a/home/mvp/mvp_db/news7-lv/2010/2010_09_15_19_00/2010_09_15_19_00.mpg;Yukio HATOYAMA.jpg;13785;13841;35961;689;692;3
/net/per610a/home/mvp/mvp_db/news7-lv/2010/2010_09_15_19_00/2010_09_15_19_00.mpg;Yukio HATOYAMA.jpg;16449;16497;35961;822;825;3
/net/per610a/home/mvp/mvp_db/news7-lv/2010/2010_09_15_19_00/2010_09_15_19_00.mpg;Naoto KAN.jpg;809;865;35961;40;43;3
/net/per610a/home/mvp/mvp_db/news7-lv/2010/2010_09_15_19_00/2010_09_15_19_00.mpg;Naoto KAN.jpg;13521;13577;35961;676;679;3
/net/per610a/home/mvp/mvp_db/news7-lv/2010/2010_09_15_19_00/2010_09_15_19_00.mpg;Naoto KAN.jpg;15549;15641;35961;777;782;5
/net/per610a/home/mvp/mvp_db/news7-lv/2010/2010_09_15_19_00/2010_09_15_19_00.mpg;Naoto KAN.jpg;2493;2589;35961;124;129;5
/net/per610a/home/mvp/mvp_db/news7-lv/2010/2010_09_15_19_00/2010_09_15_19_00.mpg;Naoto KAN.jpg;3297;3857;35961;164;192;28
/net/per610a/home/mvp/mvp_db/news7-lv/2010/2010_09_15_19_00/2010_09_15_19_00.mpg;Naoto KAN.jpg;14497;14581;35961;725;729;4
/net/per610a/home/mvp/mvp_db/news7-lv/2010/2010_09_15_19_00/2010_09_15_19_00.mpg;Seiji MAEHARA.jpg;13229;13437;35961;661;672;11
/net/per610a/home/mvp/mvp_db/news7-lv/2010/2010_09_16_19_00/2010_09_16_19_00.mpg;Katsuya OKADA.jpg;153;389;35961;7;19;12
/net/per610a/home/mvp/mvp_db/news7-lv/2010/2010_09_16_19_00/2010_09_16_19_00.mpg;Katsuya OKADA.jpg;1789;1813;35961;89;90;1
/net/per610a/home/mvp/mvp_db/news7-lv/2010/2010_09_16_19_00/2010_09_16_19_00.mpg;Katsuya OKADA.jpg;3269;3545;35961;163;177;14
/net/per610a/home/mvp/mvp_db/news7-lv/2010/2010_09_16_19_00/2010_09_16_19_00.mpg;Katsuya OKADA.jpg;5577;5765;35961;278;288;10
/net/per610a/home/mvp/mvp_db/news7-lv/2010/2010_09_16_19_00/2010_09_16_19_00.mpg;Naoto KAN.jpg;2665;2881;35961;133;144;11
/net/per610a/home/mvp/mvp_db/news7-lv/2010/2010_09_16_19_00/2010_09_16_19_00.mpg;Naoto KAN.jpg;9573;10757;35961;478;538;60
/net/per610a/home/mvp/mvp_db/news7-lv/2010/2010_09_16_19_00/2010_09_16_19_00.mpg;Naoto KAN.jpg;12989;13493;35961;649;675;26
/net/per610a/home/mvp/mvp_db/news7-lv/2010/2010_09_16_19_00/2010_09_16_19_00.mpg;Yoshihiko Noda.jpg;3553;4109;35961;177;205;28
/net/per610a/home/mvp/mvp_db/news7-lv/2010/2010_09_17_19_00/2010_09_17_19_00.mpg;Seiji MAEHARA.jpg;2665;2721;35961;133;136;3
/net/per610a/home/mvp/mvp_db/news7-lv/2010/2010_09_17_19_00/2010_09_17_19_00.mpg;Seiji MAEHARA.jpg;2869;2905;35961;143;145;2
/net/per610a/home/mvp/mvp_db/news7-lv/2010/2010_09_17_19_00/2010_09_17_19_00.mpg;Seiji MAEHARA.jpg;18077;18285;35961;904;914;10
/net/per610a/home/mvp/mvp_db/news7-lv/2010/2010_09_17_19_00/2010_09_17_19_00.mpg;Naoto KAN.jpg;3661;3785;35961;183;189;6
/net/per610a/home/mvp/mvp_db/news7-lv/2010/2010_09_17_19_00/2010_09_17_19_00.mpg;Naoto KAN.jpg;26101;26321;35961;1305;1316;11
/net/per610a/home/mvp/mvp_db/news7-lv/2010/2010_09_17_19_00/2010_09_17_19_00.mpg;Katsuya OKADA.jpg;6449;6469;35961;322;323;1
/net/per610a/home/mvp/mvp_db/news7-lv/2010/2010_09_17_19_00/2010_09_17_19_00.mpg;Katsuya OKADA.jpg;7193;7261;35961;359;363;4
/net/per610a/home/mvp/mvp_db/news7-lv/2010/2010_09_17_19_00/2010_09_17_19_00.mpg;Katsuya OKADA.jpg;29781;30749;35961;1489;1538;49
/net/per610a/home/mvp/mvp_db/news7-lv/2010/2010_09_17_19_00/2010_09_17_19_00.mpg;Renho.jpg;13925;14329;35961;696;716;20
/net/per610a/home/mvp/mvp_db/news7-lv/2010/2010_09_17_19_00/2010_09_17_19_00.mpg;Bairi Kaieda.jpg;25325;25581;35961;1266;1279;13
/net/per610a/home/mvp/mvp_db/news7-lv/2010/2010_09_18_19_00/2010_09_18_19_00.mpg;Seiji MAEHARA.jpg;2061;2405;35961;103;120;17
/net/per610a/home/mvp/mvp_db/news7-lv/2010/2010_09_18_19_00/2010_09_18_19_00.mpg;Naoto KAN.jpg;2061;2405;35961;103;120;17
/net/per610a/home/mvp/mvp_db/news7-lv/2010/2010_09_18_19_00/2010_09_18_19_00.mpg;Sadakazu TANIGAKI.jpg;3833;3833;35961;191;191;0
/net/per610a/home/mvp/mvp_db/news7-lv/2010/2010_09_18_19_00/2010_09_18_19_00.mpg;Sadakazu TANIGAKI.jpg;4005;4197;35961;200;209;9
/net/per610a/home/mvp/mvp_db/news7-lv/2010/2010_09_19_19_00/2010_09_19_19_00.mpg;Seiji MAEHARA.jpg;3513;3949;35961;175;197;22
/net/per610a/home/mvp/mvp_db/news7-lv/2010/2010_09_19_19_00/2010_09_19_19_00.mpg;Seiji MAEHARA.jpg;4053;4109;35961;202;205;3
/net/per610a/home/mvp/mvp_db/news7-lv/2010/2010_09_19_19_00/2010_09_19_19_00.mpg;Yoshihiko Noda.jpg;8273;8401;35961;413;420;7
/net/per610a/home/mvp/mvp_db/news7-lv/2010/2010_09_21_19_00/2010_09_21_19_00.mpg;Naoto KAN.jpg;16701;17309;35961;835;865;30
/net/per610a/home/mvp/mvp_db/news7-lv/2010/2010_09_21_19_00/2010_09_21_19_00.mpg;Naoto KAN.jpg;17981;18197;35961;899;910;11
/net/per610a/home/mvp/mvp_db/news7-lv/2010/2010_09_22_19_00/2010_09_22_19_00.mpg;Sadakazu TANIGAKI.jpg;14913;15169;35961;746;758;12
/net/per610a/home/mvp/mvp_db/news7-lv/2010/2010_09_24_19_00/2010_09_24_19_00.mpg;Natsuo YAMAGUCHI.jpg;30613;31505;35961;1531;1576;45
/net/per610a/home/mvp/mvp_db/news7-lv/2010/2010_09_25_19_00/2010_09_25_19_00.mpg;Seiji MAEHARA.jpg;4333;4601;35961;216;230;14
/net/per610a/home/mvp/mvp_db/news7-lv/2010/2010_09_25_19_00/2010_09_25_19_00.mpg;Seiji MAEHARA.jpg;10809;11021;35961;540;551;11
/net/per610a/home/mvp/mvp_db/news7-lv/2010/2010_09_26_19_00/2010_09_26_19_00.mpg;Naoto KAN.jpg;4737;4829;35961;236;241;5
/net/per610a/home/mvp/mvp_db/news7-lv/2010/2010_09_26_19_00/2010_09_26_19_00.mpg;Naoto KAN.jpg;15829;16277;35961;791;814;23
/net/per610a/home/mvp/mvp_db/news7-lv/2010/2010_09_26_19_00/2010_09_26_19_00.mpg;Naoto KAN.jpg;16373;17033;35961;819;852;33
/net/per610a/home/mvp/mvp_db/news7-lv/2010/2010_09_26_19_00/2010_09_26_19_00.mpg;Naoto KAN.jpg;27989;28645;35961;1400;1433;33
/net/per610a/home/mvp/mvp_db/news7-lv/2010/2010_09_27_19_00/2010_09_27_19_00.mpg;Naoto KAN.jpg;16785;17165;35961;839;858;19
/net/per610a/home/mvp/mvp_db/news7-lv/2010/2010_09_27_19_00/2010_09_27_19_00.mpg;Naoto KAN.jpg;17393;17613;35961;870;881;11
/net/per610a/home/mvp/mvp_db/news7-lv/2010/2010_09_27_19_00/2010_09_27_19_00.mpg;Naoto KAN.jpg;18149;18521;35961;907;926;19
/net/per610a/home/mvp/mvp_db/news7-lv/2010/2010_09_27_19_00/2010_09_27_19_00.mpg;Naoto KAN.jpg;26133;26949;35961;1307;1348;41
/net/per610a/home/mvp/mvp_db/news7-lv/2010/2010_09_28_19_00/2010_09_28_19_00.mpg;Naoto KAN.jpg;14533;14717;35961;727;736;9
/net/per610a/home/mvp/mvp_db/news7-lv/2010/2010_10_01_19_00/2010_10_01_19_00.mpg;Katsuya OKADA.jpg;25317;25957;35961;1266;1298;32
/net/per610a/home/mvp/mvp_db/news7-lv/2010/2010_10_01_19_00/2010_10_01_19_00.mpg;Sadakazu TANIGAKI.jpg;26021;26541;35961;1301;1327;26
/net/per610a/home/mvp/mvp_db/news7-lv/2010/2010_10_01_19_00/2010_10_01_19_00.mpg;Natsuo YAMAGUCHI.jpg;26545;28577;35961;1327;1429;102
/net/per610a/home/mvp/mvp_db/news7-lv/2010/2010_10_03_19_00/2010_10_03_19_00.mpg;Naoto KAN.jpg;5509;5629;35961;275;281;6
/net/per610a/home/mvp/mvp_db/news7-lv/2010/2010_10_03_19_00/2010_10_03_19_00.mpg;Naoto KAN.jpg;5701;6017;35961;285;301;16
/net/per610a/home/mvp/mvp_db/news7-lv/2010/2010_10_03_19_00/2010_10_03_19_00.mpg;Katsuya OKADA.jpg;7617;8353;35961;381;417;36
/net/per610a/home/mvp/mvp_db/news7-lv/2010/2010_10_03_19_00/2010_10_03_19_00.mpg;Sadakazu TANIGAKI.jpg;8409;9109;35961;420;455;35
/net/per610a/home/mvp/mvp_db/news7-lv/2010/2010_10_04_19_00/2010_10_04_19_00.mpg;Ichiro OZAWA.jpg;6257;6765;35961;313;338;25
/net/per610a/home/mvp/mvp_db/news7-lv/2010/2010_10_04_19_00/2010_10_04_19_00.mpg;Ichiro OZAWA.jpg;7193;7705;35961;359;385;26
/net/per610a/home/mvp/mvp_db/news7-lv/2010/2010_10_04_19_00/2010_10_04_19_00.mpg;Ichiro OZAWA.jpg;9009;9209;35961;450;460;10
/net/per610a/home/mvp/mvp_db/news7-lv/2010/2010_10_04_19_00/2010_10_04_19_00.mpg;Ichiro OZAWA.jpg;9469;9829;35961;473;491;18
/net/per610a/home/mvp/mvp_db/news7-lv/2010/2010_10_04_19_00/2010_10_04_19_00.mpg;Ichiro OZAWA.jpg;13509;14073;35961;675;704;29
/net/per610a/home/mvp/mvp_db/news7-lv/2010/2010_10_04_19_00/2010_10_04_19_00.mpg;Ichiro OZAWA.jpg;24977;25193;35961;1249;1260;11
/net/per610a/home/mvp/mvp_db/news7-lv/2010/2010_10_04_19_00/2010_10_04_19_00.mpg;Ichiro OZAWA.jpg;26229;26373;35961;1312;1319;7
/net/per610a/home/mvp/mvp_db/news7-lv/2010/2010_10_04_19_00/2010_10_04_19_00.mpg;Ichiro OZAWA.jpg;26573;27657;35961;1329;1383;54
/net/per610a/home/mvp/mvp_db/news7-lv/2010/2010_10_04_19_00/2010_10_04_19_00.mpg;Ichiro OZAWA.jpg;28781;29049;35961;1439;1453;14
/net/per610a/home/mvp/mvp_db/news7-lv/2010/2010_10_04_19_00/2010_10_04_19_00.mpg;Ichiro OZAWA.jpg;29409;29465;35961;1471;1474;3
/net/per610a/home/mvp/mvp_db/news7-lv/2010/2010_10_04_19_00/2010_10_04_19_00.mpg;Ichiro OZAWA.jpg;29721;29837;35961;1486;1492;6
/net/per610a/home/mvp/mvp_db/news7-lv/2010/2010_10_04_19_00/2010_10_04_19_00.mpg;Natsuo YAMAGUCHI.jpg;23393;23881;35961;1170;1194;24
/net/per610a/home/mvp/mvp_db/news7-lv/2010/2010_10_05_19_00/2010_10_05_19_00.mpg;Naoto KAN.jpg;445;613;35961;22;30;8
/net/per610a/home/mvp/mvp_db/news7-lv/2010/2010_10_05_19_00/2010_10_05_19_00.mpg;Naoto KAN.jpg;13869;13869;35961;693;693;0
/net/per610a/home/mvp/mvp_db/news7-lv/2010/2010_10_05_19_00/2010_10_05_19_00.mpg;Naoto KAN.jpg;15809;15881;35961;790;794;4
/net/per610a/home/mvp/mvp_db/news7-lv/2010/2010_10_05_19_00/2010_10_05_19_00.mpg;Naoto KAN.jpg;18901;18965;35961;945;948;3
/net/per610a/home/mvp/mvp_db/news7-lv/2010/2010_10_05_19_00/2010_10_05_19_00.mpg;Seiji MAEHARA.jpg;24861;25717;35961;1243;1286;43
/net/per610a/home/mvp/mvp_db/news7-lv/2010/2010_10_06_19_00/2010_10_06_19_00.mpg;Natsuo YAMAGUCHI.jpg;5717;5825;35961;286;291;5
/net/per610a/home/mvp/mvp_db/news7-lv/2010/2010_10_06_19_00/2010_10_06_19_00.mpg;Natsuo YAMAGUCHI.jpg;22585;22897;35961;1129;1145;16
/net/per610a/home/mvp/mvp_db/news7-lv/2010/2010_10_06_19_00/2010_10_06_19_00.mpg;Naoto KAN.jpg;16389;16453;35961;819;823;4
/net/per610a/home/mvp/mvp_db/news7-lv/2010/2010_10_06_19_00/2010_10_06_19_00.mpg;Naoto KAN.jpg;35573;35957;35961;1779;1798;19
/net/per610a/home/mvp/mvp_db/news7-lv/2010/2010_10_08_19_00/2010_10_08_19_00.mpg;Bairi Kaieda.jpg;18449;18609;35961;922;930;8
/net/per610a/home/mvp/mvp_db/news7-lv/2010/2010_10_09_19_00/2010_10_09_19_00.mpg;Yoshihiko Noda.jpg;653;881;35961;32;44;12
/net/per610a/home/mvp/mvp_db/news7-lv/2010/2010_10_09_19_00/2010_10_09_19_00.mpg;Yoshihiko Noda.jpg;6885;7241;35961;344;362;18
/net/per610a/home/mvp/mvp_db/news7-lv/2010/2010_10_09_19_00/2010_10_09_19_00.mpg;Yoshihiko Noda.jpg;7481;7785;35961;374;389;15
/net/per610a/home/mvp/mvp_db/news7-lv/2010/2010_10_09_19_00/2010_10_09_19_00.mpg;Yoshihiko Noda.jpg;8465;8717;35961;423;436;13
/net/per610a/home/mvp/mvp_db/news7-lv/2010/2010_10_09_19_00/2010_10_09_19_00.mpg;Yoshihiko Noda.jpg;10565;10865;35961;528;543;15
/net/per610a/home/mvp/mvp_db/news7-lv/2010/2010_10_09_19_00/2010_10_09_19_00.mpg;Kenji Eda.jpg;653;877;35961;32;43;11
/net/per610a/home/mvp/mvp_db/news7-lv/2010/2010_10_09_19_00/2010_10_09_19_00.mpg;Kenji Eda.jpg;7481;7649;35961;374;382;8
/net/per610a/home/mvp/mvp_db/news7-lv/2010/2010_10_09_19_00/2010_10_09_19_00.mpg;Kenji Eda.jpg;8465;8717;35961;423;436;13
/net/per610a/home/mvp/mvp_db/news7-lv/2010/2010_10_09_19_00/2010_10_09_19_00.mpg;Kenji Eda.jpg;10509;10865;35961;525;543;18
/net/per610a/home/mvp/mvp_db/news7-lv/2010/2010_10_09_19_00/2010_10_09_19_00.mpg;Naoto KAN.jpg;3105;3253;35961;155;162;7
/net/per610a/home/mvp/mvp_db/news7-lv/2010/2010_10_09_19_00/2010_10_09_19_00.mpg;Naoto KAN.jpg;4161;4925;35961;208;246;38
/net/per610a/home/mvp/mvp_db/news7-lv/2010/2010_10_12_19_00/2010_10_12_19_00.mpg;Katsuya OKADA.jpg;7949;8801;35961;397;440;43
/net/per610a/home/mvp/mvp_db/news7-lv/2010/2010_10_12_19_00/2010_10_12_19_00.mpg;Naoto KAN.jpg;21601;21681;35961;1080;1084;4
/net/per610a/home/mvp/mvp_db/news7-lv/2010/2010_10_12_19_00/2010_10_12_19_00.mpg;Naoto KAN.jpg;23465;24261;35961;1173;1213;40
/net/per610a/home/mvp/mvp_db/news7-lv/2010/2010_10_12_19_00/2010_10_12_19_00.mpg;Ichiro OZAWA.jpg;22225;22361;35961;1111;1118;7
/net/per610a/home/mvp/mvp_db/news7-lv/2010/2010_10_12_19_00/2010_10_12_19_00.mpg;Ichiro OZAWA.jpg;22381;22729;35961;1119;1137;18
/net/per610a/home/mvp/mvp_db/news7-lv/2010/2010_10_14_19_00/2010_10_14_19_00.mpg;Katsuya OKADA.jpg;20157;20365;35961;1008;1018;10
/net/per610a/home/mvp/mvp_db/news7-lv/2010/2010_10_14_19_00/2010_10_14_19_00.mpg;Katsuya OKADA.jpg;20481;21221;35961;1024;1061;37
/net/per610a/home/mvp/mvp_db/news7-lv/2010/2010_10_14_19_00/2010_10_14_19_00.mpg;Seiji MAEHARA.jpg;22217;22613;35961;1111;1131;20
/net/per610a/home/mvp/mvp_db/news7-lv/2010/2010_10_15_19_00/2010_10_15_19_00.mpg;Ichiro OZAWA.jpg;13881;14293;35961;694;715;21
/net/per610a/home/mvp/mvp_db/news7-lv/2010/2010_10_15_19_00/2010_10_15_19_00.mpg;Ichiro OZAWA.jpg;14893;15461;35961;745;773;28
/net/per610a/home/mvp/mvp_db/news7-lv/2010/2010_10_19_19_00/2010_10_19_19_00.mpg;Bairi Kaieda.jpg;9897;10353;35961;495;517;22
/net/per610a/home/mvp/mvp_db/news7-lv/2010/2010_10_19_19_00/2010_10_19_19_00.mpg;Sadakazu TANIGAKI.jpg;23865;24017;35961;1193;1201;8
/net/per610a/home/mvp/mvp_db/news7-lv/2010/2010_10_20_19_00/2010_10_20_19_00.mpg;Naoto KAN.jpg;6733;7313;35961;336;365;29
/net/per610a/home/mvp/mvp_db/news7-lv/2010/2010_10_20_19_00/2010_10_20_19_00.mpg;Naoto KAN.jpg;8733;8833;35961;436;441;5
/net/per610a/home/mvp/mvp_db/news7-lv/2010/2010_10_20_19_00/2010_10_20_19_00.mpg;Naoto KAN.jpg;9125;9525;35961;456;476;20
/net/per610a/home/mvp/mvp_db/news7-lv/2010/2010_10_22_19_00/2010_10_22_19_00.mpg;Shintaro ISHIHARA.jpg;20945;21769;35961;1047;1089;42
/net/per610a/home/mvp/mvp_db/news7-lv/2010/2010_10_22_19_00/2010_10_22_19_00.mpg;Shintaro ISHIHARA.jpg;23949;24217;35961;1198;1211;13
/net/per610a/home/mvp/mvp_db/news7-lv/2010/2010_10_23_19_00/2010_10_23_19_00.mpg;Yoshihiko Noda.jpg;16577;16641;35961;829;832;3
/net/per610a/home/mvp/mvp_db/news7-lv/2010/2010_10_23_19_00/2010_10_23_19_00.mpg;Yoshihiko Noda.jpg;17393;17461;35961;870;873;3
/net/per610a/home/mvp/mvp_db/news7-lv/2010/2010_10_23_19_00/2010_10_23_19_00.mpg;Yoshihiko Noda.jpg;19033;19245;35961;952;962;10
/net/per610a/home/mvp/mvp_db/news7-lv/2010/2010_10_25_19_00/2010_10_25_19_00.mpg;Ichiro OZAWA.jpg;7005;7405;35961;350;370;20
/net/per610a/home/mvp/mvp_db/news7-lv/2010/2010_10_25_19_00/2010_10_25_19_00.mpg;Ichiro OZAWA.jpg;31469;31485;35961;1574;1575;1
/net/per610a/home/mvp/mvp_db/news7-lv/2010/2010_10_25_19_00/2010_10_25_19_00.mpg;Katsuya OKADA.jpg;8401;8573;35961;420;428;8
/net/per610a/home/mvp/mvp_db/news7-lv/2010/2010_10_25_19_00/2010_10_25_19_00.mpg;Sadakazu TANIGAKI.jpg;9545;10149;35961;477;507;30
/net/per610a/home/mvp/mvp_db/news7-lv/2010/2010_10_25_19_00/2010_10_25_19_00.mpg;Yoshihiko Noda.jpg;13837;13921;35961;692;696;4
/net/per610a/home/mvp/mvp_db/news7-lv/2010/2010_10_25_19_00/2010_10_25_19_00.mpg;Yoshihiko Noda.jpg;15105;15173;35961;755;759;4
/net/per610a/home/mvp/mvp_db/news7-lv/2010/2010_10_26_19_00/2010_10_26_19_00.mpg;Naoto KAN.jpg;8089;8233;35961;404;411;7
/net/per610a/home/mvp/mvp_db/news7-lv/2010/2010_10_27_19_00/2010_10_27_19_00.mpg;Shizuka KAMEI.jpg;25949;26285;35961;1298;1314;16
/net/per610a/home/mvp/mvp_db/news7-lv/2010/2010_10_27_19_00/2010_10_27_19_00.mpg;Seiji MAEHARA.jpg;27697;27953;35961;1385;1398;13
/net/per610a/home/mvp/mvp_db/news7-lv/2010/2010_10_29_19_00/2010_10_29_19_00.mpg;Naoto KAN.jpg;7145;7145;35961;357;357;0
/net/per610a/home/mvp/mvp_db/news7-lv/2010/2010_10_29_19_00/2010_10_29_19_00.mpg;Naoto KAN.jpg;7249;7453;35961;362;372;10
/net/per610a/home/mvp/mvp_db/news7-lv/2010/2010_10_29_19_00/2010_10_29_19_00.mpg;Naoto KAN.jpg;8337;8453;35961;417;422;5
/net/per610a/home/mvp/mvp_db/news7-lv/2010/2010_10_29_19_00/2010_10_29_19_00.mpg;Naoto KAN.jpg;10277;10365;35961;514;518;4
/net/per610a/home/mvp/mvp_db/news7-lv/2010/2010_10_29_19_00/2010_10_29_19_00.mpg;Naoto KAN.jpg;10445;10805;35961;522;540;18
/net/per610a/home/mvp/mvp_db/news7-lv/2010/2010_10_30_19_00/2010_10_30_19_00.mpg;Yuichiro Tamaki.png;22601;22729;35961;1130;1137;7
/net/per610a/home/mvp/mvp_db/news7-lv/2010/2010_10_30_19_00/2010_10_30_19_00.mpg;Yuichiro Tamaki.png;23621;23665;35961;1181;1183;2
/net/per610a/home/mvp/mvp_db/news7-lv/2010/2010_10_30_19_00/2010_10_30_19_00.mpg;Yuichiro Tamaki.png;25961;26165;35961;1298;1308;10
/net/per610a/home/mvp/mvp_db/news7-lv/2010/2010_11_02_19_00/2010_11_02_19_00.mpg;Seiji MAEHARA.jpg;1681;1865;35961;84;93;9
/net/per610a/home/mvp/mvp_db/news7-lv/2010/2010_11_02_19_00/2010_11_02_19_00.mpg;Seiji MAEHARA.jpg;2269;2829;35961;113;141;28
/net/per610a/home/mvp/mvp_db/news7-lv/2010/2010_11_02_19_00/2010_11_02_19_00.mpg;YUriko Koike.jpg;6617;6985;35961;331;349;18
/net/per610a/home/mvp/mvp_db/news7-lv/2010/2010_11_02_19_00/2010_11_02_19_00.mpg;Naoto KAN.jpg;8209;8509;35961;410;425;15
/net/per610a/home/mvp/mvp_db/news7-lv/2010/2010_11_02_19_00/2010_11_02_19_00.mpg;Yoshihiko Noda.jpg;10961;11173;35961;548;558;10
/net/per610a/home/mvp/mvp_db/news7-lv/2010/2010_11_02_19_00/2010_11_02_19_00.mpg;Katsuya OKADA.jpg;12061;12101;35961;603;605;2
/net/per610a/home/mvp/mvp_db/news7-lv/2010/2010_11_02_19_00/2010_11_02_19_00.mpg;Katsuya OKADA.jpg;13457;13705;35961;673;685;12
/net/per610a/home/mvp/mvp_db/news7-lv/2010/2010_11_03_19_00/2010_11_03_19_00.mpg;Seiji MAEHARA.jpg;14441;14937;35961;722;747;25
/net/per610a/home/mvp/mvp_db/news7-lv/2010/2010_11_03_19_00/2010_11_03_19_00.mpg;Naoto KAN.jpg;15061;15261;35961;753;763;10
/net/per610a/home/mvp/mvp_db/news7-lv/2010/2010_11_03_19_00/2010_11_03_19_00.mpg;Ichiro OZAWA.jpg;19353;20617;35961;968;1031;63
/net/per610a/home/mvp/mvp_db/news7-lv/2010/2010_11_03_19_00/2010_11_03_19_00.mpg;Ichiro OZAWA.jpg;20689;21285;35961;1034;1064;30
/net/per610a/home/mvp/mvp_db/news7-lv/2010/2010_11_04_19_00/2010_11_04_19_00.mpg;Ichiro OZAWA.jpg;13341;13349;35961;667;667;0
/net/per610a/home/mvp/mvp_db/news7-lv/2010/2010_11_04_19_00/2010_11_04_19_00.mpg;Ichiro OZAWA.jpg;15085;15101;35961;754;755;1
/net/per610a/home/mvp/mvp_db/news7-lv/2010/2010_11_04_19_00/2010_11_04_19_00.mpg;Ichiro OZAWA.jpg;15337;15753;35961;767;788;21
/net/per610a/home/mvp/mvp_db/news7-lv/2010/2010_11_04_19_00/2010_11_04_19_00.mpg;Katsuya OKADA.jpg;13433;13761;35961;672;688;16
/net/per610a/home/mvp/mvp_db/news7-lv/2010/2010_11_04_19_00/2010_11_04_19_00.mpg;Sadakazu TANIGAKI.jpg;16913;17173;35961;846;859;13
/net/per610a/home/mvp/mvp_db/news7-lv/2010/2010_11_05_19_00/2010_11_05_19_00.mpg;Kenji Eda.jpg;31385;31429;35957;1570;1572;2
/net/per610a/home/mvp/mvp_db/news7-lv/2010/2010_11_05_19_00/2010_11_05_19_00.mpg;Kenji Eda.jpg;31537;31629;35957;1577;1582;5
/net/per610a/home/mvp/mvp_db/news7-lv/2010/2010_11_06_19_00/2010_11_06_19_00.mpg;Katsuya OKADA.jpg;9465;11385;35961;473;569;96
/net/per610a/home/mvp/mvp_db/news7-lv/2010/2010_11_07_19_00/2010_11_07_19_00.mpg;Seiji MAEHARA.jpg;7937;8369;35961;397;418;21
/net/per610a/home/mvp/mvp_db/news7-lv/2010/2010_11_08_19_00/2010_11_08_19_00.mpg;Naoto KAN.jpg;15709;16113;35961;785;806;21
/net/per610a/home/mvp/mvp_db/news7-lv/2010/2010_11_08_19_00/2010_11_08_19_00.mpg;Naoto KAN.jpg;17685;17761;35961;884;888;4
/net/per610a/home/mvp/mvp_db/news7-lv/2010/2010_11_08_19_00/2010_11_08_19_00.mpg;Naoto KAN.jpg;17833;17881;35961;892;894;2
/net/per610a/home/mvp/mvp_db/news7-lv/2010/2010_11_08_19_00/2010_11_08_19_00.mpg;Naoto KAN.jpg;22457;22761;35961;1123;1138;15
/net/per610a/home/mvp/mvp_db/news7-lv/2010/2010_11_09_19_00/2010_11_09_19_00.mpg;Natsuo YAMAGUCHI.jpg;201;405;35961;10;20;10
/net/per610a/home/mvp/mvp_db/news7-lv/2010/2010_11_09_19_00/2010_11_09_19_00.mpg;Natsuo YAMAGUCHI.jpg;2033;2469;35961;101;123;22
/net/per610a/home/mvp/mvp_db/news7-lv/2010/2010_11_09_19_00/2010_11_09_19_00.mpg;Naoto KAN.jpg;16957;17089;35961;848;854;6
/net/per610a/home/mvp/mvp_db/news7-lv/2010/2010_11_10_19_00/2010_11_10_19_00.mpg;Seiji MAEHARA.jpg;22521;22581;35961;1126;1129;3
/net/per610a/home/mvp/mvp_db/news7-lv/2010/2010_11_10_19_00/2010_11_10_19_00.mpg;Seiji MAEHARA.jpg;22793;23137;35961;1140;1157;17
/net/per610a/home/mvp/mvp_db/news7-lv/2010/2010_11_11_19_00/2010_11_11_19_00.mpg;Naoto KAN.jpg;14557;14981;35961;728;749;21
/net/per610a/home/mvp/mvp_db/news7-lv/2010/2010_11_11_19_00/2010_11_11_19_00.mpg;Naoto KAN.jpg;16053;16225;35961;803;811;8
/net/per610a/home/mvp/mvp_db/news7-lv/2010/2010_11_11_19_00/2010_11_11_19_00.mpg;Naoto KAN.jpg;15145;15341;35961;757;767;10
/net/per610a/home/mvp/mvp_db/news7-lv/2010/2010_11_11_19_00/2010_11_11_19_00.mpg;Naoto KAN.jpg;16229;16485;35961;811;824;13
/net/per610a/home/mvp/mvp_db/news7-lv/2010/2010_11_11_19_00/2010_11_11_19_00.mpg;Seiji MAEHARA.jpg;18249;18361;35961;912;918;6
/net/per610a/home/mvp/mvp_db/news7-lv/2010/2010_11_11_19_00/2010_11_11_19_00.mpg;Seiji MAEHARA.jpg;19613;19685;35961;981;984;3
/net/per610a/home/mvp/mvp_db/news7-lv/2010/2010_11_11_19_00/2010_11_11_19_00.mpg;Seiji MAEHARA.jpg;19901;19997;35961;995;1000;5
/net/per610a/home/mvp/mvp_db/news7-lv/2010/2010_11_12_19_00/2010_11_12_19_00.mpg;Seiji MAEHARA.jpg;3709;4321;35961;185;216;31
/net/per610a/home/mvp/mvp_db/news7-lv/2010/2010_11_13_19_00/2010_11_13_19_00.mpg;Naoto KAN.jpg;1749;1781;35961;87;89;2
/net/per610a/home/mvp/mvp_db/news7-lv/2010/2010_11_13_19_00/2010_11_13_19_00.mpg;Naoto KAN.jpg;24073;24117;35961;1204;1206;2
/net/per610a/home/mvp/mvp_db/news7-lv/2010/2010_11_13_19_00/2010_11_13_19_00.mpg;Seiji MAEHARA.jpg;10697;10701;35961;535;535;0
/net/per610a/home/mvp/mvp_db/news7-lv/2010/2010_11_13_19_00/2010_11_13_19_00.mpg;Seiji MAEHARA.jpg;10773;10913;35961;538;545;7
/net/per610a/home/mvp/mvp_db/news7-lv/2010/2010_11_15_19_00/2010_11_15_19_00.mpg;Yukio EDANO.jpg;16601;16833;35961;830;842;12
/net/per610a/home/mvp/mvp_db/news7-lv/2010/2010_11_15_19_00/2010_11_15_19_00.mpg;Toru Hashimoto.jpg;20497;20545;35961;1025;1027;2
/net/per610a/home/mvp/mvp_db/news7-lv/2010/2010_11_15_19_00/2010_11_15_19_00.mpg;Toru Hashimoto.jpg;20617;20957;35961;1031;1048;17
/net/per610a/home/mvp/mvp_db/news7-lv/2010/2010_11_15_19_00/2010_11_15_19_00.mpg;Sadakazu TANIGAKI.jpg;29821;29993;35961;1491;1500;9
/net/per610a/home/mvp/mvp_db/news7-lv/2010/2010_11_16_19_00/2010_11_16_19_00.mpg;Nariaki Nakayama.png;10809;11293;35961;540;564;24
/net/per610a/home/mvp/mvp_db/news7-lv/2010/2010_11_17_19_00/2010_11_17_19_00.mpg;Shinzo ABE.jpg;9617;9985;35961;481;499;18
/net/per610a/home/mvp/mvp_db/news7-lv/2010/2010_11_20_19_00/2010_11_20_19_00.mpg;Naoto KAN.jpg;2845;3001;35961;142;150;8
/net/per610a/home/mvp/mvp_db/news7-lv/2010/2010_11_21_19_00/2010_11_21_19_00.mpg;Sadakazu TANIGAKI.jpg;8221;9093;35961;411;454;43
/net/per610a/home/mvp/mvp_db/news7-lv/2010/2010_11_21_19_00/2010_11_21_19_00.mpg;Shizuka KAMEI.jpg;9101;9485;35961;455;474;19
/net/per610a/home/mvp/mvp_db/news7-lv/2010/2010_11_21_19_00/2010_11_21_19_00.mpg;Katsuya OKADA.jpg;9557;10181;35961;478;509;31
/net/per610a/home/mvp/mvp_db/news7-lv/2010/2010_11_22_19_00/2010_11_22_19_00.mpg;Naoto KAN.jpg;141;221;35961;7;11;4
/net/per610a/home/mvp/mvp_db/news7-lv/2010/2010_11_22_19_00/2010_11_22_19_00.mpg;Naoto KAN.jpg;4593;4721;35961;229;236;7
/net/per610a/home/mvp/mvp_db/news7-lv/2010/2010_11_22_19_00/2010_11_22_19_00.mpg;Naoto KAN.jpg;4801;4845;35961;240;242;2
/net/per610a/home/mvp/mvp_db/news7-lv/2010/2010_11_22_19_00/2010_11_22_19_00.mpg;Naoto KAN.jpg;11093;11153;35961;554;557;3
/net/per610a/home/mvp/mvp_db/news7-lv/2010/2010_11_24_19_00/2010_11_24_19_00.mpg;Seiji MAEHARA.jpg;19109;19473;35961;955;974;19
/net/per610a/home/mvp/mvp_db/news7-lv/2010/2010_11_24_19_00/2010_11_24_19_00.mpg;Kazuo SHII.jpg;19889;20041;35961;994;1002;8
/net/per610a/home/mvp/mvp_db/news7-lv/2010/2010_11_24_19_00/2010_11_24_19_00.mpg;Kazuo SHII.jpg;20373;20429;35961;1019;1021;2
/net/per610a/home/mvp/mvp_db/news7-lv/2010/2010_11_24_19_00/2010_11_24_19_00.mpg;Sadakazu TANIGAKI.jpg;20273;20369;35961;1014;1018;4
/net/per610a/home/mvp/mvp_db/news7-lv/2010/2010_11_25_19_00/2010_11_25_19_00.mpg;Naoto KAN.jpg;11969;12065;35961;598;603;5
/net/per610a/home/mvp/mvp_db/news7-lv/2010/2010_11_25_19_00/2010_11_25_19_00.mpg;Sadakazu TANIGAKI.jpg;26997;27137;35961;1350;1357;7
/net/per610a/home/mvp/mvp_db/news7-lv/2010/2010_11_26_19_00/2010_11_26_19_00.mpg;Sadakazu TANIGAKI.jpg;13657;13753;35961;683;688;5
/net/per610a/home/mvp/mvp_db/news7-lv/2010/2010_11_27_19_00/2010_11_27_19_00.mpg;Seiji MAEHARA.jpg;9733;11185;35961;486;559;73
/net/per610a/home/mvp/mvp_db/news7-lv/2010/2010_11_27_19_00/2010_11_27_19_00.mpg;Naoto KAN.jpg;12453;13537;35961;622;677;55
/net/per610a/home/mvp/mvp_db/news7-lv/2010/2010_11_27_19_00/2010_11_27_19_00.mpg;Yukio HATOYAMA.jpg;12453;12721;35961;622;636;14
/net/per610a/home/mvp/mvp_db/news7-lv/2010/2010_11_27_19_00/2010_11_27_19_00.mpg;Katsuya OKADA.jpg;14449;15637;35961;722;782;60
/net/per610a/home/mvp/mvp_db/news7-lv/2010/2010_12_01_19_00/2010_12_01_19_00.mpg;Shizuka KAMEI.jpg;16821;16877;35961;841;844;3
/net/per610a/home/mvp/mvp_db/news7-lv/2010/2010_12_01_19_00/2010_12_01_19_00.mpg;Shizuka KAMEI.jpg;18389;18769;35961;919;938;19
/net/per610a/home/mvp/mvp_db/news7-lv/2010/2010_12_01_19_00/2010_12_01_19_00.mpg;Katsuya OKADA.jpg;17709;17781;35961;885;889;4
/net/per610a/home/mvp/mvp_db/news7-lv/2010/2010_12_01_19_00/2010_12_01_19_00.mpg;Katsuya OKADA.jpg;17849;17953;35961;892;898;6
/net/per610a/home/mvp/mvp_db/news7-lv/2010/2010_12_02_19_00/2010_12_02_19_00.mpg;Yoshihiko Noda.jpg;6193;6717;35961;309;336;27
/net/per610a/home/mvp/mvp_db/news7-lv/2010/2010_12_03_19_00/2010_12_03_19_00.mpg;Naoto KAN.jpg;9941;9965;35961;497;498;1
/net/per610a/home/mvp/mvp_db/news7-lv/2010/2010_12_03_19_00/2010_12_03_19_00.mpg;Naoto KAN.jpg;10109;10253;35961;505;512;7
/net/per610a/home/mvp/mvp_db/news7-lv/2010/2010_12_03_19_00/2010_12_03_19_00.mpg;Naoto KAN.jpg;13805;13829;35961;690;691;1
/net/per610a/home/mvp/mvp_db/news7-lv/2010/2010_12_03_19_00/2010_12_03_19_00.mpg;Naoto KAN.jpg;13925;14401;35961;696;720;24
/net/per610a/home/mvp/mvp_db/news7-lv/2010/2010_12_03_19_00/2010_12_03_19_00.mpg;Naoto KAN.jpg;14865;14885;35961;743;744;1
/net/per610a/home/mvp/mvp_db/news7-lv/2010/2010_12_03_19_00/2010_12_03_19_00.mpg;Seiji MAEHARA.jpg;13285;13721;35961;664;686;22
/net/per610a/home/mvp/mvp_db/news7-lv/2010/2010_12_04_19_00/2010_12_04_19_00.mpg;Sadakazu TANIGAKI.jpg;25249;26957;35961;1263;1348;85
/net/per610a/home/mvp/mvp_db/news7-lv/2010/2010_12_06_19_00/2010_12_06_19_00.mpg;Seiji MAEHARA.jpg;7137;7549;35961;357;377;20
/net/per610a/home/mvp/mvp_db/news7-lv/2010/2010_12_06_19_00/2010_12_06_19_00.mpg;Seiji MAEHARA.jpg;8305;8705;35961;415;435;20
/net/per610a/home/mvp/mvp_db/news7-lv/2010/2010_12_06_19_00/2010_12_06_19_00.mpg;Naoto KAN.jpg;12581;12909;35961;629;645;16
/net/per610a/home/mvp/mvp_db/news7-lv/2010/2010_12_06_19_00/2010_12_06_19_00.mpg;Naoto KAN.jpg;13557;13837;35961;678;692;14
/net/per610a/home/mvp/mvp_db/news7-lv/2010/2010_12_06_19_00/2010_12_06_19_00.mpg;Naoto KAN.jpg;14701;15125;35961;735;756;21
/net/per610a/home/mvp/mvp_db/news7-lv/2010/2010_12_06_19_00/2010_12_06_19_00.mpg;Naoto KAN.jpg;15385;15533;35961;769;777;8
/net/per610a/home/mvp/mvp_db/news7-lv/2010/2010_12_06_19_00/2010_12_06_19_00.mpg;Naoto KAN.jpg;15825;16045;35961;791;802;11
/net/per610a/home/mvp/mvp_db/news7-lv/2010/2010_12_06_19_00/2010_12_06_19_00.mpg;Naoto KAN.jpg;16949;17465;35961;847;873;26
/net/per610a/home/mvp/mvp_db/news7-lv/2010/2010_12_07_19_00/2010_12_07_19_00.mpg;Bairi Kaieda.jpg;17837;19117;35961;892;956;64
/net/per610a/home/mvp/mvp_db/news7-lv/2010/2010_12_07_19_00/2010_12_07_19_00.mpg;Naoto KAN.jpg;25985;26205;35961;1299;1310;11
/net/per610a/home/mvp/mvp_db/news7-lv/2010/2010_12_07_19_00/2010_12_07_19_00.mpg;Naoto KAN.jpg;26545;27293;35961;1327;1365;38
/net/per610a/home/mvp/mvp_db/news7-lv/2010/2010_12_09_19_00/2010_12_09_19_00.mpg;Naoto KAN.jpg;27741;28161;35961;1387;1408;21
/net/per610a/home/mvp/mvp_db/news7-lv/2010/2010_12_10_19_00/2010_12_10_19_00.mpg;Yukio HATOYAMA.jpg;3721;3961;35961;186;198;12
/net/per610a/home/mvp/mvp_db/news7-lv/2010/2010_12_10_19_00/2010_12_10_19_00.mpg;Yukio HATOYAMA.jpg;6861;6965;35961;343;348;5
/net/per610a/home/mvp/mvp_db/news7-lv/2010/2010_12_10_19_00/2010_12_10_19_00.mpg;Yukio HATOYAMA.jpg;11333;11349;35961;566;567;1
/net/per610a/home/mvp/mvp_db/news7-lv/2010/2010_12_10_19_00/2010_12_10_19_00.mpg;Ichiro OZAWA.jpg;13277;14005;35961;664;700;36
/net/per610a/home/mvp/mvp_db/news7-lv/2010/2010_12_10_19_00/2010_12_10_19_00.mpg;Shintaro ISHIHARA.jpg;16345;16905;35961;817;845;28
/net/per610a/home/mvp/mvp_db/news7-lv/2010/2010_12_10_19_00/2010_12_10_19_00.mpg;Naoto KAN.jpg;18221;18589;35961;911;929;18
/net/per610a/home/mvp/mvp_db/news7-lv/2010/2010_12_10_19_00/2010_12_10_19_00.mpg;Naoto KAN.jpg;30893;31389;35961;1545;1570;25
/net/per610a/home/mvp/mvp_db/news7-lv/2010/2010_12_11_19_00/2010_12_11_19_00.mpg;Ichiro OZAWA.jpg;1217;1945;35961;60;97;37
/net/per610a/home/mvp/mvp_db/news7-lv/2010/2010_12_11_19_00/2010_12_11_19_00.mpg;Ichiro OZAWA.jpg;2121;3213;35961;106;160;54
/net/per610a/home/mvp/mvp_db/news7-lv/2010/2010_12_11_19_00/2010_12_11_19_00.mpg;Naoto KAN.jpg;4601;5093;35961;230;254;24
/net/per610a/home/mvp/mvp_db/news7-lv/2010/2010_12_11_19_00/2010_12_11_19_00.mpg;Naoto KAN.jpg;6281;7217;35961;314;361;47
/net/per610a/home/mvp/mvp_db/news7-lv/2010/2010_12_12_19_00/2010_12_12_19_00.mpg;Katsuya OKADA.jpg;1649;1957;35961;82;97;15
/net/per610a/home/mvp/mvp_db/news7-lv/2010/2010_12_12_19_00/2010_12_12_19_00.mpg;Yukio HATOYAMA.jpg;2169;2605;35961;108;130;22
/net/per610a/home/mvp/mvp_db/news7-lv/2010/2010_12_12_19_00/2010_12_12_19_00.mpg;Ichiro OZAWA.jpg;2169;2605;35961;108;130;22
/net/per610a/home/mvp/mvp_db/news7-lv/2010/2010_12_12_19_00/2010_12_12_19_00.mpg;Yoshihiko Noda.jpg;3069;3073;35961;153;153;0
/net/per610a/home/mvp/mvp_db/news7-lv/2010/2010_12_12_19_00/2010_12_12_19_00.mpg;Yoshihiko Noda.jpg;4641;4881;35961;232;244;12
/net/per610a/home/mvp/mvp_db/news7-lv/2010/2010_12_12_19_00/2010_12_12_19_00.mpg;Yoshihiko Noda.jpg;7237;7357;35961;362;368;6
/net/per610a/home/mvp/mvp_db/news7-lv/2010/2010_12_13_19_00/2010_12_13_19_00.mpg;Ichiro OZAWA.jpg;1549;1549;35961;77;77;0
/net/per610a/home/mvp/mvp_db/news7-lv/2010/2010_12_13_19_00/2010_12_13_19_00.mpg;Ichiro OZAWA.jpg;16345;16653;35961;817;833;16
/net/per610a/home/mvp/mvp_db/news7-lv/2010/2010_12_13_19_00/2010_12_13_19_00.mpg;Yukio HATOYAMA.jpg;6365;6865;35961;318;343;25
/net/per610a/home/mvp/mvp_db/news7-lv/2010/2010_12_13_19_00/2010_12_13_19_00.mpg;Sadakazu TANIGAKI.jpg;7669;9081;35961;383;454;71
/net/per610a/home/mvp/mvp_db/news7-lv/2010/2010_12_13_19_00/2010_12_13_19_00.mpg;Naoto KAN.jpg;13289;13361;35961;664;668;4
/net/per610a/home/mvp/mvp_db/news7-lv/2010/2010_12_13_19_00/2010_12_13_19_00.mpg;Naoto KAN.jpg;13549;14509;35961;677;725;48
/net/per610a/home/mvp/mvp_db/news7-lv/2010/2010_12_13_19_00/2010_12_13_19_00.mpg;Naoto KAN.jpg;15373;15589;35961;769;779;10
/net/per610a/home/mvp/mvp_db/news7-lv/2010/2010_12_13_19_00/2010_12_13_19_00.mpg;Yoshihiko Noda.jpg;24885;24993;35961;1244;1250;6
/net/per610a/home/mvp/mvp_db/news7-lv/2010/2010_12_14_19_00/2010_12_14_19_00.mpg;Naoto KAN.jpg;1501;1609;35961;75;80;5
/net/per610a/home/mvp/mvp_db/news7-lv/2010/2010_12_14_19_00/2010_12_14_19_00.mpg;Naoto KAN.jpg;1777;1845;35961;88;92;4
/net/per610a/home/mvp/mvp_db/news7-lv/2010/2010_12_14_19_00/2010_12_14_19_00.mpg;Naoto KAN.jpg;13045;13501;35961;652;675;23
/net/per610a/home/mvp/mvp_db/news7-lv/2010/2010_12_14_19_00/2010_12_14_19_00.mpg;Naoto KAN.jpg;13801;15357;35961;690;768;78
/net/per610a/home/mvp/mvp_db/news7-lv/2010/2010_12_14_19_00/2010_12_14_19_00.mpg;Yoshihiko Noda.jpg;5045;5321;35961;252;266;14
/net/per610a/home/mvp/mvp_db/news7-lv/2010/2010_12_15_19_00/2010_12_15_19_00.mpg;Ichiro OZAWA.jpg;16901;17001;35961;845;850;5
/net/per610a/home/mvp/mvp_db/news7-lv/2010/2010_12_15_19_00/2010_12_15_19_00.mpg;Sadakazu TANIGAKI.jpg;21285;21593;35961;1064;1080;16
/net/per610a/home/mvp/mvp_db/news7-lv/2010/2010_12_16_19_00/2010_12_16_19_00.mpg;Naoto KAN.jpg;6517;6585;35961;326;329;3
/net/per610a/home/mvp/mvp_db/news7-lv/2010/2010_12_16_19_00/2010_12_16_19_00.mpg;Naoto KAN.jpg;16601;16685;35961;830;834;4
/net/per610a/home/mvp/mvp_db/news7-lv/2010/2010_12_16_19_00/2010_12_16_19_00.mpg;Naoto KAN.jpg;17481;17501;35961;874;875;1
/net/per610a/home/mvp/mvp_db/news7-lv/2010/2010_12_16_19_00/2010_12_16_19_00.mpg;Naoto KAN.jpg;18825;19061;35961;941;953;12
/net/per610a/home/mvp/mvp_db/news7-lv/2010/2010_12_16_19_00/2010_12_16_19_00.mpg;Yoshihiko Noda.jpg;16793;16913;35961;840;846;6
/net/per610a/home/mvp/mvp_db/news7-lv/2010/2010_12_16_19_00/2010_12_16_19_00.mpg;Ichiro OZAWA.jpg;18669;19061;35961;933;953;20
/net/per610a/home/mvp/mvp_db/news7-lv/2010/2010_12_16_19_00/2010_12_16_19_00.mpg;Katsuya OKADA.jpg;19485;19973;35961;974;999;25
/net/per610a/home/mvp/mvp_db/news7-lv/2010/2010_12_17_19_00/2010_12_17_19_00.mpg;Katsuya OKADA.jpg;16713;17421;35961;836;871;35
/net/per610a/home/mvp/mvp_db/news7-lv/2010/2010_12_17_19_00/2010_12_17_19_00.mpg;Katsuya OKADA.jpg;17953;18481;35961;898;924;26
/net/per610a/home/mvp/mvp_db/news7-lv/2010/2010_12_17_19_00/2010_12_17_19_00.mpg;Katsuya OKADA.jpg;18725;19093;35961;936;955;19
/net/per610a/home/mvp/mvp_db/news7-lv/2010/2010_12_17_19_00/2010_12_17_19_00.mpg;Ichiro OZAWA.jpg;17953;18117;35961;898;906;8
/net/per610a/home/mvp/mvp_db/news7-lv/2010/2010_12_17_19_00/2010_12_17_19_00.mpg;Ichiro OZAWA.jpg;18265;18333;35961;913;917;4
/net/per610a/home/mvp/mvp_db/news7-lv/2010/2010_12_18_19_00/2010_12_18_19_00.mpg;Naoto KAN.jpg;1445;1873;35961;72;93;21
/net/per610a/home/mvp/mvp_db/news7-lv/2010/2010_12_18_19_00/2010_12_18_19_00.mpg;Naoto KAN.jpg;3161;3229;35961;158;161;3
/net/per610a/home/mvp/mvp_db/news7-lv/2010/2010_12_18_19_00/2010_12_18_19_00.mpg;Naoto KAN.jpg;3625;3965;35961;181;198;17
/net/per610a/home/mvp/mvp_db/news7-lv/2010/2010_12_18_19_00/2010_12_18_19_00.mpg;Naoto KAN.jpg;4433;5313;35961;221;265;44
/net/per610a/home/mvp/mvp_db/news7-lv/2010/2010_12_18_19_00/2010_12_18_19_00.mpg;Naoto KAN.jpg;7017;7113;35961;351;355;4
/net/per610a/home/mvp/mvp_db/news7-lv/2010/2010_12_18_19_00/2010_12_18_19_00.mpg;Naoto KAN.jpg;7749;8313;35961;387;415;28
/net/per610a/home/mvp/mvp_db/news7-lv/2010/2010_12_18_19_00/2010_12_18_19_00.mpg;Naoto KAN.jpg;23601;24001;35961;1180;1200;20
/net/per610a/home/mvp/mvp_db/news7-lv/2010/2010_12_18_19_00/2010_12_18_19_00.mpg;Ichiro OZAWA.jpg;19401;20077;35961;970;1004;34
/net/per610a/home/mvp/mvp_db/news7-lv/2010/2010_12_20_19_00/2010_12_20_19_00.mpg;Katsuya OKADA.jpg;10557;10653;35961;528;532;4
/net/per610a/home/mvp/mvp_db/news7-lv/2010/2010_12_20_19_00/2010_12_20_19_00.mpg;Katsuya OKADA.jpg;11037;11105;35961;552;555;3
/net/per610a/home/mvp/mvp_db/news7-lv/2010/2010_12_20_19_00/2010_12_20_19_00.mpg;Katsuya OKADA.jpg;11269;11849;35961;563;592;29
/net/per610a/home/mvp/mvp_db/news7-lv/2010/2010_12_20_19_00/2010_12_20_19_00.mpg;Yukio HATOYAMA.jpg;12437;13753;35961;622;688;66
/net/per610a/home/mvp/mvp_db/news7-lv/2010/2010_12_20_19_00/2010_12_20_19_00.mpg;Katsuya OKADA.jpg;16717;16841;35961;836;842;6
/net/per610a/home/mvp/mvp_db/news7-lv/2010/2010_12_21_19_00/2010_12_21_19_00.mpg;Yoshihiko Noda.jpg;11797;11845;35961;590;592;2
/net/per610a/home/mvp/mvp_db/news7-lv/2010/2010_12_21_19_00/2010_12_21_19_00.mpg;Yoshihiko Noda.jpg;12385;12933;35961;619;646;27
/net/per610a/home/mvp/mvp_db/news7-lv/2010/2010_12_21_19_00/2010_12_21_19_00.mpg;Naoto KAN.jpg;14125;14185;35961;706;709;3
/net/per610a/home/mvp/mvp_db/news7-lv/2010/2010_12_21_19_00/2010_12_21_19_00.mpg;Naoto KAN.jpg;14785;14929;35961;739;746;7
/net/per610a/home/mvp/mvp_db/news7-lv/2010/2010_12_21_19_00/2010_12_21_19_00.mpg;Naoto KAN.jpg;15369;15773;35961;768;789;21
/net/per610a/home/mvp/mvp_db/news7-lv/2010/2010_12_21_19_00/2010_12_21_19_00.mpg;Katsuya OKADA.jpg;15369;15773;35961;768;789;21
/net/per610a/home/mvp/mvp_db/news7-lv/2010/2010_12_21_19_00/2010_12_21_19_00.mpg;Sadakazu TANIGAKI.jpg;17473;17609;35961;874;880;6
/net/per610a/home/mvp/mvp_db/news7-lv/2010/2010_12_22_19_00/2010_12_22_19_00.mpg;Natsuo YAMAGUCHI.jpg;14273;14513;35961;714;726;12
/net/per610a/home/mvp/mvp_db/news7-lv/2010/2010_12_22_19_00/2010_12_22_19_00.mpg;Yoshihiko Noda.jpg;29557;29897;35961;1478;1495;17
/net/per610a/home/mvp/mvp_db/news7-lv/2010/2010_12_22_19_00/2010_12_22_19_00.mpg;Naoto KAN.jpg;31473;31689;35961;1574;1585;11
/net/per610a/home/mvp/mvp_db/news7-lv/2010/2010_12_23_19_00/2010_12_23_19_00.mpg;Seiji MAEHARA.jpg;11069;11165;35961;553;558;5
/net/per610a/home/mvp/mvp_db/news7-lv/2010/2010_12_23_19_00/2010_12_23_19_00.mpg;Yoshihiko Noda.jpg;16901;16957;35961;845;848;3
/net/per610a/home/mvp/mvp_db/news7-lv/2010/2010_12_23_19_00/2010_12_23_19_00.mpg;Yoshihiko Noda.jpg;17201;17529;35961;860;876;16
/net/per610a/home/mvp/mvp_db/news7-lv/2010/2010_12_24_19_00/2010_12_24_19_00.mpg;Takeo Hiranuma.jpeg;561;725;35961;28;36;8
/net/per610a/home/mvp/mvp_db/news7-lv/2010/2010_12_24_19_00/2010_12_24_19_00.mpg;Takeo Hiranuma.jpeg;3201;3557;35961;160;177;17
/net/per610a/home/mvp/mvp_db/news7-lv/2010/2010_12_24_19_00/2010_12_24_19_00.mpg;Takeo Hiranuma.jpeg;4429;4973;35961;221;248;27
/net/per610a/home/mvp/mvp_db/news7-lv/2010/2010_12_24_19_00/2010_12_24_19_00.mpg;Yoshihiko Noda.jpg;23773;24149;35961;1189;1208;19
/net/per610a/home/mvp/mvp_db/news7-lv/2010/2010_12_24_19_00/2010_12_24_19_00.mpg;Ichiro OZAWA.jpg;33193;33429;35961;1660;1672;12
/net/per610a/home/mvp/mvp_db/news7-lv/2010/2010_12_25_19_00/2010_12_25_19_00.mpg;Yoshihiko Noda.jpg;13837;14185;35961;692;709;17
/net/per610a/home/mvp/mvp_db/news7-lv/2010/2010_12_25_19_00/2010_12_25_19_00.mpg;Naoto KAN.jpg;14801;16177;35961;740;809;69
/net/per610a/home/mvp/mvp_db/news7-lv/2010/2010_12_25_19_00/2010_12_25_19_00.mpg;Yukio HATOYAMA.jpg;15925;16177;35961;796;809;13
/net/per610a/home/mvp/mvp_db/news7-lv/2010/2010_12_25_19_00/2010_12_25_19_00.mpg;Katsuya OKADA.jpg;16457;17069;35961;823;853;30
/net/per610a/home/mvp/mvp_db/news7-lv/2010/2010_12_27_19_00/2010_12_27_19_00.mpg;Naoto KAN.jpg;93;341;35961;4;17;13
/net/per610a/home/mvp/mvp_db/news7-lv/2010/2010_12_27_19_00/2010_12_27_19_00.mpg;Naoto KAN.jpg;2437;2625;35961;121;131;10
/net/per610a/home/mvp/mvp_db/news7-lv/2010/2010_12_27_19_00/2010_12_27_19_00.mpg;Naoto KAN.jpg;4421;5009;35961;221;250;29
/net/per610a/home/mvp/mvp_db/news7-lv/2010/2010_12_27_19_00/2010_12_27_19_00.mpg;Naoto KAN.jpg;5573;5713;35961;278;285;7
/net/per610a/home/mvp/mvp_db/news7-lv/2010/2010_12_27_19_00/2010_12_27_19_00.mpg;Naoto KAN.jpg;5849;6073;35961;292;303;11
/net/per610a/home/mvp/mvp_db/news7-lv/2010/2010_12_27_19_00/2010_12_27_19_00.mpg;Naoto KAN.jpg;8861;9633;35961;443;481;38
/net/per610a/home/mvp/mvp_db/news7-lv/2010/2010_12_27_19_00/2010_12_27_19_00.mpg;Naoto KAN.jpg;10149;10485;35961;507;524;17
/net/per610a/home/mvp/mvp_db/news7-lv/2010/2010_12_27_19_00/2010_12_27_19_00.mpg;Naoto KAN.jpg;1913;2049;35961;95;102;7
/net/per610a/home/mvp/mvp_db/news7-lv/2010/2010_12_27_19_00/2010_12_27_19_00.mpg;Katsuya OKADA.jpg;2081;2153;35961;104;107;3
/net/per610a/home/mvp/mvp_db/news7-lv/2010/2010_12_27_19_00/2010_12_27_19_00.mpg;Katsuya OKADA.jpg;5849;6073;35961;292;303;11
/net/per610a/home/mvp/mvp_db/news7-lv/2010/2010_12_28_19_00/2010_12_28_19_00.mpg;Ichiro OZAWA.jpg;109;129;35961;5;6;1
/net/per610a/home/mvp/mvp_db/news7-lv/2010/2010_12_28_19_00/2010_12_28_19_00.mpg;Ichiro OZAWA.jpg;917;933;35961;45;46;1
/net/per610a/home/mvp/mvp_db/news7-lv/2010/2010_12_28_19_00/2010_12_28_19_00.mpg;Ichiro OZAWA.jpg;1857;1933;35961;92;96;4
/net/per610a/home/mvp/mvp_db/news7-lv/2010/2010_12_28_19_00/2010_12_28_19_00.mpg;Ichiro OZAWA.jpg;9225;9441;35961;461;472;11
/net/per610a/home/mvp/mvp_db/news7-lv/2010/2010_12_28_19_00/2010_12_28_19_00.mpg;Katsuya OKADA.jpg;5629;5865;35961;281;293;12
/net/per610a/home/mvp/mvp_db/news7-lv/2010/2010_12_28_19_00/2010_12_28_19_00.mpg;Naoto KAN.jpg;5629;6525;35961;281;326;45
/net/per610a/home/mvp/mvp_db/news7-lv/2010/2010_12_28_19_00/2010_12_28_19_00.mpg;Naoto KAN.jpg;11361;11649;35961;568;582;14
/net/per610a/home/mvp/mvp_db/news7-lv/2010/2010_12_29_19_00/2010_12_29_19_00.mpg;Naoto KAN.jpg;14801;15277;35961;740;764;24
/net/per610a/home/mvp/mvp_db/news7-lv/2010/2010_12_29_19_00/2010_12_29_19_00.mpg;Naoto KAN.jpg;16269;16365;35961;813;818;5
/net/per610a/home/mvp/mvp_db/news7-lv/2010/2010_12_30_19_00/2010_12_30_19_00.mpg;Yoshihiko Noda.jpg;16017;16149;35961;801;807;6
/net/per610a/home/mvp/mvp_db/news7-lv/2010/2010_12_31_19_00/2010_12_31_19_00.mpg;Seiji MAEHARA.jpg;11069;11693;35961;553;584;31
/net/per610a/home/mvp/mvp_db/news7-lv/2010/2010_12_31_19_00/2010_12_31_19_00.mpg;Seiji MAEHARA.jpg;12185;13473;35961;609;674;65
/net/per610a/home/mvp/mvp_db/news7-lv/2010/2010_12_31_19_00/2010_12_31_19_00.mpg;Seiji MAEHARA.jpg;13873;14697;35961;694;735;41
/net/per610a/home/mvp/mvp_db/news7-lv/2011/2011_01_01_19_00/2011_01_01_19_00.mpg;Naoto KAN.jpg;10201;10461;23929;510;523;13
/net/per610a/home/mvp/mvp_db/news7-lv/2011/2011_01_01_19_00/2011_01_01_19_00.mpg;Naoto KAN.jpg;14445;14765;23929;722;738;16
/net/per610a/home/mvp/mvp_db/news7-lv/2011/2011_01_02_19_00/2011_01_02_19_00.mpg;Seiji MAEHARA.jpg;7533;8857;35961;376;443;67
/net/per610a/home/mvp/mvp_db/news7-lv/2011/2011_01_02_19_00/2011_01_02_19_00.mpg;Seiji MAEHARA.jpg;8901;9077;35961;445;454;9
/net/per610a/home/mvp/mvp_db/news7-lv/2011/2011_01_03_19_00/2011_01_03_19_00.mpg;Naoto KAN.jpg;12805;12877;35961;640;644;4
/net/per610a/home/mvp/mvp_db/news7-lv/2011/2011_01_03_19_00/2011_01_03_19_00.mpg;Naoto KAN.jpg;13009;13033;35961;650;651;1
/net/per610a/home/mvp/mvp_db/news7-lv/2011/2011_01_03_19_00/2011_01_03_19_00.mpg;Ichiro OZAWA.jpg;26025;26125;35961;1301;1306;5
/net/per610a/home/mvp/mvp_db/news7-lv/2011/2011_01_03_19_00/2011_01_03_19_00.mpg;Ichiro OZAWA.jpg;26205;26389;35961;1310;1320;10
/net/per610a/home/mvp/mvp_db/news7-lv/2011/2011_01_03_19_00/2011_01_03_19_00.mpg;Ichiro OZAWA.jpg;26461;26513;35961;1323;1326;3
/net/per610a/home/mvp/mvp_db/news7-lv/2011/2011_01_03_19_00/2011_01_03_19_00.mpg;Ichiro OZAWA.jpg;26605;26613;35961;1330;1331;1
/net/per610a/home/mvp/mvp_db/news7-lv/2011/2011_01_03_19_00/2011_01_03_19_00.mpg;Ichiro OZAWA.jpg;27229;27585;35961;1362;1379;17
/net/per610a/home/mvp/mvp_db/news7-lv/2011/2011_01_03_19_00/2011_01_03_19_00.mpg;Ichiro OZAWA.jpg;26953;27097;35961;1348;1355;7
/net/per610a/home/mvp/mvp_db/news7-lv/2011/2011_01_04_19_00/2011_01_04_19_00.mpg;Natsuo YAMAGUCHI.jpg;6981;7597;35961;349;380;31
/net/per610a/home/mvp/mvp_db/news7-lv/2011/2011_01_04_19_00/2011_01_04_19_00.mpg;Yoshimi WATANABE.jpg;7657;7737;35961;383;387;4
/net/per610a/home/mvp/mvp_db/news7-lv/2011/2011_01_04_19_00/2011_01_04_19_00.mpg;Yoshimi WATANABE.jpg;7837;8345;35961;392;417;25
/net/per610a/home/mvp/mvp_db/news7-lv/2011/2011_01_04_19_00/2011_01_04_19_00.mpg;Kazuo SHII.jpg;8493;8969;35961;424;448;24
/net/per610a/home/mvp/mvp_db/news7-lv/2011/2011_01_05_19_00/2011_01_05_19_00.mpg;Sadakazu TANIGAKI.jpg;17817;18149;35961;891;907;16
/net/per610a/home/mvp/mvp_db/news7-lv/2011/2011_01_06_19_00/2011_01_06_19_00.mpg;Ichiro OZAWA.jpg;2909;3013;35961;145;150;5
/net/per610a/home/mvp/mvp_db/news7-lv/2011/2011_01_07_19_00/2011_01_07_19_00.mpg;Seiji MAEHARA.jpg;27941;28121;35961;1397;1406;9
/net/per610a/home/mvp/mvp_db/news7-lv/2011/2011_01_08_19_00/2011_01_08_19_00.mpg;Naoto KAN.jpg;1193;1193;35961;59;59;0
/net/per610a/home/mvp/mvp_db/news7-lv/2011/2011_01_08_19_00/2011_01_08_19_00.mpg;Naoto KAN.jpg;1545;1681;35961;77;84;7
/net/per610a/home/mvp/mvp_db/news7-lv/2011/2011_01_08_19_00/2011_01_08_19_00.mpg;Naoto KAN.jpg;1761;1833;35961;88;91;3
/net/per610a/home/mvp/mvp_db/news7-lv/2011/2011_01_08_19_00/2011_01_08_19_00.mpg;Naoto KAN.jpg;2165;3561;35961;108;178;70
/net/per610a/home/mvp/mvp_db/news7-lv/2011/2011_01_08_19_00/2011_01_08_19_00.mpg;Katsuya OKADA.jpg;2165;2661;35961;108;133;25
/net/per610a/home/mvp/mvp_db/news7-lv/2011/2011_01_08_19_00/2011_01_08_19_00.mpg;Katsuya OKADA.jpg;3565;4033;35961;178;201;23
/net/per610a/home/mvp/mvp_db/news7-lv/2011/2011_01_11_19_00/2011_01_11_19_00.mpg;Ichiro OZAWA.jpg;4149;4853;35961;207;242;35
/net/per610a/home/mvp/mvp_db/news7-lv/2011/2011_01_11_19_00/2011_01_11_19_00.mpg;Ichiro OZAWA.jpg;5489;5589;35961;274;279;5
/net/per610a/home/mvp/mvp_db/news7-lv/2011/2011_01_11_19_00/2011_01_11_19_00.mpg;Ichiro OZAWA.jpg;6261;6313;35961;313;315;2
/net/per610a/home/mvp/mvp_db/news7-lv/2011/2011_01_12_19_00/2011_01_12_19_00.mpg;Katsuya OKADA.jpg;4405;4705;35961;220;235;15
/net/per610a/home/mvp/mvp_db/news7-lv/2011/2011_01_13_19_00/2011_01_13_19_00.mpg;Yukio EDANO.jpg;2149;2181;35961;107;109;2
/net/per610a/home/mvp/mvp_db/news7-lv/2011/2011_01_13_19_00/2011_01_13_19_00.mpg;Yukio EDANO.jpg;3921;4057;35961;196;202;6
/net/per610a/home/mvp/mvp_db/news7-lv/2011/2011_01_13_19_00/2011_01_13_19_00.mpg;Yukio EDANO.jpg;4541;4605;35961;227;230;3
/net/per610a/home/mvp/mvp_db/news7-lv/2011/2011_01_14_19_00/2011_01_14_19_00.mpg;Bairi Kaieda.jpg;12561;12581;35961;628;629;1
/net/per610a/home/mvp/mvp_db/news7-lv/2011/2011_01_14_19_00/2011_01_14_19_00.mpg;Bairi Kaieda.jpg;18805;19041;35961;940;952;12
/net/per610a/home/mvp/mvp_db/news7-lv/2011/2011_01_14_19_00/2011_01_14_19_00.mpg;Naoto KAN.jpg;14705;14873;35961;735;744;9
/net/per610a/home/mvp/mvp_db/news7-lv/2011/2011_01_14_19_00/2011_01_14_19_00.mpg;Naoto KAN.jpg;18233;18317;35961;912;916;4
/net/per610a/home/mvp/mvp_db/news7-lv/2011/2011_01_14_19_00/2011_01_14_19_00.mpg;Bairi Kaieda.jpg;20593;20881;35961;1030;1044;14
/net/per610a/home/mvp/mvp_db/news7-lv/2011/2011_01_14_19_00/2011_01_14_19_00.mpg;Bairi Kaieda.jpg;23181;23485;35961;1159;1174;15
/net/per610a/home/mvp/mvp_db/news7-lv/2011/2011_01_15_19_00/2011_01_15_19_00.mpg;Naoto KAN.jpg;1017;1073;35961;50;53;3
/net/per610a/home/mvp/mvp_db/news7-lv/2011/2011_01_15_19_00/2011_01_15_19_00.mpg;Naoto KAN.jpg;1193;1653;35961;59;82;23
/net/per610a/home/mvp/mvp_db/news7-lv/2011/2011_01_15_19_00/2011_01_15_19_00.mpg;Naoto KAN.jpg;2605;2821;35961;130;141;11
/net/per610a/home/mvp/mvp_db/news7-lv/2011/2011_01_15_19_00/2011_01_15_19_00.mpg;Seiji MAEHARA.jpg;16569;16805;35961;828;840;12
/net/per610a/home/mvp/mvp_db/news7-lv/2011/2011_01_16_19_00/2011_01_16_19_00.mpg;Naoto KAN.jpg;9125;9173;35961;456;458;2
/net/per610a/home/mvp/mvp_db/news7-lv/2011/2011_01_16_19_00/2011_01_16_19_00.mpg;Naoto KAN.jpg;10221;10453;35961;511;522;11
/net/per610a/home/mvp/mvp_db/news7-lv/2011/2011_01_16_19_00/2011_01_16_19_00.mpg;Naoto KAN.jpg;10673;10749;35961;533;537;4
/net/per610a/home/mvp/mvp_db/news7-lv/2011/2011_01_18_19_00/2011_01_18_19_00.mpg;Ichiro OZAWA.jpg;5161;5645;35961;258;282;24
/net/per610a/home/mvp/mvp_db/news7-lv/2011/2011_01_18_19_00/2011_01_18_19_00.mpg;Ichiro OZAWA.jpg;6821;7109;35961;341;355;14
/net/per610a/home/mvp/mvp_db/news7-lv/2011/2011_01_18_19_00/2011_01_18_19_00.mpg;Yoshihiko Noda.jpg;20569;21013;35961;1028;1051;23
/net/per610a/home/mvp/mvp_db/news7-lv/2011/2011_01_18_19_00/2011_01_18_19_00.mpg;Bairi Kaieda.jpg;21093;21629;35961;1055;1082;27
/net/per610a/home/mvp/mvp_db/news7-lv/2011/2011_01_18_19_00/2011_01_18_19_00.mpg;Nariaki Nakayama.png;21713;21925;35961;1086;1096;10
/net/per610a/home/mvp/mvp_db/news7-lv/2011/2011_01_19_19_00/2011_01_19_19_00.mpg;Shizuka KAMEI.jpg;13077;13329;35961;654;666;12
/net/per610a/home/mvp/mvp_db/news7-lv/2011/2011_01_20_19_00/2011_01_20_19_00.mpg;Sadakazu TANIGAKI.jpg;2889;3597;35961;144;179;35
/net/per610a/home/mvp/mvp_db/news7-lv/2011/2011_01_21_19_00/2011_01_21_19_00.mpg;Katsuya OKADA.jpg;7453;8073;35961;372;403;31
/net/per610a/home/mvp/mvp_db/news7-lv/2011/2011_01_21_19_00/2011_01_21_19_00.mpg;Naoto KAN.jpg;10317;10493;35961;516;524;8
/net/per610a/home/mvp/mvp_db/news7-lv/2011/2011_01_21_19_00/2011_01_21_19_00.mpg;Naoto KAN.jpg;10613;10817;35961;530;541;11
/net/per610a/home/mvp/mvp_db/news7-lv/2011/2011_01_21_19_00/2011_01_21_19_00.mpg;Naoto KAN.jpg;27881;27941;35961;1394;1397;3
/net/per610a/home/mvp/mvp_db/news7-lv/2011/2011_01_22_19_00/2011_01_22_19_00.mpg;Naoto KAN.jpg;4657;4681;35961;232;234;2
/net/per610a/home/mvp/mvp_db/news7-lv/2011/2011_01_22_19_00/2011_01_22_19_00.mpg;Naoto KAN.jpg;14413;14873;35961;721;744;23
/net/per610a/home/mvp/mvp_db/news7-lv/2011/2011_01_22_19_00/2011_01_22_19_00.mpg;Ichiro OZAWA.jpg;13533;13989;35961;677;699;22
/net/per610a/home/mvp/mvp_db/news7-lv/2011/2011_01_23_19_00/2011_01_23_19_00.mpg;Naoto KAN.jpg;6377;6825;35961;319;341;22
/net/per610a/home/mvp/mvp_db/news7-lv/2011/2011_01_23_19_00/2011_01_23_19_00.mpg;Naoto KAN.jpg;12925;13265;35961;646;663;17
/net/per610a/home/mvp/mvp_db/news7-lv/2011/2011_01_24_19_00/2011_01_24_19_00.mpg;Naoto KAN.jpg;49;269;35961;2;13;11
/net/per610a/home/mvp/mvp_db/news7-lv/2011/2011_01_24_19_00/2011_01_24_19_00.mpg;Naoto KAN.jpg;1541;1565;35961;77;78;1
/net/per610a/home/mvp/mvp_db/news7-lv/2011/2011_01_24_19_00/2011_01_24_19_00.mpg;Naoto KAN.jpg;2321;2325;35961;116;116;0
/net/per610a/home/mvp/mvp_db/news7-lv/2011/2011_01_24_19_00/2011_01_24_19_00.mpg;Naoto KAN.jpg;6601;6765;35961;330;338;8
/net/per610a/home/mvp/mvp_db/news7-lv/2011/2011_01_24_19_00/2011_01_24_19_00.mpg;Naoto KAN.jpg;6853;6913;35961;342;345;3
/net/per610a/home/mvp/mvp_db/news7-lv/2011/2011_01_24_19_00/2011_01_24_19_00.mpg;Katsuya OKADA.jpg;7865;9881;35961;393;494;101
/net/per610a/home/mvp/mvp_db/news7-lv/2011/2011_01_24_19_00/2011_01_24_19_00.mpg;Kazuo SHII.jpg;10057;10221;35961;503;511;8
/net/per610a/home/mvp/mvp_db/news7-lv/2011/2011_01_24_19_00/2011_01_24_19_00.mpg;Ichiro OZAWA.jpg;11829;11913;35961;591;595;4
/net/per610a/home/mvp/mvp_db/news7-lv/2011/2011_01_31_19_00/2011_01_31_19_00.mpg;Ichiro OZAWA.jpg;149;453;35961;7;22;15
/net/per610a/home/mvp/mvp_db/news7-lv/2011/2011_01_31_19_00/2011_01_31_19_00.mpg;Ichiro OZAWA.jpg;9741;9901;35961;487;495;8
/net/per610a/home/mvp/mvp_db/news7-lv/2011/2011_01_31_19_00/2011_01_31_19_00.mpg;Ichiro OZAWA.jpg;10057;10545;35961;503;527;24
/net/per610a/home/mvp/mvp_db/news7-lv/2011/2011_01_31_19_00/2011_01_31_19_00.mpg;Ichiro OZAWA.jpg;11537;11653;35961;577;582;5
/net/per610a/home/mvp/mvp_db/news7-lv/2011/2011_01_31_19_00/2011_01_31_19_00.mpg;Ichiro OZAWA.jpg;14341;14673;35961;717;734;17
/net/per610a/home/mvp/mvp_db/news7-lv/2011/2011_01_31_19_00/2011_01_31_19_00.mpg;Ichiro OZAWA.jpg;23817;24305;35961;1191;1215;24
/net/per610a/home/mvp/mvp_db/news7-lv/2011/2011_01_31_19_00/2011_01_31_19_00.mpg;Naoto KAN.jpg;23817;24305;35961;1191;1215;24
/net/per610a/home/mvp/mvp_db/news7-lv/2011/2011_02_03_19_00/2011_02_03_19_00.mpg;Ichiro OZAWA.jpg;25425;26033;35961;1271;1302;31
/net/per610a/home/mvp/mvp_db/news7-lv/2011/2011_02_04_19_00/2011_02_04_19_00.mpg;Yukio EDANO.jpg;22461;22957;35961;1123;1148;25
/net/per610a/home/mvp/mvp_db/news7-lv/2011/2011_02_06_19_00/2011_02_06_19_00.mpg;Ichiro OZAWA.jpg;24789;24933;35961;1240;1247;7
/net/per610a/home/mvp/mvp_db/news7-lv/2011/2011_02_07_19_00/2011_02_07_19_00.mpg;Ichiro OZAWA.jpg;7537;7581;35961;377;379;2
/net/per610a/home/mvp/mvp_db/news7-lv/2011/2011_02_07_19_00/2011_02_07_19_00.mpg;Ichiro OZAWA.jpg;8485;8509;35961;424;425;1
/net/per610a/home/mvp/mvp_db/news7-lv/2011/2011_02_07_19_00/2011_02_07_19_00.mpg;Ichiro OZAWA.jpg;8657;8921;35961;433;446;13
/net/per610a/home/mvp/mvp_db/news7-lv/2011/2011_02_08_19_00/2011_02_08_19_00.mpg;Naoto KAN.jpg;7373;7621;35961;368;381;13
/net/per610a/home/mvp/mvp_db/news7-lv/2011/2011_02_08_19_00/2011_02_08_19_00.mpg;Naoto KAN.jpg;11229;11837;35961;561;592;31
/net/per610a/home/mvp/mvp_db/news7-lv/2011/2011_02_09_19_00/2011_02_09_19_00.mpg;Ichiro OZAWA.jpg;31353;31441;35961;1568;1572;4
/net/per610a/home/mvp/mvp_db/news7-lv/2011/2011_02_10_19_00/2011_02_10_19_00.mpg;Ichiro OZAWA.jpg;13377;13421;35961;669;671;2
/net/per610a/home/mvp/mvp_db/news7-lv/2011/2011_02_10_19_00/2011_02_10_19_00.mpg;Ichiro OZAWA.jpg;14321;15141;35961;716;757;41
/net/per610a/home/mvp/mvp_db/news7-lv/2011/2011_02_14_19_00/2011_02_14_19_00.mpg;Ichiro OZAWA.jpg;1777;2173;35961;88;108;20
/net/per610a/home/mvp/mvp_db/news7-lv/2011/2011_02_14_19_00/2011_02_14_19_00.mpg;Ichiro OZAWA.jpg;27725;28161;35961;1386;1408;22
/net/per610a/home/mvp/mvp_db/news7-lv/2011/2011_02_14_19_00/2011_02_14_19_00.mpg;Katsuya OKADA.jpg;3437;3553;35961;171;177;6
/net/per610a/home/mvp/mvp_db/news7-lv/2011/2011_02_14_19_00/2011_02_14_19_00.mpg;Katsuya OKADA.jpg;4733;5009;35961;236;250;14
/net/per610a/home/mvp/mvp_db/news7-lv/2011/2011_02_14_19_00/2011_02_14_19_00.mpg;Katsuya OKADA.jpg;6957;7245;35961;348;362;14
/net/per610a/home/mvp/mvp_db/news7-lv/2011/2011_02_14_19_00/2011_02_14_19_00.mpg;Naoto KAN.jpg;26417;26601;35961;1321;1330;9
/net/per610a/home/mvp/mvp_db/news7-lv/2011/2011_02_16_19_00/2011_02_16_19_00.mpg;Shizuka KAMEI.jpg;1273;1621;35961;63;81;18
/net/per610a/home/mvp/mvp_db/news7-lv/2011/2011_02_16_19_00/2011_02_16_19_00.mpg;Yukio EDANO.jpg;4877;5541;35961;243;277;34
/net/per610a/home/mvp/mvp_db/news7-lv/2011/2011_02_16_19_00/2011_02_16_19_00.mpg;Yukio HATOYAMA.jpg;11625;11953;35961;581;597;16
/net/per610a/home/mvp/mvp_db/news7-lv/2011/2011_02_16_19_00/2011_02_16_19_00.mpg;Yukio HATOYAMA.jpg;13277;13753;35961;664;688;24
/net/per610a/home/mvp/mvp_db/news7-lv/2011/2011_02_17_19_00/2011_02_17_19_00.mpg;Sadakazu TANIGAKI.jpg;4221;4241;35961;211;212;1
/net/per610a/home/mvp/mvp_db/news7-lv/2011/2011_02_17_19_00/2011_02_17_19_00.mpg;Sadakazu TANIGAKI.jpg;4345;5001;35961;217;250;33
/net/per610a/home/mvp/mvp_db/news7-lv/2011/2011_02_17_19_00/2011_02_17_19_00.mpg;Katsuya OKADA.jpg;5733;5789;35961;286;289;3
/net/per610a/home/mvp/mvp_db/news7-lv/2011/2011_02_17_19_00/2011_02_17_19_00.mpg;Katsuya OKADA.jpg;6021;6705;35961;301;335;34
/net/per610a/home/mvp/mvp_db/news7-lv/2011/2011_02_18_19_00/2011_02_18_19_00.mpg;Mizuho FUKUSHIMA.jpg;1741;1869;35961;87;93;6
/net/per610a/home/mvp/mvp_db/news7-lv/2011/2011_02_18_19_00/2011_02_18_19_00.mpg;Yukio EDANO.jpg;2421;2989;35961;121;149;28
/net/per610a/home/mvp/mvp_db/news7-lv/2011/2011_02_18_19_00/2011_02_18_19_00.mpg;Takeo Hiranuma.jpeg;5249;5869;35961;262;293;31
/net/per610a/home/mvp/mvp_db/news7-lv/2011/2011_02_19_19_00/2011_02_19_19_00.mpg;Naoto KAN.jpg;1657;2197;35961;82;109;27
/net/per610a/home/mvp/mvp_db/news7-lv/2011/2011_02_20_19_00/2011_02_20_19_00.mpg;Taro ASO.jpg;2153;2749;35961;107;137;30
/net/per610a/home/mvp/mvp_db/news7-lv/2011/2011_02_21_19_00/2011_02_21_19_00.mpg;Ichiro OZAWA.jpg;17253;17485;35961;863;874;11
/net/per610a/home/mvp/mvp_db/news7-lv/2011/2011_02_22_19_00/2011_02_22_19_00.mpg;Seiji MAEHARA.jpg;23941;24225;35961;1197;1211;14
/net/per610a/home/mvp/mvp_db/news7-lv/2011/2011_02_26_19_00/2011_02_26_19_00.mpg;Shizuka KAMEI.jpg;16353;16593;35961;818;830;12
/net/per610a/home/mvp/mvp_db/news7-lv/2011/2011_02_26_19_00/2011_02_26_19_00.mpg;Shizuka KAMEI.jpg;18821;18841;35961;941;942;1
/net/per610a/home/mvp/mvp_db/news7-lv/2011/2011_02_26_19_00/2011_02_26_19_00.mpg;Katsuya OKADA.jpg;19321;19877;35961;966;994;28
/net/per610a/home/mvp/mvp_db/news7-lv/2011/2011_03_01_19_00/2011_03_01_19_00.mpg;Shintaro ISHIHARA.jpg;17613;18149;35949;881;908;27
/net/per610a/home/mvp/mvp_db/news7-lv/2011/2011_03_01_19_00/2011_03_01_19_00.mpg;Naoto KAN.jpg;20325;20385;35949;1017;1020;3
/net/per610a/home/mvp/mvp_db/news7-lv/2011/2011_03_01_19_00/2011_03_01_19_00.mpg;Naoto KAN.jpg;23141;23501;35949;1158;1176;18
/net/per610a/home/mvp/mvp_db/news7-lv/2011/2011_03_01_19_00/2011_03_01_19_00.mpg;Yukio EDANO.jpg;20517;20657;35949;1026;1033;7
/net/per610a/home/mvp/mvp_db/news7-lv/2011/2011_03_02_19_00/2011_03_02_19_00.mpg;Sadakazu TANIGAKI.jpg;30661;31297;35961;1533;1565;32
/net/per610a/home/mvp/mvp_db/news7-lv/2011/2011_03_02_19_00/2011_03_02_19_00.mpg;Shizuka KAMEI.jpg;31605;31821;35961;1581;1591;10
/net/per610a/home/mvp/mvp_db/news7-lv/2011/2011_03_04_19_00/2011_03_04_19_00.mpg;Seiji MAEHARA.jpg;18257;18765;35961;913;938;25
/net/per610a/home/mvp/mvp_db/news7-lv/2011/2011_03_04_19_00/2011_03_04_19_00.mpg;Seiji MAEHARA.jpg;19373;19933;35961;969;997;28
/net/per610a/home/mvp/mvp_db/news7-lv/2011/2011_03_04_19_00/2011_03_04_19_00.mpg;Seiji MAEHARA.jpg;20633;20661;35961;1032;1033;1
/net/per610a/home/mvp/mvp_db/news7-lv/2011/2011_03_04_19_00/2011_03_04_19_00.mpg;Seiji MAEHARA.jpg;20753;21241;35961;1038;1062;24
/net/per610a/home/mvp/mvp_db/news7-lv/2011/2011_03_05_19_00/2011_03_05_19_00.mpg;Seiji MAEHARA.jpg;8705;9105;35961;435;455;20
/net/per610a/home/mvp/mvp_db/news7-lv/2011/2011_03_05_19_00/2011_03_05_19_00.mpg;Seiji MAEHARA.jpg;9253;9453;35961;462;472;10
/net/per610a/home/mvp/mvp_db/news7-lv/2011/2011_03_05_19_00/2011_03_05_19_00.mpg;Naoto KAN.jpg;11629;12357;35961;581;618;37
/net/per610a/home/mvp/mvp_db/news7-lv/2011/2011_03_06_19_00/2011_03_06_19_00.mpg;Seiji MAEHARA.jpg;1477;2045;35961;73;102;29
/net/per610a/home/mvp/mvp_db/news7-lv/2011/2011_03_06_19_00/2011_03_06_19_00.mpg;Seiji MAEHARA.jpg;2549;3553;35961;127;177;50
/net/per610a/home/mvp/mvp_db/news7-lv/2011/2011_03_06_19_00/2011_03_06_19_00.mpg;Seiji MAEHARA.jpg;3941;4589;35961;197;229;32
/net/per610a/home/mvp/mvp_db/news7-lv/2011/2011_03_06_19_00/2011_03_06_19_00.mpg;Seiji MAEHARA.jpg;26537;26541;35961;1327;1327;0
/net/per610a/home/mvp/mvp_db/news7-lv/2011/2011_03_06_19_00/2011_03_06_19_00.mpg;Seiji MAEHARA.jpg;27273;27921;35961;1364;1396;32
/net/per610a/home/mvp/mvp_db/news7-lv/2011/2011_03_06_19_00/2011_03_06_19_00.mpg;Seiji MAEHARA.jpg;33249;34009;35961;1663;1701;38
/net/per610a/home/mvp/mvp_db/news7-lv/2011/2011_03_06_19_00/2011_03_06_19_00.mpg;Seiji MAEHARA.jpg;34593;35573;35961;1730;1779;49
/net/per610a/home/mvp/mvp_db/news7-lv/2011/2011_03_06_19_00/2011_03_06_19_00.mpg;Naoto KAN.jpg;4625;5109;35961;231;255;24
/net/per610a/home/mvp/mvp_db/news7-lv/2011/2011_03_06_19_00/2011_03_06_19_00.mpg;Naoto KAN.jpg;33729;34009;35961;1687;1701;14
/net/per610a/home/mvp/mvp_db/news7-lv/2011/2011_03_06_19_00/2011_03_06_19_00.mpg;Yoshihiko Noda.jpg;5309;6077;35961;265;304;39
/net/per610a/home/mvp/mvp_db/news7-lv/2011/2011_03_08_19_00/2011_03_08_19_00.mpg;Naoto KAN.jpg;8985;9081;35961;449;454;5
/net/per610a/home/mvp/mvp_db/news7-lv/2011/2011_03_08_19_00/2011_03_08_19_00.mpg;YUriko Koike.jpg;9265;10049;35961;463;502;39
/net/per610a/home/mvp/mvp_db/news7-lv/2011/2011_03_08_19_00/2011_03_08_19_00.mpg;Yukio EDANO.jpg;10725;11101;35961;536;555;19
/net/per610a/home/mvp/mvp_db/news7-lv/2011/2011_03_08_19_00/2011_03_08_19_00.mpg;Yukio EDANO.jpg;22397;23005;35961;1120;1150;30
/net/per610a/home/mvp/mvp_db/news7-lv/2011/2011_03_08_19_00/2011_03_08_19_00.mpg;Yukio EDANO.jpg;23701;23981;35961;1185;1199;14
/net/per610a/home/mvp/mvp_db/news7-lv/2011/2011_03_10_19_00/2011_03_10_19_00.mpg;Yukio EDANO.jpg;4741;5549;35961;237;277;40
/net/per610a/home/mvp/mvp_db/news7-lv/2011/2011_03_10_19_00/2011_03_10_19_00.mpg;Sadakazu TANIGAKI.jpg;21893;22445;35961;1095;1122;27
/net/per610a/home/mvp/mvp_db/news7-lv/2011/2011_03_15_19_00/2011_03_15_19_00.mpg;Naoto KAN.jpg;5849;7441;35961;292;372;80
/net/per610a/home/mvp/mvp_db/news7-lv/2011/2011_03_15_19_00/2011_03_15_19_00.mpg;Naoto KAN.jpg;20393;20881;35961;1020;1044;24
/net/per610a/home/mvp/mvp_db/news7-lv/2011/2011_03_18_19_00/2011_03_18_19_00.mpg;Yukio EDANO.jpg;3257;3509;35961;162;175;13
/net/per610a/home/mvp/mvp_db/news7-lv/2011/2011_03_22_19_00/2011_03_22_19_00.mpg;Ichiro OZAWA.jpg;21553;22353;35961;1078;1118;40
/net/per610a/home/mvp/mvp_db/news7-lv/2011/2011_03_23_19_00/2011_03_23_19_00.mpg;Shintaro ISHIHARA.jpg;5333;5613;35961;266;280;14
/net/per610a/home/mvp/mvp_db/news7-lv/2011/2011_03_28_19_00/2011_03_28_19_00.mpg;Yukio EDANO.jpg;5789;6313;35961;289;315;26
/net/per610a/home/mvp/mvp_db/news7-lv/2011/2011_03_29_19_00/2011_03_29_19_00.mpg;Nariaki Nakayama.png;1637;1837;35961;81;91;10
/net/per610a/home/mvp/mvp_db/news7-lv/2011/2011_03_30_19_00/2011_03_30_19_00.mpg;Yukio EDANO.jpg;10265;10749;35961;513;537;24
/net/per610a/home/mvp/mvp_db/news7-lv/2011/2011_03_30_19_00/2011_03_30_19_00.mpg;Yukio EDANO.jpg;17525;17781;35961;876;889;13
/net/per610a/home/mvp/mvp_db/news7-lv/2011/2011_03_31_19_00/2011_03_31_19_00.mpg;Naoto KAN.jpg;8321;8893;35961;416;444;28
/net/per610a/home/mvp/mvp_db/news7-lv/2011/2011_03_31_19_00/2011_03_31_19_00.mpg;Naoto KAN.jpg;9881;11441;35961;494;572;78
/net/per610a/home/mvp/mvp_db/news7-lv/2011/2011_04_05_19_00/2011_04_05_19_00.mpg;Yukio EDANO.jpg;7889;8817;35961;394;441;47
/net/per610a/home/mvp/mvp_db/news7-lv/2011/2011_04_05_19_00/2011_04_05_19_00.mpg;Yukio EDANO.jpg;28741;29061;35961;1437;1453;16
/net/per610a/home/mvp/mvp_db/news7-lv/2011/2011_04_07_19_00/2011_04_07_19_00.mpg;Yukio EDANO.jpg;17233;18365;35961;862;918;56
/net/per610a/home/mvp/mvp_db/news7-lv/2011/2011_04_07_19_00/2011_04_07_19_00.mpg;Yukio EDANO.jpg;18601;19373;35961;930;969;39
/net/per610a/home/mvp/mvp_db/news7-lv/2011/2011_04_09_19_00/2011_04_09_19_00.mpg;Katsuya OKADA.jpg;26693;27865;35961;1335;1393;58
/net/per610a/home/mvp/mvp_db/news7-lv/2011/2011_04_13_19_00/2011_04_13_19_00.mpg;Yukio EDANO.jpg;12605;13065;35961;630;653;23
/net/per610a/home/mvp/mvp_db/news7-lv/2011/2011_04_14_19_00/2011_04_14_19_00.mpg;Naoto KAN.jpg;6525;7177;35961;326;359;33
/net/per610a/home/mvp/mvp_db/news7-lv/2011/2011_04_15_19_00/2011_04_15_19_00.mpg;Bairi Kaieda.jpg;15141;15377;35961;757;769;12
/net/per610a/home/mvp/mvp_db/news7-lv/2011/2011_04_16_19_00/2011_04_16_19_00.mpg;Yoshihiko Noda.jpg;22737;22861;35961;1137;1143;6
/net/per610a/home/mvp/mvp_db/news7-lv/2011/2011_04_17_19_00/2011_04_17_19_00.mpg;Bairi Kaieda.jpg;1325;1553;35961;66;77;11
/net/per610a/home/mvp/mvp_db/news7-lv/2011/2011_04_17_19_00/2011_04_17_19_00.mpg;Bairi Kaieda.jpg;7613;8977;35961;380;449;69
/net/per610a/home/mvp/mvp_db/news7-lv/2011/2011_04_17_19_00/2011_04_17_19_00.mpg;Yukiko Kada.jpg;12509;12857;35961;625;643;18
/net/per610a/home/mvp/mvp_db/news7-lv/2011/2011_04_17_19_00/2011_04_17_19_00.mpg;Takenori KANZAKI.jpg;12865;13033;35961;643;651;8
/net/per610a/home/mvp/mvp_db/news7-lv/2011/2011_04_18_19_00/2011_04_18_19_00.mpg;Toranosuke Katayama.jpg;31869;32153;35961;1594;1608;14
/net/per610a/home/mvp/mvp_db/news7-lv/2011/2011_04_19_19_00/2011_04_19_19_00.mpg;Ichiro OZAWA.jpg;17453;17589;35961;873;879;6
/net/per610a/home/mvp/mvp_db/news7-lv/2011/2011_04_19_19_00/2011_04_19_19_00.mpg;Ichiro OZAWA.jpg;18625;18981;35961;931;949;18
/net/per610a/home/mvp/mvp_db/news7-lv/2011/2011_04_19_19_00/2011_04_19_19_00.mpg;Yukio EDANO.jpg;19097;19609;35961;955;980;25
/net/per610a/home/mvp/mvp_db/news7-lv/2011/2011_04_20_19_00/2011_04_20_19_00.mpg;Katsuya OKADA.jpg;34537;34609;35961;1727;1731;4
/net/per610a/home/mvp/mvp_db/news7-lv/2011/2011_04_20_19_00/2011_04_20_19_00.mpg;Katsuya OKADA.jpg;35109;35141;35961;1756;1757;1
/net/per610a/home/mvp/mvp_db/news7-lv/2011/2011_04_24_19_00/2011_04_24_19_00.mpg;Bairi Kaieda.jpg;25389;26165;35961;1270;1308;38
/net/per610a/home/mvp/mvp_db/news7-lv/2011/2011_04_25_19_00/2011_04_25_19_00.mpg;Katsuya OKADA.jpg;12517;12621;35961;626;631;5
/net/per610a/home/mvp/mvp_db/news7-lv/2011/2011_04_25_19_00/2011_04_25_19_00.mpg;Katsuya OKADA.jpg;12833;12945;35961;641;647;6
/net/per610a/home/mvp/mvp_db/news7-lv/2011/2011_04_26_19_00/2011_04_26_19_00.mpg;Katsuya OKADA.jpg;27149;27461;35961;1358;1373;15
/net/per610a/home/mvp/mvp_db/news7-lv/2011/2011_04_26_19_00/2011_04_26_19_00.mpg;Sadakazu TANIGAKI.jpg;27513;27545;35961;1376;1377;1
/net/per610a/home/mvp/mvp_db/news7-lv/2011/2011_04_26_19_00/2011_04_26_19_00.mpg;Sadakazu TANIGAKI.jpg;27665;27957;35961;1383;1398;15
/net/per610a/home/mvp/mvp_db/news7-lv/2011/2011_04_26_19_00/2011_04_26_19_00.mpg;Sadakazu TANIGAKI.jpg;28233;28625;35961;1412;1432;20
/net/per610a/home/mvp/mvp_db/news7-lv/2011/2011_05_01_19_00/2011_05_01_19_00.mpg;Yoshihiko Noda.jpg;7957;8269;35961;398;413;15
/net/per610a/home/mvp/mvp_db/news7-lv/2011/2011_05_01_19_00/2011_05_01_19_00.mpg;Yoshihiko Noda.jpg;8341;8837;35961;417;442;25
/net/per610a/home/mvp/mvp_db/news7-lv/2011/2011_05_02_19_00/2011_05_02_19_00.mpg;Yukio EDANO.jpg;14157;14545;35961;708;727;19
/net/per610a/home/mvp/mvp_db/news7-lv/2011/2011_05_02_19_00/2011_05_02_19_00.mpg;Katsuya OKADA.jpg;23425;24149;35961;1171;1208;37
/net/per610a/home/mvp/mvp_db/news7-lv/2011/2011_05_02_19_00/2011_05_02_19_00.mpg;Sadakazu TANIGAKI.jpg;24201;26861;35961;1210;1343;133
/net/per610a/home/mvp/mvp_db/news7-lv/2011/2011_05_04_19_00/2011_05_04_19_00.mpg;Ichiro OZAWA.jpg;12061;12121;35961;603;606;3
/net/per610a/home/mvp/mvp_db/news7-lv/2011/2011_05_05_19_00/2011_05_05_19_00.mpg;Bairi Kaieda.jpg;16349;16449;35961;817;822;5
/net/per610a/home/mvp/mvp_db/news7-lv/2011/2011_05_07_19_00/2011_05_07_19_00.mpg;Naoto KAN.jpg;7801;7981;35961;390;399;9
/net/per610a/home/mvp/mvp_db/news7-lv/2011/2011_05_17_19_00/2011_05_17_19_00.mpg;Naoto KAN.jpg;593;773;35961;29;38;9
/net/per610a/home/mvp/mvp_db/news7-lv/2011/2011_05_17_19_00/2011_05_17_19_00.mpg;Naoto KAN.jpg;16241;16577;35961;812;829;17
/net/per610a/home/mvp/mvp_db/news7-lv/2011/2011_05_17_19_00/2011_05_17_19_00.mpg;Naoto KAN.jpg;17121;17537;35961;856;877;21
/net/per610a/home/mvp/mvp_db/news7-lv/2011/2011_05_17_19_00/2011_05_17_19_00.mpg;Sadakazu TANIGAKI.jpg;27197;27797;35961;1360;1390;30
/net/per610a/home/mvp/mvp_db/news7-lv/2011/2011_05_17_19_00/2011_05_17_19_00.mpg;Sadakazu TANIGAKI.jpg;28393;28513;35961;1420;1426;6
/net/per610a/home/mvp/mvp_db/news7-lv/2011/2011_05_17_19_00/2011_05_17_19_00.mpg;Sadakazu TANIGAKI.jpg;28637;28729;35961;1432;1437;5
/net/per610a/home/mvp/mvp_db/news7-lv/2011/2011_05_17_19_00/2011_05_17_19_00.mpg;Natsuo YAMAGUCHI.jpg;28845;29065;35961;1443;1454;11
/net/per610a/home/mvp/mvp_db/news7-lv/2011/2011_05_17_19_00/2011_05_17_19_00.mpg;Yoshimi WATANABE.jpg;29129;29209;35961;1457;1461;4
/net/per610a/home/mvp/mvp_db/news7-lv/2011/2011_05_17_19_00/2011_05_17_19_00.mpg;Kazuo SHII.jpg;29405;29521;35961;1471;1476;5
/net/per610a/home/mvp/mvp_db/news7-lv/2011/2011_05_22_19_00/2011_05_22_19_00.mpg;Yukio EDANO.jpg;7537;8265;35961;377;413;36
/net/per610a/home/mvp/mvp_db/news7-lv/2011/2011_05_24_19_00/2011_05_24_19_00.mpg;Naoto KAN.jpg;7889;8457;35957;394;423;29
/net/per610a/home/mvp/mvp_db/news7-lv/2011/2011_05_24_19_00/2011_05_24_19_00.mpg;Naoto KAN.jpg;31421;31813;35957;1572;1591;19
/net/per610a/home/mvp/mvp_db/news7-lv/2011/2011_05_25_19_00/2011_05_25_19_00.mpg;Yukio EDANO.jpg;8165;8597;35961;408;430;22
/net/per610a/home/mvp/mvp_db/news7-lv/2011/2011_05_25_19_00/2011_05_25_19_00.mpg;Bairi Kaieda.jpg;15833;16101;35961;792;805;13
/net/per610a/home/mvp/mvp_db/news7-lv/2011/2011_05_25_19_00/2011_05_25_19_00.mpg;Naoto KAN.jpg;31509;31733;35961;1576;1587;11
/net/per610a/home/mvp/mvp_db/news7-lv/2011/2011_05_26_19_00/2011_05_26_19_00.mpg;Sadakazu TANIGAKI.jpg;30517;31101;35961;1526;1555;29
/net/per610a/home/mvp/mvp_db/news7-lv/2011/2011_05_28_19_00/2011_05_28_19_00.mpg;Sadakazu TANIGAKI.jpg;12841;14093;35961;642;705;63
/net/per610a/home/mvp/mvp_db/news7-lv/2011/2011_05_28_19_00/2011_05_28_19_00.mpg;Natsuo YAMAGUCHI.jpg;14113;14849;35961;706;742;36
/net/per610a/home/mvp/mvp_db/news7-lv/2011/2011_05_28_19_00/2011_05_28_19_00.mpg;Yoshihiko Noda.jpg;16021;16633;35961;801;832;31
/net/per610a/home/mvp/mvp_db/news7-lv/2011/2011_05_28_19_00/2011_05_28_19_00.mpg;Bairi Kaieda.jpg;28389;28805;35961;1420;1441;21
/net/per610a/home/mvp/mvp_db/news7-lv/2011/2011_05_29_19_00/2011_05_29_19_00.mpg;Sadakazu TANIGAKI.jpg;13281;14581;35961;664;729;65
/net/per610a/home/mvp/mvp_db/news7-lv/2011/2011_05_30_19_00/2011_05_30_19_00.mpg;Sadakazu TANIGAKI.jpg;18597;18789;35961;930;939;9
/net/per610a/home/mvp/mvp_db/news7-lv/2011/2011_05_30_19_00/2011_05_30_19_00.mpg;Katsuya OKADA.jpg;22453;22781;35961;1123;1139;16
/net/per610a/home/mvp/mvp_db/news7-lv/2011/2011_05_31_19_00/2011_05_31_19_00.mpg;Natsuo YAMAGUCHI.jpg;3593;4129;35961;179;206;27
/net/per610a/home/mvp/mvp_db/news7-lv/2011/2011_05_31_19_00/2011_05_31_19_00.mpg;Natsuo YAMAGUCHI.jpg;4741;5425;35961;237;271;34
/net/per610a/home/mvp/mvp_db/news7-lv/2011/2011_05_31_19_00/2011_05_31_19_00.mpg;Sadakazu TANIGAKI.jpg;4197;4737;35961;209;236;27
/net/per610a/home/mvp/mvp_db/news7-lv/2011/2011_05_31_19_00/2011_05_31_19_00.mpg;Yukio HATOYAMA.jpg;10205;10645;35961;510;532;22
/net/per610a/home/mvp/mvp_db/news7-lv/2011/2011_05_31_19_00/2011_05_31_19_00.mpg;Yukio EDANO.jpg;10793;11869;35961;539;593;54
/net/per610a/home/mvp/mvp_db/news7-lv/2011/2011_06_01_19_00/2011_06_01_19_00.mpg;Yukio HATOYAMA.jpg;93;201;35961;4;10;6
/net/per610a/home/mvp/mvp_db/news7-lv/2011/2011_06_01_19_00/2011_06_01_19_00.mpg;Yukio HATOYAMA.jpg;1249;1753;35961;62;87;25
/net/per610a/home/mvp/mvp_db/news7-lv/2011/2011_06_01_19_00/2011_06_01_19_00.mpg;Yukio HATOYAMA.jpg;4913;5617;35961;245;280;35
/net/per610a/home/mvp/mvp_db/news7-lv/2011/2011_06_01_19_00/2011_06_01_19_00.mpg;Yukio HATOYAMA.jpg;34061;34345;35961;1703;1718;15
/net/per610a/home/mvp/mvp_db/news7-lv/2011/2011_06_01_19_00/2011_06_01_19_00.mpg;Ichiro OZAWA.jpg;1249;1753;35961;62;87;25
/net/per610a/home/mvp/mvp_db/news7-lv/2011/2011_06_01_19_00/2011_06_01_19_00.mpg;Sadakazu TANIGAKI.jpg;2441;2577;35961;122;128;6
/net/per610a/home/mvp/mvp_db/news7-lv/2011/2011_06_01_19_00/2011_06_01_19_00.mpg;Sadakazu TANIGAKI.jpg;2889;2913;35961;144;145;1
/net/per610a/home/mvp/mvp_db/news7-lv/2011/2011_06_01_19_00/2011_06_01_19_00.mpg;Natsuo YAMAGUCHI.jpg;2597;2681;35961;129;134;5
/net/per610a/home/mvp/mvp_db/news7-lv/2011/2011_06_01_19_00/2011_06_01_19_00.mpg;Natsuo YAMAGUCHI.jpg;3997;4561;35961;199;228;29
/net/per610a/home/mvp/mvp_db/news7-lv/2011/2011_06_01_19_00/2011_06_01_19_00.mpg;Shizuka KAMEI.jpg;7657;8185;35961;383;409;26
/net/per610a/home/mvp/mvp_db/news7-lv/2011/2011_06_02_19_00/2011_06_02_19_00.mpg;Shizuka KAMEI.jpg;3389;3497;35961;169;174;5
/net/per610a/home/mvp/mvp_db/news7-lv/2011/2011_06_02_19_00/2011_06_02_19_00.mpg;Shizuka KAMEI.jpg;7305;7345;35961;365;367;2
/net/per610a/home/mvp/mvp_db/news7-lv/2011/2011_06_02_19_00/2011_06_02_19_00.mpg;Shizuka KAMEI.jpg;15485;15873;35961;774;794;20
/net/per610a/home/mvp/mvp_db/news7-lv/2011/2011_06_02_19_00/2011_06_02_19_00.mpg;Naoto KAN.jpg;3885;3977;35961;194;198;4
/net/per610a/home/mvp/mvp_db/news7-lv/2011/2011_06_02_19_00/2011_06_02_19_00.mpg;Naoto KAN.jpg;19165;19213;35961;958;961;3
/net/per610a/home/mvp/mvp_db/news7-lv/2011/2011_06_02_19_00/2011_06_02_19_00.mpg;Yukio HATOYAMA.jpg;4069;4397;35961;203;219;16
/net/per610a/home/mvp/mvp_db/news7-lv/2011/2011_06_02_19_00/2011_06_02_19_00.mpg;Naoto KAN.jpg;4069;4397;35961;203;219;16
/net/per610a/home/mvp/mvp_db/news7-lv/2011/2011_06_02_19_00/2011_06_02_19_00.mpg;Naoto KAN.jpg;4709;5277;35961;235;263;28
/net/per610a/home/mvp/mvp_db/news7-lv/2011/2011_06_02_19_00/2011_06_02_19_00.mpg;Naoto KAN.jpg;10121;10181;35961;506;509;3
/net/per610a/home/mvp/mvp_db/news7-lv/2011/2011_06_02_19_00/2011_06_02_19_00.mpg;Yukio HATOYAMA.jpg;5661;5725;35961;283;286;3
/net/per610a/home/mvp/mvp_db/news7-lv/2011/2011_06_02_19_00/2011_06_02_19_00.mpg;Yukio HATOYAMA.jpg;5889;6189;35961;294;309;15
/net/per610a/home/mvp/mvp_db/news7-lv/2011/2011_06_02_19_00/2011_06_02_19_00.mpg;Yukio HATOYAMA.jpg;7461;7657;35961;373;383;10
/net/per610a/home/mvp/mvp_db/news7-lv/2011/2011_06_02_19_00/2011_06_02_19_00.mpg;Yukio HATOYAMA.jpg;11773;12893;35961;588;644;56
/net/per610a/home/mvp/mvp_db/news7-lv/2011/2011_06_02_19_00/2011_06_02_19_00.mpg;Sadakazu TANIGAKI.jpg;15921;18229;35961;796;911;115
/net/per610a/home/mvp/mvp_db/news7-lv/2011/2011_06_02_19_00/2011_06_02_19_00.mpg;Sadakazu TANIGAKI.jpg;22025;22921;35961;1101;1146;45
/net/per610a/home/mvp/mvp_db/news7-lv/2011/2011_06_03_19_00/2011_06_03_19_00.mpg;Ichiro OZAWA.jpg;5369;5569;35961;268;278;10
/net/per610a/home/mvp/mvp_db/news7-lv/2011/2011_06_03_19_00/2011_06_03_19_00.mpg;Yukio EDANO.jpg;5661;6077;35961;283;304;21
/net/per610a/home/mvp/mvp_db/news7-lv/2011/2011_06_03_19_00/2011_06_03_19_00.mpg;Katsuya OKADA.jpg;14241;15265;35961;712;763;51
/net/per610a/home/mvp/mvp_db/news7-lv/2011/2011_06_05_19_00/2011_06_05_19_00.mpg;Katsuya OKADA.jpg;3337;3581;35961;166;179;13
/net/per610a/home/mvp/mvp_db/news7-lv/2011/2011_06_05_19_00/2011_06_05_19_00.mpg;Shizuka KAMEI.jpg;3741;4729;35961;187;236;49
/net/per610a/home/mvp/mvp_db/news7-lv/2011/2011_06_06_19_00/2011_06_06_19_00.mpg;Yukio EDANO.jpg;141;225;35961;7;11;4
/net/per610a/home/mvp/mvp_db/news7-lv/2011/2011_06_06_19_00/2011_06_06_19_00.mpg;Yukio EDANO.jpg;2757;3141;35961;137;157;20
/net/per610a/home/mvp/mvp_db/news7-lv/2011/2011_06_06_19_00/2011_06_06_19_00.mpg;Yukio EDANO.jpg;8025;8541;35961;401;427;26
/net/per610a/home/mvp/mvp_db/news7-lv/2011/2011_06_06_19_00/2011_06_06_19_00.mpg;Sadakazu TANIGAKI.jpg;237;313;35961;11;15;4
/net/per610a/home/mvp/mvp_db/news7-lv/2011/2011_06_06_19_00/2011_06_06_19_00.mpg;Sadakazu TANIGAKI.jpg;889;1517;35961;44;75;31
/net/per610a/home/mvp/mvp_db/news7-lv/2011/2011_06_06_19_00/2011_06_06_19_00.mpg;Sadakazu TANIGAKI.jpg;3297;4241;35961;164;212;48
/net/per610a/home/mvp/mvp_db/news7-lv/2011/2011_06_06_19_00/2011_06_06_19_00.mpg;Katsuya OKADA.jpg;10109;10345;35961;505;517;12
/net/per610a/home/mvp/mvp_db/news7-lv/2011/2011_06_06_19_00/2011_06_06_19_00.mpg;Ichiro OZAWA.jpg;10825;11017;35961;541;551;10
/net/per610a/home/mvp/mvp_db/news7-lv/2011/2011_06_07_19_00/2011_06_07_19_00.mpg;Yukio HATOYAMA.jpg;22913;23561;35961;1146;1178;32
/net/per610a/home/mvp/mvp_db/news7-lv/2011/2011_06_07_19_00/2011_06_07_19_00.mpg;Katsuya OKADA.jpg;22917;23561;35961;1146;1178;32
/net/per610a/home/mvp/mvp_db/news7-lv/2011/2011_06_08_19_00/2011_06_08_19_00.mpg;Shizuka KAMEI.jpg;18949;19485;35961;947;974;27
/net/per610a/home/mvp/mvp_db/news7-lv/2011/2011_06_09_19_00/2011_06_09_19_00.mpg;Naoto KAN.jpg;1;77;35961;0;3;3
/net/per610a/home/mvp/mvp_db/news7-lv/2011/2011_06_09_19_00/2011_06_09_19_00.mpg;Bairi Kaieda.jpg;2533;2713;35961;126;135;9
/net/per610a/home/mvp/mvp_db/news7-lv/2011/2011_06_09_19_00/2011_06_09_19_00.mpg;Ichiro OZAWA.jpg;5757;5885;35961;288;294;6
/net/per610a/home/mvp/mvp_db/news7-lv/2011/2011_06_09_19_00/2011_06_09_19_00.mpg;Ichiro OZAWA.jpg;5933;6161;35961;296;308;12
/net/per610a/home/mvp/mvp_db/news7-lv/2011/2011_06_10_19_00/2011_06_10_19_00.mpg;Yoshihiko Noda.jpg;20229;20757;35961;1011;1038;27
/net/per610a/home/mvp/mvp_db/news7-lv/2011/2011_06_10_19_00/2011_06_10_19_00.mpg;Toru Hashimoto.jpg;30049;31165;35961;1503;1559;56
/net/per610a/home/mvp/mvp_db/news7-lv/2011/2011_06_11_19_00/2011_06_11_19_00.mpg;Sadakazu TANIGAKI.jpg;29893;29981;35961;1495;1499;4
/net/per610a/home/mvp/mvp_db/news7-lv/2011/2011_06_13_19_00/2011_06_13_19_00.mpg;Shizuka KAMEI.jpg;22761;22785;35961;1138;1139;1
/net/per610a/home/mvp/mvp_db/news7-lv/2011/2011_06_13_19_00/2011_06_13_19_00.mpg;Shizuka KAMEI.jpg;22881;22985;35961;1144;1149;5
/net/per610a/home/mvp/mvp_db/news7-lv/2011/2011_06_13_19_00/2011_06_13_19_00.mpg;Shizuka KAMEI.jpg;23217;23269;35961;1161;1164;3
/net/per610a/home/mvp/mvp_db/news7-lv/2011/2011_06_13_19_00/2011_06_13_19_00.mpg;Shizuka KAMEI.jpg;23569;23605;35961;1179;1180;1
/net/per610a/home/mvp/mvp_db/news7-lv/2011/2011_06_13_19_00/2011_06_13_19_00.mpg;Shizuka KAMEI.jpg;23949;23949;35961;1198;1198;0
/net/per610a/home/mvp/mvp_db/news7-lv/2011/2011_06_13_19_00/2011_06_13_19_00.mpg;Shizuka KAMEI.jpg;24941;25273;35961;1247;1264;17
/net/per610a/home/mvp/mvp_db/news7-lv/2011/2011_06_13_19_00/2011_06_13_19_00.mpg;Yoshihiko Noda.jpg;29441;29785;35961;1472;1490;18
/net/per610a/home/mvp/mvp_db/news7-lv/2011/2011_06_15_19_00/2011_06_15_19_00.mpg;Katsuya OKADA.jpg;21269;22665;35961;1064;1133;69
/net/per610a/home/mvp/mvp_db/news7-lv/2011/2011_06_15_19_00/2011_06_15_19_00.mpg;Sadakazu TANIGAKI.jpg;22709;23061;35961;1136;1153;17
/net/per610a/home/mvp/mvp_db/news7-lv/2011/2011_06_18_19_00/2011_06_18_19_00.mpg;Bairi Kaieda.jpg;1705;2405;35961;85;120;35
/net/per610a/home/mvp/mvp_db/news7-lv/2011/2011_06_18_19_00/2011_06_18_19_00.mpg;Bairi Kaieda.jpg;3273;3665;35961;163;183;20
/net/per610a/home/mvp/mvp_db/news7-lv/2011/2011_06_18_19_00/2011_06_18_19_00.mpg;Katsuya OKADA.jpg;27861;28225;35961;1393;1411;18
/net/per610a/home/mvp/mvp_db/news7-lv/2011/2011_06_19_19_00/2011_06_19_19_00.mpg;Katsuya OKADA.jpg;17861;18201;35961;893;910;17
/net/per610a/home/mvp/mvp_db/news7-lv/2011/2011_06_19_19_00/2011_06_19_19_00.mpg;Bairi Kaieda.jpg;28573;28713;35961;1429;1436;7
/net/per610a/home/mvp/mvp_db/news7-lv/2011/2011_06_21_19_00/2011_06_21_19_00.mpg;Yukiko Kada.jpg;16713;17121;35961;836;856;20
/net/per610a/home/mvp/mvp_db/news7-lv/2011/2011_06_22_19_00/2011_06_22_19_00.mpg;Yoshihiko Noda.jpg;693;785;35961;34;39;5
/net/per610a/home/mvp/mvp_db/news7-lv/2011/2011_06_22_19_00/2011_06_22_19_00.mpg;Yoshihiko Noda.jpg;1497;1533;35961;74;76;2
/net/per610a/home/mvp/mvp_db/news7-lv/2011/2011_06_22_19_00/2011_06_22_19_00.mpg;Yoshihiko Noda.jpg;4785;4877;35961;239;243;4
/net/per610a/home/mvp/mvp_db/news7-lv/2011/2011_06_22_19_00/2011_06_22_19_00.mpg;Yoshihiko Noda.jpg;4961;4977;35961;248;248;0
/net/per610a/home/mvp/mvp_db/news7-lv/2011/2011_06_22_19_00/2011_06_22_19_00.mpg;Yoshihiko Noda.jpg;8157;8249;35961;408;412;4
/net/per610a/home/mvp/mvp_db/news7-lv/2011/2011_06_22_19_00/2011_06_22_19_00.mpg;Yoshihiko Noda.jpg;8333;8337;35961;416;417;1
/net/per610a/home/mvp/mvp_db/news7-lv/2011/2011_06_22_19_00/2011_06_22_19_00.mpg;Kenji Eda.jpg;3877;3913;35961;193;195;2
/net/per610a/home/mvp/mvp_db/news7-lv/2011/2011_06_22_19_00/2011_06_22_19_00.mpg;Kenji Eda.jpg;8057;8085;35961;403;404;1
/net/per610a/home/mvp/mvp_db/news7-lv/2011/2011_06_22_19_00/2011_06_22_19_00.mpg;Kenji Eda.jpg;8721;8845;35961;436;442;6
/net/per610a/home/mvp/mvp_db/news7-lv/2011/2011_06_24_19_00/2011_06_24_19_00.mpg;Yukio EDANO.jpg;18189;18561;35961;909;928;19
/net/per610a/home/mvp/mvp_db/news7-lv/2011/2011_06_26_19_00/2011_06_26_19_00.mpg;Bairi Kaieda.jpg;5813;6017;35961;290;301;11
/net/per610a/home/mvp/mvp_db/news7-lv/2011/2011_06_27_19_00/2011_06_27_19_00.mpg;Shizuka KAMEI.jpg;1;73;35961;0;3;3
/net/per610a/home/mvp/mvp_db/news7-lv/2011/2011_06_27_19_00/2011_06_27_19_00.mpg;Shizuka KAMEI.jpg;4053;4181;35961;202;209;7
/net/per610a/home/mvp/mvp_db/news7-lv/2011/2011_06_27_19_00/2011_06_27_19_00.mpg;Shizuka KAMEI.jpg;4429;5289;35961;221;264;43
/net/per610a/home/mvp/mvp_db/news7-lv/2011/2011_06_28_19_00/2011_06_28_19_00.mpg;Sadakazu TANIGAKI.jpg;22893;23069;35961;1145;1154;9
/net/per610a/home/mvp/mvp_db/news7-lv/2011/2011_06_29_19_00/2011_06_29_19_00.mpg;Bairi Kaieda.jpg;11369;11837;35961;568;592;24
/net/per610a/home/mvp/mvp_db/news7-lv/2011/2011_06_29_19_00/2011_06_29_19_00.mpg;Bairi Kaieda.jpg;14117;14173;35961;706;709;3
/net/per610a/home/mvp/mvp_db/news7-lv/2011/2011_06_30_19_00/2011_06_30_19_00.mpg;Naoto KAN.jpg;11197;11293;35957;560;565;5
/net/per610a/home/mvp/mvp_db/news7-lv/2011/2011_07_01_19_00/2011_07_01_19_00.mpg;Bairi Kaieda.jpg;12845;13085;35961;642;654;12
/net/per610a/home/mvp/mvp_db/news7-lv/2011/2011_07_01_19_00/2011_07_01_19_00.mpg;Kenji Eda.jpg;13701;13789;35961;685;689;4
/net/per610a/home/mvp/mvp_db/news7-lv/2011/2011_07_01_19_00/2011_07_01_19_00.mpg;Ichiro OZAWA.jpg;19105;19301;35961;955;965;10
/net/per610a/home/mvp/mvp_db/news7-lv/2011/2011_07_01_19_00/2011_07_01_19_00.mpg;Toru Hashimoto.jpg;30249;30293;35961;1513;1515;2
/net/per610a/home/mvp/mvp_db/news7-lv/2011/2011_07_01_19_00/2011_07_01_19_00.mpg;Toru Hashimoto.jpg;30457;30533;35961;1523;1527;4
/net/per610a/home/mvp/mvp_db/news7-lv/2011/2011_07_04_19_00/2011_07_04_19_00.mpg;Bairi Kaieda.jpg;2357;2805;35961;117;140;23
/net/per610a/home/mvp/mvp_db/news7-lv/2011/2011_07_04_19_00/2011_07_04_19_00.mpg;Katsuya OKADA.jpg;16065;16713;35961;803;836;33
/net/per610a/home/mvp/mvp_db/news7-lv/2011/2011_07_07_19_00/2011_07_07_19_00.mpg;Yukio EDANO.jpg;17177;17597;35961;859;880;21
/net/per610a/home/mvp/mvp_db/news7-lv/2011/2011_07_07_19_00/2011_07_07_19_00.mpg;Seiji MAEHARA.jpg;18329;18753;35961;916;938;22
/net/per610a/home/mvp/mvp_db/news7-lv/2011/2011_07_07_19_00/2011_07_07_19_00.mpg;Seiji MAEHARA.jpg;19149;19573;35961;957;979;22
/net/per610a/home/mvp/mvp_db/news7-lv/2011/2011_07_07_19_00/2011_07_07_19_00.mpg;Katsuya OKADA.jpg;19953;20309;35961;998;1015;17
/net/per610a/home/mvp/mvp_db/news7-lv/2011/2011_07_14_19_00/2011_07_14_19_00.mpg;Naoto KAN.jpg;20605;20605;35961;1030;1030;0
/net/per610a/home/mvp/mvp_db/news7-lv/2011/2011_07_14_19_00/2011_07_14_19_00.mpg;Naoto KAN.jpg;25473;25857;35961;1274;1293;19
/net/per610a/home/mvp/mvp_db/news7-lv/2011/2011_07_15_19_00/2011_07_15_19_00.mpg;Toru Hashimoto.jpg;27829;28417;35961;1392;1421;29
/net/per610a/home/mvp/mvp_db/news7-lv/2011/2011_07_16_19_00/2011_07_16_19_00.mpg;Naoto KAN.jpg;10649;10769;35961;532;538;6
/net/per610a/home/mvp/mvp_db/news7-lv/2011/2011_07_16_19_00/2011_07_16_19_00.mpg;Naoto KAN.jpg;10929;11305;35961;546;565;19
/net/per610a/home/mvp/mvp_db/news7-lv/2011/2011_07_16_19_00/2011_07_16_19_00.mpg;Naoto KAN.jpg;11453;11845;35961;572;592;20
/net/per610a/home/mvp/mvp_db/news7-lv/2011/2011_07_16_19_00/2011_07_16_19_00.mpg;Naoto KAN.jpg;12861;13373;35961;643;669;26
/net/per610a/home/mvp/mvp_db/news7-lv/2011/2011_07_16_19_00/2011_07_16_19_00.mpg;Shintaro ISHIHARA.jpg;21213;21413;35961;1061;1071;10
/net/per610a/home/mvp/mvp_db/news7-lv/2011/2011_07_17_19_00/2011_07_17_19_00.mpg;Bairi Kaieda.jpg;28085;28589;35961;1404;1430;26
/net/per610a/home/mvp/mvp_db/news7-lv/2011/2011_07_18_19_00/2011_07_18_19_00.mpg;Bairi Kaieda.jpg;30581;31281;35961;1529;1564;35
/net/per610a/home/mvp/mvp_db/news7-lv/2011/2011_07_22_19_00/2011_07_22_19_00.mpg;Kohei Otsuka.jpg;3481;3885;35961;174;194;20
/net/per610a/home/mvp/mvp_db/news7-lv/2011/2011_07_22_19_00/2011_07_22_19_00.mpg;Katsuya OKADA.jpg;11565;11849;35961;578;592;14
/net/per610a/home/mvp/mvp_db/news7-lv/2011/2011_07_22_19_00/2011_07_22_19_00.mpg;Katsuya OKADA.jpg;12369;12425;35961;618;621;3
/net/per610a/home/mvp/mvp_db/news7-lv/2011/2011_07_22_19_00/2011_07_22_19_00.mpg;Katsuya OKADA.jpg;14697;14805;35961;735;740;5
/net/per610a/home/mvp/mvp_db/news7-lv/2011/2011_07_22_19_00/2011_07_22_19_00.mpg;Katsuya OKADA.jpg;14957;15589;35961;748;779;31
/net/per610a/home/mvp/mvp_db/news7-lv/2011/2011_07_22_19_00/2011_07_22_19_00.mpg;Yukio HATOYAMA.jpg;13037;13469;35961;652;673;21
/net/per610a/home/mvp/mvp_db/news7-lv/2011/2011_07_22_19_00/2011_07_22_19_00.mpg;YUriko Koike.jpg;13821;14069;35961;691;703;12
/net/per610a/home/mvp/mvp_db/news7-lv/2011/2011_07_25_19_00/2011_07_25_19_00.mpg;Kohei Otsuka.jpg;27249;27873;36037;1363;1394;31
/net/per610a/home/mvp/mvp_db/news7-lv/2011/2011_07_26_19_00/2011_07_26_19_00.mpg;Yoshihiko Noda.jpg;17989;18161;36041;899;908;9
/net/per610a/home/mvp/mvp_db/news7-lv/2011/2011_07_26_19_00/2011_07_26_19_00.mpg;Naoto KAN.jpg;22697;23113;36041;1135;1156;21
/net/per610a/home/mvp/mvp_db/news7-lv/2011/2011_07_26_19_00/2011_07_26_19_00.mpg;Naoto KAN.jpg;23177;23561;36041;1159;1178;19
/net/per610a/home/mvp/mvp_db/news7-lv/2011/2011_07_29_19_00/2011_07_29_19_00.mpg;Bairi Kaieda.jpg;42997;43333;54017;2151;2168;17
/net/per610a/home/mvp/mvp_db/news7-lv/2011/2011_08_01_19_00/2011_08_01_19_00.mpg;Yoshihiko Noda.jpg;3073;3369;36033;153;168;15
/net/per610a/home/mvp/mvp_db/news7-lv/2011/2011_08_02_19_00/2011_08_02_19_00.mpg;Yoshihiko Noda.jpg;19689;19845;36041;984;992;8
/net/per610a/home/mvp/mvp_db/news7-lv/2011/2011_08_03_19_00/2011_08_03_19_00.mpg;Naoto KAN.jpg;26249;26429;36041;1313;1322;9
/net/per610a/home/mvp/mvp_db/news7-lv/2011/2011_08_04_19_00/2011_08_04_19_00.mpg;Yoshihiko Noda.jpg;4461;4989;38429;223;249;26
/net/per610a/home/mvp/mvp_db/news7-lv/2011/2011_08_04_19_00/2011_08_04_19_00.mpg;Naoto KAN.jpg;11137;11289;38429;557;564;7
/net/per610a/home/mvp/mvp_db/news7-lv/2011/2011_08_05_19_00/2011_08_05_19_00.mpg;Yoshihiko Noda.jpg;18985;19005;36033;949;950;1
/net/per610a/home/mvp/mvp_db/news7-lv/2011/2011_08_05_19_00/2011_08_05_19_00.mpg;Yoshihiko Noda.jpg;19081;19365;36033;954;968;14
/net/per610a/home/mvp/mvp_db/news7-lv/2011/2011_08_08_19_00/2011_08_08_19_00.mpg;Yoshihiko Noda.jpg;1905;1973;36033;95;98;3
/net/per610a/home/mvp/mvp_db/news7-lv/2011/2011_08_08_19_00/2011_08_08_19_00.mpg;Sadakazu TANIGAKI.jpg;6221;6773;36033;311;338;27
/net/per610a/home/mvp/mvp_db/news7-lv/2011/2011_08_08_19_00/2011_08_08_19_00.mpg;Natsuo YAMAGUCHI.jpg;6505;6773;36033;325;338;13
/net/per610a/home/mvp/mvp_db/news7-lv/2011/2011_08_08_19_00/2011_08_08_19_00.mpg;Katsuya OKADA.jpg;6877;6973;36033;344;348;4
/net/per610a/home/mvp/mvp_db/news7-lv/2011/2011_08_08_19_00/2011_08_08_19_00.mpg;Katsuya OKADA.jpg;7417;7549;36033;371;377;6
/net/per610a/home/mvp/mvp_db/news7-lv/2011/2011_08_08_19_00/2011_08_08_19_00.mpg;Ichiro OZAWA.jpg;27265;27469;36033;1364;1374;10
/net/per610a/home/mvp/mvp_db/news7-lv/2011/2011_08_09_19_00/2011_08_09_19_00.mpg;Naoto KAN.jpg;9141;9669;36033;457;483;26
/net/per610a/home/mvp/mvp_db/news7-lv/2011/2011_08_09_19_00/2011_08_09_19_00.mpg;Naoto KAN.jpg;12497;12625;36033;625;631;6
/net/per610a/home/mvp/mvp_db/news7-lv/2011/2011_08_09_19_00/2011_08_09_19_00.mpg;Katsuya OKADA.jpg;12173;12453;36033;609;623;14
/net/per610a/home/mvp/mvp_db/news7-lv/2011/2011_08_09_19_00/2011_08_09_19_00.mpg;Takako DOI.jpg;15365;15529;36033;768;777;9
/net/per610a/home/mvp/mvp_db/news7-lv/2011/2011_08_09_19_00/2011_08_09_19_00.mpg;Sadakazu TANIGAKI.jpg;27081;27413;36033;1355;1371;16
/net/per610a/home/mvp/mvp_db/news7-lv/2011/2011_08_10_19_00/2011_08_10_19_00.mpg;Yoshihiko Noda.jpg;10861;10941;36037;543;547;4
/net/per610a/home/mvp/mvp_db/news7-lv/2011/2011_08_10_19_00/2011_08_10_19_00.mpg;Yoshihiko Noda.jpg;16373;16481;36037;819;824;5
/net/per610a/home/mvp/mvp_db/news7-lv/2011/2011_08_10_19_00/2011_08_10_19_00.mpg;Bairi Kaieda.jpg;16765;16885;36037;838;844;6
/net/per610a/home/mvp/mvp_db/news7-lv/2011/2011_08_13_19_00/2011_08_13_19_00.mpg;Yoshihiko Noda.jpg;15793;16661;36033;790;833;43
/net/per610a/home/mvp/mvp_db/news7-lv/2011/2011_08_13_19_00/2011_08_13_19_00.mpg;Yoshihiko Noda.jpg;16729;18921;36033;837;946;109
/net/per610a/home/mvp/mvp_db/news7-lv/2011/2011_08_13_19_00/2011_08_13_19_00.mpg;Seiji MAEHARA.jpg;19305;19881;36033;965;994;29
/net/per610a/home/mvp/mvp_db/news7-lv/2011/2011_08_14_19_00/2011_08_14_19_00.mpg;Bairi Kaieda.jpg;28273;28501;36033;1414;1426;12
/net/per610a/home/mvp/mvp_db/news7-lv/2011/2011_08_17_19_00/2011_08_17_19_00.mpg;Ichiro OZAWA.jpg;27349;28325;36033;1368;1417;49
/net/per610a/home/mvp/mvp_db/news7-lv/2011/2011_08_18_19_00/2011_08_18_19_00.mpg;Bairi Kaieda.jpg;19301;19921;36033;965;996;31
/net/per610a/home/mvp/mvp_db/news7-lv/2011/2011_08_18_19_00/2011_08_18_19_00.mpg;Bairi Kaieda.jpg;20953;21025;36033;1048;1052;4
/net/per610a/home/mvp/mvp_db/news7-lv/2011/2011_08_19_19_00/2011_08_19_19_00.mpg;Ichiro OZAWA.jpg;8249;8661;36033;412;433;21
/net/per610a/home/mvp/mvp_db/news7-lv/2011/2011_08_20_19_00/2011_08_20_19_00.mpg;Yoshihiko Noda.jpg;1613;1721;36033;80;86;6
/net/per610a/home/mvp/mvp_db/news7-lv/2011/2011_08_20_19_00/2011_08_20_19_00.mpg;Yoshihiko Noda.jpg;1845;2333;36033;92;116;24
/net/per610a/home/mvp/mvp_db/news7-lv/2011/2011_08_20_19_00/2011_08_20_19_00.mpg;Yoshihiko Noda.jpg;6733;7001;36033;336;350;14
/net/per610a/home/mvp/mvp_db/news7-lv/2011/2011_08_20_19_00/2011_08_20_19_00.mpg;Yukio HATOYAMA.jpg;1845;2333;36033;92;116;24
/net/per610a/home/mvp/mvp_db/news7-lv/2011/2011_08_20_19_00/2011_08_20_19_00.mpg;Yukio HATOYAMA.jpg;2521;3385;36033;126;169;43
/net/per610a/home/mvp/mvp_db/news7-lv/2011/2011_08_21_19_00/2011_08_21_19_00.mpg;Naoto KAN.jpg;6321;7033;36033;316;351;35
/net/per610a/home/mvp/mvp_db/news7-lv/2011/2011_08_22_19_00/2011_08_22_19_00.mpg;Seiji MAEHARA.jpg;8817;9425;36033;441;471;30
/net/per610a/home/mvp/mvp_db/news7-lv/2011/2011_08_22_19_00/2011_08_22_19_00.mpg;Yukio HATOYAMA.jpg;9593;9781;36033;480;489;9
/net/per610a/home/mvp/mvp_db/news7-lv/2011/2011_08_22_19_00/2011_08_22_19_00.mpg;Yoshihiko Noda.jpg;10133;10289;36033;507;514;7
/net/per610a/home/mvp/mvp_db/news7-lv/2011/2011_08_22_19_00/2011_08_22_19_00.mpg;Bairi Kaieda.jpg;11581;11693;36033;579;585;6
/net/per610a/home/mvp/mvp_db/news7-lv/2011/2011_08_22_19_00/2011_08_22_19_00.mpg;Katsuya OKADA.jpg;12545;12669;36033;627;633;6
/net/per610a/home/mvp/mvp_db/news7-lv/2011/2011_08_23_19_00/2011_08_23_19_00.mpg;Seiji MAEHARA.jpg;137;313;36033;6;15;9
/net/per610a/home/mvp/mvp_db/news7-lv/2011/2011_08_23_19_00/2011_08_23_19_00.mpg;Seiji MAEHARA.jpg;985;1449;36033;49;72;23
/net/per610a/home/mvp/mvp_db/news7-lv/2011/2011_08_23_19_00/2011_08_23_19_00.mpg;Seiji MAEHARA.jpg;1513;3797;36033;75;189;114
/net/per610a/home/mvp/mvp_db/news7-lv/2011/2011_08_23_19_00/2011_08_23_19_00.mpg;Seiji MAEHARA.jpg;7793;8317;36033;389;416;27
/net/per610a/home/mvp/mvp_db/news7-lv/2011/2011_08_23_19_00/2011_08_23_19_00.mpg;Seiji MAEHARA.jpg;10093;10277;36033;505;514;9
/net/per610a/home/mvp/mvp_db/news7-lv/2011/2011_08_23_19_00/2011_08_23_19_00.mpg;Bairi Kaieda.jpg;329;429;36033;16;21;5
/net/per610a/home/mvp/mvp_db/news7-lv/2011/2011_08_23_19_00/2011_08_23_19_00.mpg;Bairi Kaieda.jpg;9165;9289;36033;458;464;6
/net/per610a/home/mvp/mvp_db/news7-lv/2011/2011_08_23_19_00/2011_08_23_19_00.mpg;Yoshihiko Noda.jpg;329;425;36033;16;21;5
/net/per610a/home/mvp/mvp_db/news7-lv/2011/2011_08_23_19_00/2011_08_23_19_00.mpg;Yoshihiko Noda.jpg;7793;8317;36033;389;416;27
/net/per610a/home/mvp/mvp_db/news7-lv/2011/2011_08_23_19_00/2011_08_23_19_00.mpg;Ichiro OZAWA.jpg;5373;5793;36033;268;289;21
/net/per610a/home/mvp/mvp_db/news7-lv/2011/2011_08_23_19_00/2011_08_23_19_00.mpg;Natsuo YAMAGUCHI.jpg;6573;7177;36033;328;359;31
/net/per610a/home/mvp/mvp_db/news7-lv/2011/2011_08_23_19_00/2011_08_23_19_00.mpg;Seiji MAEHARA.jpg;7717;7785;36033;386;389;3
/net/per610a/home/mvp/mvp_db/news7-lv/2011/2011_08_23_19_00/2011_08_23_19_00.mpg;Seiji MAEHARA.jpg;9029;9289;36033;451;464;13
/net/per610a/home/mvp/mvp_db/news7-lv/2011/2011_08_24_19_00/2011_08_24_19_00.mpg;Seiji MAEHARA.jpg;1;197;36037;0;9;9
/net/per610a/home/mvp/mvp_db/news7-lv/2011/2011_08_24_19_00/2011_08_24_19_00.mpg;Seiji MAEHARA.jpg;1909;2405;36037;95;120;25
/net/per610a/home/mvp/mvp_db/news7-lv/2011/2011_08_24_19_00/2011_08_24_19_00.mpg;Seiji MAEHARA.jpg;5857;6337;36037;293;317;24
/net/per610a/home/mvp/mvp_db/news7-lv/2011/2011_08_24_19_00/2011_08_24_19_00.mpg;Yukio HATOYAMA.jpg;1909;2405;36037;95;120;25
/net/per610a/home/mvp/mvp_db/news7-lv/2011/2011_08_24_19_00/2011_08_24_19_00.mpg;Yoshihiko Noda.jpg;2905;4189;36037;145;209;64
/net/per610a/home/mvp/mvp_db/news7-lv/2011/2011_08_24_19_00/2011_08_24_19_00.mpg;Yoshihiko Noda.jpg;12217;12361;36037;611;618;7
/net/per610a/home/mvp/mvp_db/news7-lv/2011/2011_08_24_19_00/2011_08_24_19_00.mpg;Ichiro OZAWA.jpg;5153;6825;36037;257;341;84
/net/per610a/home/mvp/mvp_db/news7-lv/2011/2011_08_24_19_00/2011_08_24_19_00.mpg;Bairi Kaieda.jpg;7077;7409;36037;354;370;16
/net/per610a/home/mvp/mvp_db/news7-lv/2011/2011_08_25_19_00/2011_08_25_19_00.mpg;Yoshihiko Noda.jpg;9377;10309;36033;469;515;46
/net/per610a/home/mvp/mvp_db/news7-lv/2011/2011_08_25_19_00/2011_08_25_19_00.mpg;Yukio HATOYAMA.jpg;11729;13445;36033;586;672;86
/net/per610a/home/mvp/mvp_db/news7-lv/2011/2011_08_25_19_00/2011_08_25_19_00.mpg;Ichiro OZAWA.jpg;11729;12545;36033;586;627;41
/net/per610a/home/mvp/mvp_db/news7-lv/2011/2011_08_26_19_00/2011_08_26_19_00.mpg;Naoto KAN.jpg;49;161;38433;2;8;6
/net/per610a/home/mvp/mvp_db/news7-lv/2011/2011_08_26_19_00/2011_08_26_19_00.mpg;Naoto KAN.jpg;1541;1689;38433;77;84;7
/net/per610a/home/mvp/mvp_db/news7-lv/2011/2011_08_26_19_00/2011_08_26_19_00.mpg;Naoto KAN.jpg;10789;11249;38433;539;562;23
/net/per610a/home/mvp/mvp_db/news7-lv/2011/2011_08_26_19_00/2011_08_26_19_00.mpg;Naoto KAN.jpg;11317;12185;38433;566;609;43
/net/per610a/home/mvp/mvp_db/news7-lv/2011/2011_08_26_19_00/2011_08_26_19_00.mpg;Seiji MAEHARA.jpg;2693;3165;38433;134;158;24
/net/per610a/home/mvp/mvp_db/news7-lv/2011/2011_08_26_19_00/2011_08_26_19_00.mpg;Seiji MAEHARA.jpg;7765;8173;38433;388;408;20
/net/per610a/home/mvp/mvp_db/news7-lv/2011/2011_08_26_19_00/2011_08_26_19_00.mpg;Yoshihiko Noda.jpg;3457;3957;38433;172;197;25
/net/per610a/home/mvp/mvp_db/news7-lv/2011/2011_08_26_19_00/2011_08_26_19_00.mpg;Yukio HATOYAMA.jpg;5213;5661;38433;260;283;23
/net/per610a/home/mvp/mvp_db/news7-lv/2011/2011_08_26_19_00/2011_08_26_19_00.mpg;Yukio HATOYAMA.jpg;6013;6725;38433;300;336;36
/net/per610a/home/mvp/mvp_db/news7-lv/2011/2011_08_26_19_00/2011_08_26_19_00.mpg;Ichiro OZAWA.jpg;6013;6725;38433;300;336;36
/net/per610a/home/mvp/mvp_db/news7-lv/2011/2011_08_26_19_00/2011_08_26_19_00.mpg;Ichiro OZAWA.jpg;7765;9781;38433;388;489;101
/net/per610a/home/mvp/mvp_db/news7-lv/2011/2011_08_27_19_00/2011_08_27_19_00.mpg;Bairi Kaieda.jpg;109;205;36033;5;10;5
/net/per610a/home/mvp/mvp_db/news7-lv/2011/2011_08_27_19_00/2011_08_27_19_00.mpg;Bairi Kaieda.jpg;2713;3101;36033;135;155;20
/net/per610a/home/mvp/mvp_db/news7-lv/2011/2011_08_27_19_00/2011_08_27_19_00.mpg;Bairi Kaieda.jpg;6465;6781;36033;323;339;16
/net/per610a/home/mvp/mvp_db/news7-lv/2011/2011_08_27_19_00/2011_08_27_19_00.mpg;Bairi Kaieda.jpg;12805;13113;36033;640;656;16
/net/per610a/home/mvp/mvp_db/news7-lv/2011/2011_08_27_19_00/2011_08_27_19_00.mpg;Bairi Kaieda.jpg;14109;14117;36033;705;706;1
/net/per610a/home/mvp/mvp_db/news7-lv/2011/2011_08_27_19_00/2011_08_27_19_00.mpg;Bairi Kaieda.jpg;15965;17565;36033;798;878;80
/net/per610a/home/mvp/mvp_db/news7-lv/2011/2011_08_27_19_00/2011_08_27_19_00.mpg;Yoshihiko Noda.jpg;129;205;36033;6;10;4
/net/per610a/home/mvp/mvp_db/news7-lv/2011/2011_08_27_19_00/2011_08_27_19_00.mpg;Yoshihiko Noda.jpg;3181;3793;36033;159;189;30
/net/per610a/home/mvp/mvp_db/news7-lv/2011/2011_08_27_19_00/2011_08_27_19_00.mpg;Yoshihiko Noda.jpg;6077;6337;36033;304;317;13
/net/per610a/home/mvp/mvp_db/news7-lv/2011/2011_08_27_19_00/2011_08_27_19_00.mpg;Yoshihiko Noda.jpg;13149;13393;36033;657;670;13
/net/per610a/home/mvp/mvp_db/news7-lv/2011/2011_08_27_19_00/2011_08_27_19_00.mpg;Yoshihiko Noda.jpg;15597;15693;36033;780;785;5
/net/per610a/home/mvp/mvp_db/news7-lv/2011/2011_08_27_19_00/2011_08_27_19_00.mpg;Seiji MAEHARA.jpg;937;1041;36033;46;52;6
/net/per610a/home/mvp/mvp_db/news7-lv/2011/2011_08_27_19_00/2011_08_27_19_00.mpg;Seiji MAEHARA.jpg;6077;6337;36033;304;317;13
/net/per610a/home/mvp/mvp_db/news7-lv/2011/2011_08_27_19_00/2011_08_27_19_00.mpg;Seiji MAEHARA.jpg;8245;9521;36033;412;476;64
/net/per610a/home/mvp/mvp_db/news7-lv/2011/2011_08_27_19_00/2011_08_27_19_00.mpg;Seiji MAEHARA.jpg;9649;11537;36033;482;577;95
/net/per610a/home/mvp/mvp_db/news7-lv/2011/2011_08_27_19_00/2011_08_27_19_00.mpg;Seiji MAEHARA.jpg;11713;12421;36033;586;621;35
/net/per610a/home/mvp/mvp_db/news7-lv/2011/2011_08_27_19_00/2011_08_27_19_00.mpg;Seiji MAEHARA.jpg;14109;14117;36033;705;706;1
/net/per610a/home/mvp/mvp_db/news7-lv/2011/2011_08_27_19_00/2011_08_27_19_00.mpg;Seiji MAEHARA.jpg;15273;15389;36033;764;770;6
/net/per610a/home/mvp/mvp_db/news7-lv/2011/2011_08_27_19_00/2011_08_27_19_00.mpg;Naoto KAN.jpg;22357;22737;36033;1118;1137;19
/net/per610a/home/mvp/mvp_db/news7-lv/2011/2011_08_27_19_00/2011_08_27_19_00.mpg;Naoto KAN.jpg;23681;24261;36033;1184;1213;29
/net/per610a/home/mvp/mvp_db/news7-lv/2011/2011_08_28_19_00/2011_08_28_19_00.mpg;Seiji MAEHARA.jpg;45;137;36033;2;6;4
/net/per610a/home/mvp/mvp_db/news7-lv/2011/2011_08_28_19_00/2011_08_28_19_00.mpg;Seiji MAEHARA.jpg;2289;2693;36033;114;134;20
/net/per610a/home/mvp/mvp_db/news7-lv/2011/2011_08_28_19_00/2011_08_28_19_00.mpg;Seiji MAEHARA.jpg;6833;6853;36033;341;342;1
/net/per610a/home/mvp/mvp_db/news7-lv/2011/2011_08_28_19_00/2011_08_28_19_00.mpg;Seiji MAEHARA.jpg;7105;9413;36033;355;471;116
/net/per610a/home/mvp/mvp_db/news7-lv/2011/2011_08_28_19_00/2011_08_28_19_00.mpg;Seiji MAEHARA.jpg;9973;10321;36033;499;516;17
/net/per610a/home/mvp/mvp_db/news7-lv/2011/2011_08_28_19_00/2011_08_28_19_00.mpg;Seiji MAEHARA.jpg;11617;11641;36033;581;582;1
/net/per610a/home/mvp/mvp_db/news7-lv/2011/2011_08_28_19_00/2011_08_28_19_00.mpg;Seiji MAEHARA.jpg;14701;14773;36033;735;739;4
/net/per610a/home/mvp/mvp_db/news7-lv/2011/2011_08_28_19_00/2011_08_28_19_00.mpg;Seiji MAEHARA.jpg;15169;15221;36033;759;761;2
/net/per610a/home/mvp/mvp_db/news7-lv/2011/2011_08_28_19_00/2011_08_28_19_00.mpg;Seiji MAEHARA.jpg;1537;1785;36033;76;89;13
/net/per610a/home/mvp/mvp_db/news7-lv/2011/2011_08_28_19_00/2011_08_28_19_00.mpg;Seiji MAEHARA.jpg;1873;2129;36033;93;106;13
/net/per610a/home/mvp/mvp_db/news7-lv/2011/2011_08_28_19_00/2011_08_28_19_00.mpg;Yukio HATOYAMA.jpg;3857;3985;36033;192;199;7
/net/per610a/home/mvp/mvp_db/news7-lv/2011/2011_08_28_19_00/2011_08_28_19_00.mpg;Yoshihiko Noda.jpg;5037;5817;36033;252;291;39
/net/per610a/home/mvp/mvp_db/news7-lv/2011/2011_08_28_19_00/2011_08_28_19_00.mpg;Yoshihiko Noda.jpg;6893;6921;36033;344;346;2
/net/per610a/home/mvp/mvp_db/news7-lv/2011/2011_08_28_19_00/2011_08_28_19_00.mpg;Yoshihiko Noda.jpg;11617;11777;36033;581;589;8
/net/per610a/home/mvp/mvp_db/news7-lv/2011/2011_08_28_19_00/2011_08_28_19_00.mpg;Yoshihiko Noda.jpg;13049;13365;36033;652;668;16
/net/per610a/home/mvp/mvp_db/news7-lv/2011/2011_08_28_19_00/2011_08_28_19_00.mpg;Yoshihiko Noda.jpg;14809;14841;36033;741;742;1
/net/per610a/home/mvp/mvp_db/news7-lv/2011/2011_08_29_19_00/2011_08_29_19_00.mpg;Yoshihiko Noda.jpg;137;381;38433;6;19;13
/net/per610a/home/mvp/mvp_db/news7-lv/2011/2011_08_29_19_00/2011_08_29_19_00.mpg;Yoshihiko Noda.jpg;3989;5181;38433;199;259;60
/net/per610a/home/mvp/mvp_db/news7-lv/2011/2011_08_29_19_00/2011_08_29_19_00.mpg;Yoshihiko Noda.jpg;6169;6701;38433;308;335;27
/net/per610a/home/mvp/mvp_db/news7-lv/2011/2011_08_29_19_00/2011_08_29_19_00.mpg;Yoshihiko Noda.jpg;27385;27633;38433;1370;1382;12
/net/per610a/home/mvp/mvp_db/news7-lv/2011/2011_08_29_19_00/2011_08_29_19_00.mpg;Yoshihiko Noda.jpg;5429;5437;38433;271;272;1
/net/per610a/home/mvp/mvp_db/news7-lv/2011/2011_08_29_19_00/2011_08_29_19_00.mpg;Yoshihiko Noda.jpg;14309;14349;38433;715;717;2
/net/per610a/home/mvp/mvp_db/news7-lv/2011/2011_08_29_19_00/2011_08_29_19_00.mpg;Sadakazu TANIGAKI.jpg;7509;7545;38433;375;377;2
/net/per610a/home/mvp/mvp_db/news7-lv/2011/2011_08_29_19_00/2011_08_29_19_00.mpg;Sadakazu TANIGAKI.jpg;27093;27121;38433;1355;1357;2
/net/per610a/home/mvp/mvp_db/news7-lv/2011/2011_08_29_19_00/2011_08_29_19_00.mpg;Sadakazu TANIGAKI.jpg;27185;27305;38433;1360;1366;6
/net/per610a/home/mvp/mvp_db/news7-lv/2011/2011_08_29_19_00/2011_08_29_19_00.mpg;Yoshihiko Noda.jpg;17081;17153;38433;854;858;4
/net/per610a/home/mvp/mvp_db/news7-lv/2011/2011_08_29_19_00/2011_08_29_19_00.mpg;Yoshihiko Noda.jpg;17413;17505;38433;871;875;4
/net/per610a/home/mvp/mvp_db/news7-lv/2011/2011_08_29_19_00/2011_08_29_19_00.mpg;Yoshihiko Noda.jpg;17697;19217;38433;885;961;76
/net/per610a/home/mvp/mvp_db/news7-lv/2011/2011_08_29_19_00/2011_08_29_19_00.mpg;Yoshihiko Noda.jpg;19285;24381;38433;964;1219;255
/net/per610a/home/mvp/mvp_db/news7-lv/2011/2011_08_29_19_00/2011_08_29_19_00.mpg;Yoshihiko Noda.jpg;26893;27029;38433;1345;1352;7
/net/per610a/home/mvp/mvp_db/news7-lv/2011/2011_08_29_19_00/2011_08_29_19_00.mpg;Yoshihiko Noda.jpg;27129;27169;38433;1357;1359;2
/net/per610a/home/mvp/mvp_db/news7-lv/2011/2011_08_30_19_00/2011_08_30_19_00.mpg;Yoshihiko Noda.jpg;93;225;36033;4;11;7
/net/per610a/home/mvp/mvp_db/news7-lv/2011/2011_08_30_19_00/2011_08_30_19_00.mpg;Yoshihiko Noda.jpg;1897;1921;36033;94;96;2
/net/per610a/home/mvp/mvp_db/news7-lv/2011/2011_08_30_19_00/2011_08_30_19_00.mpg;Yoshihiko Noda.jpg;5933;6121;36033;296;306;10
/net/per610a/home/mvp/mvp_db/news7-lv/2011/2011_08_30_19_00/2011_08_30_19_00.mpg;Yoshihiko Noda.jpg;6957;6993;36033;348;349;1
/net/per610a/home/mvp/mvp_db/news7-lv/2011/2011_08_30_19_00/2011_08_30_19_00.mpg;Yoshihiko Noda.jpg;7705;7961;36033;385;398;13
/net/per610a/home/mvp/mvp_db/news7-lv/2011/2011_08_30_19_00/2011_08_30_19_00.mpg;Yoshihiko Noda.jpg;9089;12953;36033;454;648;194
/net/per610a/home/mvp/mvp_db/news7-lv/2011/2011_08_30_19_00/2011_08_30_19_00.mpg;Yoshihiko Noda.jpg;13545;13733;36033;677;687;10
/net/per610a/home/mvp/mvp_db/news7-lv/2011/2011_08_30_19_00/2011_08_30_19_00.mpg;Yoshihiko Noda.jpg;15657;16893;36033;783;845;62
/net/per610a/home/mvp/mvp_db/news7-lv/2011/2011_08_30_19_00/2011_08_30_19_00.mpg;Yoshihiko Noda.jpg;17117;17229;36033;856;862;6
/net/per610a/home/mvp/mvp_db/news7-lv/2011/2011_08_30_19_00/2011_08_30_19_00.mpg;Yoshihiko Noda.jpg;17921;18081;36033;896;904;8
/net/per610a/home/mvp/mvp_db/news7-lv/2011/2011_08_30_19_00/2011_08_30_19_00.mpg;Yoshihiko Noda.jpg;18477;18481;36033;924;924;0
/net/per610a/home/mvp/mvp_db/news7-lv/2011/2011_08_30_19_00/2011_08_30_19_00.mpg;Seiji MAEHARA.jpg;3377;4357;36033;168;218;50
/net/per610a/home/mvp/mvp_db/news7-lv/2011/2011_08_30_19_00/2011_08_30_19_00.mpg;Seiji MAEHARA.jpg;17097;17221;36033;855;861;6
/net/per610a/home/mvp/mvp_db/news7-lv/2011/2011_08_30_19_00/2011_08_30_19_00.mpg;Seiji MAEHARA.jpg;17545;17909;36033;877;896;19
/net/per610a/home/mvp/mvp_db/news7-lv/2011/2011_08_30_19_00/2011_08_30_19_00.mpg;Seiji MAEHARA.jpg;18381;18549;36033;919;928;9
/net/per610a/home/mvp/mvp_db/news7-lv/2011/2011_08_31_19_00/2011_08_31_19_00.mpg;Yoshihiko Noda.jpg;1713;1853;36033;85;92;7
/net/per610a/home/mvp/mvp_db/news7-lv/2011/2011_08_31_19_00/2011_08_31_19_00.mpg;Yoshihiko Noda.jpg;3653;3709;36033;182;185;3
/net/per610a/home/mvp/mvp_db/news7-lv/2011/2011_08_31_19_00/2011_08_31_19_00.mpg;Yoshihiko Noda.jpg;7437;7561;36033;372;378;6
/net/per610a/home/mvp/mvp_db/news7-lv/2011/2011_09_01_19_00/2011_09_01_19_00.mpg;Sadakazu TANIGAKI.jpg;5361;5581;36033;268;279;11
/net/per610a/home/mvp/mvp_db/news7-lv/2011/2011_09_01_19_00/2011_09_01_19_00.mpg;Sadakazu TANIGAKI.jpg;5889;6161;36033;294;308;14
/net/per610a/home/mvp/mvp_db/news7-lv/2011/2011_09_01_19_00/2011_09_01_19_00.mpg;Yoshihiko Noda.jpg;5593;5685;36033;279;284;5
/net/per610a/home/mvp/mvp_db/news7-lv/2011/2011_09_01_19_00/2011_09_01_19_00.mpg;Yoshihiko Noda.jpg;6629;7489;36033;331;374;43
/net/per610a/home/mvp/mvp_db/news7-lv/2011/2011_09_01_19_00/2011_09_01_19_00.mpg;Yoshihiko Noda.jpg;8785;9517;36033;439;476;37
/net/per610a/home/mvp/mvp_db/news7-lv/2011/2011_09_02_19_00/2011_09_02_19_00.mpg;Yoshihiko Noda.jpg;93;121;71997;4;6;2
/net/per610a/home/mvp/mvp_db/news7-lv/2011/2011_09_02_19_00/2011_09_02_19_00.mpg;Yoshihiko Noda.jpg;213;385;71997;10;19;9
/net/per610a/home/mvp/mvp_db/news7-lv/2011/2011_09_02_19_00/2011_09_02_19_00.mpg;Yoshihiko Noda.jpg;1197;1261;71997;59;63;4
/net/per610a/home/mvp/mvp_db/news7-lv/2011/2011_09_02_19_00/2011_09_02_19_00.mpg;Yoshihiko Noda.jpg;9989;10429;71997;499;521;22
/net/per610a/home/mvp/mvp_db/news7-lv/2011/2011_09_02_19_00/2011_09_02_19_00.mpg;Yoshihiko Noda.jpg;10509;10609;71997;525;530;5
/net/per610a/home/mvp/mvp_db/news7-lv/2011/2011_09_02_19_00/2011_09_02_19_00.mpg;Yoshihiko Noda.jpg;38025;38069;71997;1902;1905;3
/net/per610a/home/mvp/mvp_db/news7-lv/2011/2011_09_02_19_00/2011_09_02_19_00.mpg;Yoshihiko Noda.jpg;52681;52985;71997;2636;2651;15
/net/per610a/home/mvp/mvp_db/news7-lv/2011/2011_09_02_19_00/2011_09_02_19_00.mpg;Yoshihiko Noda.jpg;60077;60841;71997;3006;3044;38
/net/per610a/home/mvp/mvp_db/news7-lv/2011/2011_09_02_19_00/2011_09_02_19_00.mpg;Yoshihiko Noda.jpg;14001;15593;71997;700;780;80
/net/per610a/home/mvp/mvp_db/news7-lv/2011/2011_09_02_19_00/2011_09_02_19_00.mpg;Yoshihiko Noda.jpg;35461;35541;71997;1774;1778;4
/net/per610a/home/mvp/mvp_db/news7-lv/2011/2011_09_02_19_00/2011_09_02_19_00.mpg;Yoshihiko Noda.jpg;59093;59357;71997;2957;2970;13
/net/per610a/home/mvp/mvp_db/news7-lv/2011/2011_09_02_19_00/2011_09_02_19_00.mpg;Yoshihiko Noda.jpg;61065;61233;71997;3055;3064;9
/net/per610a/home/mvp/mvp_db/news7-lv/2011/2011_09_02_19_00/2011_09_02_19_00.mpg;Yoshihiko Noda.jpg;61677;61757;71997;3086;3090;4
/net/per610a/home/mvp/mvp_db/news7-lv/2011/2011_09_02_19_00/2011_09_02_19_00.mpg;Ichiro OZAWA.jpg;40773;40861;71997;2040;2044;4
/net/per610a/home/mvp/mvp_db/news7-lv/2011/2011_09_02_19_00/2011_09_02_19_00.mpg;Katsuya OKADA.jpg;47457;47757;71997;2374;2389;15
/net/per610a/home/mvp/mvp_db/news7-lv/2011/2011_09_03_19_00/2011_09_03_19_00.mpg;Yoshihiko Noda.jpg;35529;35841;54017;1777;1793;16
/net/per610a/home/mvp/mvp_db/news7-lv/2011/2011_09_03_19_00/2011_09_03_19_00.mpg;Yoshihiko Noda.jpg;35913;35925;54017;1797;1797;0
/net/per610a/home/mvp/mvp_db/news7-lv/2011/2011_09_03_19_00/2011_09_03_19_00.mpg;Yoshihiko Noda.jpg;36477;36477;54017;1825;1825;0
/net/per610a/home/mvp/mvp_db/news7-lv/2011/2011_09_03_19_00/2011_09_03_19_00.mpg;Yoshihiko Noda.jpg;38249;38341;54017;1913;1918;5
/net/per610a/home/mvp/mvp_db/news7-lv/2011/2011_09_04_19_00/2011_09_04_19_00.mpg;Yoshihiko Noda.jpg;64525;64545;72005;3228;3229;1
/net/per610a/home/mvp/mvp_db/news7-lv/2011/2011_09_04_19_00/2011_09_04_19_00.mpg;Yoshihiko Noda.jpg;64877;65225;72005;3246;3263;17
/net/per610a/home/mvp/mvp_db/news7-lv/2011/2011_09_05_19_00/2011_09_05_19_00.mpg;Yoshihiko Noda.jpg;25869;26177;38433;1294;1309;15
/net/per610a/home/mvp/mvp_db/news7-lv/2011/2011_09_05_19_00/2011_09_05_19_00.mpg;Yoshihiko Noda.jpg;27753;27813;38433;1388;1391;3
/net/per610a/home/mvp/mvp_db/news7-lv/2011/2011_09_05_19_00/2011_09_05_19_00.mpg;Yoshihiko Noda.jpg;27965;28069;38433;1399;1404;5
/net/per610a/home/mvp/mvp_db/news7-lv/2011/2011_09_05_19_00/2011_09_05_19_00.mpg;Yoshihiko Noda.jpg;28141;28189;38433;1408;1410;2
/net/per610a/home/mvp/mvp_db/news7-lv/2011/2011_09_06_19_00/2011_09_06_19_00.mpg;Yoshihiko Noda.jpg;19813;20165;36033;991;1009;18
/net/per610a/home/mvp/mvp_db/news7-lv/2011/2011_09_06_19_00/2011_09_06_19_00.mpg;Yoshihiko Noda.jpg;20289;20289;36033;1015;1015;0
/net/per610a/home/mvp/mvp_db/news7-lv/2011/2011_09_06_19_00/2011_09_06_19_00.mpg;Yoshihiko Noda.jpg;20417;20625;36033;1021;1032;11
/net/per610a/home/mvp/mvp_db/news7-lv/2011/2011_09_07_19_00/2011_09_07_19_00.mpg;Yoshihiko Noda.jpg;29261;29597;36037;1463;1480;17
/net/per610a/home/mvp/mvp_db/news7-lv/2011/2011_09_08_19_00/2011_09_08_19_00.mpg;Yoshihiko Noda.jpg;11121;11621;36041;556;581;25
/net/per610a/home/mvp/mvp_db/news7-lv/2011/2011_09_08_19_00/2011_09_08_19_00.mpg;Yoshihiko Noda.jpg;11833;12089;36041;591;604;13
/net/per610a/home/mvp/mvp_db/news7-lv/2011/2011_09_08_19_00/2011_09_08_19_00.mpg;Yoshihiko Noda.jpg;12797;13309;36041;640;665;25
/net/per610a/home/mvp/mvp_db/news7-lv/2011/2011_09_09_19_00/2011_09_09_19_00.mpg;Yoshihiko Noda.jpg;2997;3225;36033;149;161;12
/net/per610a/home/mvp/mvp_db/news7-lv/2011/2011_09_09_19_00/2011_09_09_19_00.mpg;Yoshihiko Noda.jpg;9089;9293;36033;454;464;10
/net/per610a/home/mvp/mvp_db/news7-lv/2011/2011_09_10_19_00/2011_09_10_19_00.mpg;Yoshihiko Noda.jpg;20585;20809;36033;1030;1041;11
/net/per610a/home/mvp/mvp_db/news7-lv/2011/2011_09_12_19_00/2011_09_12_19_00.mpg;Yoshihiko Noda.jpg;23949;24017;36033;1198;1201;3
/net/per610a/home/mvp/mvp_db/news7-lv/2011/2011_09_12_19_00/2011_09_12_19_00.mpg;Yoshihiko Noda.jpg;24269;24381;36033;1214;1219;5
/net/per610a/home/mvp/mvp_db/news7-lv/2011/2011_09_12_19_00/2011_09_12_19_00.mpg;Yoshihiko Noda.jpg;24681;24729;36033;1234;1237;3
/net/per610a/home/mvp/mvp_db/news7-lv/2011/2011_09_12_19_00/2011_09_12_19_00.mpg;Yoshihiko Noda.jpg;25281;25333;36033;1264;1267;3
/net/per610a/home/mvp/mvp_db/news7-lv/2011/2011_09_12_19_00/2011_09_12_19_00.mpg;Ichiro OZAWA.jpg;26241;26433;36033;1313;1322;9
/net/per610a/home/mvp/mvp_db/news7-lv/2011/2011_09_13_19_00/2011_09_13_19_00.mpg;Yoshihiko Noda.jpg;793;1061;36033;39;53;14
/net/per610a/home/mvp/mvp_db/news7-lv/2011/2011_09_13_19_00/2011_09_13_19_00.mpg;Yoshihiko Noda.jpg;2765;2869;36033;138;143;5
/net/per610a/home/mvp/mvp_db/news7-lv/2011/2011_09_13_19_00/2011_09_13_19_00.mpg;Yoshihiko Noda.jpg;3001;3521;36033;150;176;26
/net/per610a/home/mvp/mvp_db/news7-lv/2011/2011_09_13_19_00/2011_09_13_19_00.mpg;Yoshihiko Noda.jpg;6369;7345;36033;318;367;49
/net/per610a/home/mvp/mvp_db/news7-lv/2011/2011_09_13_19_00/2011_09_13_19_00.mpg;Yoshihiko Noda.jpg;11533;11637;36033;577;582;5
/net/per610a/home/mvp/mvp_db/news7-lv/2011/2011_09_13_19_00/2011_09_13_19_00.mpg;Yoshihiko Noda.jpg;11753;11873;36033;588;594;6
/net/per610a/home/mvp/mvp_db/news7-lv/2011/2011_09_13_19_00/2011_09_13_19_00.mpg;Katsuya OKADA.jpg;4333;4437;36033;216;222;6
/net/per610a/home/mvp/mvp_db/news7-lv/2011/2011_09_13_19_00/2011_09_13_19_00.mpg;Sadakazu TANIGAKI.jpg;8229;10645;36033;411;532;121
/net/per610a/home/mvp/mvp_db/news7-lv/2011/2011_09_14_19_00/2011_09_14_19_00.mpg;Yoshihiko Noda.jpg;869;1405;36033;43;70;27
/net/per610a/home/mvp/mvp_db/news7-lv/2011/2011_09_14_19_00/2011_09_14_19_00.mpg;Yoshihiko Noda.jpg;1513;1573;36033;75;78;3
/net/per610a/home/mvp/mvp_db/news7-lv/2011/2011_09_14_19_00/2011_09_14_19_00.mpg;Yoshihiko Noda.jpg;7461;7769;36033;373;388;15
/net/per610a/home/mvp/mvp_db/news7-lv/2011/2011_09_14_19_00/2011_09_14_19_00.mpg;Sadakazu TANIGAKI.jpg;6753;7445;36033;337;372;35
/net/per610a/home/mvp/mvp_db/news7-lv/2011/2011_09_14_19_00/2011_09_14_19_00.mpg;Sadakazu TANIGAKI.jpg;7893;8289;36033;394;414;20
/net/per610a/home/mvp/mvp_db/news7-lv/2011/2011_09_15_19_00/2011_09_15_19_00.mpg;Yoshihiko Noda.jpg;12409;12877;36033;620;644;24
/net/per610a/home/mvp/mvp_db/news7-lv/2011/2011_09_16_19_00/2011_09_16_19_00.mpg;Yoshihiko Noda.jpg;14205;14413;36037;710;721;11
/net/per610a/home/mvp/mvp_db/news7-lv/2011/2011_09_16_19_00/2011_09_16_19_00.mpg;Yoshihiko Noda.jpg;20713;21073;36037;1036;1054;18
/net/per610a/home/mvp/mvp_db/news7-lv/2011/2011_09_16_19_00/2011_09_16_19_00.mpg;Natsuo YAMAGUCHI.jpg;23357;23685;36037;1168;1185;17
/net/per610a/home/mvp/mvp_db/news7-lv/2011/2011_09_17_19_00/2011_09_17_19_00.mpg;Seiji MAEHARA.jpg;26781;27173;36033;1340;1359;19
/net/per610a/home/mvp/mvp_db/news7-lv/2011/2011_09_17_19_00/2011_09_17_19_00.mpg;Seiji MAEHARA.jpg;28617;29561;36033;1431;1479;48
/net/per610a/home/mvp/mvp_db/news7-lv/2011/2011_09_22_19_00/2011_09_22_19_00.mpg;Yoshihiko Noda.jpg;22765;22821;36033;1139;1141;2
/net/per610a/home/mvp/mvp_db/news7-lv/2011/2011_09_22_19_00/2011_09_22_19_00.mpg;Yoshihiko Noda.jpg;23369;23749;36033;1169;1188;19
/net/per610a/home/mvp/mvp_db/news7-lv/2011/2011_09_26_19_00/2011_09_26_19_00.mpg;Yukio EDANO.jpg;19397;19945;38429;970;998;28
/net/per610a/home/mvp/mvp_db/news7-lv/2011/2011_09_26_19_00/2011_09_26_19_00.mpg;Yoshihiko Noda.jpg;23661;24173;38429;1184;1209;25
/net/per610a/home/mvp/mvp_db/news7-lv/2011/2011_09_26_19_00/2011_09_26_19_00.mpg;Yoshihiko Noda.jpg;24661;24937;38429;1234;1247;13
/net/per610a/home/mvp/mvp_db/news7-lv/2011/2011_09_27_19_00/2011_09_27_19_00.mpg;Yoshihiko Noda.jpg;13977;14413;36033;699;721;22
/net/per610a/home/mvp/mvp_db/news7-lv/2011/2011_09_27_19_00/2011_09_27_19_00.mpg;Yoshihiko Noda.jpg;15477;15901;36033;774;795;21
/net/per610a/home/mvp/mvp_db/news7-lv/2011/2011_09_27_19_00/2011_09_27_19_00.mpg;Yoshihiko Noda.jpg;16185;16585;36033;809;829;20
/net/per610a/home/mvp/mvp_db/news7-lv/2011/2011_09_27_19_00/2011_09_27_19_00.mpg;Yoshihiko Noda.jpg;16901;16925;36033;845;846;1
/net/per610a/home/mvp/mvp_db/news7-lv/2011/2011_09_28_19_00/2011_09_28_19_00.mpg;Yoshihiko Noda.jpg;12613;13273;36033;631;664;33
/net/per610a/home/mvp/mvp_db/news7-lv/2011/2011_09_28_19_00/2011_09_28_19_00.mpg;Yoshihiko Noda.jpg;13629;13869;36033;681;693;12
/net/per610a/home/mvp/mvp_db/news7-lv/2011/2011_09_28_19_00/2011_09_28_19_00.mpg;Yoshihiko Noda.jpg;13953;14485;36033;698;724;26
/net/per610a/home/mvp/mvp_db/news7-lv/2011/2011_09_28_19_00/2011_09_28_19_00.mpg;Yoshihiko Noda.jpg;15849;16101;36033;793;805;12
/net/per610a/home/mvp/mvp_db/news7-lv/2011/2011_09_28_19_00/2011_09_28_19_00.mpg;Yoshihiko Noda.jpg;30125;31005;36033;1507;1551;44
/net/per610a/home/mvp/mvp_db/news7-lv/2011/2011_09_28_19_00/2011_09_28_19_00.mpg;Yoshihiko Noda.jpg;31617;31985;36033;1582;1600;18
/net/per610a/home/mvp/mvp_db/news7-lv/2011/2011_09_29_19_00/2011_09_29_19_00.mpg;Yoshihiko Noda.jpg;29897;30357;39629;1496;1519;23
/net/per610a/home/mvp/mvp_db/news7-lv/2011/2011_09_29_19_00/2011_09_29_19_00.mpg;Yoshihiko Noda.jpg;32433;32841;39629;1622;1643;21
/net/per610a/home/mvp/mvp_db/news7-lv/2011/2011_09_29_19_00/2011_09_29_19_00.mpg;Yoshihiko Noda.jpg;33101;33421;39629;1656;1672;16
/net/per610a/home/mvp/mvp_db/news7-lv/2011/2011_09_30_19_00/2011_09_30_19_00.mpg;Yoshihiko Noda.jpg;1125;1233;36037;56;61;5
/net/per610a/home/mvp/mvp_db/news7-lv/2011/2011_09_30_19_00/2011_09_30_19_00.mpg;Yoshihiko Noda.jpg;1417;1469;36037;70;73;3
/net/per610a/home/mvp/mvp_db/news7-lv/2011/2011_09_30_19_00/2011_09_30_19_00.mpg;Yoshihiko Noda.jpg;1661;1945;36037;83;97;14
/net/per610a/home/mvp/mvp_db/news7-lv/2011/2011_09_30_19_00/2011_09_30_19_00.mpg;Yoshihiko Noda.jpg;9789;10409;36037;489;520;31
/net/per610a/home/mvp/mvp_db/news7-lv/2011/2011_09_30_19_00/2011_09_30_19_00.mpg;Yoshihiko Noda.jpg;10541;11325;36037;527;566;39
/net/per610a/home/mvp/mvp_db/news7-lv/2011/2011_09_30_19_00/2011_09_30_19_00.mpg;Yoshihiko Noda.jpg;11393;11917;36037;570;596;26
/net/per610a/home/mvp/mvp_db/news7-lv/2011/2011_09_30_19_00/2011_09_30_19_00.mpg;Yoshihiko Noda.jpg;12281;12753;36037;614;638;24
/net/per610a/home/mvp/mvp_db/news7-lv/2011/2011_09_30_19_00/2011_09_30_19_00.mpg;Yoshihiko Noda.jpg;18485;19201;36037;924;960;36
/net/per610a/home/mvp/mvp_db/news7-lv/2011/2011_09_30_19_00/2011_09_30_19_00.mpg;Sadakazu TANIGAKI.jpg;13065;13117;36037;653;656;3
/net/per610a/home/mvp/mvp_db/news7-lv/2011/2011_09_30_19_00/2011_09_30_19_00.mpg;Sadakazu TANIGAKI.jpg;13201;13313;36037;660;666;6
/net/per610a/home/mvp/mvp_db/news7-lv/2011/2011_09_30_19_00/2011_09_30_19_00.mpg;Sadakazu TANIGAKI.jpg;14529;14997;36037;726;750;24
/net/per610a/home/mvp/mvp_db/news7-lv/2011/2011_09_30_19_00/2011_09_30_19_00.mpg;Sadakazu TANIGAKI.jpg;16045;16841;36037;802;842;40
/net/per610a/home/mvp/mvp_db/news7-lv/2011/2011_09_30_19_00/2011_09_30_19_00.mpg;Sadakazu TANIGAKI.jpg;16945;17001;36037;847;850;3
/net/per610a/home/mvp/mvp_db/news7-lv/2011/2011_09_30_19_00/2011_09_30_19_00.mpg;Sadakazu TANIGAKI.jpg;17485;17529;36037;874;877;3
/net/per610a/home/mvp/mvp_db/news7-lv/2011/2011_10_01_19_00/2011_10_01_19_00.mpg;Ichiro OZAWA.jpg;14161;14625;36033;708;731;23
/net/per610a/home/mvp/mvp_db/news7-lv/2011/2011_10_02_19_00/2011_10_02_19_00.mpg;Ichiro OZAWA.jpg;20673;21133;36033;1034;1057;23
/net/per610a/home/mvp/mvp_db/news7-lv/2011/2011_10_02_19_00/2011_10_02_19_00.mpg;Ichiro OZAWA.jpg;21621;22397;36033;1081;1120;39
/net/per610a/home/mvp/mvp_db/news7-lv/2011/2011_10_05_19_00/2011_10_05_19_00.mpg;Yoshihiko Noda.jpg;29521;31461;38429;1477;1574;97
/net/per610a/home/mvp/mvp_db/news7-lv/2011/2011_10_06_19_00/2011_10_06_19_00.mpg;Ichiro OZAWA.jpg;169;261;38429;8;13;5
/net/per610a/home/mvp/mvp_db/news7-lv/2011/2011_10_06_19_00/2011_10_06_19_00.mpg;Ichiro OZAWA.jpg;3233;3585;38429;161;179;18
/net/per610a/home/mvp/mvp_db/news7-lv/2011/2011_10_06_19_00/2011_10_06_19_00.mpg;Ichiro OZAWA.jpg;5621;5753;38429;281;287;6
/net/per610a/home/mvp/mvp_db/news7-lv/2011/2011_10_06_19_00/2011_10_06_19_00.mpg;Ichiro OZAWA.jpg;6369;6513;38429;318;325;7
/net/per610a/home/mvp/mvp_db/news7-lv/2011/2011_10_06_19_00/2011_10_06_19_00.mpg;Ichiro OZAWA.jpg;6941;7497;38429;347;375;28
/net/per610a/home/mvp/mvp_db/news7-lv/2011/2011_10_06_19_00/2011_10_06_19_00.mpg;Ichiro OZAWA.jpg;8805;8853;38429;440;443;3
/net/per610a/home/mvp/mvp_db/news7-lv/2011/2011_10_06_19_00/2011_10_06_19_00.mpg;Ichiro OZAWA.jpg;8933;10105;38429;447;505;58
/net/per610a/home/mvp/mvp_db/news7-lv/2011/2011_10_06_19_00/2011_10_06_19_00.mpg;Yoshihiko Noda.jpg;14701;15949;38429;735;798;63
/net/per610a/home/mvp/mvp_db/news7-lv/2011/2011_10_06_19_00/2011_10_06_19_00.mpg;Yoshihiko Noda.jpg;26737;27157;38429;1337;1358;21
/net/per610a/home/mvp/mvp_db/news7-lv/2011/2011_10_06_19_00/2011_10_06_19_00.mpg;Sadakazu TANIGAKI.jpg;16009;18201;38429;801;910;109
/net/per610a/home/mvp/mvp_db/news7-lv/2011/2011_10_07_19_00/2011_10_07_19_00.mpg;Yoshihiko Noda.jpg;8949;9721;36033;447;486;39
/net/per610a/home/mvp/mvp_db/news7-lv/2011/2011_10_07_19_00/2011_10_07_19_00.mpg;Yoshihiko Noda.jpg;10361;10501;36033;518;525;7
/net/per610a/home/mvp/mvp_db/news7-lv/2011/2011_10_07_19_00/2011_10_07_19_00.mpg;Yoshihiko Noda.jpg;11285;11369;36033;564;568;4
/net/per610a/home/mvp/mvp_db/news7-lv/2011/2011_10_07_19_00/2011_10_07_19_00.mpg;Kazuo SHII.jpg;10057;10345;36033;503;517;14
/net/per610a/home/mvp/mvp_db/news7-lv/2011/2011_10_07_19_00/2011_10_07_19_00.mpg;Kazuo SHII.jpg;10577;10933;36033;529;547;18
/net/per610a/home/mvp/mvp_db/news7-lv/2011/2011_10_07_19_00/2011_10_07_19_00.mpg;Mizuho FUKUSHIMA.jpg;11017;11269;36033;551;563;12
/net/per610a/home/mvp/mvp_db/news7-lv/2011/2011_10_07_19_00/2011_10_07_19_00.mpg;Mizuho FUKUSHIMA.jpg;11405;11689;36033;570;584;14
/net/per610a/home/mvp/mvp_db/news7-lv/2011/2011_10_07_19_00/2011_10_07_19_00.mpg;Takeo Hiranuma.jpeg;11801;12209;36033;590;610;20
/net/per610a/home/mvp/mvp_db/news7-lv/2011/2011_10_07_19_00/2011_10_07_19_00.mpg;Ichiro OZAWA.jpg;15677;15757;36033;784;788;4
/net/per610a/home/mvp/mvp_db/news7-lv/2011/2011_10_08_19_00/2011_10_08_19_00.mpg;Seiji MAEHARA.jpg;2969;3025;36041;148;151;3
/net/per610a/home/mvp/mvp_db/news7-lv/2011/2011_10_08_19_00/2011_10_08_19_00.mpg;Yoshihiko Noda.jpg;11497;11929;36041;575;596;21
/net/per610a/home/mvp/mvp_db/news7-lv/2011/2011_10_08_19_00/2011_10_08_19_00.mpg;Yoshihiko Noda.jpg;12285;12333;36041;614;616;2
/net/per610a/home/mvp/mvp_db/news7-lv/2011/2011_10_08_19_00/2011_10_08_19_00.mpg;Yoshihiko Noda.jpg;12509;13049;36041;625;652;27
/net/per610a/home/mvp/mvp_db/news7-lv/2011/2011_10_09_19_00/2011_10_09_19_00.mpg;Yoshihiko Noda.jpg;25573;25833;36033;1279;1292;13
/net/per610a/home/mvp/mvp_db/news7-lv/2011/2011_10_10_19_00/2011_10_10_19_00.mpg;Yoshihiko Noda.jpg;21537;21537;36033;1077;1077;0
/net/per610a/home/mvp/mvp_db/news7-lv/2011/2011_10_10_19_00/2011_10_10_19_00.mpg;Yoshihiko Noda.jpg;22709;22797;36033;1136;1140;4
/net/per610a/home/mvp/mvp_db/news7-lv/2011/2011_10_10_19_00/2011_10_10_19_00.mpg;Yoshihiko Noda.jpg;23005;23949;36033;1151;1198;47
/net/per610a/home/mvp/mvp_db/news7-lv/2011/2011_10_11_19_00/2011_10_11_19_00.mpg;Yoshihiko Noda.jpg;23805;24069;36033;1191;1204;13
/net/per610a/home/mvp/mvp_db/news7-lv/2011/2011_10_11_19_00/2011_10_11_19_00.mpg;Yoshihiko Noda.jpg;24569;24569;36033;1229;1229;0
/net/per610a/home/mvp/mvp_db/news7-lv/2011/2011_10_11_19_00/2011_10_11_19_00.mpg;Yoshihiko Noda.jpg;24913;24973;36033;1246;1249;3
/net/per610a/home/mvp/mvp_db/news7-lv/2011/2011_10_11_19_00/2011_10_11_19_00.mpg;Ichiro OZAWA.jpg;26801;27153;36033;1341;1358;17
/net/per610a/home/mvp/mvp_db/news7-lv/2011/2011_10_14_19_00/2011_10_14_19_00.mpg;Yukio EDANO.jpg;4137;4717;36033;207;236;29
/net/per610a/home/mvp/mvp_db/news7-lv/2011/2011_10_15_19_00/2011_10_15_19_00.mpg;Yoshihiko Noda.jpg;1989;2061;36045;99;103;4
/net/per610a/home/mvp/mvp_db/news7-lv/2011/2011_10_15_19_00/2011_10_15_19_00.mpg;Yoshihiko Noda.jpg;15461;15473;36045;773;774;1
/net/per610a/home/mvp/mvp_db/news7-lv/2011/2011_10_17_19_00/2011_10_17_19_00.mpg;Yoshihiko Noda.jpg;17369;18057;36041;868;903;35
/net/per610a/home/mvp/mvp_db/news7-lv/2011/2011_10_17_19_00/2011_10_17_19_00.mpg;Yukio EDANO.jpg;25513;26465;36041;1276;1323;47
/net/per610a/home/mvp/mvp_db/news7-lv/2011/2011_10_18_19_00/2011_10_18_19_00.mpg;Yoshihiko Noda.jpg;8413;8433;36033;420;421;1
/net/per610a/home/mvp/mvp_db/news7-lv/2011/2011_10_18_19_00/2011_10_18_19_00.mpg;Yoshihiko Noda.jpg;8613;8737;36033;430;437;7
/net/per610a/home/mvp/mvp_db/news7-lv/2011/2011_10_18_19_00/2011_10_18_19_00.mpg;Yoshihiko Noda.jpg;9113;9357;36033;455;468;13
/net/per610a/home/mvp/mvp_db/news7-lv/2011/2011_10_20_19_00/2011_10_20_19_00.mpg;Yoshihiko Noda.jpg;5465;5757;36033;273;288;15
/net/per610a/home/mvp/mvp_db/news7-lv/2011/2011_10_20_19_00/2011_10_20_19_00.mpg;Yoshihiko Noda.jpg;5881;5941;36033;294;297;3
/net/per610a/home/mvp/mvp_db/news7-lv/2011/2011_10_20_19_00/2011_10_20_19_00.mpg;Seiji MAEHARA.jpg;6189;6277;36033;309;314;5
/net/per610a/home/mvp/mvp_db/news7-lv/2011/2011_10_20_19_00/2011_10_20_19_00.mpg;Sadakazu TANIGAKI.jpg;7357;7817;36033;368;391;23
/net/per610a/home/mvp/mvp_db/news7-lv/2011/2011_10_20_19_00/2011_10_20_19_00.mpg;Natsuo YAMAGUCHI.jpg;8041;8245;36033;402;412;10
/net/per610a/home/mvp/mvp_db/news7-lv/2011/2011_10_21_19_00/2011_10_21_19_00.mpg;Toru Hashimoto.jpg;26781;26913;36033;1340;1346;6
/net/per610a/home/mvp/mvp_db/news7-lv/2011/2011_10_23_19_00/2011_10_23_19_00.mpg;Toru Hashimoto.jpg;15121;15309;36033;756;766;10
/net/per610a/home/mvp/mvp_db/news7-lv/2011/2011_10_23_19_00/2011_10_23_19_00.mpg;Toru Hashimoto.jpg;15485;15577;36033;774;779;5
/net/per610a/home/mvp/mvp_db/news7-lv/2011/2011_10_23_19_00/2011_10_23_19_00.mpg;Ichiro Matsui.jpeg;16613;17117;36033;831;856;25
/net/per610a/home/mvp/mvp_db/news7-lv/2011/2011_10_23_19_00/2011_10_23_19_00.mpg;Ichiro Matsui.jpeg;18829;19505;36033;942;975;33
/net/per610a/home/mvp/mvp_db/news7-lv/2011/2011_10_23_19_00/2011_10_23_19_00.mpg;Yoshihiko Noda.jpg;24805;24969;36033;1241;1249;8
/net/per610a/home/mvp/mvp_db/news7-lv/2011/2011_10_23_19_00/2011_10_23_19_00.mpg;Toranosuke Katayama.jpg;30169;30265;36033;1509;1514;5
/net/per610a/home/mvp/mvp_db/news7-lv/2011/2011_10_24_19_00/2011_10_24_19_00.mpg;Yoshihiko Noda.jpg;14137;14609;36033;707;730;23
/net/per610a/home/mvp/mvp_db/news7-lv/2011/2011_10_24_19_00/2011_10_24_19_00.mpg;Yoshihiko Noda.jpg;15109;15313;36033;756;766;10
/net/per610a/home/mvp/mvp_db/news7-lv/2011/2011_10_25_19_00/2011_10_25_19_00.mpg;Yukio EDANO.jpg;30913;31441;38429;1546;1573;27
/net/per610a/home/mvp/mvp_db/news7-lv/2011/2011_10_28_19_00/2011_10_28_19_00.mpg;Yoshihiko Noda.jpg;17305;17841;36033;865;892;27
/net/per610a/home/mvp/mvp_db/news7-lv/2011/2011_10_28_19_00/2011_10_28_19_00.mpg;Yoshihiko Noda.jpg;17941;18529;36033;897;927;30
/net/per610a/home/mvp/mvp_db/news7-lv/2011/2011_10_28_19_00/2011_10_28_19_00.mpg;Sadakazu TANIGAKI.jpg;20193;20685;36033;1010;1035;25
/net/per610a/home/mvp/mvp_db/news7-lv/2011/2011_10_30_19_00/2011_10_30_19_00.mpg;Ichiro OZAWA.jpg;8901;9437;36041;445;472;27
/net/per610a/home/mvp/mvp_db/news7-lv/2011/2011_10_31_19_00/2011_10_31_19_00.mpg;Yoshihiko Noda.jpg;23161;23293;36045;1159;1165;6
/net/per610a/home/mvp/mvp_db/news7-lv/2011/2011_10_31_19_00/2011_10_31_19_00.mpg;Yoshihiko Noda.jpg;23505;23505;36045;1176;1176;0
/net/per610a/home/mvp/mvp_db/news7-lv/2011/2011_10_31_19_00/2011_10_31_19_00.mpg;Yoshihiko Noda.jpg;23601;23601;36045;1181;1181;0
/net/per610a/home/mvp/mvp_db/news7-lv/2011/2011_10_31_19_00/2011_10_31_19_00.mpg;Yoshihiko Noda.jpg;26953;27637;36045;1348;1383;35
/net/per610a/home/mvp/mvp_db/news7-lv/2011/2011_10_31_19_00/2011_10_31_19_00.mpg;Yoshihiko Noda.jpg;28173;28297;36045;1410;1416;6
/net/per610a/home/mvp/mvp_db/news7-lv/2011/2011_11_01_19_00/2011_11_01_19_00.mpg;Yoshihiko Noda.jpg;24457;24989;36033;1223;1250;27
/net/per610a/home/mvp/mvp_db/news7-lv/2011/2011_11_02_19_00/2011_11_02_19_00.mpg;Yoshihiko Noda.jpg;25357;25877;36033;1268;1294;26
/net/per610a/home/mvp/mvp_db/news7-lv/2011/2011_11_02_19_00/2011_11_02_19_00.mpg;Yoshihiko Noda.jpg;25961;27445;36033;1299;1373;74
/net/per610a/home/mvp/mvp_db/news7-lv/2011/2011_11_03_19_00/2011_11_03_19_00.mpg;Yoshihiko Noda.jpg;8089;8305;36045;404;415;11
/net/per610a/home/mvp/mvp_db/news7-lv/2011/2011_11_03_19_00/2011_11_03_19_00.mpg;Yoshihiko Noda.jpg;8761;9337;36045;438;467;29
/net/per610a/home/mvp/mvp_db/news7-lv/2011/2011_11_03_19_00/2011_11_03_19_00.mpg;Yoshihiko Noda.jpg;10157;10497;36045;508;525;17
/net/per610a/home/mvp/mvp_db/news7-lv/2011/2011_11_05_19_00/2011_11_05_19_00.mpg;Yoshihiko Noda.jpg;8821;8885;36033;441;444;3
/net/per610a/home/mvp/mvp_db/news7-lv/2011/2011_11_05_19_00/2011_11_05_19_00.mpg;Yoshihiko Noda.jpg;9645;9945;36033;482;497;15
/net/per610a/home/mvp/mvp_db/news7-lv/2011/2011_11_05_19_00/2011_11_05_19_00.mpg;Sadakazu TANIGAKI.jpg;11593;11921;36033;580;596;16
/net/per610a/home/mvp/mvp_db/news7-lv/2011/2011_11_05_19_00/2011_11_05_19_00.mpg;Sadakazu TANIGAKI.jpg;12077;12413;36033;604;621;17
/net/per610a/home/mvp/mvp_db/news7-lv/2011/2011_11_05_19_00/2011_11_05_19_00.mpg;Katsuya OKADA.jpg;23857;24109;36033;1193;1206;13
/net/per610a/home/mvp/mvp_db/news7-lv/2011/2011_11_06_19_00/2011_11_06_19_00.mpg;Taro ASO.jpg;2117;2233;36033;105;111;6
/net/per610a/home/mvp/mvp_db/news7-lv/2011/2011_11_07_19_00/2011_11_07_19_00.mpg;Yoshihiko Noda.jpg;245;337;36041;12;16;4
/net/per610a/home/mvp/mvp_db/news7-lv/2011/2011_11_07_19_00/2011_11_07_19_00.mpg;Shizuka KAMEI.jpg;4657;5105;36041;232;255;23
/net/per610a/home/mvp/mvp_db/news7-lv/2011/2011_11_07_19_00/2011_11_07_19_00.mpg;Yoshihiko Noda.jpg;26149;26233;36041;1308;1312;4
/net/per610a/home/mvp/mvp_db/news7-lv/2011/2011_11_07_19_00/2011_11_07_19_00.mpg;Yoshihiko Noda.jpg;26745;27133;36041;1337;1357;20
/net/per610a/home/mvp/mvp_db/news7-lv/2011/2011_11_08_19_00/2011_11_08_19_00.mpg;Yoshihiko Noda.jpg;28777;29733;36033;1439;1487;48
/net/per610a/home/mvp/mvp_db/news7-lv/2011/2011_11_09_19_00/2011_11_09_19_00.mpg;Yoshihiko Noda.jpg;27257;27521;36037;1363;1376;13
/net/per610a/home/mvp/mvp_db/news7-lv/2011/2011_11_09_19_00/2011_11_09_19_00.mpg;Yoshihiko Noda.jpg;28009;28173;36037;1401;1409;8
/net/per610a/home/mvp/mvp_db/news7-lv/2011/2011_11_09_19_00/2011_11_09_19_00.mpg;Yoshihiko Noda.jpg;28253;28325;36037;1413;1417;4
/net/per610a/home/mvp/mvp_db/news7-lv/2011/2011_11_09_19_00/2011_11_09_19_00.mpg;Toru Hashimoto.jpg;32621;32997;36037;1632;1650;18
/net/per610a/home/mvp/mvp_db/news7-lv/2011/2011_11_10_19_00/2011_11_10_19_00.mpg;Yoshihiko Noda.jpg;9;29;36029;0;1;1
/net/per610a/home/mvp/mvp_db/news7-lv/2011/2011_11_10_19_00/2011_11_10_19_00.mpg;Yoshihiko Noda.jpg;2025;2253;36029;101;112;11
/net/per610a/home/mvp/mvp_db/news7-lv/2011/2011_11_10_19_00/2011_11_10_19_00.mpg;Yoshihiko Noda.jpg;7625;7781;36029;381;389;8
/net/per610a/home/mvp/mvp_db/news7-lv/2011/2011_11_10_19_00/2011_11_10_19_00.mpg;Yoshihiko Noda.jpg;8717;8773;36029;436;439;3
/net/per610a/home/mvp/mvp_db/news7-lv/2011/2011_11_10_19_00/2011_11_10_19_00.mpg;Yoshihiko Noda.jpg;9325;9373;36029;466;469;3
/net/per610a/home/mvp/mvp_db/news7-lv/2011/2011_11_10_19_00/2011_11_10_19_00.mpg;Yoshihiko Noda.jpg;9677;10025;36029;484;501;17
/net/per610a/home/mvp/mvp_db/news7-lv/2011/2011_11_10_19_00/2011_11_10_19_00.mpg;Seiji MAEHARA.jpg;1209;1269;36029;60;63;3
/net/per610a/home/mvp/mvp_db/news7-lv/2011/2011_11_10_19_00/2011_11_10_19_00.mpg;Seiji MAEHARA.jpg;8385;8469;36029;419;423;4
/net/per610a/home/mvp/mvp_db/news7-lv/2011/2011_11_10_19_00/2011_11_10_19_00.mpg;Yukio EDANO.jpg;3621;4313;36029;181;215;34
/net/per610a/home/mvp/mvp_db/news7-lv/2011/2011_11_10_19_00/2011_11_10_19_00.mpg;Yoshimi WATANABE.jpg;7197;7561;36029;360;378;18
/net/per610a/home/mvp/mvp_db/news7-lv/2011/2011_11_11_19_00/2011_11_11_19_00.mpg;Yoshihiko Noda.jpg;1;305;36033;0;15;15
/net/per610a/home/mvp/mvp_db/news7-lv/2011/2011_11_11_19_00/2011_11_11_19_00.mpg;Yoshihiko Noda.jpg;973;1349;36033;48;67;19
/net/per610a/home/mvp/mvp_db/news7-lv/2011/2011_11_11_19_00/2011_11_11_19_00.mpg;Yoshihiko Noda.jpg;1893;2009;36033;94;100;6
/net/per610a/home/mvp/mvp_db/news7-lv/2011/2011_11_11_19_00/2011_11_11_19_00.mpg;Yoshihiko Noda.jpg;2429;2533;36033;121;126;5
/net/per610a/home/mvp/mvp_db/news7-lv/2011/2011_11_11_19_00/2011_11_11_19_00.mpg;Yoshihiko Noda.jpg;9289;9397;36033;464;470;6
/net/per610a/home/mvp/mvp_db/news7-lv/2011/2011_11_11_19_00/2011_11_11_19_00.mpg;Yoshihiko Noda.jpg;2541;2585;36033;127;129;2
/net/per610a/home/mvp/mvp_db/news7-lv/2011/2011_11_11_19_00/2011_11_11_19_00.mpg;Yoshihiko Noda.jpg;2821;3153;36033;141;157;16
/net/per610a/home/mvp/mvp_db/news7-lv/2011/2011_11_12_19_00/2011_11_12_19_00.mpg;Yoshihiko Noda.jpg;16301;17625;38429;815;881;66
/net/per610a/home/mvp/mvp_db/news7-lv/2011/2011_11_13_19_00/2011_11_13_19_00.mpg;Yoshihiko Noda.jpg;45;77;36041;2;3;1
/net/per610a/home/mvp/mvp_db/news7-lv/2011/2011_11_13_19_00/2011_11_13_19_00.mpg;Yoshihiko Noda.jpg;169;237;36041;8;11;3
/net/per610a/home/mvp/mvp_db/news7-lv/2011/2011_11_13_19_00/2011_11_13_19_00.mpg;Yoshihiko Noda.jpg;2921;3189;36041;146;159;13
/net/per610a/home/mvp/mvp_db/news7-lv/2011/2011_11_13_19_00/2011_11_13_19_00.mpg;Yoshihiko Noda.jpg;4769;4829;36041;238;241;3
/net/per610a/home/mvp/mvp_db/news7-lv/2011/2011_11_13_19_00/2011_11_13_19_00.mpg;Yoshihiko Noda.jpg;6857;6933;36041;343;346;3
/net/per610a/home/mvp/mvp_db/news7-lv/2011/2011_11_13_19_00/2011_11_13_19_00.mpg;Yoshihiko Noda.jpg;11641;11733;36041;582;586;4
/net/per610a/home/mvp/mvp_db/news7-lv/2011/2011_11_13_19_00/2011_11_13_19_00.mpg;Yoshihiko Noda.jpg;349;461;36041;17;23;6
/net/per610a/home/mvp/mvp_db/news7-lv/2011/2011_11_13_19_00/2011_11_13_19_00.mpg;Yoshihiko Noda.jpg;4253;4493;36041;212;224;12
/net/per610a/home/mvp/mvp_db/news7-lv/2011/2011_11_13_19_00/2011_11_13_19_00.mpg;Yoshihiko Noda.jpg;1301;1573;36041;65;78;13
/net/per610a/home/mvp/mvp_db/news7-lv/2011/2011_11_13_19_00/2011_11_13_19_00.mpg;Yoshihiko Noda.jpg;2065;2173;36041;103;108;5
/net/per610a/home/mvp/mvp_db/news7-lv/2011/2011_11_13_19_00/2011_11_13_19_00.mpg;Yoshihiko Noda.jpg;2649;2693;36041;132;134;2
/net/per610a/home/mvp/mvp_db/news7-lv/2011/2011_11_13_19_00/2011_11_13_19_00.mpg;Yoshihiko Noda.jpg;7105;8009;36041;355;400;45
/net/per610a/home/mvp/mvp_db/news7-lv/2011/2011_11_13_19_00/2011_11_13_19_00.mpg;Yoshihiko Noda.jpg;9361;9713;36041;468;485;17
/net/per610a/home/mvp/mvp_db/news7-lv/2011/2011_11_13_19_00/2011_11_13_19_00.mpg;Yoshihiko Noda.jpg;11741;11989;36041;587;599;12
/net/per610a/home/mvp/mvp_db/news7-lv/2011/2011_11_13_19_00/2011_11_13_19_00.mpg;Seiji MAEHARA.jpg;5405;6105;36041;270;305;35
/net/per610a/home/mvp/mvp_db/news7-lv/2011/2011_11_13_19_00/2011_11_13_19_00.mpg;Toru Hashimoto.jpg;18581;19013;36041;929;951;22
/net/per610a/home/mvp/mvp_db/news7-lv/2011/2011_11_14_19_00/2011_11_14_19_00.mpg;Sadakazu TANIGAKI.jpg;12529;13017;36033;626;651;25
/net/per610a/home/mvp/mvp_db/news7-lv/2011/2011_11_14_19_00/2011_11_14_19_00.mpg;Yoshihiko Noda.jpg;26793;26801;36033;1340;1341;1
/net/per610a/home/mvp/mvp_db/news7-lv/2011/2011_11_14_19_00/2011_11_14_19_00.mpg;Yoshihiko Noda.jpg;26873;26873;36033;1344;1344;0
/net/per610a/home/mvp/mvp_db/news7-lv/2011/2011_11_14_19_00/2011_11_14_19_00.mpg;Yoshihiko Noda.jpg;28433;28537;36033;1422;1427;5
/net/per610a/home/mvp/mvp_db/news7-lv/2011/2011_11_14_19_00/2011_11_14_19_00.mpg;Yoshihiko Noda.jpg;28629;29049;36033;1432;1453;21
/net/per610a/home/mvp/mvp_db/news7-lv/2011/2011_11_14_19_00/2011_11_14_19_00.mpg;Yoshihiko Noda.jpg;29293;29317;36033;1465;1466;1
/net/per610a/home/mvp/mvp_db/news7-lv/2011/2011_11_14_19_00/2011_11_14_19_00.mpg;Yoshihiko Noda.jpg;26957;27277;36033;1348;1364;16
/net/per610a/home/mvp/mvp_db/news7-lv/2011/2011_11_16_19_00/2011_11_16_19_00.mpg;Yoshihiko Noda.jpg;14777;15437;36033;739;772;33
/net/per610a/home/mvp/mvp_db/news7-lv/2011/2011_11_16_19_00/2011_11_16_19_00.mpg;Yoshihiko Noda.jpg;17709;18101;36033;886;905;19
/net/per610a/home/mvp/mvp_db/news7-lv/2011/2011_11_16_19_00/2011_11_16_19_00.mpg;Yoshihiko Noda.jpg;19165;19485;36033;958;974;16
/net/per610a/home/mvp/mvp_db/news7-lv/2011/2011_11_19_19_00/2011_11_19_19_00.mpg;Yoshihiko Noda.jpg;14673;16389;36033;734;820;86
/net/per610a/home/mvp/mvp_db/news7-lv/2011/2011_11_19_19_00/2011_11_19_19_00.mpg;Yoshihiko Noda.jpg;16473;17505;36033;824;875;51
/net/per610a/home/mvp/mvp_db/news7-lv/2011/2011_11_19_19_00/2011_11_19_19_00.mpg;Yoshihiko Noda.jpg;17625;17629;36033;881;882;1
/net/per610a/home/mvp/mvp_db/news7-lv/2011/2011_11_20_19_00/2011_11_20_19_00.mpg;Yuichiro Tamaki.png;2013;2141;36033;100;107;7
/net/per610a/home/mvp/mvp_db/news7-lv/2011/2011_11_20_19_00/2011_11_20_19_00.mpg;Yuichiro Tamaki.png;4901;5369;36033;245;268;23
/net/per610a/home/mvp/mvp_db/news7-lv/2011/2011_11_20_19_00/2011_11_20_19_00.mpg;Yuichiro Tamaki.png;6397;6825;36033;320;341;21
/net/per610a/home/mvp/mvp_db/news7-lv/2011/2011_11_20_19_00/2011_11_20_19_00.mpg;Yuichiro Tamaki.png;8589;9005;36033;429;450;21
/net/per610a/home/mvp/mvp_db/news7-lv/2011/2011_11_20_19_00/2011_11_20_19_00.mpg;Yuichiro Tamaki.png;9685;9937;36033;484;497;13
/net/per610a/home/mvp/mvp_db/news7-lv/2011/2011_11_22_19_00/2011_11_22_19_00.mpg;Toru Hashimoto.jpg;24817;25133;36037;1241;1257;16
/net/per610a/home/mvp/mvp_db/news7-lv/2011/2011_11_22_19_00/2011_11_22_19_00.mpg;Yoshihiko Noda.jpg;27805;27821;36037;1391;1391;0
/net/per610a/home/mvp/mvp_db/news7-lv/2011/2011_11_22_19_00/2011_11_22_19_00.mpg;Yoshihiko Noda.jpg;27893;28693;36037;1395;1435;40
/net/per610a/home/mvp/mvp_db/news7-lv/2011/2011_11_23_19_00/2011_11_23_19_00.mpg;Renho.jpg;13449;13661;36041;672;683;11
/net/per610a/home/mvp/mvp_db/news7-lv/2011/2011_11_23_19_00/2011_11_23_19_00.mpg;Renho.jpg;16909;17681;36041;845;884;39
/net/per610a/home/mvp/mvp_db/news7-lv/2011/2011_11_23_19_00/2011_11_23_19_00.mpg;Yoshihiko Noda.jpg;17693;17801;36041;885;890;5
/net/per610a/home/mvp/mvp_db/news7-lv/2011/2011_11_24_19_00/2011_11_24_19_00.mpg;Yoshihiko Noda.jpg;24401;24457;38433;1220;1223;3
/net/per610a/home/mvp/mvp_db/news7-lv/2011/2011_11_24_19_00/2011_11_24_19_00.mpg;Yoshihiko Noda.jpg;26881;27437;38433;1344;1372;28
/net/per610a/home/mvp/mvp_db/news7-lv/2011/2011_11_25_19_00/2011_11_25_19_00.mpg;Shizuka KAMEI.jpg;26405;27345;36037;1321;1368;47
/net/per610a/home/mvp/mvp_db/news7-lv/2011/2011_11_25_19_00/2011_11_25_19_00.mpg;Takeo Hiranuma.jpeg;27121;27345;36037;1356;1368;12
/net/per610a/home/mvp/mvp_db/news7-lv/2011/2011_11_26_19_00/2011_11_26_19_00.mpg;Toru Hashimoto.jpg;8173;8301;36033;408;415;7
/net/per610a/home/mvp/mvp_db/news7-lv/2011/2011_11_28_19_00/2011_11_28_19_00.mpg;Shintaro ISHIHARA.jpg;3085;3573;36033;154;178;24
/net/per610a/home/mvp/mvp_db/news7-lv/2011/2011_11_29_19_00/2011_11_29_19_00.mpg;Toru Hashimoto.jpg;8261;8341;36033;413;417;4
/net/per610a/home/mvp/mvp_db/news7-lv/2011/2011_11_29_19_00/2011_11_29_19_00.mpg;Toru Hashimoto.jpg;8705;9189;36033;435;459;24
/net/per610a/home/mvp/mvp_db/news7-lv/2011/2011_11_29_19_00/2011_11_29_19_00.mpg;Yoshihiko Noda.jpg;9361;9517;36033;468;476;8
/net/per610a/home/mvp/mvp_db/news7-lv/2011/2011_11_29_19_00/2011_11_29_19_00.mpg;Yoshihiko Noda.jpg;9613;9789;36033;481;489;8
/net/per610a/home/mvp/mvp_db/news7-lv/2011/2011_11_29_19_00/2011_11_29_19_00.mpg;Yoshihiko Noda.jpg;9885;10209;36033;494;510;16
/net/per610a/home/mvp/mvp_db/news7-lv/2011/2011_11_29_19_00/2011_11_29_19_00.mpg;Renho.jpg;16185;16481;36033;809;824;15
/net/per610a/home/mvp/mvp_db/news7-lv/2011/2011_11_30_19_00/2011_11_30_19_00.mpg;Yoshihiko Noda.jpg;6413;6581;38429;320;329;9
/net/per610a/home/mvp/mvp_db/news7-lv/2011/2011_11_30_19_00/2011_11_30_19_00.mpg;Yoshihiko Noda.jpg;8661;8969;38429;433;448;15
/net/per610a/home/mvp/mvp_db/news7-lv/2011/2011_11_30_19_00/2011_11_30_19_00.mpg;Yoshihiko Noda.jpg;9817;9977;38429;491;499;8
/net/per610a/home/mvp/mvp_db/news7-lv/2011/2011_11_30_19_00/2011_11_30_19_00.mpg;Yoshihiko Noda.jpg;10393;10757;38429;520;538;18
/net/per610a/home/mvp/mvp_db/news7-lv/2011/2011_11_30_19_00/2011_11_30_19_00.mpg;Takeo Hiranuma.jpeg;22109;22541;38429;1106;1127;21
/net/per610a/home/mvp/mvp_db/news7-lv/2011/2011_11_30_19_00/2011_11_30_19_00.mpg;Ichiro OZAWA.jpg;22109;22541;38429;1106;1127;21
/net/per610a/home/mvp/mvp_db/news7-lv/2011/2011_12_01_19_00/2011_12_01_19_00.mpg;Yoshihiko Noda.jpg;11989;13269;36037;599;663;64
/net/per610a/home/mvp/mvp_db/news7-lv/2011/2011_12_01_19_00/2011_12_01_19_00.mpg;Yoshihiko Noda.jpg;13461;14033;36037;673;702;29
/net/per610a/home/mvp/mvp_db/news7-lv/2011/2011_12_02_19_00/2011_12_02_19_00.mpg;Yoshihiko Noda.jpg;6097;6445;36033;305;322;17
/net/per610a/home/mvp/mvp_db/news7-lv/2011/2011_12_02_19_00/2011_12_02_19_00.mpg;Yoshihiko Noda.jpg;19745;20209;36033;987;1011;24
/net/per610a/home/mvp/mvp_db/news7-lv/2011/2011_12_02_19_00/2011_12_02_19_00.mpg;Yoshihiko Noda.jpg;20361;20713;36033;1018;1036;18
/net/per610a/home/mvp/mvp_db/news7-lv/2011/2011_12_02_19_00/2011_12_02_19_00.mpg;Yoshihiko Noda.jpg;21145;21597;36033;1058;1080;22
/net/per610a/home/mvp/mvp_db/news7-lv/2011/2011_12_02_19_00/2011_12_02_19_00.mpg;Yoshihiko Noda.jpg;22077;22225;36033;1104;1112;8
/net/per610a/home/mvp/mvp_db/news7-lv/2011/2011_12_02_19_00/2011_12_02_19_00.mpg;Yoshihiko Noda.jpg;23441;23869;36033;1172;1194;22
/net/per610a/home/mvp/mvp_db/news7-lv/2011/2011_12_03_19_00/2011_12_03_19_00.mpg;Kazuo SHII.jpg;29225;29689;36041;1462;1485;23
/net/per610a/home/mvp/mvp_db/news7-lv/2011/2011_12_03_19_00/2011_12_03_19_00.mpg;Kazuo SHII.jpg;29761;29909;36041;1488;1496;8
/net/per610a/home/mvp/mvp_db/news7-lv/2011/2011_12_04_19_00/2011_12_04_19_00.mpg;Yoshihiko Noda.jpg;28065;28877;36033;1404;1444;40
/net/per610a/home/mvp/mvp_db/news7-lv/2011/2011_12_05_19_00/2011_12_05_19_00.mpg;Yoshihiko Noda.jpg;9637;9741;36033;482;487;5
/net/per610a/home/mvp/mvp_db/news7-lv/2011/2011_12_06_19_00/2011_12_06_19_00.mpg;Yoshihiko Noda.jpg;32265;32565;36033;1614;1629;15
/net/per610a/home/mvp/mvp_db/news7-lv/2011/2011_12_09_19_00/2011_12_09_19_00.mpg;Yoshihiko Noda.jpg;305;497;38429;15;24;9
/net/per610a/home/mvp/mvp_db/news7-lv/2011/2011_12_09_19_00/2011_12_09_19_00.mpg;Yoshihiko Noda.jpg;5153;5625;38429;257;281;24
/net/per610a/home/mvp/mvp_db/news7-lv/2011/2011_12_09_19_00/2011_12_09_19_00.mpg;Yoshihiko Noda.jpg;14697;15241;38429;735;762;27
/net/per610a/home/mvp/mvp_db/news7-lv/2011/2011_12_09_19_00/2011_12_09_19_00.mpg;Yoshihiko Noda.jpg;1089;1473;38429;54;73;19
/net/per610a/home/mvp/mvp_db/news7-lv/2011/2011_12_09_19_00/2011_12_09_19_00.mpg;Kazuo SHII.jpg;3945;4509;38429;197;225;28
/net/per610a/home/mvp/mvp_db/news7-lv/2011/2011_12_09_19_00/2011_12_09_19_00.mpg;Kazuo SHII.jpg;4629;4709;38429;231;235;4
/net/per610a/home/mvp/mvp_db/news7-lv/2011/2011_12_09_19_00/2011_12_09_19_00.mpg;Sadakazu TANIGAKI.jpg;9169;11561;38429;458;578;120
/net/per610a/home/mvp/mvp_db/news7-lv/2011/2011_12_12_19_00/2011_12_12_19_00.mpg;Yoshihiko Noda.jpg;15089;15229;36033;755;762;7
/net/per610a/home/mvp/mvp_db/news7-lv/2011/2011_12_12_19_00/2011_12_12_19_00.mpg;Toru Hashimoto.jpg;17293;17341;36033;865;867;2
/net/per610a/home/mvp/mvp_db/news7-lv/2011/2011_12_12_19_00/2011_12_12_19_00.mpg;Toru Hashimoto.jpg;17437;17993;36033;872;900;28
/net/per610a/home/mvp/mvp_db/news7-lv/2011/2011_12_16_19_00/2011_12_16_19_00.mpg;Yoshihiko Noda.jpg;93;261;36033;4;13;9
/net/per610a/home/mvp/mvp_db/news7-lv/2011/2011_12_16_19_00/2011_12_16_19_00.mpg;Yoshihiko Noda.jpg;989;4541;36033;49;227;178
/net/per610a/home/mvp/mvp_db/news7-lv/2011/2011_12_16_19_00/2011_12_16_19_00.mpg;Yoshihiko Noda.jpg;4789;5437;36033;239;272;33
/net/per610a/home/mvp/mvp_db/news7-lv/2011/2011_12_16_19_00/2011_12_16_19_00.mpg;Yoshihiko Noda.jpg;6633;7277;36033;331;364;33
/net/per610a/home/mvp/mvp_db/news7-lv/2011/2011_12_16_19_00/2011_12_16_19_00.mpg;Yoshihiko Noda.jpg;22969;23485;36033;1149;1175;26
/net/per610a/home/mvp/mvp_db/news7-lv/2011/2011_12_16_19_00/2011_12_16_19_00.mpg;Yoshihiko Noda.jpg;24153;24621;36033;1208;1231;23
/net/per610a/home/mvp/mvp_db/news7-lv/2011/2011_12_18_19_00/2011_12_18_19_00.mpg;Yoshihiko Noda.jpg;5117;5693;36033;256;284;28
/net/per610a/home/mvp/mvp_db/news7-lv/2011/2011_12_18_19_00/2011_12_18_19_00.mpg;Yoshihiko Noda.jpg;7949;8013;36033;397;400;3
/net/per610a/home/mvp/mvp_db/news7-lv/2011/2011_12_18_19_00/2011_12_18_19_00.mpg;Yukio EDANO.jpg;15109;15849;36033;756;793;37
/net/per610a/home/mvp/mvp_db/news7-lv/2011/2011_12_19_19_00/2011_12_19_19_00.mpg;Masashi Nakano.jpg;19357;20089;71997;968;1005;37
/net/per610a/home/mvp/mvp_db/news7-lv/2011/2011_12_19_19_00/2011_12_19_19_00.mpg;Masashi Nakano.jpg;21077;21493;71997;1054;1075;21
/net/per610a/home/mvp/mvp_db/news7-lv/2011/2011_12_19_19_00/2011_12_19_19_00.mpg;Masashi Nakano.jpg;25305;25845;71997;1266;1293;27
/net/per610a/home/mvp/mvp_db/news7-lv/2011/2011_12_19_19_00/2011_12_19_19_00.mpg;Masashi Nakano.jpg;26497;26813;71997;1326;1341;15
/net/per610a/home/mvp/mvp_db/news7-lv/2011/2011_12_19_19_00/2011_12_19_19_00.mpg;Masashi Nakano.jpg;37905;38781;71997;1896;1940;44
/net/per610a/home/mvp/mvp_db/news7-lv/2011/2011_12_19_19_00/2011_12_19_19_00.mpg;Junichiro KOIZUMI.jpg;20293;20773;71997;1015;1039;24
/net/per610a/home/mvp/mvp_db/news7-lv/2011/2011_12_19_19_00/2011_12_19_19_00.mpg;Yoshihiko Noda.jpg;29917;30137;71997;1497;1508;11
/net/per610a/home/mvp/mvp_db/news7-lv/2011/2011_12_19_19_00/2011_12_19_19_00.mpg;Yoshihiko Noda.jpg;31213;31897;71997;1562;1596;34
/net/per610a/home/mvp/mvp_db/news7-lv/2011/2011_12_19_19_00/2011_12_19_19_00.mpg;Toru Hashimoto.jpg;58081;58153;71997;2906;2910;4
/net/per610a/home/mvp/mvp_db/news7-lv/2011/2011_12_19_19_00/2011_12_19_19_00.mpg;Toru Hashimoto.jpg;58445;58861;71997;2924;2945;21
/net/per610a/home/mvp/mvp_db/news7-lv/2011/2011_12_19_19_00/2011_12_19_19_00.mpg;Seiji MAEHARA.jpg;59377;59905;71997;2971;2997;26
/net/per610a/home/mvp/mvp_db/news7-lv/2011/2011_12_19_19_00/2011_12_19_19_00.mpg;Toru Hashimoto.jpg;59929;60141;71997;2999;3009;10
/net/per610a/home/mvp/mvp_db/news7-lv/2011/2011_12_20_19_00/2011_12_20_19_00.mpg;Ichiro OZAWA.jpg;9905;10373;36033;495;519;24
/net/per610a/home/mvp/mvp_db/news7-lv/2011/2011_12_23_19_00/2011_12_23_19_00.mpg;Seiji MAEHARA.jpg;5801;5969;36033;290;298;8
/net/per610a/home/mvp/mvp_db/news7-lv/2011/2011_12_23_19_00/2011_12_23_19_00.mpg;Seiji MAEHARA.jpg;6681;6985;36033;334;349;15
/net/per610a/home/mvp/mvp_db/news7-lv/2011/2011_12_23_19_00/2011_12_23_19_00.mpg;Seiji MAEHARA.jpg;7653;8281;36033;382;414;32
/net/per610a/home/mvp/mvp_db/news7-lv/2011/2011_12_25_19_00/2011_12_25_19_00.mpg;Yoshihiko Noda.jpg;97;149;36041;4;7;3
/net/per610a/home/mvp/mvp_db/news7-lv/2011/2011_12_25_19_00/2011_12_25_19_00.mpg;Yoshihiko Noda.jpg;1509;1741;36041;75;87;12
/net/per610a/home/mvp/mvp_db/news7-lv/2011/2011_12_25_19_00/2011_12_25_19_00.mpg;Yoshihiko Noda.jpg;2101;2157;36041;105;107;2
/net/per610a/home/mvp/mvp_db/news7-lv/2011/2011_12_26_19_00/2011_12_26_19_00.mpg;Yoshihiko Noda.jpg;2209;2377;36033;110;118;8
/net/per610a/home/mvp/mvp_db/news7-lv/2011/2011_12_26_19_00/2011_12_26_19_00.mpg;Yoshihiko Noda.jpg;9073;9709;36033;453;485;32
/net/per610a/home/mvp/mvp_db/news7-lv/2011/2011_12_26_19_00/2011_12_26_19_00.mpg;Yoshihiko Noda.jpg;19425;19597;36033;971;980;9
/net/per610a/home/mvp/mvp_db/news7-lv/2011/2011_12_26_19_00/2011_12_26_19_00.mpg;Naoto KAN.jpg;7609;7721;36033;380;386;6
/net/per610a/home/mvp/mvp_db/news7-lv/2011/2011_12_27_19_00/2011_12_27_19_00.mpg;Yoshihiko Noda.jpg;1981;2925;36033;99;146;47
/net/per610a/home/mvp/mvp_db/news7-lv/2011/2011_12_27_19_00/2011_12_27_19_00.mpg;Yoshihiko Noda.jpg;3017;3173;36033;150;158;8
/net/per610a/home/mvp/mvp_db/news7-lv/2011/2011_12_28_19_00/2011_12_28_19_00.mpg;Sadakazu TANIGAKI.jpg;5257;5769;36037;263;288;25
/net/per610a/home/mvp/mvp_db/news7-lv/2011/2011_12_28_19_00/2011_12_28_19_00.mpg;Yoshihiko Noda.jpg;10649;11101;36037;532;555;23
/net/per610a/home/mvp/mvp_db/news7-lv/2011/2011_12_29_19_00/2011_12_29_19_00.mpg;Yoshihiko Noda.jpg;1741;2001;36033;87;100;13
/net/per610a/home/mvp/mvp_db/news7-lv/2011/2011_12_29_19_00/2011_12_29_19_00.mpg;Yoshihiko Noda.jpg;3989;4609;36033;199;230;31
/net/per610a/home/mvp/mvp_db/news7-lv/2011/2011_12_29_19_00/2011_12_29_19_00.mpg;Seiji MAEHARA.jpg;3385;3481;36033;169;174;5
/net/per610a/home/mvp/mvp_db/news7-lv/2011/2011_12_30_19_00/2011_12_30_19_00.mpg;Yoshihiko Noda.jpg;1141;1917;36033;57;95;38
/net/per610a/home/mvp/mvp_db/news7-lv/2011/2011_12_30_19_00/2011_12_30_19_00.mpg;Yoshihiko Noda.jpg;2121;2469;36033;106;123;17
/net/per610a/home/mvp/mvp_db/news7-lv/2011/2011_12_30_19_00/2011_12_30_19_00.mpg;Yoshihiko Noda.jpg;8389;8473;36033;419;423;4
/net/per610a/home/mvp/mvp_db/news7-lv/2011/2011_12_30_19_00/2011_12_30_19_00.mpg;Seiji MAEHARA.jpg;2553;2601;36033;127;130;3
/net/per610a/home/mvp/mvp_db/news7-lv/2011/2011_12_30_19_00/2011_12_30_19_00.mpg;Seiji MAEHARA.jpg;2761;3285;36033;138;164;26
/net/per610a/home/mvp/mvp_db/news7-lv/2011/2011_12_30_19_00/2011_12_30_19_00.mpg;Seiji MAEHARA.jpg;5945;5973;36033;297;298;1
/net/per610a/home/mvp/mvp_db/news7-lv/2011/2011_12_30_19_00/2011_12_30_19_00.mpg;Yukio HATOYAMA.jpg;8909;9045;36033;445;452;7
/net/per610a/home/mvp/mvp_db/news7-lv/2011/2011_12_30_19_00/2011_12_30_19_00.mpg;Ichiro OZAWA.jpg;8909;9045;36033;445;452;7
/net/per610a/home/mvp/mvp_db/news7-lv/2012/2012_01_02_19_00/2012_01_02_19_00.mpg;Yoshihiko Noda.jpg;18121;18553;36033;906;928;22
/net/per610a/home/mvp/mvp_db/news7-lv/2012/2012_01_03_19_00/2012_01_03_19_00.mpg;Ichiro OZAWA.jpg;15809;16209;36033;791;811;20
/net/per610a/home/mvp/mvp_db/news7-lv/2012/2012_01_03_19_00/2012_01_03_19_00.mpg;Yoshihiko Noda.jpg;16213;16461;36033;811;823;12
/net/per610a/home/mvp/mvp_db/news7-lv/2012/2012_01_03_19_00/2012_01_03_19_00.mpg;Yoshihiko Noda.jpg;17905;18729;36033;895;937;42
/net/per610a/home/mvp/mvp_db/news7-lv/2012/2012_01_03_19_00/2012_01_03_19_00.mpg;Ichiro OZAWA.jpg;16825;17661;36033;841;883;42
/net/per610a/home/mvp/mvp_db/news7-lv/2012/2012_01_04_19_00/2012_01_04_19_00.mpg;Yoshihiko Noda.jpg;341;493;36033;17;24;7
/net/per610a/home/mvp/mvp_db/news7-lv/2012/2012_01_04_19_00/2012_01_04_19_00.mpg;Yoshihiko Noda.jpg;965;969;36033;48;48;0
/net/per610a/home/mvp/mvp_db/news7-lv/2012/2012_01_04_19_00/2012_01_04_19_00.mpg;Yoshihiko Noda.jpg;1585;1669;36033;79;83;4
/net/per610a/home/mvp/mvp_db/news7-lv/2012/2012_01_04_19_00/2012_01_04_19_00.mpg;Yoshihiko Noda.jpg;1797;1897;36033;89;94;5
/net/per610a/home/mvp/mvp_db/news7-lv/2012/2012_01_04_19_00/2012_01_04_19_00.mpg;Yoshihiko Noda.jpg;2025;2601;36033;101;130;29
/net/per610a/home/mvp/mvp_db/news7-lv/2012/2012_01_04_19_00/2012_01_04_19_00.mpg;Sadakazu TANIGAKI.jpg;965;1497;36033;48;74;26
/net/per610a/home/mvp/mvp_db/news7-lv/2012/2012_01_04_19_00/2012_01_04_19_00.mpg;Sadakazu TANIGAKI.jpg;4513;4681;36033;225;234;9
/net/per610a/home/mvp/mvp_db/news7-lv/2012/2012_01_04_19_00/2012_01_04_19_00.mpg;Natsuo YAMAGUCHI.jpg;4777;5321;36033;239;266;27
/net/per610a/home/mvp/mvp_db/news7-lv/2012/2012_01_04_19_00/2012_01_04_19_00.mpg;Yoshimi WATANABE.jpg;5389;5725;36033;269;286;17
/net/per610a/home/mvp/mvp_db/news7-lv/2012/2012_01_04_19_00/2012_01_04_19_00.mpg;Kazuo SHII.jpg;5809;6097;36033;290;305;15
/net/per610a/home/mvp/mvp_db/news7-lv/2012/2012_01_05_19_00/2012_01_05_19_00.mpg;Yukio HATOYAMA.jpg;5105;5877;36033;255;294;39
/net/per610a/home/mvp/mvp_db/news7-lv/2012/2012_01_05_19_00/2012_01_05_19_00.mpg;Sadakazu TANIGAKI.jpg;24361;24813;36033;1218;1241;23
/net/per610a/home/mvp/mvp_db/news7-lv/2012/2012_01_05_19_00/2012_01_05_19_00.mpg;Sadakazu TANIGAKI.jpg;25633;26177;36033;1282;1309;27
/net/per610a/home/mvp/mvp_db/news7-lv/2012/2012_01_05_19_00/2012_01_05_19_00.mpg;Sadakazu TANIGAKI.jpg;26265;26325;36033;1314;1317;3
/net/per610a/home/mvp/mvp_db/news7-lv/2012/2012_01_05_19_00/2012_01_05_19_00.mpg;Yoshihiko Noda.jpg;24885;25529;36033;1245;1277;32
/net/per610a/home/mvp/mvp_db/news7-lv/2012/2012_01_06_19_00/2012_01_06_19_00.mpg;Seiji MAEHARA.jpg;8057;8161;36041;403;408;5
/net/per610a/home/mvp/mvp_db/news7-lv/2012/2012_01_06_19_00/2012_01_06_19_00.mpg;Yoshihiko Noda.jpg;17661;17845;36041;883;892;9
/net/per610a/home/mvp/mvp_db/news7-lv/2012/2012_01_08_19_00/2012_01_08_19_00.mpg;Yoshihiko Noda.jpg;137;297;36033;6;14;8
/net/per610a/home/mvp/mvp_db/news7-lv/2012/2012_01_08_19_00/2012_01_08_19_00.mpg;Yoshihiko Noda.jpg;1949;2093;36033;97;104;7
/net/per610a/home/mvp/mvp_db/news7-lv/2012/2012_01_08_19_00/2012_01_08_19_00.mpg;Yoshihiko Noda.jpg;2241;2409;36033;112;120;8
/net/per610a/home/mvp/mvp_db/news7-lv/2012/2012_01_08_19_00/2012_01_08_19_00.mpg;Yoshihiko Noda.jpg;2589;3361;36033;129;168;39
/net/per610a/home/mvp/mvp_db/news7-lv/2012/2012_01_08_19_00/2012_01_08_19_00.mpg;Yoshihiko Noda.jpg;7233;7989;36033;361;399;38
/net/per610a/home/mvp/mvp_db/news7-lv/2012/2012_01_10_19_00/2012_01_10_19_00.mpg;Ichiro OZAWA.jpg;10089;10361;36033;504;518;14
/net/per610a/home/mvp/mvp_db/news7-lv/2012/2012_01_10_19_00/2012_01_10_19_00.mpg;Ichiro OZAWA.jpg;10697;11025;36033;535;551;16
/net/per610a/home/mvp/mvp_db/news7-lv/2012/2012_01_10_19_00/2012_01_10_19_00.mpg;Yoshihiko Noda.jpg;19893;20265;36033;995;1014;19
/net/per610a/home/mvp/mvp_db/news7-lv/2012/2012_01_10_19_00/2012_01_10_19_00.mpg;Yoshihiko Noda.jpg;21093;21113;36033;1055;1056;1
/net/per610a/home/mvp/mvp_db/news7-lv/2012/2012_01_10_19_00/2012_01_10_19_00.mpg;Yoshihiko Noda.jpg;21449;21537;36033;1073;1077;4
/net/per610a/home/mvp/mvp_db/news7-lv/2012/2012_01_10_19_00/2012_01_10_19_00.mpg;Yoshihiko Noda.jpg;22537;22805;36033;1127;1141;14
/net/per610a/home/mvp/mvp_db/news7-lv/2012/2012_01_10_19_00/2012_01_10_19_00.mpg;Yoshihiko Noda.jpg;22893;23501;36033;1145;1175;30
/net/per610a/home/mvp/mvp_db/news7-lv/2012/2012_01_10_19_00/2012_01_10_19_00.mpg;Takenori KANZAKI.jpg;23069;23501;36033;1154;1175;21
/net/per610a/home/mvp/mvp_db/news7-lv/2012/2012_01_11_19_00/2012_01_11_19_00.mpg;Natsuo YAMAGUCHI.jpg;281;373;36041;14;18;4
/net/per610a/home/mvp/mvp_db/news7-lv/2012/2012_01_11_19_00/2012_01_11_19_00.mpg;Ichiro OZAWA.jpg;6113;6589;36041;305;329;24
/net/per610a/home/mvp/mvp_db/news7-lv/2012/2012_01_11_19_00/2012_01_11_19_00.mpg;Ichiro OZAWA.jpg;8517;8661;36041;426;433;7
/net/per610a/home/mvp/mvp_db/news7-lv/2012/2012_01_11_19_00/2012_01_11_19_00.mpg;Ichiro OZAWA.jpg;9385;9521;36041;469;476;7
/net/per610a/home/mvp/mvp_db/news7-lv/2012/2012_01_11_19_00/2012_01_11_19_00.mpg;Ichiro OZAWA.jpg;10013;10417;36041;500;521;21
/net/per610a/home/mvp/mvp_db/news7-lv/2012/2012_01_11_19_00/2012_01_11_19_00.mpg;Yoshihiko Noda.jpg;24833;25101;36041;1242;1255;13
/net/per610a/home/mvp/mvp_db/news7-lv/2012/2012_01_12_19_00/2012_01_12_19_00.mpg;Yoshihiko Noda.jpg;1065;1613;36033;53;80;27
/net/per610a/home/mvp/mvp_db/news7-lv/2012/2012_01_12_19_00/2012_01_12_19_00.mpg;Yoshihiko Noda.jpg;3765;3813;36033;188;190;2
/net/per610a/home/mvp/mvp_db/news7-lv/2012/2012_01_13_19_00/2012_01_13_19_00.mpg;Seiji MAEHARA.jpg;6321;6553;44425;316;327;11
/net/per610a/home/mvp/mvp_db/news7-lv/2012/2012_01_13_19_00/2012_01_13_19_00.mpg;Katsuya OKADA.jpg;10433;11489;44425;522;574;52
/net/per610a/home/mvp/mvp_db/news7-lv/2012/2012_01_13_19_00/2012_01_13_19_00.mpg;Yoshihiko Noda.jpg;15401;17177;44425;770;859;89
/net/per610a/home/mvp/mvp_db/news7-lv/2012/2012_01_13_19_00/2012_01_13_19_00.mpg;Yoshihiko Noda.jpg;17437;17501;44425;872;875;3
/net/per610a/home/mvp/mvp_db/news7-lv/2012/2012_01_13_19_00/2012_01_13_19_00.mpg;Yoshihiko Noda.jpg;20053;20161;44425;1003;1008;5
/net/per610a/home/mvp/mvp_db/news7-lv/2012/2012_01_13_19_00/2012_01_13_19_00.mpg;Yoshihiko Noda.jpg;20585;20857;44425;1030;1043;13
/net/per610a/home/mvp/mvp_db/news7-lv/2012/2012_01_13_19_00/2012_01_13_19_00.mpg;Yoshihiko Noda.jpg;21701;22289;44425;1085;1115;30
/net/per610a/home/mvp/mvp_db/news7-lv/2012/2012_01_13_19_00/2012_01_13_19_00.mpg;Yoshihiko Noda.jpg;26545;26597;44425;1328;1330;2
/net/per610a/home/mvp/mvp_db/news7-lv/2012/2012_01_13_19_00/2012_01_13_19_00.mpg;Yoshihiko Noda.jpg;26321;26537;44425;1317;1327;10
/net/per610a/home/mvp/mvp_db/news7-lv/2012/2012_01_13_19_00/2012_01_13_19_00.mpg;Yoshihiko Noda.jpg;26653;27109;44425;1333;1356;23
/net/per610a/home/mvp/mvp_db/news7-lv/2012/2012_01_15_19_00/2012_01_15_19_00.mpg;Yoshihiko Noda.jpg;12013;12445;36033;601;622;21
/net/per610a/home/mvp/mvp_db/news7-lv/2012/2012_01_16_19_00/2012_01_16_19_00.mpg;Katsuya OKADA.jpg;1757;1797;36033;87;89;2
/net/per610a/home/mvp/mvp_db/news7-lv/2012/2012_01_16_19_00/2012_01_16_19_00.mpg;Katsuya OKADA.jpg;2289;2665;36033;114;133;19
/net/per610a/home/mvp/mvp_db/news7-lv/2012/2012_01_16_19_00/2012_01_16_19_00.mpg;Katsuya OKADA.jpg;9501;9541;36033;475;477;2
/net/per610a/home/mvp/mvp_db/news7-lv/2012/2012_01_18_19_00/2012_01_18_19_00.mpg;Shizuka KAMEI.jpg;16681;17181;36045;834;859;25
/net/per610a/home/mvp/mvp_db/news7-lv/2012/2012_01_20_19_00/2012_01_20_19_00.mpg;Katsuya OKADA.jpg;21565;21793;36033;1079;1090;11
/net/per610a/home/mvp/mvp_db/news7-lv/2012/2012_01_22_19_00/2012_01_22_19_00.mpg;Sadakazu TANIGAKI.jpg;14533;14801;36033;727;740;13
/net/per610a/home/mvp/mvp_db/news7-lv/2012/2012_01_23_19_00/2012_01_23_19_00.mpg;Shizuka KAMEI.jpg;25241;25785;36033;1262;1290;28
/net/per610a/home/mvp/mvp_db/news7-lv/2012/2012_01_23_19_00/2012_01_23_19_00.mpg;Yoshihiko Noda.jpg;25241;25785;36033;1262;1290;28
/net/per610a/home/mvp/mvp_db/news7-lv/2012/2012_01_24_19_00/2012_01_24_19_00.mpg;Yoshihiko Noda.jpg;6593;6781;36033;329;339;10
/net/per610a/home/mvp/mvp_db/news7-lv/2012/2012_01_24_19_00/2012_01_24_19_00.mpg;Yoshihiko Noda.jpg;7025;7293;36033;351;364;13
/net/per610a/home/mvp/mvp_db/news7-lv/2012/2012_01_24_19_00/2012_01_24_19_00.mpg;Yoshihiko Noda.jpg;9193;10153;36033;459;508;49
/net/per610a/home/mvp/mvp_db/news7-lv/2012/2012_01_24_19_00/2012_01_24_19_00.mpg;Yoshihiko Noda.jpg;10305;10885;36033;515;544;29
/net/per610a/home/mvp/mvp_db/news7-lv/2012/2012_01_24_19_00/2012_01_24_19_00.mpg;Yoshihiko Noda.jpg;14065;14337;36033;703;717;14
/net/per610a/home/mvp/mvp_db/news7-lv/2012/2012_01_24_19_00/2012_01_24_19_00.mpg;Yoshihiko Noda.jpg;15573;15633;36033;779;782;3
/net/per610a/home/mvp/mvp_db/news7-lv/2012/2012_01_24_19_00/2012_01_24_19_00.mpg;Yoshihiko Noda.jpg;16221;16533;36033;811;827;16
/net/per610a/home/mvp/mvp_db/news7-lv/2012/2012_01_24_19_00/2012_01_24_19_00.mpg;Yoshihiko Noda.jpg;16989;17541;36033;850;877;27
/net/per610a/home/mvp/mvp_db/news7-lv/2012/2012_01_24_19_00/2012_01_24_19_00.mpg;Taro ASO.jpg;7437;7457;36033;372;373;1
/net/per610a/home/mvp/mvp_db/news7-lv/2012/2012_01_24_19_00/2012_01_24_19_00.mpg;Taro ASO.jpg;8373;9121;36033;418;456;38
/net/per610a/home/mvp/mvp_db/news7-lv/2012/2012_01_24_19_00/2012_01_24_19_00.mpg;Taro ASO.jpg;10881;11241;36033;544;562;18
/net/per610a/home/mvp/mvp_db/news7-lv/2012/2012_01_24_19_00/2012_01_24_19_00.mpg;Taro ASO.jpg;14417;14585;36033;721;729;8
/net/per610a/home/mvp/mvp_db/news7-lv/2012/2012_01_24_19_00/2012_01_24_19_00.mpg;Yasuo FUKUDA.jpg;8661;8773;36033;433;438;5
/net/per610a/home/mvp/mvp_db/news7-lv/2012/2012_01_24_19_00/2012_01_24_19_00.mpg;Sadakazu TANIGAKI.jpg;15733;15877;36033;787;794;7
/net/per610a/home/mvp/mvp_db/news7-lv/2012/2012_01_24_19_00/2012_01_24_19_00.mpg;Natsuo YAMAGUCHI.jpg;16353;16849;36033;818;843;25
/net/per610a/home/mvp/mvp_db/news7-lv/2012/2012_01_26_19_00/2012_01_26_19_00.mpg;Yoshihiko Noda.jpg;15245;15529;36033;762;777;15
/net/per610a/home/mvp/mvp_db/news7-lv/2012/2012_01_26_19_00/2012_01_26_19_00.mpg;Yoshihiko Noda.jpg;16977;17361;36033;849;868;19
/net/per610a/home/mvp/mvp_db/news7-lv/2012/2012_01_26_19_00/2012_01_26_19_00.mpg;Yoshihiko Noda.jpg;17473;17861;36033;874;893;19
/net/per610a/home/mvp/mvp_db/news7-lv/2012/2012_01_26_19_00/2012_01_26_19_00.mpg;Yoshihiko Noda.jpg;17953;18197;36033;898;910;12
/net/per610a/home/mvp/mvp_db/news7-lv/2012/2012_01_26_19_00/2012_01_26_19_00.mpg;Yoshihiko Noda.jpg;23401;23573;36033;1170;1179;9
/net/per610a/home/mvp/mvp_db/news7-lv/2012/2012_01_27_19_00/2012_01_27_19_00.mpg;Katsuya OKADA.jpg;5653;5857;36033;282;293;11
/net/per610a/home/mvp/mvp_db/news7-lv/2012/2012_01_27_19_00/2012_01_27_19_00.mpg;Katsuya OKADA.jpg;7501;7761;36033;375;388;13
/net/per610a/home/mvp/mvp_db/news7-lv/2012/2012_01_27_19_00/2012_01_27_19_00.mpg;Katsuya OKADA.jpg;19921;19993;36033;996;1000;4
/net/per610a/home/mvp/mvp_db/news7-lv/2012/2012_01_27_19_00/2012_01_27_19_00.mpg;Naoto KAN.jpg;6029;6109;36033;301;305;4
/net/per610a/home/mvp/mvp_db/news7-lv/2012/2012_01_28_19_00/2012_01_28_19_00.mpg;Yoshihiko Noda.jpg;2365;2533;36033;118;126;8
/net/per610a/home/mvp/mvp_db/news7-lv/2012/2012_01_28_19_00/2012_01_28_19_00.mpg;Natsuo YAMAGUCHI.jpg;13817;14277;36033;691;714;23
/net/per610a/home/mvp/mvp_db/news7-lv/2012/2012_01_28_19_00/2012_01_28_19_00.mpg;Natsuo YAMAGUCHI.jpg;16045;16753;36033;802;838;36
/net/per610a/home/mvp/mvp_db/news7-lv/2012/2012_01_28_19_00/2012_01_28_19_00.mpg;Yoshihiko Noda.jpg;27021;27953;36033;1352;1398;46
/net/per610a/home/mvp/mvp_db/news7-lv/2012/2012_01_29_19_00/2012_01_29_19_00.mpg;Seiji MAEHARA.jpg;8573;8765;36033;428;438;10
/net/per610a/home/mvp/mvp_db/news7-lv/2012/2012_01_29_19_00/2012_01_29_19_00.mpg;Yoshihiko Noda.jpg;8825;8965;36033;441;448;7
/net/per610a/home/mvp/mvp_db/news7-lv/2012/2012_01_30_19_00/2012_01_30_19_00.mpg;Natsuo YAMAGUCHI.jpg;11509;12069;36033;575;603;28
/net/per610a/home/mvp/mvp_db/news7-lv/2012/2012_01_30_19_00/2012_01_30_19_00.mpg;Natsuo YAMAGUCHI.jpg;16109;16353;36033;806;818;12
/net/per610a/home/mvp/mvp_db/news7-lv/2012/2012_02_01_19_00/2012_02_01_19_00.mpg;Yoshihiko Noda.jpg;28725;29081;38429;1437;1455;18
/net/per610a/home/mvp/mvp_db/news7-lv/2012/2012_02_01_19_00/2012_02_01_19_00.mpg;Yoshihiko Noda.jpg;29525;30085;38429;1477;1505;28
/net/per610a/home/mvp/mvp_db/news7-lv/2012/2012_02_01_19_00/2012_02_01_19_00.mpg;Yoshihiko Noda.jpg;30385;30949;38429;1520;1548;28
/net/per610a/home/mvp/mvp_db/news7-lv/2012/2012_02_02_19_00/2012_02_02_19_00.mpg;Nariaki Nakayama.png;18489;18553;36033;925;928;3
/net/per610a/home/mvp/mvp_db/news7-lv/2012/2012_02_02_19_00/2012_02_02_19_00.mpg;Nariaki Nakayama.png;18977;19069;36033;949;954;5
/net/per610a/home/mvp/mvp_db/news7-lv/2012/2012_02_03_19_00/2012_02_03_19_00.mpg;Toru Hashimoto.jpg;9801;10017;36029;490;501;11
/net/per610a/home/mvp/mvp_db/news7-lv/2012/2012_02_03_19_00/2012_02_03_19_00.mpg;Shintaro ISHIHARA.jpg;29749;30353;36029;1488;1518;30
/net/per610a/home/mvp/mvp_db/news7-lv/2012/2012_02_03_19_00/2012_02_03_19_00.mpg;Katsuya OKADA.jpg;30693;30985;36029;1535;1550;15
/net/per610a/home/mvp/mvp_db/news7-lv/2012/2012_02_04_19_00/2012_02_04_19_00.mpg;Yoshihiko Noda.jpg;169;169;36033;8;8;0
/net/per610a/home/mvp/mvp_db/news7-lv/2012/2012_02_04_19_00/2012_02_04_19_00.mpg;Yoshihiko Noda.jpg;253;345;36033;12;17;5
/net/per610a/home/mvp/mvp_db/news7-lv/2012/2012_02_04_19_00/2012_02_04_19_00.mpg;Yoshihiko Noda.jpg;10185;10637;36033;509;532;23
/net/per610a/home/mvp/mvp_db/news7-lv/2012/2012_02_04_19_00/2012_02_04_19_00.mpg;Yoshihiko Noda.jpg;10893;12417;36033;545;621;76
/net/per610a/home/mvp/mvp_db/news7-lv/2012/2012_02_04_19_00/2012_02_04_19_00.mpg;Yoshihiko Noda.jpg;12881;13125;36033;644;656;12
/net/per610a/home/mvp/mvp_db/news7-lv/2012/2012_02_04_19_00/2012_02_04_19_00.mpg;Yoshihiko Noda.jpg;13357;13817;36033;668;691;23
/net/per610a/home/mvp/mvp_db/news7-lv/2012/2012_02_06_19_00/2012_02_06_19_00.mpg;Seiji MAEHARA.jpg;18913;18945;36033;946;947;1
/net/per610a/home/mvp/mvp_db/news7-lv/2012/2012_02_06_19_00/2012_02_06_19_00.mpg;Seiji MAEHARA.jpg;19045;19201;36033;952;960;8
/net/per610a/home/mvp/mvp_db/news7-lv/2012/2012_02_07_19_00/2012_02_07_19_00.mpg;Yoshihiko Noda.jpg;27353;27969;36045;1368;1399;31
/net/per610a/home/mvp/mvp_db/news7-lv/2012/2012_02_09_19_00/2012_02_09_19_00.mpg;Yoshihiko Noda.jpg;1101;1101;36033;55;55;0
/net/per610a/home/mvp/mvp_db/news7-lv/2012/2012_02_09_19_00/2012_02_09_19_00.mpg;Yoshihiko Noda.jpg;1425;1429;36033;71;71;0
/net/per610a/home/mvp/mvp_db/news7-lv/2012/2012_02_09_19_00/2012_02_09_19_00.mpg;Yoshihiko Noda.jpg;5525;5893;36033;276;294;18
/net/per610a/home/mvp/mvp_db/news7-lv/2012/2012_02_10_19_00/2012_02_10_19_00.mpg;Yoshihiko Noda.jpg;13945;14093;38429;697;705;8
/net/per610a/home/mvp/mvp_db/news7-lv/2012/2012_02_10_19_00/2012_02_10_19_00.mpg;Yoshihiko Noda.jpg;15357;17053;38429;768;853;85
/net/per610a/home/mvp/mvp_db/news7-lv/2012/2012_02_10_19_00/2012_02_10_19_00.mpg;Yoshihiko Noda.jpg;23173;23557;38429;1159;1178;19
/net/per610a/home/mvp/mvp_db/news7-lv/2012/2012_02_10_19_00/2012_02_10_19_00.mpg;Yoshihiko Noda.jpg;24117;24589;38429;1206;1230;24
/net/per610a/home/mvp/mvp_db/news7-lv/2012/2012_02_11_19_00/2012_02_11_19_00.mpg;Yoshihiko Noda.jpg;26277;26489;36033;1314;1325;11
/net/per610a/home/mvp/mvp_db/news7-lv/2012/2012_02_12_19_00/2012_02_12_19_00.mpg;Kyoko Nakayama.jpg;7985;8185;38433;399;409;10
/net/per610a/home/mvp/mvp_db/news7-lv/2012/2012_02_12_19_00/2012_02_12_19_00.mpg;Kyoko Nakayama.jpg;8741;8817;38433;437;441;4
/net/per610a/home/mvp/mvp_db/news7-lv/2012/2012_02_12_19_00/2012_02_12_19_00.mpg;Naoto KAN.jpg;17597;17705;38433;880;885;5
/net/per610a/home/mvp/mvp_db/news7-lv/2012/2012_02_13_19_00/2012_02_13_19_00.mpg;Yoshihiko Noda.jpg;22481;22969;36029;1125;1149;24
/net/per610a/home/mvp/mvp_db/news7-lv/2012/2012_02_13_19_00/2012_02_13_19_00.mpg;Yoshihiko Noda.jpg;24109;24121;36029;1206;1207;1
/net/per610a/home/mvp/mvp_db/news7-lv/2012/2012_02_13_19_00/2012_02_13_19_00.mpg;Toru Hashimoto.jpg;26105;26301;36029;1306;1316;10
/net/per610a/home/mvp/mvp_db/news7-lv/2012/2012_02_16_19_00/2012_02_16_19_00.mpg;Shintaro ISHIHARA.jpg;27281;27537;36029;1365;1378;13
/net/per610a/home/mvp/mvp_db/news7-lv/2012/2012_02_17_19_00/2012_02_17_19_00.mpg;Ichiro OZAWA.jpg;4761;5453;36033;238;272;34
/net/per610a/home/mvp/mvp_db/news7-lv/2012/2012_02_17_19_00/2012_02_17_19_00.mpg;Ichiro OZAWA.jpg;19833;20141;36033;992;1007;15
/net/per610a/home/mvp/mvp_db/news7-lv/2012/2012_02_17_19_00/2012_02_17_19_00.mpg;Katsuya OKADA.jpg;16313;16557;36033;816;828;12
/net/per610a/home/mvp/mvp_db/news7-lv/2012/2012_02_17_19_00/2012_02_17_19_00.mpg;Shizuka KAMEI.jpg;19833;20141;36033;992;1007;15
/net/per610a/home/mvp/mvp_db/news7-lv/2012/2012_02_19_19_00/2012_02_19_19_00.mpg;Yoshihiko Noda.jpg;25493;25701;36033;1275;1286;11
/net/per610a/home/mvp/mvp_db/news7-lv/2012/2012_02_21_19_00/2012_02_21_19_00.mpg;Yoshihiko Noda.jpg;20645;21225;36041;1032;1061;29
/net/per610a/home/mvp/mvp_db/news7-lv/2012/2012_02_21_19_00/2012_02_21_19_00.mpg;Yoshihiko Noda.jpg;21309;21437;36041;1066;1072;6
/net/per610a/home/mvp/mvp_db/news7-lv/2012/2012_02_21_19_00/2012_02_21_19_00.mpg;Sadakazu TANIGAKI.jpg;22877;23725;36041;1144;1186;42
/net/per610a/home/mvp/mvp_db/news7-lv/2012/2012_02_23_19_00/2012_02_23_19_00.mpg;Yoshihiko Noda.jpg;23721;23885;36033;1186;1195;9
/net/per610a/home/mvp/mvp_db/news7-lv/2012/2012_02_24_19_00/2012_02_24_19_00.mpg;Yoshihiko Noda.jpg;22661;23449;36033;1133;1173;40
/net/per610a/home/mvp/mvp_db/news7-lv/2012/2012_02_24_19_00/2012_02_24_19_00.mpg;Yoshihiko Noda.jpg;23585;23965;36033;1180;1199;19
/net/per610a/home/mvp/mvp_db/news7-lv/2012/2012_02_24_19_00/2012_02_24_19_00.mpg;Yoshihiko Noda.jpg;24089;24153;36033;1205;1208;3
/net/per610a/home/mvp/mvp_db/news7-lv/2012/2012_02_24_19_00/2012_02_24_19_00.mpg;Yoshihiko Noda.jpg;24293;24749;36033;1215;1238;23
/net/per610a/home/mvp/mvp_db/news7-lv/2012/2012_02_26_19_00/2012_02_26_19_00.mpg;Yoshihiko Noda.jpg;16101;16717;36033;805;836;31
/net/per610a/home/mvp/mvp_db/news7-lv/2012/2012_02_26_19_00/2012_02_26_19_00.mpg;Yoshihiko Noda.jpg;16949;17001;36033;848;850;2
/net/per610a/home/mvp/mvp_db/news7-lv/2012/2012_02_26_19_00/2012_02_26_19_00.mpg;Yoshihiko Noda.jpg;18317;19373;36033;916;969;53
/net/per610a/home/mvp/mvp_db/news7-lv/2012/2012_02_27_19_00/2012_02_27_19_00.mpg;Yoshihiko Noda.jpg;285;305;36033;14;15;1
/net/per610a/home/mvp/mvp_db/news7-lv/2012/2012_02_27_19_00/2012_02_27_19_00.mpg;Yoshihiko Noda.jpg;5729;6841;36033;286;342;56
/net/per610a/home/mvp/mvp_db/news7-lv/2012/2012_03_02_19_00/2012_03_02_19_00.mpg;Yoshihiko Noda.jpg;2517;2813;36033;125;140;15
/net/per610a/home/mvp/mvp_db/news7-lv/2012/2012_03_02_19_00/2012_03_02_19_00.mpg;Yoshihiko Noda.jpg;4657;5105;36033;233;255;22
/net/per610a/home/mvp/mvp_db/news7-lv/2012/2012_03_03_19_00/2012_03_03_19_00.mpg;Katsuya OKADA.jpg;8969;9789;36033;448;489;41
/net/per610a/home/mvp/mvp_db/news7-lv/2012/2012_03_03_19_00/2012_03_03_19_00.mpg;Katsuya OKADA.jpg;11417;12833;36033;571;642;71
/net/per610a/home/mvp/mvp_db/news7-lv/2012/2012_03_03_19_00/2012_03_03_19_00.mpg;Ichiro OZAWA.jpg;9873;11173;36033;494;559;65
/net/per610a/home/mvp/mvp_db/news7-lv/2012/2012_03_03_19_00/2012_03_03_19_00.mpg;Sadakazu TANIGAKI.jpg;10877;11173;36033;544;559;15
/net/per610a/home/mvp/mvp_db/news7-lv/2012/2012_03_04_19_00/2012_03_04_19_00.mpg;Yoshihiko Noda.jpg;20157;21577;36033;1008;1079;71
/net/per610a/home/mvp/mvp_db/news7-lv/2012/2012_03_05_19_00/2012_03_05_19_00.mpg;Kohei Otsuka.jpg;7357;7473;36033;368;373;5
/net/per610a/home/mvp/mvp_db/news7-lv/2012/2012_03_07_19_00/2012_03_07_19_00.mpg;Yoshihiko Noda.jpg;21613;22081;36029;1081;1104;23
/net/per610a/home/mvp/mvp_db/news7-lv/2012/2012_03_07_19_00/2012_03_07_19_00.mpg;Yoshihiko Noda.jpg;23057;23373;36029;1153;1169;16
/net/per610a/home/mvp/mvp_db/news7-lv/2012/2012_03_07_19_00/2012_03_07_19_00.mpg;Yoshihiko Noda.jpg;23449;23949;36029;1173;1198;25
/net/per610a/home/mvp/mvp_db/news7-lv/2012/2012_03_11_19_00/2012_03_11_19_00.mpg;Yoshihiko Noda.jpg;56097;56257;72005;2806;2814;8
/net/per610a/home/mvp/mvp_db/news7-lv/2012/2012_03_11_19_00/2012_03_11_19_00.mpg;Yoshihiko Noda.jpg;61305;62413;72005;3067;3123;56
/net/per610a/home/mvp/mvp_db/news7-lv/2012/2012_03_11_19_00/2012_03_11_19_00.mpg;Yoshihiko Noda.jpg;62513;63865;72005;3128;3195;67
/net/per610a/home/mvp/mvp_db/news7-lv/2012/2012_03_12_19_00/2012_03_12_19_00.mpg;Yoshihiko Noda.jpg;22941;23213;36033;1147;1161;14
/net/per610a/home/mvp/mvp_db/news7-lv/2012/2012_03_12_19_00/2012_03_12_19_00.mpg;Yoshihiko Noda.jpg;24429;24545;36033;1222;1228;6
/net/per610a/home/mvp/mvp_db/news7-lv/2012/2012_03_12_19_00/2012_03_12_19_00.mpg;Yoshihiko Noda.jpg;24613;24829;36033;1231;1242;11
/net/per610a/home/mvp/mvp_db/news7-lv/2012/2012_03_12_19_00/2012_03_12_19_00.mpg;Toru Hashimoto.jpg;26129;26653;36033;1307;1333;26
/net/per610a/home/mvp/mvp_db/news7-lv/2012/2012_03_13_19_00/2012_03_13_19_00.mpg;Seiji MAEHARA.jpg;15397;15729;36033;770;787;17
/net/per610a/home/mvp/mvp_db/news7-lv/2012/2012_03_13_19_00/2012_03_13_19_00.mpg;Seiji MAEHARA.jpg;16061;16213;36033;803;811;8
/net/per610a/home/mvp/mvp_db/news7-lv/2012/2012_03_13_19_00/2012_03_13_19_00.mpg;Yoshihiko Noda.jpg;25089;25501;36033;1255;1276;21
/net/per610a/home/mvp/mvp_db/news7-lv/2012/2012_03_13_19_00/2012_03_13_19_00.mpg;Yoshihiko Noda.jpg;25997;26425;36033;1300;1322;22
/net/per610a/home/mvp/mvp_db/news7-lv/2012/2012_03_13_19_00/2012_03_13_19_00.mpg;Yoshihiko Noda.jpg;27585;28117;36033;1380;1406;26
/net/per610a/home/mvp/mvp_db/news7-lv/2012/2012_03_13_19_00/2012_03_13_19_00.mpg;Yoshihiko Noda.jpg;28377;29033;36033;1419;1452;33
/net/per610a/home/mvp/mvp_db/news7-lv/2012/2012_03_14_19_00/2012_03_14_19_00.mpg;Seiji MAEHARA.jpg;20669;21001;39677;1034;1050;16
/net/per610a/home/mvp/mvp_db/news7-lv/2012/2012_03_14_19_00/2012_03_14_19_00.mpg;Yoshihiko Noda.jpg;23757;24193;39677;1188;1210;22
/net/per610a/home/mvp/mvp_db/news7-lv/2012/2012_03_14_19_00/2012_03_14_19_00.mpg;Shizuka KAMEI.jpg;25613;25849;39677;1281;1293;12
/net/per610a/home/mvp/mvp_db/news7-lv/2012/2012_03_16_19_00/2012_03_16_19_00.mpg;Yoshihiko Noda.jpg;5653;5793;36033;282;289;7
/net/per610a/home/mvp/mvp_db/news7-lv/2012/2012_03_16_19_00/2012_03_16_19_00.mpg;Yoshihiko Noda.jpg;5865;6261;36033;293;313;20
/net/per610a/home/mvp/mvp_db/news7-lv/2012/2012_03_16_19_00/2012_03_16_19_00.mpg;Seiji MAEHARA.jpg;6429;6681;36033;321;334;13
/net/per610a/home/mvp/mvp_db/news7-lv/2012/2012_03_16_19_00/2012_03_16_19_00.mpg;Seiji MAEHARA.jpg;6961;7045;36033;348;352;4
/net/per610a/home/mvp/mvp_db/news7-lv/2012/2012_03_17_19_00/2012_03_17_19_00.mpg;Katsuya OKADA.jpg;981;1213;36033;49;60;11
/net/per610a/home/mvp/mvp_db/news7-lv/2012/2012_03_17_19_00/2012_03_17_19_00.mpg;Katsuya OKADA.jpg;1717;2941;36033;85;147;62
/net/per610a/home/mvp/mvp_db/news7-lv/2012/2012_03_18_19_00/2012_03_18_19_00.mpg;Yoshihiko Noda.jpg;22057;22805;36033;1103;1141;38
/net/per610a/home/mvp/mvp_db/news7-lv/2012/2012_03_19_19_00/2012_03_19_19_00.mpg;Ichiro OZAWA.jpg;897;1373;36033;44;68;24
/net/per610a/home/mvp/mvp_db/news7-lv/2012/2012_03_20_19_00/2012_03_20_19_00.mpg;Yoshihiko Noda.jpg;1561;1789;36033;78;89;11
/net/per610a/home/mvp/mvp_db/news7-lv/2012/2012_03_20_19_00/2012_03_20_19_00.mpg;Yoshihiko Noda.jpg;2117;2485;36033;105;124;19
/net/per610a/home/mvp/mvp_db/news7-lv/2012/2012_03_20_19_00/2012_03_20_19_00.mpg;Yoshihiko Noda.jpg;26993;27125;36033;1350;1357;7
/net/per610a/home/mvp/mvp_db/news7-lv/2012/2012_03_20_19_00/2012_03_20_19_00.mpg;Yoshihiko Noda.jpg;27337;27553;36033;1367;1378;11
/net/per610a/home/mvp/mvp_db/news7-lv/2012/2012_03_20_19_00/2012_03_20_19_00.mpg;Yoshihiko Noda.jpg;29917;30145;36033;1496;1508;12
/net/per610a/home/mvp/mvp_db/news7-lv/2012/2012_03_21_19_00/2012_03_21_19_00.mpg;Yukio EDANO.jpg;10545;10801;36033;527;540;13
/net/per610a/home/mvp/mvp_db/news7-lv/2012/2012_03_21_19_00/2012_03_21_19_00.mpg;Seiji MAEHARA.jpg;16733;17021;36033;837;851;14
/net/per610a/home/mvp/mvp_db/news7-lv/2012/2012_03_21_19_00/2012_03_21_19_00.mpg;Seiji MAEHARA.jpg;17765;17785;36033;888;889;1
/net/per610a/home/mvp/mvp_db/news7-lv/2012/2012_03_22_19_00/2012_03_22_19_00.mpg;Yukio HATOYAMA.jpg;16249;16357;36033;813;818;5
/net/per610a/home/mvp/mvp_db/news7-lv/2012/2012_03_23_19_00/2012_03_23_19_00.mpg;Toru Hashimoto.jpg;9393;9945;36033;470;497;27
/net/per610a/home/mvp/mvp_db/news7-lv/2012/2012_03_23_19_00/2012_03_23_19_00.mpg;Yoshihiko Noda.jpg;11637;11789;36033;582;589;7
/net/per610a/home/mvp/mvp_db/news7-lv/2012/2012_03_23_19_00/2012_03_23_19_00.mpg;Yoshihiko Noda.jpg;13617;13873;36033;681;694;13
/net/per610a/home/mvp/mvp_db/news7-lv/2012/2012_03_23_19_00/2012_03_23_19_00.mpg;Yukio EDANO.jpg;12269;12833;36033;613;642;29
/net/per610a/home/mvp/mvp_db/news7-lv/2012/2012_03_23_19_00/2012_03_23_19_00.mpg;Seiji MAEHARA.jpg;27317;27521;36033;1366;1377;11
/net/per610a/home/mvp/mvp_db/news7-lv/2012/2012_03_23_19_00/2012_03_23_19_00.mpg;Seiji MAEHARA.jpg;27853;27973;36033;1393;1399;6
/net/per610a/home/mvp/mvp_db/news7-lv/2012/2012_03_24_19_00/2012_03_24_19_00.mpg;Yoshihiko Noda.jpg;9497;9817;36033;475;491;16
/net/per610a/home/mvp/mvp_db/news7-lv/2012/2012_03_24_19_00/2012_03_24_19_00.mpg;Yoshihiko Noda.jpg;10089;11449;36033;504;572;68
/net/per610a/home/mvp/mvp_db/news7-lv/2012/2012_03_24_19_00/2012_03_24_19_00.mpg;Toru Hashimoto.jpg;15561;15753;36033;778;788;10
/net/per610a/home/mvp/mvp_db/news7-lv/2012/2012_03_24_19_00/2012_03_24_19_00.mpg;Sadakazu TANIGAKI.jpg;16405;17181;36033;820;859;39
/net/per610a/home/mvp/mvp_db/news7-lv/2012/2012_03_26_19_00/2012_03_26_19_00.mpg;Seiji MAEHARA.jpg;19453;20305;36037;973;1015;42
/net/per610a/home/mvp/mvp_db/news7-lv/2012/2012_03_26_19_00/2012_03_26_19_00.mpg;Yoshihiko Noda.jpg;20697;20881;36037;1035;1044;9
/net/per610a/home/mvp/mvp_db/news7-lv/2012/2012_03_27_19_00/2012_03_27_19_00.mpg;Yoshihiko Noda.jpg;11165;11585;36033;558;579;21
/net/per610a/home/mvp/mvp_db/news7-lv/2012/2012_03_27_19_00/2012_03_27_19_00.mpg;Yoshihiko Noda.jpg;18593;18701;36033;930;935;5
/net/per610a/home/mvp/mvp_db/news7-lv/2012/2012_03_27_19_00/2012_03_27_19_00.mpg;Yoshihiko Noda.jpg;18965;19237;36033;948;962;14
/net/per610a/home/mvp/mvp_db/news7-lv/2012/2012_03_27_19_00/2012_03_27_19_00.mpg;Seiji MAEHARA.jpg;15849;15953;36033;793;798;5
/net/per610a/home/mvp/mvp_db/news7-lv/2012/2012_03_27_19_00/2012_03_27_19_00.mpg;Seiji MAEHARA.jpg;18077;18389;36033;904;920;16
/net/per610a/home/mvp/mvp_db/news7-lv/2012/2012_03_27_19_00/2012_03_27_19_00.mpg;Seiji MAEHARA.jpg;18593;18885;36033;930;944;14
/net/per610a/home/mvp/mvp_db/news7-lv/2012/2012_03_27_19_00/2012_03_27_19_00.mpg;Ichiro OZAWA.jpg;17057;17437;36033;853;872;19
/net/per610a/home/mvp/mvp_db/news7-lv/2012/2012_03_27_19_00/2012_03_27_19_00.mpg;Shizuka KAMEI.jpg;17449;18005;36033;873;900;27
/net/per610a/home/mvp/mvp_db/news7-lv/2012/2012_03_27_19_00/2012_03_27_19_00.mpg;Katsuya OKADA.jpg;18593;18885;36033;930;944;14
/net/per610a/home/mvp/mvp_db/news7-lv/2012/2012_03_28_19_00/2012_03_28_19_00.mpg;Seiji MAEHARA.jpg;1045;1149;36037;52;57;5
/net/per610a/home/mvp/mvp_db/news7-lv/2012/2012_03_28_19_00/2012_03_28_19_00.mpg;Seiji MAEHARA.jpg;4265;4293;36037;213;214;1
/net/per610a/home/mvp/mvp_db/news7-lv/2012/2012_03_28_19_00/2012_03_28_19_00.mpg;Yoshihiko Noda.jpg;1225;1693;36037;61;84;23
/net/per610a/home/mvp/mvp_db/news7-lv/2012/2012_03_29_19_00/2012_03_29_19_00.mpg;Yoshihiko Noda.jpg;1;69;36041;0;3;3
/net/per610a/home/mvp/mvp_db/news7-lv/2012/2012_03_29_19_00/2012_03_29_19_00.mpg;Yoshihiko Noda.jpg;685;1437;36041;34;71;37
/net/per610a/home/mvp/mvp_db/news7-lv/2012/2012_03_29_19_00/2012_03_29_19_00.mpg;Yoshihiko Noda.jpg;5305;5369;36041;265;268;3
/net/per610a/home/mvp/mvp_db/news7-lv/2012/2012_03_29_19_00/2012_03_29_19_00.mpg;Yoshihiko Noda.jpg;5477;6513;36041;273;325;52
/net/per610a/home/mvp/mvp_db/news7-lv/2012/2012_03_29_19_00/2012_03_29_19_00.mpg;Ichiro OZAWA.jpg;437;481;36041;21;24;3
/net/per610a/home/mvp/mvp_db/news7-lv/2012/2012_03_29_19_00/2012_03_29_19_00.mpg;Ichiro OZAWA.jpg;4369;4877;36041;218;243;25
/net/per610a/home/mvp/mvp_db/news7-lv/2012/2012_03_29_19_00/2012_03_29_19_00.mpg;Shizuka KAMEI.jpg;685;1437;36041;34;71;37
/net/per610a/home/mvp/mvp_db/news7-lv/2012/2012_03_29_19_00/2012_03_29_19_00.mpg;Shizuka KAMEI.jpg;2505;2681;36041;125;134;9
/net/per610a/home/mvp/mvp_db/news7-lv/2012/2012_03_29_19_00/2012_03_29_19_00.mpg;Seiji MAEHARA.jpg;3477;3697;36041;173;184;11
/net/per610a/home/mvp/mvp_db/news7-lv/2012/2012_03_29_19_00/2012_03_29_19_00.mpg;Yukiko Kada.jpg;15289;15389;36041;764;769;5
/net/per610a/home/mvp/mvp_db/news7-lv/2012/2012_03_30_19_00/2012_03_30_19_00.mpg;Shizuka KAMEI.jpg;213;265;38433;10;13;3
/net/per610a/home/mvp/mvp_db/news7-lv/2012/2012_03_30_19_00/2012_03_30_19_00.mpg;Shizuka KAMEI.jpg;3365;3681;38433;168;184;16
/net/per610a/home/mvp/mvp_db/news7-lv/2012/2012_03_30_19_00/2012_03_30_19_00.mpg;Yoshihiko Noda.jpg;429;465;38433;21;23;2
/net/per610a/home/mvp/mvp_db/news7-lv/2012/2012_03_30_19_00/2012_03_30_19_00.mpg;Yoshihiko Noda.jpg;949;1677;38433;47;83;36
/net/per610a/home/mvp/mvp_db/news7-lv/2012/2012_03_30_19_00/2012_03_30_19_00.mpg;Yoshihiko Noda.jpg;9449;10229;38433;472;511;39
/net/per610a/home/mvp/mvp_db/news7-lv/2012/2012_03_30_19_00/2012_03_30_19_00.mpg;Yoshihiko Noda.jpg;12233;12745;38433;612;637;25
/net/per610a/home/mvp/mvp_db/news7-lv/2012/2012_03_30_19_00/2012_03_30_19_00.mpg;Shizuka KAMEI.jpg;3093;3325;38433;154;166;12
/net/per610a/home/mvp/mvp_db/news7-lv/2012/2012_03_30_19_00/2012_03_30_19_00.mpg;Seiji MAEHARA.jpg;11909;12089;38433;595;604;9
/net/per610a/home/mvp/mvp_db/news7-lv/2012/2012_03_30_19_00/2012_03_30_19_00.mpg;Sadakazu TANIGAKI.jpg;12233;12613;38433;612;631;19
/net/per610a/home/mvp/mvp_db/news7-lv/2012/2012_03_30_19_00/2012_03_30_19_00.mpg;Yoshihiko Noda.jpg;13385;13889;38433;669;694;25
/net/per610a/home/mvp/mvp_db/news7-lv/2012/2012_03_30_19_00/2012_03_30_19_00.mpg;Yoshihiko Noda.jpg;14425;14825;38433;721;741;20
/net/per610a/home/mvp/mvp_db/news7-lv/2012/2012_03_31_19_00/2012_03_31_19_00.mpg;Katsuya OKADA.jpg;15785;16421;36033;789;821;32
/net/per610a/home/mvp/mvp_db/news7-lv/2012/2012_03_31_19_00/2012_03_31_19_00.mpg;Katsuya OKADA.jpg;17741;18601;36033;887;930;43
/net/per610a/home/mvp/mvp_db/news7-lv/2012/2012_04_01_19_00/2012_04_01_19_00.mpg;Katsuya OKADA.jpg;22437;22705;36033;1122;1136;14
/net/per610a/home/mvp/mvp_db/news7-lv/2012/2012_04_01_19_00/2012_04_01_19_00.mpg;Ichiro OZAWA.jpg;22709;23197;36033;1136;1160;24
/net/per610a/home/mvp/mvp_db/news7-lv/2012/2012_04_01_19_00/2012_04_01_19_00.mpg;Natsuo YAMAGUCHI.jpg;24013;24845;36033;1201;1243;42
/net/per610a/home/mvp/mvp_db/news7-lv/2012/2012_04_01_19_00/2012_04_01_19_00.mpg;Shizuka KAMEI.jpg;24985;26097;36033;1250;1305;55
/net/per610a/home/mvp/mvp_db/news7-lv/2012/2012_04_03_19_00/2012_04_03_19_00.mpg;Yoshihiko Noda.jpg;46857;47049;71997;2344;2354;10
/net/per610a/home/mvp/mvp_db/news7-lv/2012/2012_04_04_19_00/2012_04_04_19_00.mpg;Ichiro OZAWA.jpg;8801;8881;36033;440;444;4
/net/per610a/home/mvp/mvp_db/news7-lv/2012/2012_04_05_19_00/2012_04_05_19_00.mpg;Yoshihiko Noda.jpg;18665;19217;36033;933;961;28
/net/per610a/home/mvp/mvp_db/news7-lv/2012/2012_04_05_19_00/2012_04_05_19_00.mpg;Yoshihiko Noda.jpg;20445;20593;36033;1023;1030;7
/net/per610a/home/mvp/mvp_db/news7-lv/2012/2012_04_05_19_00/2012_04_05_19_00.mpg;Yoshihiko Noda.jpg;21489;22121;36033;1075;1106;31
/net/per610a/home/mvp/mvp_db/news7-lv/2012/2012_04_05_19_00/2012_04_05_19_00.mpg;Yoshihiko Noda.jpg;23161;23413;36033;1158;1171;13
/net/per610a/home/mvp/mvp_db/news7-lv/2012/2012_04_05_19_00/2012_04_05_19_00.mpg;Yoshihiko Noda.jpg;24181;24345;36033;1209;1218;9
/net/per610a/home/mvp/mvp_db/news7-lv/2012/2012_04_05_19_00/2012_04_05_19_00.mpg;Sadakazu TANIGAKI.jpg;20893;21333;36033;1045;1067;22
/net/per610a/home/mvp/mvp_db/news7-lv/2012/2012_04_05_19_00/2012_04_05_19_00.mpg;Sadakazu TANIGAKI.jpg;24181;24345;36033;1209;1218;9
/net/per610a/home/mvp/mvp_db/news7-lv/2012/2012_04_05_19_00/2012_04_05_19_00.mpg;Ichiro OZAWA.jpg;24349;24685;36033;1218;1235;17
/net/per610a/home/mvp/mvp_db/news7-lv/2012/2012_04_06_19_00/2012_04_06_19_00.mpg;Yukio EDANO.jpg;289;521;36037;14;26;12
/net/per610a/home/mvp/mvp_db/news7-lv/2012/2012_04_06_19_00/2012_04_06_19_00.mpg;Yukio EDANO.jpg;3509;4101;36037;175;205;30
/net/per610a/home/mvp/mvp_db/news7-lv/2012/2012_04_06_19_00/2012_04_06_19_00.mpg;Shizuka KAMEI.jpg;18021;18281;36037;901;914;13
/net/per610a/home/mvp/mvp_db/news7-lv/2012/2012_04_06_19_00/2012_04_06_19_00.mpg;Shizuka KAMEI.jpg;18821;19905;36037;941;995;54
/net/per610a/home/mvp/mvp_db/news7-lv/2012/2012_04_07_19_00/2012_04_07_19_00.mpg;Yoshihiko Noda.jpg;101;401;36033;5;20;15
/net/per610a/home/mvp/mvp_db/news7-lv/2012/2012_04_07_19_00/2012_04_07_19_00.mpg;Yoshihiko Noda.jpg;4973;5585;36033;248;279;31
/net/per610a/home/mvp/mvp_db/news7-lv/2012/2012_04_07_19_00/2012_04_07_19_00.mpg;Yoshihiko Noda.jpg;5873;6701;36033;293;335;42
/net/per610a/home/mvp/mvp_db/news7-lv/2012/2012_04_07_19_00/2012_04_07_19_00.mpg;Yoshihiko Noda.jpg;7181;7957;36033;359;398;39
/net/per610a/home/mvp/mvp_db/news7-lv/2012/2012_04_08_19_00/2012_04_08_19_00.mpg;Yoshihiko Noda.jpg;22937;24137;36033;1147;1207;60
/net/per610a/home/mvp/mvp_db/news7-lv/2012/2012_04_09_19_00/2012_04_09_19_00.mpg;Yoshihiko Noda.jpg;15733;15841;36029;787;792;5
/net/per610a/home/mvp/mvp_db/news7-lv/2012/2012_04_09_19_00/2012_04_09_19_00.mpg;Yoshihiko Noda.jpg;23605;24033;36029;1181;1202;21
/net/per610a/home/mvp/mvp_db/news7-lv/2012/2012_04_09_19_00/2012_04_09_19_00.mpg;Yoshihiko Noda.jpg;25085;25233;36029;1255;1262;7
/net/per610a/home/mvp/mvp_db/news7-lv/2012/2012_04_09_19_00/2012_04_09_19_00.mpg;Yoshihiko Noda.jpg;24809;24817;36029;1241;1241;0
/net/per610a/home/mvp/mvp_db/news7-lv/2012/2012_04_09_19_00/2012_04_09_19_00.mpg;Yoshihiko Noda.jpg;25625;25781;36029;1282;1290;8
/net/per610a/home/mvp/mvp_db/news7-lv/2012/2012_04_10_19_00/2012_04_10_19_00.mpg;Yoshihiko Noda.jpg;10881;11221;36033;544;561;17
/net/per610a/home/mvp/mvp_db/news7-lv/2012/2012_04_10_19_00/2012_04_10_19_00.mpg;Yoshihiko Noda.jpg;11365;12045;36033;568;602;34
/net/per610a/home/mvp/mvp_db/news7-lv/2012/2012_04_10_19_00/2012_04_10_19_00.mpg;Yoshihiko Noda.jpg;12221;13133;36033;611;657;46
/net/per610a/home/mvp/mvp_db/news7-lv/2012/2012_04_10_19_00/2012_04_10_19_00.mpg;Katsuya OKADA.jpg;30693;30713;36033;1535;1536;1
/net/per610a/home/mvp/mvp_db/news7-lv/2012/2012_04_10_19_00/2012_04_10_19_00.mpg;Katsuya OKADA.jpg;30785;31005;36033;1540;1551;11
/net/per610a/home/mvp/mvp_db/news7-lv/2012/2012_04_10_19_00/2012_04_10_19_00.mpg;Katsuya OKADA.jpg;31217;31245;36033;1562;1563;1
/net/per610a/home/mvp/mvp_db/news7-lv/2012/2012_04_10_19_00/2012_04_10_19_00.mpg;Katsuya OKADA.jpg;31373;31573;36033;1569;1579;10
/net/per610a/home/mvp/mvp_db/news7-lv/2012/2012_04_11_19_00/2012_04_11_19_00.mpg;Yoshihiko Noda.jpg;22229;22325;36033;1112;1117;5
/net/per610a/home/mvp/mvp_db/news7-lv/2012/2012_04_11_19_00/2012_04_11_19_00.mpg;Yoshihiko Noda.jpg;22453;22993;36033;1123;1150;27
/net/per610a/home/mvp/mvp_db/news7-lv/2012/2012_04_11_19_00/2012_04_11_19_00.mpg;Yoshihiko Noda.jpg;23537;23833;36033;1177;1192;15
/net/per610a/home/mvp/mvp_db/news7-lv/2012/2012_04_11_19_00/2012_04_11_19_00.mpg;Yoshihiko Noda.jpg;24793;24969;36033;1240;1249;9
/net/per610a/home/mvp/mvp_db/news7-lv/2012/2012_04_11_19_00/2012_04_11_19_00.mpg;Yoshihiko Noda.jpg;25425;25633;36033;1272;1282;10
/net/per610a/home/mvp/mvp_db/news7-lv/2012/2012_04_11_19_00/2012_04_11_19_00.mpg;Yoshihiko Noda.jpg;25741;26565;36033;1288;1329;41
/net/per610a/home/mvp/mvp_db/news7-lv/2012/2012_04_12_19_00/2012_04_12_19_00.mpg;Yoshihiko Noda.jpg;12417;12461;36033;621;623;2
/net/per610a/home/mvp/mvp_db/news7-lv/2012/2012_04_12_19_00/2012_04_12_19_00.mpg;Yoshihiko Noda.jpg;14977;14977;36033;749;749;0
/net/per610a/home/mvp/mvp_db/news7-lv/2012/2012_04_12_19_00/2012_04_12_19_00.mpg;Yoshihiko Noda.jpg;15201;15201;36033;760;760;0
/net/per610a/home/mvp/mvp_db/news7-lv/2012/2012_04_12_19_00/2012_04_12_19_00.mpg;Yoshihiko Noda.jpg;15401;15577;36033;770;779;9
/net/per610a/home/mvp/mvp_db/news7-lv/2012/2012_04_12_19_00/2012_04_12_19_00.mpg;Yoshihiko Noda.jpg;15841;16137;36033;792;807;15
/net/per610a/home/mvp/mvp_db/news7-lv/2012/2012_04_12_19_00/2012_04_12_19_00.mpg;Yoshihiko Noda.jpg;12741;13341;36033;637;667;30
/net/per610a/home/mvp/mvp_db/news7-lv/2012/2012_04_12_19_00/2012_04_12_19_00.mpg;Yukio EDANO.jpg;16613;18013;36033;831;901;70
/net/per610a/home/mvp/mvp_db/news7-lv/2012/2012_04_13_19_00/2012_04_13_19_00.mpg;Sadakazu TANIGAKI.jpg;22849;22933;50429;1143;1147;4
/net/per610a/home/mvp/mvp_db/news7-lv/2012/2012_04_14_19_00/2012_04_14_19_00.mpg;Yoshihiko Noda.jpg;11789;11985;36033;589;599;10
/net/per610a/home/mvp/mvp_db/news7-lv/2012/2012_04_15_19_00/2012_04_15_19_00.mpg;Yukio EDANO.jpg;1849;2385;36037;92;119;27
/net/per610a/home/mvp/mvp_db/news7-lv/2012/2012_04_15_19_00/2012_04_15_19_00.mpg;Yukio EDANO.jpg;3609;3941;36037;180;197;17
/net/per610a/home/mvp/mvp_db/news7-lv/2012/2012_04_16_19_00/2012_04_16_19_00.mpg;Yoshihiko Noda.jpg;23137;23301;36041;1157;1165;8
/net/per610a/home/mvp/mvp_db/news7-lv/2012/2012_04_16_19_00/2012_04_16_19_00.mpg;Sadakazu TANIGAKI.jpg;26277;26973;36041;1314;1349;35
/net/per610a/home/mvp/mvp_db/news7-lv/2012/2012_04_18_19_00/2012_04_18_19_00.mpg;Sadakazu TANIGAKI.jpg;13953;14561;36033;698;728;30
/net/per610a/home/mvp/mvp_db/news7-lv/2012/2012_04_18_19_00/2012_04_18_19_00.mpg;Yoshihiko Noda.jpg;15205;15309;36033;760;766;6
/net/per610a/home/mvp/mvp_db/news7-lv/2012/2012_04_18_19_00/2012_04_18_19_00.mpg;Yoshihiko Noda.jpg;15433;15517;36033;772;776;4
/net/per610a/home/mvp/mvp_db/news7-lv/2012/2012_04_19_19_00/2012_04_19_19_00.mpg;Sadakazu TANIGAKI.jpg;7593;7925;36033;379;396;17
/net/per610a/home/mvp/mvp_db/news7-lv/2012/2012_04_21_19_00/2012_04_21_19_00.mpg;Katsuya OKADA.jpg;10061;11129;36033;503;556;53
/net/per610a/home/mvp/mvp_db/news7-lv/2012/2012_04_23_19_00/2012_04_23_19_00.mpg;Yukiko Kada.jpg;18445;18521;36033;922;926;4
/net/per610a/home/mvp/mvp_db/news7-lv/2012/2012_04_23_19_00/2012_04_23_19_00.mpg;Yukiko Kada.jpg;18953;19001;36033;948;950;2
/net/per610a/home/mvp/mvp_db/news7-lv/2012/2012_04_23_19_00/2012_04_23_19_00.mpg;Yukiko Kada.jpg;20165;20481;36033;1009;1024;15
/net/per610a/home/mvp/mvp_db/news7-lv/2012/2012_04_23_19_00/2012_04_23_19_00.mpg;Shintaro ISHIHARA.jpg;29549;30265;36033;1478;1514;36
/net/per610a/home/mvp/mvp_db/news7-lv/2012/2012_04_26_19_00/2012_04_26_19_00.mpg;Ichiro OZAWA.jpg;213;313;36033;10;15;5
/net/per610a/home/mvp/mvp_db/news7-lv/2012/2012_04_26_19_00/2012_04_26_19_00.mpg;Ichiro OZAWA.jpg;877;921;36033;43;46;3
/net/per610a/home/mvp/mvp_db/news7-lv/2012/2012_04_26_19_00/2012_04_26_19_00.mpg;Ichiro OZAWA.jpg;1401;1613;36033;70;80;10
/net/per610a/home/mvp/mvp_db/news7-lv/2012/2012_04_26_19_00/2012_04_26_19_00.mpg;Ichiro OZAWA.jpg;5829;6189;36033;291;309;18
/net/per610a/home/mvp/mvp_db/news7-lv/2012/2012_04_26_19_00/2012_04_26_19_00.mpg;Ichiro OZAWA.jpg;20453;21201;36033;1023;1060;37
/net/per610a/home/mvp/mvp_db/news7-lv/2012/2012_04_26_19_00/2012_04_26_19_00.mpg;Yoshihiko Noda.jpg;12461;12889;36033;623;644;21
/net/per610a/home/mvp/mvp_db/news7-lv/2012/2012_04_26_19_00/2012_04_26_19_00.mpg;Yoshihiko Noda.jpg;20273;20361;36033;1014;1018;4
/net/per610a/home/mvp/mvp_db/news7-lv/2012/2012_04_26_19_00/2012_04_26_19_00.mpg;Sadakazu TANIGAKI.jpg;21265;22309;36033;1064;1116;52
/net/per610a/home/mvp/mvp_db/news7-lv/2012/2012_04_27_19_00/2012_04_27_19_00.mpg;Yoshihiko Noda.jpg;26517;26773;36033;1326;1339;13
/net/per610a/home/mvp/mvp_db/news7-lv/2012/2012_04_30_19_00/2012_04_30_19_00.mpg;Yoshihiko Noda.jpg;11789;11813;36033;589;591;2
/net/per610a/home/mvp/mvp_db/news7-lv/2012/2012_04_30_19_00/2012_04_30_19_00.mpg;Yoshihiko Noda.jpg;12193;12597;36033;610;630;20
/net/per610a/home/mvp/mvp_db/news7-lv/2012/2012_04_30_19_00/2012_04_30_19_00.mpg;Yoshihiko Noda.jpg;15433;15793;36033;772;790;18
/net/per610a/home/mvp/mvp_db/news7-lv/2012/2012_05_01_19_00/2012_05_01_19_00.mpg;Yoshihiko Noda.jpg;9285;9657;36033;464;483;19
/net/per610a/home/mvp/mvp_db/news7-lv/2012/2012_05_01_19_00/2012_05_01_19_00.mpg;Yoshihiko Noda.jpg;10609;11073;36033;530;554;24
/net/per610a/home/mvp/mvp_db/news7-lv/2012/2012_05_01_19_00/2012_05_01_19_00.mpg;Seiji MAEHARA.jpg;11241;11589;36033;562;579;17
/net/per610a/home/mvp/mvp_db/news7-lv/2012/2012_05_07_19_00/2012_05_07_19_00.mpg;Ichiro OZAWA.jpg;24581;25113;36033;1229;1256;27
/net/per610a/home/mvp/mvp_db/news7-lv/2012/2012_05_08_19_00/2012_05_08_19_00.mpg;Ichiro OZAWA.jpg;8241;8617;36033;412;431;19
/net/per610a/home/mvp/mvp_db/news7-lv/2012/2012_05_08_19_00/2012_05_08_19_00.mpg;Ichiro OZAWA.jpg;10309;11757;36033;515;588;73
/net/per610a/home/mvp/mvp_db/news7-lv/2012/2012_05_08_19_00/2012_05_08_19_00.mpg;Yukio HATOYAMA.jpg;9241;9357;36033;462;468;6
/net/per610a/home/mvp/mvp_db/news7-lv/2012/2012_05_09_19_00/2012_05_09_19_00.mpg;Seiji MAEHARA.jpg;11173;12757;38437;558;638;80
/net/per610a/home/mvp/mvp_db/news7-lv/2012/2012_05_11_19_00/2012_05_11_19_00.mpg;Yoshihiko Noda.jpg;69;149;36033;3;7;4
/net/per610a/home/mvp/mvp_db/news7-lv/2012/2012_05_11_19_00/2012_05_11_19_00.mpg;Ichiro OZAWA.jpg;3365;3689;36033;168;184;16
/net/per610a/home/mvp/mvp_db/news7-lv/2012/2012_05_11_19_00/2012_05_11_19_00.mpg;Natsuo YAMAGUCHI.jpg;3701;3949;36033;185;197;12
/net/per610a/home/mvp/mvp_db/news7-lv/2012/2012_05_11_19_00/2012_05_11_19_00.mpg;Yukio EDANO.jpg;13681;13841;36033;684;692;8
/net/per610a/home/mvp/mvp_db/news7-lv/2012/2012_05_12_19_00/2012_05_12_19_00.mpg;Seiji MAEHARA.jpg;7917;8441;36037;396;422;26
/net/per610a/home/mvp/mvp_db/news7-lv/2012/2012_05_13_19_00/2012_05_13_19_00.mpg;Yoshihiko Noda.jpg;9225;9409;36033;461;470;9
/net/per610a/home/mvp/mvp_db/news7-lv/2012/2012_05_13_19_00/2012_05_13_19_00.mpg;Yoshihiko Noda.jpg;9485;10117;36033;474;506;32
/net/per610a/home/mvp/mvp_db/news7-lv/2012/2012_05_13_19_00/2012_05_13_19_00.mpg;Yoshihiko Noda.jpg;10381;10405;36033;519;520;1
/net/per610a/home/mvp/mvp_db/news7-lv/2012/2012_05_13_19_00/2012_05_13_19_00.mpg;Yoshihiko Noda.jpg;10653;11041;36033;533;552;19
/net/per610a/home/mvp/mvp_db/news7-lv/2012/2012_05_13_19_00/2012_05_13_19_00.mpg;Yoshihiko Noda.jpg;12469;12509;36033;623;625;2
/net/per610a/home/mvp/mvp_db/news7-lv/2012/2012_05_13_19_00/2012_05_13_19_00.mpg;Yoshihiko Noda.jpg;13889;14033;36033;694;702;8
/net/per610a/home/mvp/mvp_db/news7-lv/2012/2012_05_13_19_00/2012_05_13_19_00.mpg;Yoshihiko Noda.jpg;10477;10477;36033;524;524;0
/net/per610a/home/mvp/mvp_db/news7-lv/2012/2012_05_13_19_00/2012_05_13_19_00.mpg;Yoshihiko Noda.jpg;13357;13637;36033;668;682;14
/net/per610a/home/mvp/mvp_db/news7-lv/2012/2012_05_14_19_00/2012_05_14_19_00.mpg;Yoshihiko Noda.jpg;19993;20057;36033;1000;1003;3
/net/per610a/home/mvp/mvp_db/news7-lv/2012/2012_05_14_19_00/2012_05_14_19_00.mpg;Yoshihiko Noda.jpg;20189;20285;36033;1010;1015;5
/net/per610a/home/mvp/mvp_db/news7-lv/2012/2012_05_14_19_00/2012_05_14_19_00.mpg;Yoshihiko Noda.jpg;20457;20737;36033;1023;1037;14
/net/per610a/home/mvp/mvp_db/news7-lv/2012/2012_05_14_19_00/2012_05_14_19_00.mpg;Yoshihiko Noda.jpg;27665;27989;36033;1384;1400;16
/net/per610a/home/mvp/mvp_db/news7-lv/2012/2012_05_15_19_00/2012_05_15_19_00.mpg;Yoshihiko Noda.jpg;3661;4185;36041;183;209;26
/net/per610a/home/mvp/mvp_db/news7-lv/2012/2012_05_15_19_00/2012_05_15_19_00.mpg;Yoshihiko Noda.jpg;11417;11565;36041;571;578;7
/net/per610a/home/mvp/mvp_db/news7-lv/2012/2012_05_15_19_00/2012_05_15_19_00.mpg;Yoshihiko Noda.jpg;12493;13129;36041;624;656;32
/net/per610a/home/mvp/mvp_db/news7-lv/2012/2012_05_18_19_00/2012_05_18_19_00.mpg;Masashi Nakano.jpg;6901;7045;36033;345;352;7
/net/per610a/home/mvp/mvp_db/news7-lv/2012/2012_05_18_19_00/2012_05_18_19_00.mpg;Masashi Nakano.jpg;7573;7881;36033;378;394;16
/net/per610a/home/mvp/mvp_db/news7-lv/2012/2012_05_19_19_00/2012_05_19_19_00.mpg;Yoshihiko Noda.jpg;1777;1837;36037;88;91;3
/net/per610a/home/mvp/mvp_db/news7-lv/2012/2012_05_19_19_00/2012_05_19_19_00.mpg;Yoshihiko Noda.jpg;6581;7225;36037;329;361;32
/net/per610a/home/mvp/mvp_db/news7-lv/2012/2012_05_20_19_00/2012_05_20_19_00.mpg;Yoshihiko Noda.jpg;2589;2889;36033;129;144;15
/net/per610a/home/mvp/mvp_db/news7-lv/2012/2012_05_21_19_00/2012_05_21_19_00.mpg;Yoshihiko Noda.jpg;20605;21221;36037;1030;1061;31
/net/per610a/home/mvp/mvp_db/news7-lv/2012/2012_05_21_19_00/2012_05_21_19_00.mpg;Ichiro OZAWA.jpg;20605;20877;36037;1030;1044;14
/net/per610a/home/mvp/mvp_db/news7-lv/2012/2012_05_22_19_00/2012_05_22_19_00.mpg;Ichiro OZAWA.jpg;13881;14529;36033;694;726;32
/net/per610a/home/mvp/mvp_db/news7-lv/2012/2012_05_22_19_00/2012_05_22_19_00.mpg;Ichiro OZAWA.jpg;15665;15981;36033;783;799;16
/net/per610a/home/mvp/mvp_db/news7-lv/2012/2012_05_22_19_00/2012_05_22_19_00.mpg;Ichiro OZAWA.jpg;18209;18561;36033;911;928;17
/net/per610a/home/mvp/mvp_db/news7-lv/2012/2012_05_22_19_00/2012_05_22_19_00.mpg;Katsuya OKADA.jpg;16361;16657;36033;818;833;15
/net/per610a/home/mvp/mvp_db/news7-lv/2012/2012_05_22_19_00/2012_05_22_19_00.mpg;Seiji MAEHARA.jpg;16733;17269;36033;837;864;27
/net/per610a/home/mvp/mvp_db/news7-lv/2012/2012_05_24_19_00/2012_05_24_19_00.mpg;Seiji MAEHARA.jpg;16645;17053;36033;832;853;21
/net/per610a/home/mvp/mvp_db/news7-lv/2012/2012_05_24_19_00/2012_05_24_19_00.mpg;Yoshihiko Noda.jpg;18061;18149;36033;903;908;5
/net/per610a/home/mvp/mvp_db/news7-lv/2012/2012_05_26_19_00/2012_05_26_19_00.mpg;Yoshihiko Noda.jpg;14189;14533;36033;709;727;18
/net/per610a/home/mvp/mvp_db/news7-lv/2012/2012_05_26_19_00/2012_05_26_19_00.mpg;Yoshihiko Noda.jpg;15357;15669;36033;768;784;16
/net/per610a/home/mvp/mvp_db/news7-lv/2012/2012_05_26_19_00/2012_05_26_19_00.mpg;Yoshihiko Noda.jpg;15917;15977;36033;796;799;3
/net/per610a/home/mvp/mvp_db/news7-lv/2012/2012_05_26_19_00/2012_05_26_19_00.mpg;Yoshihiko Noda.jpg;16889;16981;36033;845;849;4
/net/per610a/home/mvp/mvp_db/news7-lv/2012/2012_05_26_19_00/2012_05_26_19_00.mpg;Yoshihiko Noda.jpg;17093;17465;36033;855;873;18
/net/per610a/home/mvp/mvp_db/news7-lv/2012/2012_05_26_19_00/2012_05_26_19_00.mpg;Yoshihiko Noda.jpg;18449;18577;36033;923;929;6
/net/per610a/home/mvp/mvp_db/news7-lv/2012/2012_05_27_19_00/2012_05_27_19_00.mpg;Ichiro OZAWA.jpg;17389;17837;36033;870;892;22
/net/per610a/home/mvp/mvp_db/news7-lv/2012/2012_05_27_19_00/2012_05_27_19_00.mpg;Ichiro OZAWA.jpg;18149;18345;36033;908;917;9
/net/per610a/home/mvp/mvp_db/news7-lv/2012/2012_05_27_19_00/2012_05_27_19_00.mpg;Sadakazu TANIGAKI.jpg;17389;17837;36033;870;892;22
/net/per610a/home/mvp/mvp_db/news7-lv/2012/2012_05_27_19_00/2012_05_27_19_00.mpg;Yoshihiko Noda.jpg;20033;20349;36033;1002;1018;16
/net/per610a/home/mvp/mvp_db/news7-lv/2012/2012_05_28_19_00/2012_05_28_19_00.mpg;Yukio EDANO.jpg;21401;21729;36041;1070;1087;17
/net/per610a/home/mvp/mvp_db/news7-lv/2012/2012_05_28_19_00/2012_05_28_19_00.mpg;Yoshihiko Noda.jpg;31337;31513;36041;1567;1576;9
/net/per610a/home/mvp/mvp_db/news7-lv/2012/2012_05_30_19_00/2012_05_30_19_00.mpg;Yoshihiko Noda.jpg;257;413;38433;12;20;8
/net/per610a/home/mvp/mvp_db/news7-lv/2012/2012_05_30_19_00/2012_05_30_19_00.mpg;Yoshihiko Noda.jpg;1585;3001;38433;79;150;71
/net/per610a/home/mvp/mvp_db/news7-lv/2012/2012_05_30_19_00/2012_05_30_19_00.mpg;Yoshihiko Noda.jpg;3749;5125;38433;187;256;69
/net/per610a/home/mvp/mvp_db/news7-lv/2012/2012_05_30_19_00/2012_05_30_19_00.mpg;Ichiro OZAWA.jpg;801;1381;38433;40;69;29
/net/per610a/home/mvp/mvp_db/news7-lv/2012/2012_05_30_19_00/2012_05_30_19_00.mpg;Ichiro OZAWA.jpg;1589;1921;38433;79;96;17
/net/per610a/home/mvp/mvp_db/news7-lv/2012/2012_05_30_19_00/2012_05_30_19_00.mpg;Ichiro OZAWA.jpg;3137;3137;38433;156;156;0
/net/per610a/home/mvp/mvp_db/news7-lv/2012/2012_05_30_19_00/2012_05_30_19_00.mpg;Ichiro OZAWA.jpg;8285;8693;38433;414;434;20
/net/per610a/home/mvp/mvp_db/news7-lv/2012/2012_05_30_19_00/2012_05_30_19_00.mpg;Ichiro OZAWA.jpg;9497;9777;38433;475;489;14
/net/per610a/home/mvp/mvp_db/news7-lv/2012/2012_05_30_19_00/2012_05_30_19_00.mpg;Seiji MAEHARA.jpg;5637;6601;38433;282;330;48
/net/per610a/home/mvp/mvp_db/news7-lv/2012/2012_05_30_19_00/2012_05_30_19_00.mpg;Yukiko Kada.jpg;13837;14565;38433;692;728;36
/net/per610a/home/mvp/mvp_db/news7-lv/2012/2012_05_31_19_00/2012_05_31_19_00.mpg;Ichiro OZAWA.jpg;16189;16497;36041;809;825;16
/net/per610a/home/mvp/mvp_db/news7-lv/2012/2012_05_31_19_00/2012_05_31_19_00.mpg;Ichiro OZAWA.jpg;16825;17425;36041;841;871;30
/net/per610a/home/mvp/mvp_db/news7-lv/2012/2012_05_31_19_00/2012_05_31_19_00.mpg;Yukiko Kada.jpg;21061;21145;36041;1053;1057;4
/net/per610a/home/mvp/mvp_db/news7-lv/2012/2012_06_01_19_00/2012_06_01_19_00.mpg;Yoshihiko Noda.jpg;10277;10325;36033;514;516;2
/net/per610a/home/mvp/mvp_db/news7-lv/2012/2012_06_01_19_00/2012_06_01_19_00.mpg;Yoshihiko Noda.jpg;11545;11593;36033;577;580;3
/net/per610a/home/mvp/mvp_db/news7-lv/2012/2012_06_01_19_00/2012_06_01_19_00.mpg;Yoshihiko Noda.jpg;12277;12373;36033;614;619;5
/net/per610a/home/mvp/mvp_db/news7-lv/2012/2012_06_01_19_00/2012_06_01_19_00.mpg;Yoshihiko Noda.jpg;12633;12661;36033;632;633;1
/net/per610a/home/mvp/mvp_db/news7-lv/2012/2012_06_01_19_00/2012_06_01_19_00.mpg;Sadakazu TANIGAKI.jpg;10973;11513;36033;549;576;27
/net/per610a/home/mvp/mvp_db/news7-lv/2012/2012_06_02_19_00/2012_06_02_19_00.mpg;Katsuya OKADA.jpg;761;761;36033;38;38;0
/net/per610a/home/mvp/mvp_db/news7-lv/2012/2012_06_02_19_00/2012_06_02_19_00.mpg;Katsuya OKADA.jpg;1181;2181;36033;59;109;50
/net/per610a/home/mvp/mvp_db/news7-lv/2012/2012_06_02_19_00/2012_06_02_19_00.mpg;Ichiro OZAWA.jpg;2293;3005;36033;114;150;36
/net/per610a/home/mvp/mvp_db/news7-lv/2012/2012_06_03_19_00/2012_06_03_19_00.mpg;Yoshihiko Noda.jpg;213;265;36033;10;13;3
/net/per610a/home/mvp/mvp_db/news7-lv/2012/2012_06_03_19_00/2012_06_03_19_00.mpg;Yoshihiko Noda.jpg;1841;1913;36033;92;95;3
/net/per610a/home/mvp/mvp_db/news7-lv/2012/2012_06_03_19_00/2012_06_03_19_00.mpg;Yoshihiko Noda.jpg;2177;2485;36033;108;124;16
/net/per610a/home/mvp/mvp_db/news7-lv/2012/2012_06_03_19_00/2012_06_03_19_00.mpg;Yoshihiko Noda.jpg;10405;10709;36033;520;535;15
/net/per610a/home/mvp/mvp_db/news7-lv/2012/2012_06_03_19_00/2012_06_03_19_00.mpg;Yoshihiko Noda.jpg;721;725;36033;36;36;0
/net/per610a/home/mvp/mvp_db/news7-lv/2012/2012_06_03_19_00/2012_06_03_19_00.mpg;Yoshihiko Noda.jpg;2965;3777;36033;148;188;40
/net/per610a/home/mvp/mvp_db/news7-lv/2012/2012_06_04_19_00/2012_06_04_19_00.mpg;Yoshihiko Noda.jpg;17;45;72001;0;2;2
/net/per610a/home/mvp/mvp_db/news7-lv/2012/2012_06_04_19_00/2012_06_04_19_00.mpg;Yoshihiko Noda.jpg;861;861;72001;43;43;0
/net/per610a/home/mvp/mvp_db/news7-lv/2012/2012_06_04_19_00/2012_06_04_19_00.mpg;Yoshihiko Noda.jpg;1681;2293;72001;84;114;30
/net/per610a/home/mvp/mvp_db/news7-lv/2012/2012_06_04_19_00/2012_06_04_19_00.mpg;Yoshihiko Noda.jpg;2677;2865;72001;133;143;10
/net/per610a/home/mvp/mvp_db/news7-lv/2012/2012_06_04_19_00/2012_06_04_19_00.mpg;Yoshihiko Noda.jpg;8113;8717;72001;405;436;31
/net/per610a/home/mvp/mvp_db/news7-lv/2012/2012_06_04_19_00/2012_06_04_19_00.mpg;Yoshihiko Noda.jpg;8877;9137;72001;444;457;13
/net/per610a/home/mvp/mvp_db/news7-lv/2012/2012_06_04_19_00/2012_06_04_19_00.mpg;Yoshihiko Noda.jpg;67201;67601;72001;3362;3382;20
/net/per610a/home/mvp/mvp_db/news7-lv/2012/2012_06_04_19_00/2012_06_04_19_00.mpg;Sadakazu TANIGAKI.jpg;21109;23805;72001;1056;1191;135
/net/per610a/home/mvp/mvp_db/news7-lv/2012/2012_06_05_19_00/2012_06_05_19_00.mpg;Yoshihiko Noda.jpg;10001;10029;36033;500;501;1
/net/per610a/home/mvp/mvp_db/news7-lv/2012/2012_06_05_19_00/2012_06_05_19_00.mpg;Yoshihiko Noda.jpg;12289;12665;36033;614;633;19
/net/per610a/home/mvp/mvp_db/news7-lv/2012/2012_06_07_19_00/2012_06_07_19_00.mpg;Sadakazu TANIGAKI.jpg;10561;10825;36045;528;541;13
/net/per610a/home/mvp/mvp_db/news7-lv/2012/2012_06_07_19_00/2012_06_07_19_00.mpg;Sadakazu TANIGAKI.jpg;11361;11945;36045;568;597;29
/net/per610a/home/mvp/mvp_db/news7-lv/2012/2012_06_07_19_00/2012_06_07_19_00.mpg;Sadakazu TANIGAKI.jpg;10977;11117;36045;549;556;7
/net/per610a/home/mvp/mvp_db/news7-lv/2012/2012_06_07_19_00/2012_06_07_19_00.mpg;Seiji MAEHARA.jpg;15589;15989;36045;780;800;20
/net/per610a/home/mvp/mvp_db/news7-lv/2012/2012_06_07_19_00/2012_06_07_19_00.mpg;Ichiro OZAWA.jpg;16105;16561;36045;806;828;22
/net/per610a/home/mvp/mvp_db/news7-lv/2012/2012_06_08_19_00/2012_06_08_19_00.mpg;Yoshihiko Noda.jpg;89;377;36033;4;18;14
/net/per610a/home/mvp/mvp_db/news7-lv/2012/2012_06_08_19_00/2012_06_08_19_00.mpg;Yoshihiko Noda.jpg;905;5369;36033;45;268;223
/net/per610a/home/mvp/mvp_db/news7-lv/2012/2012_06_08_19_00/2012_06_08_19_00.mpg;Yoshihiko Noda.jpg;21833;21969;36033;1092;1099;7
/net/per610a/home/mvp/mvp_db/news7-lv/2012/2012_06_09_19_00/2012_06_09_19_00.mpg;Seiji MAEHARA.jpg;26061;26645;36033;1304;1333;29
/net/per610a/home/mvp/mvp_db/news7-lv/2012/2012_06_09_19_00/2012_06_09_19_00.mpg;Seiji MAEHARA.jpg;27669;28377;36033;1384;1419;35
/net/per610a/home/mvp/mvp_db/news7-lv/2012/2012_06_10_19_00/2012_06_10_19_00.mpg;Yoshihiko Noda.jpg;4089;4309;36033;204;215;11
/net/per610a/home/mvp/mvp_db/news7-lv/2012/2012_06_10_19_00/2012_06_10_19_00.mpg;Yoshihiko Noda.jpg;4561;4609;36033;228;230;2
/net/per610a/home/mvp/mvp_db/news7-lv/2012/2012_06_10_19_00/2012_06_10_19_00.mpg;Yoshihiko Noda.jpg;4757;5277;36033;238;264;26
/net/per610a/home/mvp/mvp_db/news7-lv/2012/2012_06_10_19_00/2012_06_10_19_00.mpg;Yoshihiko Noda.jpg;15185;15393;36033;759;770;11
/net/per610a/home/mvp/mvp_db/news7-lv/2012/2012_06_10_19_00/2012_06_10_19_00.mpg;Yoshihiko Noda.jpg;15465;16953;36033;773;848;75
/net/per610a/home/mvp/mvp_db/news7-lv/2012/2012_06_11_19_00/2012_06_11_19_00.mpg;Yoshihiko Noda.jpg;105;277;36041;5;13;8
/net/per610a/home/mvp/mvp_db/news7-lv/2012/2012_06_11_19_00/2012_06_11_19_00.mpg;Yoshihiko Noda.jpg;377;413;36041;18;20;2
/net/per610a/home/mvp/mvp_db/news7-lv/2012/2012_06_11_19_00/2012_06_11_19_00.mpg;Yoshihiko Noda.jpg;889;1385;36041;44;69;25
/net/per610a/home/mvp/mvp_db/news7-lv/2012/2012_06_11_19_00/2012_06_11_19_00.mpg;Yoshihiko Noda.jpg;1485;2065;36041;74;103;29
/net/per610a/home/mvp/mvp_db/news7-lv/2012/2012_06_11_19_00/2012_06_11_19_00.mpg;Yoshihiko Noda.jpg;5493;5545;36041;274;277;3
/net/per610a/home/mvp/mvp_db/news7-lv/2012/2012_06_11_19_00/2012_06_11_19_00.mpg;Yoshihiko Noda.jpg;20265;20609;36041;1013;1030;17
/net/per610a/home/mvp/mvp_db/news7-lv/2012/2012_06_11_19_00/2012_06_11_19_00.mpg;Yoshihiko Noda.jpg;21297;21297;36041;1065;1065;0
/net/per610a/home/mvp/mvp_db/news7-lv/2012/2012_06_11_19_00/2012_06_11_19_00.mpg;Yoshihiko Noda.jpg;21753;22189;36041;1088;1110;22
/net/per610a/home/mvp/mvp_db/news7-lv/2012/2012_06_11_19_00/2012_06_11_19_00.mpg;Ichiro OZAWA.jpg;22197;22725;36041;1110;1136;26
/net/per610a/home/mvp/mvp_db/news7-lv/2012/2012_06_12_19_00/2012_06_12_19_00.mpg;Yoshihiko Noda.jpg;817;1613;36033;40;80;40
/net/per610a/home/mvp/mvp_db/news7-lv/2012/2012_06_12_19_00/2012_06_12_19_00.mpg;Yoshihiko Noda.jpg;1677;1721;36033;83;86;3
/net/per610a/home/mvp/mvp_db/news7-lv/2012/2012_06_12_19_00/2012_06_12_19_00.mpg;Yoshihiko Noda.jpg;22997;23657;36033;1150;1183;33
/net/per610a/home/mvp/mvp_db/news7-lv/2012/2012_06_12_19_00/2012_06_12_19_00.mpg;Yoshihiko Noda.jpg;23785;23901;36033;1190;1195;5
/net/per610a/home/mvp/mvp_db/news7-lv/2012/2012_06_12_19_00/2012_06_12_19_00.mpg;Yoshihiko Noda.jpg;24029;24033;36033;1202;1202;0
/net/per610a/home/mvp/mvp_db/news7-lv/2012/2012_06_12_19_00/2012_06_12_19_00.mpg;Sadakazu TANIGAKI.jpg;2277;2473;36033;113;123;10
/net/per610a/home/mvp/mvp_db/news7-lv/2012/2012_06_12_19_00/2012_06_12_19_00.mpg;Natsuo YAMAGUCHI.jpg;2537;2893;36033;126;144;18
/net/per610a/home/mvp/mvp_db/news7-lv/2012/2012_06_12_19_00/2012_06_12_19_00.mpg;Yukio HATOYAMA.jpg;4873;5417;36033;243;271;28
/net/per610a/home/mvp/mvp_db/news7-lv/2012/2012_06_13_19_00/2012_06_13_19_00.mpg;Yoshihiko Noda.jpg;17;93;36033;0;4;4
/net/per610a/home/mvp/mvp_db/news7-lv/2012/2012_06_13_19_00/2012_06_13_19_00.mpg;Yoshihiko Noda.jpg;793;805;36033;39;40;1
/net/per610a/home/mvp/mvp_db/news7-lv/2012/2012_06_13_19_00/2012_06_13_19_00.mpg;Yoshihiko Noda.jpg;1561;1769;36033;78;88;10
/net/per610a/home/mvp/mvp_db/news7-lv/2012/2012_06_13_19_00/2012_06_13_19_00.mpg;Yoshihiko Noda.jpg;1877;1909;36033;93;95;2
/net/per610a/home/mvp/mvp_db/news7-lv/2012/2012_06_13_19_00/2012_06_13_19_00.mpg;Yoshihiko Noda.jpg;2009;2257;36033;100;112;12
/net/per610a/home/mvp/mvp_db/news7-lv/2012/2012_06_13_19_00/2012_06_13_19_00.mpg;Yoshihiko Noda.jpg;4677;5637;36033;234;282;48
/net/per610a/home/mvp/mvp_db/news7-lv/2012/2012_06_13_19_00/2012_06_13_19_00.mpg;Seiji MAEHARA.jpg;4677;5637;36033;234;282;48
/net/per610a/home/mvp/mvp_db/news7-lv/2012/2012_06_13_19_00/2012_06_13_19_00.mpg;Sadakazu TANIGAKI.jpg;5657;6149;36033;283;307;24
/net/per610a/home/mvp/mvp_db/news7-lv/2012/2012_06_14_19_00/2012_06_14_19_00.mpg;Sadakazu TANIGAKI.jpg;1189;1365;36033;59;68;9
/net/per610a/home/mvp/mvp_db/news7-lv/2012/2012_06_14_19_00/2012_06_14_19_00.mpg;Sadakazu TANIGAKI.jpg;1433;1621;36033;71;81;10
/net/per610a/home/mvp/mvp_db/news7-lv/2012/2012_06_14_19_00/2012_06_14_19_00.mpg;Natsuo YAMAGUCHI.jpg;1729;1877;36033;86;93;7
/net/per610a/home/mvp/mvp_db/news7-lv/2012/2012_06_14_19_00/2012_06_14_19_00.mpg;Ichiro OZAWA.jpg;1969;2433;36033;98;121;23
/net/per610a/home/mvp/mvp_db/news7-lv/2012/2012_06_14_19_00/2012_06_14_19_00.mpg;Ichiro OZAWA.jpg;8677;8917;36033;434;446;12
/net/per610a/home/mvp/mvp_db/news7-lv/2012/2012_06_15_19_00/2012_06_15_19_00.mpg;Sadakazu TANIGAKI.jpg;22525;22669;39629;1127;1134;7
/net/per610a/home/mvp/mvp_db/news7-lv/2012/2012_06_15_19_00/2012_06_15_19_00.mpg;Sadakazu TANIGAKI.jpg;22749;22837;39629;1138;1142;4
/net/per610a/home/mvp/mvp_db/news7-lv/2012/2012_06_16_19_00/2012_06_16_19_00.mpg;Toru Hashimoto.jpg;11585;11917;36033;579;596;17
/net/per610a/home/mvp/mvp_db/news7-lv/2012/2012_06_16_19_00/2012_06_16_19_00.mpg;Sadakazu TANIGAKI.jpg;20017;20765;36033;1001;1039;38
/net/per610a/home/mvp/mvp_db/news7-lv/2012/2012_06_16_19_00/2012_06_16_19_00.mpg;Katsuya OKADA.jpg;20769;23645;36033;1039;1183;144
/net/per610a/home/mvp/mvp_db/news7-lv/2012/2012_06_17_19_00/2012_06_17_19_00.mpg;Yoshihiko Noda.jpg;14965;15637;36033;748;782;34
/net/per610a/home/mvp/mvp_db/news7-lv/2012/2012_06_17_19_00/2012_06_17_19_00.mpg;Yoshihiko Noda.jpg;16381;18381;36033;819;919;100
/net/per610a/home/mvp/mvp_db/news7-lv/2012/2012_06_17_19_00/2012_06_17_19_00.mpg;Yukio HATOYAMA.jpg;15793;16377;36033;790;819;29
/net/per610a/home/mvp/mvp_db/news7-lv/2012/2012_06_18_19_00/2012_06_18_19_00.mpg;Sadakazu TANIGAKI.jpg;14681;14757;36033;734;738;4
/net/per610a/home/mvp/mvp_db/news7-lv/2012/2012_06_18_19_00/2012_06_18_19_00.mpg;Natsuo YAMAGUCHI.jpg;14909;14921;36033;746;746;0
/net/per610a/home/mvp/mvp_db/news7-lv/2012/2012_06_18_19_00/2012_06_18_19_00.mpg;Natsuo YAMAGUCHI.jpg;15053;15469;36033;753;774;21
/net/per610a/home/mvp/mvp_db/news7-lv/2012/2012_06_18_19_00/2012_06_18_19_00.mpg;Yoshihiko Noda.jpg;15833;16381;36033;792;819;27
/net/per610a/home/mvp/mvp_db/news7-lv/2012/2012_06_18_19_00/2012_06_18_19_00.mpg;Yukio HATOYAMA.jpg;16529;17009;36033;827;851;24
/net/per610a/home/mvp/mvp_db/news7-lv/2012/2012_06_18_19_00/2012_06_18_19_00.mpg;Seiji MAEHARA.jpg;17789;18077;36033;890;904;14
/net/per610a/home/mvp/mvp_db/news7-lv/2012/2012_06_18_19_00/2012_06_18_19_00.mpg;Seiji MAEHARA.jpg;18485;18581;36033;924;929;5
/net/per610a/home/mvp/mvp_db/news7-lv/2012/2012_06_18_19_00/2012_06_18_19_00.mpg;Seiji MAEHARA.jpg;20149;20261;36033;1008;1013;5
/net/per610a/home/mvp/mvp_db/news7-lv/2012/2012_06_18_19_00/2012_06_18_19_00.mpg;Ichiro OZAWA.jpg;19077;19245;36033;954;962;8
/net/per610a/home/mvp/mvp_db/news7-lv/2012/2012_06_19_19_00/2012_06_19_19_00.mpg;Seiji MAEHARA.jpg;39173;39641;73317;1960;1983;23
/net/per610a/home/mvp/mvp_db/news7-lv/2012/2012_06_19_19_00/2012_06_19_19_00.mpg;Seiji MAEHARA.jpg;43077;43201;73317;2155;2161;6
/net/per610a/home/mvp/mvp_db/news7-lv/2012/2012_06_19_19_00/2012_06_19_19_00.mpg;Seiji MAEHARA.jpg;39717;39785;73317;1987;1990;3
/net/per610a/home/mvp/mvp_db/news7-lv/2012/2012_06_19_19_00/2012_06_19_19_00.mpg;Yoshihiko Noda.jpg;40529;40713;73317;2028;2037;9
/net/per610a/home/mvp/mvp_db/news7-lv/2012/2012_06_19_19_00/2012_06_19_19_00.mpg;Yukio HATOYAMA.jpg;41201;41249;73317;2061;2064;3
/net/per610a/home/mvp/mvp_db/news7-lv/2012/2012_06_19_19_00/2012_06_19_19_00.mpg;Yukio HATOYAMA.jpg;41437;41533;73317;2073;2078;5
/net/per610a/home/mvp/mvp_db/news7-lv/2012/2012_06_20_19_00/2012_06_20_19_00.mpg;Yukio HATOYAMA.jpg;3773;3925;36033;188;196;8
/net/per610a/home/mvp/mvp_db/news7-lv/2012/2012_06_21_19_00/2012_06_21_19_00.mpg;Ichiro OZAWA.jpg;689;1321;36033;34;66;32
/net/per610a/home/mvp/mvp_db/news7-lv/2012/2012_06_21_19_00/2012_06_21_19_00.mpg;Ichiro OZAWA.jpg;1749;2393;36033;87;119;32
/net/per610a/home/mvp/mvp_db/news7-lv/2012/2012_06_21_19_00/2012_06_21_19_00.mpg;Ichiro OZAWA.jpg;2457;3469;36033;122;173;51
/net/per610a/home/mvp/mvp_db/news7-lv/2012/2012_06_21_19_00/2012_06_21_19_00.mpg;Ichiro OZAWA.jpg;5297;5389;36033;265;269;4
/net/per610a/home/mvp/mvp_db/news7-lv/2012/2012_06_21_19_00/2012_06_21_19_00.mpg;Ichiro OZAWA.jpg;5865;6473;36033;293;323;30
/net/per610a/home/mvp/mvp_db/news7-lv/2012/2012_06_21_19_00/2012_06_21_19_00.mpg;Ichiro OZAWA.jpg;12401;13125;36033;620;656;36
/net/per610a/home/mvp/mvp_db/news7-lv/2012/2012_06_21_19_00/2012_06_21_19_00.mpg;Yoshihiko Noda.jpg;13521;13565;36033;676;678;2
/net/per610a/home/mvp/mvp_db/news7-lv/2012/2012_06_21_19_00/2012_06_21_19_00.mpg;Yoshihiko Noda.jpg;13953;14265;36033;698;713;15
/net/per610a/home/mvp/mvp_db/news7-lv/2012/2012_06_22_19_00/2012_06_22_19_00.mpg;Yoshihiko Noda.jpg;245;297;36033;12;14;2
/net/per610a/home/mvp/mvp_db/news7-lv/2012/2012_06_22_19_00/2012_06_22_19_00.mpg;Yoshihiko Noda.jpg;1237;1329;36033;61;66;5
/net/per610a/home/mvp/mvp_db/news7-lv/2012/2012_06_22_19_00/2012_06_22_19_00.mpg;Yoshihiko Noda.jpg;1469;1769;36033;73;88;15
/net/per610a/home/mvp/mvp_db/news7-lv/2012/2012_06_22_19_00/2012_06_22_19_00.mpg;Yoshihiko Noda.jpg;6129;6217;36033;306;311;5
/net/per610a/home/mvp/mvp_db/news7-lv/2012/2012_06_22_19_00/2012_06_22_19_00.mpg;Yoshihiko Noda.jpg;7033;7245;36033;351;362;11
/net/per610a/home/mvp/mvp_db/news7-lv/2012/2012_06_22_19_00/2012_06_22_19_00.mpg;Yukio HATOYAMA.jpg;3389;3517;36033;169;175;6
/net/per610a/home/mvp/mvp_db/news7-lv/2012/2012_06_23_19_00/2012_06_23_19_00.mpg;Ichiro OZAWA.jpg;837;1613;36037;41;80;39
/net/per610a/home/mvp/mvp_db/news7-lv/2012/2012_06_23_19_00/2012_06_23_19_00.mpg;Sadakazu TANIGAKI.jpg;3701;4217;36037;185;210;25
/net/per610a/home/mvp/mvp_db/news7-lv/2012/2012_06_23_19_00/2012_06_23_19_00.mpg;Toru Hashimoto.jpg;4953;5057;36037;247;253;6
/net/per610a/home/mvp/mvp_db/news7-lv/2012/2012_06_23_19_00/2012_06_23_19_00.mpg;Toru Hashimoto.jpg;5205;5717;36037;260;286;26
/net/per610a/home/mvp/mvp_db/news7-lv/2012/2012_06_23_19_00/2012_06_23_19_00.mpg;Shintaro ISHIHARA.jpg;5825;5929;36037;291;296;5
/net/per610a/home/mvp/mvp_db/news7-lv/2012/2012_06_24_19_00/2012_06_24_19_00.mpg;Katsuya OKADA.jpg;817;2261;36033;40;113;73
/net/per610a/home/mvp/mvp_db/news7-lv/2012/2012_06_25_19_00/2012_06_25_19_00.mpg;Yoshihiko Noda.jpg;173;421;36037;8;21;13
/net/per610a/home/mvp/mvp_db/news7-lv/2012/2012_06_25_19_00/2012_06_25_19_00.mpg;Yoshihiko Noda.jpg;1049;1449;36037;52;72;20
/net/per610a/home/mvp/mvp_db/news7-lv/2012/2012_06_25_19_00/2012_06_25_19_00.mpg;Yoshihiko Noda.jpg;2141;3009;36037;107;150;43
/net/per610a/home/mvp/mvp_db/news7-lv/2012/2012_06_25_19_00/2012_06_25_19_00.mpg;Yoshihiko Noda.jpg;3089;3705;36037;154;185;31
/net/per610a/home/mvp/mvp_db/news7-lv/2012/2012_06_25_19_00/2012_06_25_19_00.mpg;Yoshihiko Noda.jpg;3997;4181;36037;199;209;10
/net/per610a/home/mvp/mvp_db/news7-lv/2012/2012_06_25_19_00/2012_06_25_19_00.mpg;Yoshihiko Noda.jpg;4361;4421;36037;218;221;3
/net/per610a/home/mvp/mvp_db/news7-lv/2012/2012_06_25_19_00/2012_06_25_19_00.mpg;Yoshihiko Noda.jpg;7513;7605;36037;375;380;5
/net/per610a/home/mvp/mvp_db/news7-lv/2012/2012_06_25_19_00/2012_06_25_19_00.mpg;Yoshihiko Noda.jpg;7841;7961;36037;392;398;6
/net/per610a/home/mvp/mvp_db/news7-lv/2012/2012_06_25_19_00/2012_06_25_19_00.mpg;Yoshihiko Noda.jpg;8877;9017;36037;444;451;7
/net/per610a/home/mvp/mvp_db/news7-lv/2012/2012_06_25_19_00/2012_06_25_19_00.mpg;Yoshihiko Noda.jpg;5133;5177;36037;256;259;3
/net/per610a/home/mvp/mvp_db/news7-lv/2012/2012_06_25_19_00/2012_06_25_19_00.mpg;Yoshihiko Noda.jpg;5625;6013;36037;281;300;19
/net/per610a/home/mvp/mvp_db/news7-lv/2012/2012_06_25_19_00/2012_06_25_19_00.mpg;Yoshihiko Noda.jpg;8653;8757;36037;432;438;6
/net/per610a/home/mvp/mvp_db/news7-lv/2012/2012_06_25_19_00/2012_06_25_19_00.mpg;Yukio HATOYAMA.jpg;6153;6473;36037;307;323;16
/net/per610a/home/mvp/mvp_db/news7-lv/2012/2012_06_25_19_00/2012_06_25_19_00.mpg;Sadakazu TANIGAKI.jpg;6577;6973;36037;329;348;19
/net/per610a/home/mvp/mvp_db/news7-lv/2012/2012_06_26_19_00/2012_06_26_19_00.mpg;Yukio HATOYAMA.jpg;5569;5905;39629;278;295;17
/net/per610a/home/mvp/mvp_db/news7-lv/2012/2012_06_26_19_00/2012_06_26_19_00.mpg;Yoshihiko Noda.jpg;7285;7349;39629;364;367;3
/net/per610a/home/mvp/mvp_db/news7-lv/2012/2012_06_26_19_00/2012_06_26_19_00.mpg;Yoshihiko Noda.jpg;14517;14545;39629;726;727;1
/net/per610a/home/mvp/mvp_db/news7-lv/2012/2012_06_26_19_00/2012_06_26_19_00.mpg;Yoshihiko Noda.jpg;29885;29929;39629;1495;1497;2
/net/per610a/home/mvp/mvp_db/news7-lv/2012/2012_06_26_19_00/2012_06_26_19_00.mpg;Seiji MAEHARA.jpg;14941;15153;39629;747;758;11
/net/per610a/home/mvp/mvp_db/news7-lv/2012/2012_06_27_19_00/2012_06_27_19_00.mpg;Yoshihiko Noda.jpg;437;477;36033;21;23;2
/net/per610a/home/mvp/mvp_db/news7-lv/2012/2012_06_27_19_00/2012_06_27_19_00.mpg;Yoshihiko Noda.jpg;13117;13505;36033;656;675;19
/net/per610a/home/mvp/mvp_db/news7-lv/2012/2012_06_27_19_00/2012_06_27_19_00.mpg;Yoshihiko Noda.jpg;13965;14777;36033;698;739;41
/net/per610a/home/mvp/mvp_db/news7-lv/2012/2012_06_27_19_00/2012_06_27_19_00.mpg;Ichiro OZAWA.jpg;12441;13017;36033;622;651;29
/net/per610a/home/mvp/mvp_db/news7-lv/2012/2012_06_27_19_00/2012_06_27_19_00.mpg;Ichiro OZAWA.jpg;17833;18161;36033;892;908;16
/net/per610a/home/mvp/mvp_db/news7-lv/2012/2012_06_28_19_00/2012_06_28_19_00.mpg;Ichiro OZAWA.jpg;237;269;36033;11;13;2
/net/per610a/home/mvp/mvp_db/news7-lv/2012/2012_06_28_19_00/2012_06_28_19_00.mpg;Ichiro OZAWA.jpg;3669;4545;36033;183;227;44
/net/per610a/home/mvp/mvp_db/news7-lv/2012/2012_06_28_19_00/2012_06_28_19_00.mpg;Sadakazu TANIGAKI.jpg;3053;3625;36033;152;181;29
/net/per610a/home/mvp/mvp_db/news7-lv/2012/2012_06_29_19_00/2012_06_29_19_00.mpg;Ichiro OZAWA.jpg;4617;4649;36033;231;232;1
/net/per610a/home/mvp/mvp_db/news7-lv/2012/2012_06_29_19_00/2012_06_29_19_00.mpg;Ichiro OZAWA.jpg;5325;6657;36033;266;333;67
/net/per610a/home/mvp/mvp_db/news7-lv/2012/2012_06_30_19_00/2012_06_30_19_00.mpg;Ichiro OZAWA.jpg;1045;2669;36033;52;133;81
/net/per610a/home/mvp/mvp_db/news7-lv/2012/2012_06_30_19_00/2012_06_30_19_00.mpg;Yoshihiko Noda.jpg;5361;6709;36033;268;335;67
/net/per610a/home/mvp/mvp_db/news7-lv/2012/2012_07_01_19_00/2012_07_01_19_00.mpg;Yukio EDANO.jpg;22773;22809;36033;1139;1141;2
/net/per610a/home/mvp/mvp_db/news7-lv/2012/2012_07_01_19_00/2012_07_01_19_00.mpg;Yukio EDANO.jpg;23245;23397;36033;1163;1170;7
/net/per610a/home/mvp/mvp_db/news7-lv/2012/2012_07_02_19_00/2012_07_02_19_00.mpg;Yoshihiko Noda.jpg;601;1321;38429;30;66;36
/net/per610a/home/mvp/mvp_db/news7-lv/2012/2012_07_02_19_00/2012_07_02_19_00.mpg;Yoshihiko Noda.jpg;5385;5425;38429;269;271;2
/net/per610a/home/mvp/mvp_db/news7-lv/2012/2012_07_02_19_00/2012_07_02_19_00.mpg;Yoshihiko Noda.jpg;5613;5897;38429;280;295;15
/net/per610a/home/mvp/mvp_db/news7-lv/2012/2012_07_02_19_00/2012_07_02_19_00.mpg;Yoshihiko Noda.jpg;10481;11937;38429;524;597;73
/net/per610a/home/mvp/mvp_db/news7-lv/2012/2012_07_02_19_00/2012_07_02_19_00.mpg;Yoshihiko Noda.jpg;18621;19149;38429;931;958;27
/net/per610a/home/mvp/mvp_db/news7-lv/2012/2012_07_02_19_00/2012_07_02_19_00.mpg;Yoshihiko Noda.jpg;19253;19389;38429;963;970;7
/net/per610a/home/mvp/mvp_db/news7-lv/2012/2012_07_03_19_00/2012_07_03_19_00.mpg;Ichiro OZAWA.jpg;6697;7325;36033;335;366;31
/net/per610a/home/mvp/mvp_db/news7-lv/2012/2012_07_03_19_00/2012_07_03_19_00.mpg;Ichiro OZAWA.jpg;8661;8921;36033;433;446;13
/net/per610a/home/mvp/mvp_db/news7-lv/2012/2012_07_03_19_00/2012_07_03_19_00.mpg;Yoshihiko Noda.jpg;7609;7769;36033;380;388;8
/net/per610a/home/mvp/mvp_db/news7-lv/2012/2012_07_03_19_00/2012_07_03_19_00.mpg;Yoshihiko Noda.jpg;13565;14185;36033;678;709;31
/net/per610a/home/mvp/mvp_db/news7-lv/2012/2012_07_03_19_00/2012_07_03_19_00.mpg;Seiji MAEHARA.jpg;11521;11649;36033;576;582;6
/net/per610a/home/mvp/mvp_db/news7-lv/2012/2012_07_04_19_00/2012_07_04_19_00.mpg;Ichiro OZAWA.jpg;19013;19477;36041;951;974;23
/net/per610a/home/mvp/mvp_db/news7-lv/2012/2012_07_04_19_00/2012_07_04_19_00.mpg;Ichiro OZAWA.jpg;21013;21125;36041;1051;1056;5
/net/per610a/home/mvp/mvp_db/news7-lv/2012/2012_07_04_19_00/2012_07_04_19_00.mpg;Yukio HATOYAMA.jpg;22585;22717;36041;1129;1136;7
/net/per610a/home/mvp/mvp_db/news7-lv/2012/2012_07_04_19_00/2012_07_04_19_00.mpg;Yukio HATOYAMA.jpg;22921;23157;36041;1146;1158;12
/net/per610a/home/mvp/mvp_db/news7-lv/2012/2012_07_04_19_00/2012_07_04_19_00.mpg;Yukio HATOYAMA.jpg;24213;24265;36041;1211;1213;2
/net/per610a/home/mvp/mvp_db/news7-lv/2012/2012_07_05_19_00/2012_07_05_19_00.mpg;Naoto KAN.jpg;6645;7193;36037;332;359;27
/net/per610a/home/mvp/mvp_db/news7-lv/2012/2012_07_05_19_00/2012_07_05_19_00.mpg;Ichiro OZAWA.jpg;20917;21481;36037;1046;1074;28
/net/per610a/home/mvp/mvp_db/news7-lv/2012/2012_07_05_19_00/2012_07_05_19_00.mpg;Ichiro OZAWA.jpg;21685;22273;36037;1084;1114;30
/net/per610a/home/mvp/mvp_db/news7-lv/2012/2012_07_05_19_00/2012_07_05_19_00.mpg;Yukio HATOYAMA.jpg;23005;23137;36037;1150;1157;7
/net/per610a/home/mvp/mvp_db/news7-lv/2012/2012_07_05_19_00/2012_07_05_19_00.mpg;Yukio HATOYAMA.jpg;23221;23265;36037;1161;1163;2
/net/per610a/home/mvp/mvp_db/news7-lv/2012/2012_07_05_19_00/2012_07_05_19_00.mpg;Yukio HATOYAMA.jpg;23405;23441;36037;1170;1172;2
/net/per610a/home/mvp/mvp_db/news7-lv/2012/2012_07_06_19_00/2012_07_06_19_00.mpg;Yoshihiko Noda.jpg;8977;9497;36041;449;475;26
/net/per610a/home/mvp/mvp_db/news7-lv/2012/2012_07_06_19_00/2012_07_06_19_00.mpg;Ichiro OZAWA.jpg;8977;9497;36041;449;475;26
/net/per610a/home/mvp/mvp_db/news7-lv/2012/2012_07_06_19_00/2012_07_06_19_00.mpg;Toru Hashimoto.jpg;14037;14269;36041;702;713;11
/net/per610a/home/mvp/mvp_db/news7-lv/2012/2012_07_06_19_00/2012_07_06_19_00.mpg;Toru Hashimoto.jpg;16553;17029;36041;828;851;23
/net/per610a/home/mvp/mvp_db/news7-lv/2012/2012_07_07_19_00/2012_07_07_19_00.mpg;Shintaro ISHIHARA.jpg;517;737;36033;25;36;11
/net/per610a/home/mvp/mvp_db/news7-lv/2012/2012_07_07_19_00/2012_07_07_19_00.mpg;Shintaro ISHIHARA.jpg;4265;4949;36033;213;247;34
/net/per610a/home/mvp/mvp_db/news7-lv/2012/2012_07_07_19_00/2012_07_07_19_00.mpg;Sadakazu TANIGAKI.jpg;12685;13201;36033;634;660;26
/net/per610a/home/mvp/mvp_db/news7-lv/2012/2012_07_07_19_00/2012_07_07_19_00.mpg;Sadakazu TANIGAKI.jpg;14689;16257;36033;735;813;78
/net/per610a/home/mvp/mvp_db/news7-lv/2012/2012_07_08_19_00/2012_07_08_19_00.mpg;Yoshihiko Noda.jpg;6221;6289;36033;311;314;3
/net/per610a/home/mvp/mvp_db/news7-lv/2012/2012_07_08_19_00/2012_07_08_19_00.mpg;Yoshihiko Noda.jpg;7737;7753;36033;387;387;0
/net/per610a/home/mvp/mvp_db/news7-lv/2012/2012_07_08_19_00/2012_07_08_19_00.mpg;Yoshihiko Noda.jpg;8069;8117;36033;403;406;3
/net/per610a/home/mvp/mvp_db/news7-lv/2012/2012_07_09_19_00/2012_07_09_19_00.mpg;Ichiro OZAWA.jpg;925;1585;36041;46;79;33
/net/per610a/home/mvp/mvp_db/news7-lv/2012/2012_07_09_19_00/2012_07_09_19_00.mpg;Ichiro OZAWA.jpg;6809;7657;36041;340;383;43
/net/per610a/home/mvp/mvp_db/news7-lv/2012/2012_07_09_19_00/2012_07_09_19_00.mpg;Ichiro OZAWA.jpg;11345;11365;36041;567;568;1
/net/per610a/home/mvp/mvp_db/news7-lv/2012/2012_07_09_19_00/2012_07_09_19_00.mpg;Ichiro OZAWA.jpg;11433;11797;36041;571;590;19
/net/per610a/home/mvp/mvp_db/news7-lv/2012/2012_07_09_19_00/2012_07_09_19_00.mpg;Yukio HATOYAMA.jpg;6809;8053;36041;340;402;62
/net/per610a/home/mvp/mvp_db/news7-lv/2012/2012_07_09_19_00/2012_07_09_19_00.mpg;Toru Hashimoto.jpg;11801;12329;36041;590;616;26
/net/per610a/home/mvp/mvp_db/news7-lv/2012/2012_07_10_19_00/2012_07_10_19_00.mpg;Yukio HATOYAMA.jpg;1401;1713;36033;70;85;15
/net/per610a/home/mvp/mvp_db/news7-lv/2012/2012_07_10_19_00/2012_07_10_19_00.mpg;Yukio HATOYAMA.jpg;1877;2445;36033;93;122;29
/net/per610a/home/mvp/mvp_db/news7-lv/2012/2012_07_10_19_00/2012_07_10_19_00.mpg;Yoshimi WATANABE.jpg;3913;4481;36033;195;224;29
/net/per610a/home/mvp/mvp_db/news7-lv/2012/2012_07_10_19_00/2012_07_10_19_00.mpg;Yoshihiko Noda.jpg;5609;6065;36033;280;303;23
/net/per610a/home/mvp/mvp_db/news7-lv/2012/2012_07_11_19_00/2012_07_11_19_00.mpg;Ichiro OZAWA.jpg;909;1313;36037;45;65;20
/net/per610a/home/mvp/mvp_db/news7-lv/2012/2012_07_11_19_00/2012_07_11_19_00.mpg;Ichiro OZAWA.jpg;3945;4097;36037;197;204;7
/net/per610a/home/mvp/mvp_db/news7-lv/2012/2012_07_11_19_00/2012_07_11_19_00.mpg;Ichiro OZAWA.jpg;4925;6685;36037;246;334;88
/net/per610a/home/mvp/mvp_db/news7-lv/2012/2012_07_11_19_00/2012_07_11_19_00.mpg;Ichiro OZAWA.jpg;8297;8773;36037;415;438;23
/net/per610a/home/mvp/mvp_db/news7-lv/2012/2012_07_11_19_00/2012_07_11_19_00.mpg;Ichiro OZAWA.jpg;9953;10465;36037;497;523;26
/net/per610a/home/mvp/mvp_db/news7-lv/2012/2012_07_11_19_00/2012_07_11_19_00.mpg;Yoshihiko Noda.jpg;9545;9681;36037;477;484;7
/net/per610a/home/mvp/mvp_db/news7-lv/2012/2012_07_11_19_00/2012_07_11_19_00.mpg;Yukio HATOYAMA.jpg;9953;10465;36037;497;523;26
/net/per610a/home/mvp/mvp_db/news7-lv/2012/2012_07_12_19_00/2012_07_12_19_00.mpg;Ichiro OZAWA.jpg;21245;21713;38433;1062;1086;24
/net/per610a/home/mvp/mvp_db/news7-lv/2012/2012_07_12_19_00/2012_07_12_19_00.mpg;Yoshihiko Noda.jpg;21245;21713;38433;1062;1086;24
/net/per610a/home/mvp/mvp_db/news7-lv/2012/2012_07_12_19_00/2012_07_12_19_00.mpg;Yoshihiko Noda.jpg;23109;23121;38433;1156;1156;0
/net/per610a/home/mvp/mvp_db/news7-lv/2012/2012_07_12_19_00/2012_07_12_19_00.mpg;Yoshihiko Noda.jpg;24677;25013;38433;1234;1251;17
/net/per610a/home/mvp/mvp_db/news7-lv/2012/2012_07_12_19_00/2012_07_12_19_00.mpg;Yoshihiko Noda.jpg;25825;26857;38433;1292;1343;51
/net/per610a/home/mvp/mvp_db/news7-lv/2012/2012_07_14_19_00/2012_07_14_19_00.mpg;Yoshihiko Noda.jpg;31297;31349;38429;1566;1568;2
/net/per610a/home/mvp/mvp_db/news7-lv/2012/2012_07_14_19_00/2012_07_14_19_00.mpg;Yoshihiko Noda.jpg;31625;31953;38429;1582;1598;16
/net/per610a/home/mvp/mvp_db/news7-lv/2012/2012_07_16_19_00/2012_07_16_19_00.mpg;Yoshihiko Noda.jpg;18489;19129;36037;925;957;32
/net/per610a/home/mvp/mvp_db/news7-lv/2012/2012_07_18_19_00/2012_07_18_19_00.mpg;Yoshihiko Noda.jpg;8957;9345;36033;448;467;19
/net/per610a/home/mvp/mvp_db/news7-lv/2012/2012_07_18_19_00/2012_07_18_19_00.mpg;Yoshihiko Noda.jpg;13525;13669;36033;676;683;7
/net/per610a/home/mvp/mvp_db/news7-lv/2012/2012_07_18_19_00/2012_07_18_19_00.mpg;Yoshihiko Noda.jpg;14025;14957;36033;701;748;47
/net/per610a/home/mvp/mvp_db/news7-lv/2012/2012_07_19_19_00/2012_07_19_19_00.mpg;Yoshihiko Noda.jpg;24749;25217;36033;1238;1261;23
/net/per610a/home/mvp/mvp_db/news7-lv/2012/2012_07_19_19_00/2012_07_19_19_00.mpg;Yoshihiko Noda.jpg;25377;25453;36033;1269;1273;4
/net/per610a/home/mvp/mvp_db/news7-lv/2012/2012_07_19_19_00/2012_07_19_19_00.mpg;Yoshihiko Noda.jpg;25685;25977;36033;1285;1299;14
/net/per610a/home/mvp/mvp_db/news7-lv/2012/2012_07_19_19_00/2012_07_19_19_00.mpg;Yoshihiko Noda.jpg;27105;27569;36033;1356;1379;23
/net/per610a/home/mvp/mvp_db/news7-lv/2012/2012_07_19_19_00/2012_07_19_19_00.mpg;Yoshihiko Noda.jpg;27665;27745;36033;1384;1388;4
/net/per610a/home/mvp/mvp_db/news7-lv/2012/2012_07_19_19_00/2012_07_19_19_00.mpg;Yoshihiko Noda.jpg;27953;28381;36033;1398;1420;22
/net/per610a/home/mvp/mvp_db/news7-lv/2012/2012_07_19_19_00/2012_07_19_19_00.mpg;Yoshihiko Noda.jpg;28553;28665;36033;1428;1434;6
/net/per610a/home/mvp/mvp_db/news7-lv/2012/2012_07_19_19_00/2012_07_19_19_00.mpg;Yoshihiko Noda.jpg;28801;29289;36033;1441;1465;24
/net/per610a/home/mvp/mvp_db/news7-lv/2012/2012_07_22_19_00/2012_07_22_19_00.mpg;Yoshihiko Noda.jpg;28613;29293;36041;1431;1465;34
/net/per610a/home/mvp/mvp_db/news7-lv/2012/2012_07_23_19_00/2012_07_23_19_00.mpg;Yoshihiko Noda.jpg;8509;8757;36037;425;438;13
/net/per610a/home/mvp/mvp_db/news7-lv/2012/2012_07_24_19_00/2012_07_24_19_00.mpg;Yoshihiko Noda.jpg;12501;13321;36037;625;666;41
/net/per610a/home/mvp/mvp_db/news7-lv/2012/2012_07_26_19_00/2012_07_26_19_00.mpg;Yoshihiko Noda.jpg;14301;14729;36033;715;737;22
/net/per610a/home/mvp/mvp_db/news7-lv/2012/2012_07_26_19_00/2012_07_26_19_00.mpg;Yoshihiko Noda.jpg;15057;15553;36033;753;778;25
/net/per610a/home/mvp/mvp_db/news7-lv/2012/2012_07_26_19_00/2012_07_26_19_00.mpg;Yoshihiko Noda.jpg;15837;16169;36033;792;809;17
/net/per610a/home/mvp/mvp_db/news7-lv/2012/2012_07_27_19_00/2012_07_27_19_00.mpg;Natsuo YAMAGUCHI.jpg;18469;18757;36033;924;938;14
/net/per610a/home/mvp/mvp_db/news7-lv/2012/2012_07_27_19_00/2012_07_27_19_00.mpg;Sadakazu TANIGAKI.jpg;18469;19333;36033;924;967;43
/net/per610a/home/mvp/mvp_db/news7-lv/2012/2012_07_28_19_00/2012_07_28_19_00.mpg;Yukio HATOYAMA.jpg;24965;25109;36037;1249;1256;7
/net/per610a/home/mvp/mvp_db/news7-lv/2012/2012_08_02_19_00/2012_08_02_19_00.mpg;Taro ASO.jpg;28505;28605;36033;1426;1431;5
/net/per610a/home/mvp/mvp_db/news7-lv/2012/2012_08_02_19_00/2012_08_02_19_00.mpg;Ichiro OZAWA.jpg;29137;29893;36033;1457;1495;38
/net/per610a/home/mvp/mvp_db/news7-lv/2012/2012_08_02_19_00/2012_08_02_19_00.mpg;Kenji Eda.jpg;30037;30205;36033;1502;1511;9
/net/per610a/home/mvp/mvp_db/news7-lv/2012/2012_08_02_19_00/2012_08_02_19_00.mpg;Kazuo SHII.jpg;30669;31129;36033;1534;1557;23
/net/per610a/home/mvp/mvp_db/news7-lv/2012/2012_08_03_19_00/2012_08_03_19_00.mpg;Kazuo SHII.jpg;1741;1837;36041;87;91;4
/net/per610a/home/mvp/mvp_db/news7-lv/2012/2012_08_03_19_00/2012_08_03_19_00.mpg;Yoshihiko Noda.jpg;2925;3553;36041;146;177;31
/net/per610a/home/mvp/mvp_db/news7-lv/2012/2012_08_03_19_00/2012_08_03_19_00.mpg;Yoshihiko Noda.jpg;4961;5645;36041;248;282;34
/net/per610a/home/mvp/mvp_db/news7-lv/2012/2012_08_03_19_00/2012_08_03_19_00.mpg;Yoshihiko Noda.jpg;8405;8673;36041;420;433;13
/net/per610a/home/mvp/mvp_db/news7-lv/2012/2012_08_03_19_00/2012_08_03_19_00.mpg;Yoshimi WATANABE.jpg;6249;6369;36041;312;318;6
/net/per610a/home/mvp/mvp_db/news7-lv/2012/2012_08_03_19_00/2012_08_03_19_00.mpg;Yoshimi WATANABE.jpg;6469;6817;36041;323;341;18
/net/per610a/home/mvp/mvp_db/news7-lv/2012/2012_08_05_19_00/2012_08_05_19_00.mpg;Yoshihiko Noda.jpg;24313;25045;36033;1216;1253;37
/net/per610a/home/mvp/mvp_db/news7-lv/2012/2012_08_05_19_00/2012_08_05_19_00.mpg;Yoshihiko Noda.jpg;25237;25825;36033;1262;1292;30
/net/per610a/home/mvp/mvp_db/news7-lv/2012/2012_08_05_19_00/2012_08_05_19_00.mpg;Yoshihiko Noda.jpg;26149;26801;36033;1308;1341;33
/net/per610a/home/mvp/mvp_db/news7-lv/2012/2012_08_06_19_00/2012_08_06_19_00.mpg;Sadakazu TANIGAKI.jpg;10377;11357;42025;519;568;49
/net/per610a/home/mvp/mvp_db/news7-lv/2012/2012_08_06_19_00/2012_08_06_19_00.mpg;Yoshihiko Noda.jpg;10377;12189;42025;519;609;90
/net/per610a/home/mvp/mvp_db/news7-lv/2012/2012_08_07_19_00/2012_08_07_19_00.mpg;Seiji MAEHARA.jpg;6349;7189;36033;317;359;42
/net/per610a/home/mvp/mvp_db/news7-lv/2012/2012_08_07_19_00/2012_08_07_19_00.mpg;Yoshihiko Noda.jpg;8321;8381;36033;416;419;3
/net/per610a/home/mvp/mvp_db/news7-lv/2012/2012_08_07_19_00/2012_08_07_19_00.mpg;Yoshihiko Noda.jpg;8449;8737;36033;422;437;15
/net/per610a/home/mvp/mvp_db/news7-lv/2012/2012_08_07_19_00/2012_08_07_19_00.mpg;Natsuo YAMAGUCHI.jpg;8449;8737;36033;422;437;15
/net/per610a/home/mvp/mvp_db/news7-lv/2012/2012_08_08_19_00/2012_08_08_19_00.mpg;Sadakazu TANIGAKI.jpg;105;317;42037;5;15;10
/net/per610a/home/mvp/mvp_db/news7-lv/2012/2012_08_08_19_00/2012_08_08_19_00.mpg;Sadakazu TANIGAKI.jpg;857;1461;42037;42;73;31
/net/per610a/home/mvp/mvp_db/news7-lv/2012/2012_08_08_19_00/2012_08_08_19_00.mpg;Sadakazu TANIGAKI.jpg;8573;9077;42037;428;454;26
/net/per610a/home/mvp/mvp_db/news7-lv/2012/2012_08_08_19_00/2012_08_08_19_00.mpg;Sadakazu TANIGAKI.jpg;29441;30273;42037;1472;1514;42
/net/per610a/home/mvp/mvp_db/news7-lv/2012/2012_08_08_19_00/2012_08_08_19_00.mpg;Sadakazu TANIGAKI.jpg;39445;40113;42037;1973;2006;33
/net/per610a/home/mvp/mvp_db/news7-lv/2012/2012_08_08_19_00/2012_08_08_19_00.mpg;Sadakazu TANIGAKI.jpg;40797;41045;42037;2040;2053;13
/net/per610a/home/mvp/mvp_db/news7-lv/2012/2012_08_08_19_00/2012_08_08_19_00.mpg;Yoshihiko Noda.jpg;4101;4669;42037;205;233;28
/net/per610a/home/mvp/mvp_db/news7-lv/2012/2012_08_08_19_00/2012_08_08_19_00.mpg;Yoshihiko Noda.jpg;4853;5369;42037;242;268;26
/net/per610a/home/mvp/mvp_db/news7-lv/2012/2012_08_08_19_00/2012_08_08_19_00.mpg;Yoshihiko Noda.jpg;7717;7805;42037;386;390;4
/net/per610a/home/mvp/mvp_db/news7-lv/2012/2012_08_08_19_00/2012_08_08_19_00.mpg;Yoshihiko Noda.jpg;8573;9077;42037;428;454;26
/net/per610a/home/mvp/mvp_db/news7-lv/2012/2012_08_08_19_00/2012_08_08_19_00.mpg;Yoshihiko Noda.jpg;29441;30273;42037;1472;1514;42
/net/per610a/home/mvp/mvp_db/news7-lv/2012/2012_08_08_19_00/2012_08_08_19_00.mpg;Yoshihiko Noda.jpg;30349;31113;42037;1518;1556;38
/net/per610a/home/mvp/mvp_db/news7-lv/2012/2012_08_08_19_00/2012_08_08_19_00.mpg;Yoshihiko Noda.jpg;39445;40113;42037;1973;2006;33
/net/per610a/home/mvp/mvp_db/news7-lv/2012/2012_08_08_19_00/2012_08_08_19_00.mpg;Yoshihiko Noda.jpg;40441;41045;42037;2023;2053;30
/net/per610a/home/mvp/mvp_db/news7-lv/2012/2012_08_08_19_00/2012_08_08_19_00.mpg;Junichiro KOIZUMI.jpg;6733;6973;42037;336;348;12
/net/per610a/home/mvp/mvp_db/news7-lv/2012/2012_08_08_19_00/2012_08_08_19_00.mpg;Taro ASO.jpg;6733;6969;42037;336;348;12
/net/per610a/home/mvp/mvp_db/news7-lv/2012/2012_08_09_19_00/2012_08_09_19_00.mpg;Yoshihiko Noda.jpg;1717;1953;48021;85;97;12
/net/per610a/home/mvp/mvp_db/news7-lv/2012/2012_08_09_19_00/2012_08_09_19_00.mpg;Yoshihiko Noda.jpg;2025;2065;48021;101;103;2
/net/per610a/home/mvp/mvp_db/news7-lv/2012/2012_08_09_19_00/2012_08_09_19_00.mpg;Yoshihiko Noda.jpg;2277;2313;48021;113;115;2
/net/per610a/home/mvp/mvp_db/news7-lv/2012/2012_08_09_19_00/2012_08_09_19_00.mpg;Yoshihiko Noda.jpg;10005;10529;48021;500;526;26
/net/per610a/home/mvp/mvp_db/news7-lv/2012/2012_08_09_19_00/2012_08_09_19_00.mpg;Yoshihiko Noda.jpg;12233;12277;48021;612;614;2
/net/per610a/home/mvp/mvp_db/news7-lv/2012/2012_08_09_19_00/2012_08_09_19_00.mpg;Sadakazu TANIGAKI.jpg;2077;2077;48021;103;103;0
/net/per610a/home/mvp/mvp_db/news7-lv/2012/2012_08_09_19_00/2012_08_09_19_00.mpg;Sadakazu TANIGAKI.jpg;3129;3661;48021;156;183;27
/net/per610a/home/mvp/mvp_db/news7-lv/2012/2012_08_09_19_00/2012_08_09_19_00.mpg;Sadakazu TANIGAKI.jpg;8677;8957;48021;434;448;14
/net/per610a/home/mvp/mvp_db/news7-lv/2012/2012_08_09_19_00/2012_08_09_19_00.mpg;Sadakazu TANIGAKI.jpg;10005;10529;48021;500;526;26
/net/per610a/home/mvp/mvp_db/news7-lv/2012/2012_08_09_19_00/2012_08_09_19_00.mpg;Sadakazu TANIGAKI.jpg;10633;10881;48021;532;544;12
/net/per610a/home/mvp/mvp_db/news7-lv/2012/2012_08_09_19_00/2012_08_09_19_00.mpg;Sadakazu TANIGAKI.jpg;12549;12625;48021;627;631;4
/net/per610a/home/mvp/mvp_db/news7-lv/2012/2012_08_09_19_00/2012_08_09_19_00.mpg;Taro ASO.jpg;3841;4041;48021;192;202;10
/net/per610a/home/mvp/mvp_db/news7-lv/2012/2012_08_09_19_00/2012_08_09_19_00.mpg;Ichiro OZAWA.jpg;6749;7241;48021;337;362;25
/net/per610a/home/mvp/mvp_db/news7-lv/2012/2012_08_09_19_00/2012_08_09_19_00.mpg;Yoshihiko Noda.jpg;8677;8957;48021;434;448;14
/net/per610a/home/mvp/mvp_db/news7-lv/2012/2012_08_09_19_00/2012_08_09_19_00.mpg;Yoshihiko Noda.jpg;10633;10881;48021;532;544;12
/net/per610a/home/mvp/mvp_db/news7-lv/2012/2012_08_09_19_00/2012_08_09_19_00.mpg;Yoshihiko Noda.jpg;12173;12213;48021;609;611;2
/net/per610a/home/mvp/mvp_db/news7-lv/2012/2012_08_09_19_00/2012_08_09_19_00.mpg;Yoshihiko Noda.jpg;12293;12625;48021;615;631;16
/net/per610a/home/mvp/mvp_db/news7-lv/2012/2012_08_10_19_00/2012_08_10_19_00.mpg;Yoshihiko Noda.jpg;1;69;54013;0;3;3
/net/per610a/home/mvp/mvp_db/news7-lv/2012/2012_08_10_19_00/2012_08_10_19_00.mpg;Yoshihiko Noda.jpg;1997;2549;54013;99;127;28
/net/per610a/home/mvp/mvp_db/news7-lv/2012/2012_08_10_19_00/2012_08_10_19_00.mpg;Yoshihiko Noda.jpg;2773;2861;54013;138;143;5
/net/per610a/home/mvp/mvp_db/news7-lv/2012/2012_08_10_19_00/2012_08_10_19_00.mpg;Yoshihiko Noda.jpg;5441;10649;54013;272;532;260
/net/per610a/home/mvp/mvp_db/news7-lv/2012/2012_08_10_19_00/2012_08_10_19_00.mpg;Yoshihiko Noda.jpg;25557;26101;54013;1278;1306;28
/net/per610a/home/mvp/mvp_db/news7-lv/2012/2012_08_13_19_00/2012_08_13_19_00.mpg;Yoshihiko Noda.jpg;24037;24357;36045;1203;1219;16
/net/per610a/home/mvp/mvp_db/news7-lv/2012/2012_08_13_19_00/2012_08_13_19_00.mpg;Yoshihiko Noda.jpg;25545;25997;36045;1278;1301;23
/net/per610a/home/mvp/mvp_db/news7-lv/2012/2012_08_15_19_00/2012_08_15_19_00.mpg;Yoshihiko Noda.jpg;5145;5273;36033;257;263;6
/net/per610a/home/mvp/mvp_db/news7-lv/2012/2012_08_15_19_00/2012_08_15_19_00.mpg;Yoshihiko Noda.jpg;7909;8237;36033;395;412;17
/net/per610a/home/mvp/mvp_db/news7-lv/2012/2012_08_15_19_00/2012_08_15_19_00.mpg;Masashi Nakano.jpg;25109;25865;36033;1256;1294;38
/net/per610a/home/mvp/mvp_db/news7-lv/2012/2012_08_17_19_00/2012_08_17_19_00.mpg;Yoshihiko Noda.jpg;1861;1937;36029;93;96;3
/net/per610a/home/mvp/mvp_db/news7-lv/2012/2012_08_17_19_00/2012_08_17_19_00.mpg;Yoshihiko Noda.jpg;2121;2329;36029;106;116;10
/net/per610a/home/mvp/mvp_db/news7-lv/2012/2012_08_17_19_00/2012_08_17_19_00.mpg;Yoshihiko Noda.jpg;12917;13081;36029;646;654;8
/net/per610a/home/mvp/mvp_db/news7-lv/2012/2012_08_17_19_00/2012_08_17_19_00.mpg;Shintaro ISHIHARA.jpg;3505;3865;36029;175;193;18
/net/per610a/home/mvp/mvp_db/news7-lv/2012/2012_08_20_19_00/2012_08_20_19_00.mpg;Seiji MAEHARA.jpg;18741;18857;36037;937;943;6
/net/per610a/home/mvp/mvp_db/news7-lv/2012/2012_08_21_19_00/2012_08_21_19_00.mpg;Yoshihiko Noda.jpg;509;597;36033;25;29;4
/net/per610a/home/mvp/mvp_db/news7-lv/2012/2012_08_21_19_00/2012_08_21_19_00.mpg;Yoshihiko Noda.jpg;12349;12613;36033;617;631;14
/net/per610a/home/mvp/mvp_db/news7-lv/2012/2012_08_21_19_00/2012_08_21_19_00.mpg;Yoshihiko Noda.jpg;28309;28685;36033;1416;1435;19
/net/per610a/home/mvp/mvp_db/news7-lv/2012/2012_08_22_19_00/2012_08_22_19_00.mpg;Yoshihiko Noda.jpg;397;477;36033;19;23;4
/net/per610a/home/mvp/mvp_db/news7-lv/2012/2012_08_22_19_00/2012_08_22_19_00.mpg;Yoshihiko Noda.jpg;1021;1453;36033;51;72;21
/net/per610a/home/mvp/mvp_db/news7-lv/2012/2012_08_22_19_00/2012_08_22_19_00.mpg;Yoshihiko Noda.jpg;1681;1705;36033;84;85;1
/net/per610a/home/mvp/mvp_db/news7-lv/2012/2012_08_22_19_00/2012_08_22_19_00.mpg;Yoshihiko Noda.jpg;7277;7341;36033;364;367;3
/net/per610a/home/mvp/mvp_db/news7-lv/2012/2012_08_22_19_00/2012_08_22_19_00.mpg;Yukio EDANO.jpg;12281;12377;36033;614;619;5
/net/per610a/home/mvp/mvp_db/news7-lv/2012/2012_08_23_19_00/2012_08_23_19_00.mpg;Yoshihiko Noda.jpg;89;193;36033;4;9;5
/net/per610a/home/mvp/mvp_db/news7-lv/2012/2012_08_23_19_00/2012_08_23_19_00.mpg;Yoshihiko Noda.jpg;337;409;36033;16;20;4
/net/per610a/home/mvp/mvp_db/news7-lv/2012/2012_08_23_19_00/2012_08_23_19_00.mpg;Yoshihiko Noda.jpg;5153;5793;36033;257;289;32
/net/per610a/home/mvp/mvp_db/news7-lv/2012/2012_08_23_19_00/2012_08_23_19_00.mpg;Yoshihiko Noda.jpg;16789;17373;36033;840;869;29
/net/per610a/home/mvp/mvp_db/news7-lv/2012/2012_08_23_19_00/2012_08_23_19_00.mpg;Sadakazu TANIGAKI.jpg;16777;17381;36033;839;869;30
/net/per610a/home/mvp/mvp_db/news7-lv/2012/2012_08_24_19_00/2012_08_24_19_00.mpg;Yoshihiko Noda.jpg;37;221;36033;1;11;10
/net/per610a/home/mvp/mvp_db/news7-lv/2012/2012_08_24_19_00/2012_08_24_19_00.mpg;Yoshihiko Noda.jpg;305;401;36033;15;20;5
/net/per610a/home/mvp/mvp_db/news7-lv/2012/2012_08_24_19_00/2012_08_24_19_00.mpg;Yoshihiko Noda.jpg;617;2133;36033;30;106;76
/net/per610a/home/mvp/mvp_db/news7-lv/2012/2012_08_24_19_00/2012_08_24_19_00.mpg;Yoshihiko Noda.jpg;3585;3993;36033;179;199;20
/net/per610a/home/mvp/mvp_db/news7-lv/2012/2012_08_24_19_00/2012_08_24_19_00.mpg;Yoshihiko Noda.jpg;4145;5225;36033;207;261;54
/net/per610a/home/mvp/mvp_db/news7-lv/2012/2012_08_24_19_00/2012_08_24_19_00.mpg;Yoshihiko Noda.jpg;6725;7053;36033;336;352;16
/net/per610a/home/mvp/mvp_db/news7-lv/2012/2012_08_24_19_00/2012_08_24_19_00.mpg;Yoshihiko Noda.jpg;20441;20465;36033;1022;1024;2
/net/per610a/home/mvp/mvp_db/news7-lv/2012/2012_08_24_19_00/2012_08_24_19_00.mpg;Yoshihiko Noda.jpg;8365;12393;36033;418;620;202
/net/per610a/home/mvp/mvp_db/news7-lv/2012/2012_08_24_19_00/2012_08_24_19_00.mpg;Yoshihiko Noda.jpg;12505;12509;36033;625;625;0
/net/per610a/home/mvp/mvp_db/news7-lv/2012/2012_08_24_19_00/2012_08_24_19_00.mpg;Yoshihiko Noda.jpg;16449;16797;36033;823;840;17
/net/per610a/home/mvp/mvp_db/news7-lv/2012/2012_08_24_19_00/2012_08_24_19_00.mpg;Yoshihiko Noda.jpg;18997;19533;36033;950;977;27
/net/per610a/home/mvp/mvp_db/news7-lv/2012/2012_08_24_19_00/2012_08_24_19_00.mpg;Ichiro OZAWA.jpg;28837;28841;36033;1442;1443;1
/net/per610a/home/mvp/mvp_db/news7-lv/2012/2012_08_24_19_00/2012_08_24_19_00.mpg;Ichiro OZAWA.jpg;29165;29269;36033;1459;1464;5
/net/per610a/home/mvp/mvp_db/news7-lv/2012/2012_08_25_19_00/2012_08_25_19_00.mpg;Katsuya OKADA.jpg;15265;17001;36033;763;850;87
/net/per610a/home/mvp/mvp_db/news7-lv/2012/2012_08_25_19_00/2012_08_25_19_00.mpg;Sadakazu TANIGAKI.jpg;15265;15873;36033;763;794;31
/net/per610a/home/mvp/mvp_db/news7-lv/2012/2012_08_25_19_00/2012_08_25_19_00.mpg;Sadakazu TANIGAKI.jpg;17005;17969;36033;850;899;49
/net/per610a/home/mvp/mvp_db/news7-lv/2012/2012_08_27_19_00/2012_08_27_19_00.mpg;Shintaro ISHIHARA.jpg;5705;6201;36033;285;310;25
/net/per610a/home/mvp/mvp_db/news7-lv/2012/2012_08_28_19_00/2012_08_28_19_00.mpg;Sadakazu TANIGAKI.jpg;9745;9845;36033;487;492;5
/net/per610a/home/mvp/mvp_db/news7-lv/2012/2012_08_28_19_00/2012_08_28_19_00.mpg;Sadakazu TANIGAKI.jpg;13897;13905;36033;695;695;0
/net/per610a/home/mvp/mvp_db/news7-lv/2012/2012_08_28_19_00/2012_08_28_19_00.mpg;Yoshihiko Noda.jpg;12329;12413;36033;616;621;5
/net/per610a/home/mvp/mvp_db/news7-lv/2012/2012_08_28_19_00/2012_08_28_19_00.mpg;Sadakazu TANIGAKI.jpg;14085;14265;36033;704;713;9
/net/per610a/home/mvp/mvp_db/news7-lv/2012/2012_08_29_19_00/2012_08_29_19_00.mpg;Yoshihiko Noda.jpg;397;553;38437;19;27;8
/net/per610a/home/mvp/mvp_db/news7-lv/2012/2012_08_29_19_00/2012_08_29_19_00.mpg;Yoshihiko Noda.jpg;1361;1477;38437;68;73;5
/net/per610a/home/mvp/mvp_db/news7-lv/2012/2012_08_29_19_00/2012_08_29_19_00.mpg;Yoshihiko Noda.jpg;2785;2965;38437;139;148;9
/net/per610a/home/mvp/mvp_db/news7-lv/2012/2012_08_29_19_00/2012_08_29_19_00.mpg;Yoshihiko Noda.jpg;8385;8421;38437;419;421;2
/net/per610a/home/mvp/mvp_db/news7-lv/2012/2012_08_29_19_00/2012_08_29_19_00.mpg;Yoshihiko Noda.jpg;9413;9489;38437;470;474;4
/net/per610a/home/mvp/mvp_db/news7-lv/2012/2012_08_29_19_00/2012_08_29_19_00.mpg;Yoshihiko Noda.jpg;10021;10125;38437;501;506;5
/net/per610a/home/mvp/mvp_db/news7-lv/2012/2012_08_29_19_00/2012_08_29_19_00.mpg;Yoshihiko Noda.jpg;5409;5521;38437;270;276;6
/net/per610a/home/mvp/mvp_db/news7-lv/2012/2012_08_29_19_00/2012_08_29_19_00.mpg;Yoshihiko Noda.jpg;5853;6109;38437;292;305;13
/net/per610a/home/mvp/mvp_db/news7-lv/2012/2012_08_29_19_00/2012_08_29_19_00.mpg;Yoshihiko Noda.jpg;11501;11613;38437;575;580;5
/net/per610a/home/mvp/mvp_db/news7-lv/2012/2012_08_29_19_00/2012_08_29_19_00.mpg;Yoshihiko Noda.jpg;12113;12305;38437;606;615;9
/net/per610a/home/mvp/mvp_db/news7-lv/2012/2012_08_29_19_00/2012_08_29_19_00.mpg;Natsuo YAMAGUCHI.jpg;7949;8289;38437;397;414;17
/net/per610a/home/mvp/mvp_db/news7-lv/2012/2012_08_29_19_00/2012_08_29_19_00.mpg;Yasuo FUKUDA.jpg;10917;11025;38437;546;551;5
/net/per610a/home/mvp/mvp_db/news7-lv/2012/2012_08_29_19_00/2012_08_29_19_00.mpg;Taro ASO.jpg;11225;11261;38437;561;563;2
/net/per610a/home/mvp/mvp_db/news7-lv/2012/2012_08_29_19_00/2012_08_29_19_00.mpg;Taro ASO.jpg;11357;11425;38437;568;571;3
/net/per610a/home/mvp/mvp_db/news7-lv/2012/2012_08_29_19_00/2012_08_29_19_00.mpg;Toru Hashimoto.jpg;14489;15101;38437;724;755;31
/net/per610a/home/mvp/mvp_db/news7-lv/2012/2012_08_30_19_00/2012_08_30_19_00.mpg;Sadakazu TANIGAKI.jpg;1725;1885;36033;86;94;8
/net/per610a/home/mvp/mvp_db/news7-lv/2012/2012_08_30_19_00/2012_08_30_19_00.mpg;Sadakazu TANIGAKI.jpg;4477;5185;36033;224;259;35
/net/per610a/home/mvp/mvp_db/news7-lv/2012/2012_08_30_19_00/2012_08_30_19_00.mpg;Yoshihiko Noda.jpg;2905;3017;36033;145;150;5
/net/per610a/home/mvp/mvp_db/news7-lv/2012/2012_08_30_19_00/2012_08_30_19_00.mpg;Yoshihiko Noda.jpg;3081;3185;36033;154;159;5
/net/per610a/home/mvp/mvp_db/news7-lv/2012/2012_08_31_19_00/2012_08_31_19_00.mpg;Yoshihiko Noda.jpg;9605;9913;36033;480;496;16
/net/per610a/home/mvp/mvp_db/news7-lv/2012/2012_08_31_19_00/2012_08_31_19_00.mpg;Sadakazu TANIGAKI.jpg;27009;27949;36033;1351;1398;47
/net/per610a/home/mvp/mvp_db/news7-lv/2012/2012_09_01_19_00/2012_09_01_19_00.mpg;Shinzo ABE.jpg;10013;10285;36033;501;514;13
/net/per610a/home/mvp/mvp_db/news7-lv/2012/2012_09_01_19_00/2012_09_01_19_00.mpg;Sadakazu TANIGAKI.jpg;10013;10285;36033;501;514;13
/net/per610a/home/mvp/mvp_db/news7-lv/2012/2012_09_02_19_00/2012_09_02_19_00.mpg;Shintaro ISHIHARA.jpg;6349;6697;36045;317;335;18
/net/per610a/home/mvp/mvp_db/news7-lv/2012/2012_09_02_19_00/2012_09_02_19_00.mpg;Shinzo ABE.jpg;10645;11149;36045;532;557;25
/net/per610a/home/mvp/mvp_db/news7-lv/2012/2012_09_02_19_00/2012_09_02_19_00.mpg;Yoshimi WATANABE.jpg;12077;12561;36045;604;628;24
/net/per610a/home/mvp/mvp_db/news7-lv/2012/2012_09_02_19_00/2012_09_02_19_00.mpg;Yoshimi WATANABE.jpg;13349;14197;36045;668;710;42
/net/per610a/home/mvp/mvp_db/news7-lv/2012/2012_09_02_19_00/2012_09_02_19_00.mpg;Yoshihiko Noda.jpg;16585;16865;36045;830;844;14
/net/per610a/home/mvp/mvp_db/news7-lv/2012/2012_09_03_19_00/2012_09_03_19_00.mpg;Shintaro ISHIHARA.jpg;669;889;36033;33;44;11
/net/per610a/home/mvp/mvp_db/news7-lv/2012/2012_09_03_19_00/2012_09_03_19_00.mpg;Shintaro ISHIHARA.jpg;8397;8969;36033;420;448;28
/net/per610a/home/mvp/mvp_db/news7-lv/2012/2012_09_03_19_00/2012_09_03_19_00.mpg;Sadakazu TANIGAKI.jpg;2293;2717;36033;114;135;21
/net/per610a/home/mvp/mvp_db/news7-lv/2012/2012_09_03_19_00/2012_09_03_19_00.mpg;Shintaro ISHIHARA.jpg;8973;9217;36033;448;461;13
/net/per610a/home/mvp/mvp_db/news7-lv/2012/2012_09_03_19_00/2012_09_03_19_00.mpg;Shintaro ISHIHARA.jpg;9673;9893;36033;484;495;11
/net/per610a/home/mvp/mvp_db/news7-lv/2012/2012_09_03_19_00/2012_09_03_19_00.mpg;Shintaro ISHIHARA.jpg;10761;11001;36033;538;550;12
/net/per610a/home/mvp/mvp_db/news7-lv/2012/2012_09_03_19_00/2012_09_03_19_00.mpg;Shintaro ISHIHARA.jpg;12469;12813;36033;623;641;18
/net/per610a/home/mvp/mvp_db/news7-lv/2012/2012_09_05_19_00/2012_09_05_19_00.mpg;Yoshihiko Noda.jpg;1565;2145;36041;78;107;29
/net/per610a/home/mvp/mvp_db/news7-lv/2012/2012_09_05_19_00/2012_09_05_19_00.mpg;Sadakazu TANIGAKI.jpg;5833;5949;36041;291;297;6
/net/per610a/home/mvp/mvp_db/news7-lv/2012/2012_09_05_19_00/2012_09_05_19_00.mpg;Shinzo ABE.jpg;7693;8001;36041;384;400;16
/net/per610a/home/mvp/mvp_db/news7-lv/2012/2012_09_05_19_00/2012_09_05_19_00.mpg;Shintaro ISHIHARA.jpg;29497;29757;36041;1475;1488;13
/net/per610a/home/mvp/mvp_db/news7-lv/2012/2012_09_06_19_00/2012_09_06_19_00.mpg;Seiji MAEHARA.jpg;3925;4729;36033;196;236;40
/net/per610a/home/mvp/mvp_db/news7-lv/2012/2012_09_06_19_00/2012_09_06_19_00.mpg;Seiji MAEHARA.jpg;28885;29149;36033;1445;1458;13
/net/per610a/home/mvp/mvp_db/news7-lv/2012/2012_09_06_19_00/2012_09_06_19_00.mpg;Shinzo ABE.jpg;7457;7477;36033;373;374;1
/net/per610a/home/mvp/mvp_db/news7-lv/2012/2012_09_06_19_00/2012_09_06_19_00.mpg;Shinzo ABE.jpg;7545;7601;36033;377;380;3
/net/per610a/home/mvp/mvp_db/news7-lv/2012/2012_09_06_19_00/2012_09_06_19_00.mpg;Shinzo ABE.jpg;8693;9129;36033;434;456;22
/net/per610a/home/mvp/mvp_db/news7-lv/2012/2012_09_06_19_00/2012_09_06_19_00.mpg;Shinzo ABE.jpg;9673;10389;36033;484;519;35
/net/per610a/home/mvp/mvp_db/news7-lv/2012/2012_09_06_19_00/2012_09_06_19_00.mpg;Yukio EDANO.jpg;16005;16365;36033;800;818;18
/net/per610a/home/mvp/mvp_db/news7-lv/2012/2012_09_06_19_00/2012_09_06_19_00.mpg;Shintaro ISHIHARA.jpg;29345;29829;36033;1468;1492;24
/net/per610a/home/mvp/mvp_db/news7-lv/2012/2012_09_07_19_00/2012_09_07_19_00.mpg;Sadakazu TANIGAKI.jpg;301;341;36033;15;17;2
/net/per610a/home/mvp/mvp_db/news7-lv/2012/2012_09_07_19_00/2012_09_07_19_00.mpg;Sadakazu TANIGAKI.jpg;7713;8449;36033;385;422;37
/net/per610a/home/mvp/mvp_db/news7-lv/2012/2012_09_07_19_00/2012_09_07_19_00.mpg;Sadakazu TANIGAKI.jpg;9669;9749;36033;483;487;4
/net/per610a/home/mvp/mvp_db/news7-lv/2012/2012_09_07_19_00/2012_09_07_19_00.mpg;Sadakazu TANIGAKI.jpg;10513;10621;36033;526;531;5
/net/per610a/home/mvp/mvp_db/news7-lv/2012/2012_09_07_19_00/2012_09_07_19_00.mpg;Shinzo ABE.jpg;12225;12317;36033;611;616;5
/net/per610a/home/mvp/mvp_db/news7-lv/2012/2012_09_07_19_00/2012_09_07_19_00.mpg;Shinzo ABE.jpg;12557;13149;36033;628;657;29
/net/per610a/home/mvp/mvp_db/news7-lv/2012/2012_09_07_19_00/2012_09_07_19_00.mpg;Yoshihiko Noda.jpg;27801;28005;36033;1391;1401;10
/net/per610a/home/mvp/mvp_db/news7-lv/2012/2012_09_08_19_00/2012_09_08_19_00.mpg;Yoshihiko Noda.jpg;61;197;36041;3;9;6
/net/per610a/home/mvp/mvp_db/news7-lv/2012/2012_09_08_19_00/2012_09_08_19_00.mpg;Yoshihiko Noda.jpg;1149;1401;36041;57;70;13
/net/per610a/home/mvp/mvp_db/news7-lv/2012/2012_09_08_19_00/2012_09_08_19_00.mpg;Yoshihiko Noda.jpg;1773;2165;36041;88;108;20
/net/per610a/home/mvp/mvp_db/news7-lv/2012/2012_09_08_19_00/2012_09_08_19_00.mpg;Yoshihiko Noda.jpg;3729;4305;36041;186;215;29
/net/per610a/home/mvp/mvp_db/news7-lv/2012/2012_09_08_19_00/2012_09_08_19_00.mpg;Yoshihiko Noda.jpg;4957;5069;36041;247;253;6
/net/per610a/home/mvp/mvp_db/news7-lv/2012/2012_09_08_19_00/2012_09_08_19_00.mpg;Yoshihiko Noda.jpg;14821;14997;36041;741;750;9
/net/per610a/home/mvp/mvp_db/news7-lv/2012/2012_09_08_19_00/2012_09_08_19_00.mpg;Toru Hashimoto.jpg;6769;7389;36041;338;369;31
/net/per610a/home/mvp/mvp_db/news7-lv/2012/2012_09_08_19_00/2012_09_08_19_00.mpg;Toru Hashimoto.jpg;7581;7717;36041;379;386;7
/net/per610a/home/mvp/mvp_db/news7-lv/2012/2012_09_08_19_00/2012_09_08_19_00.mpg;Toru Hashimoto.jpg;8913;9009;36041;445;450;5
/net/per610a/home/mvp/mvp_db/news7-lv/2012/2012_09_08_19_00/2012_09_08_19_00.mpg;Toru Hashimoto.jpg;9125;9361;36041;456;468;12
/net/per610a/home/mvp/mvp_db/news7-lv/2012/2012_09_08_19_00/2012_09_08_19_00.mpg;Toru Hashimoto.jpg;9709;9809;36041;485;490;5
/net/per610a/home/mvp/mvp_db/news7-lv/2012/2012_09_08_19_00/2012_09_08_19_00.mpg;Ichiro Matsui.jpeg;7785;7849;36041;389;392;3
/net/per610a/home/mvp/mvp_db/news7-lv/2012/2012_09_08_19_00/2012_09_08_19_00.mpg;Ichiro Matsui.jpeg;10417;10653;36041;521;532;11
/net/per610a/home/mvp/mvp_db/news7-lv/2012/2012_09_08_19_00/2012_09_08_19_00.mpg;Sadakazu TANIGAKI.jpg;10657;11073;36041;533;553;20
/net/per610a/home/mvp/mvp_db/news7-lv/2012/2012_09_08_19_00/2012_09_08_19_00.mpg;Sadakazu TANIGAKI.jpg;11561;12101;36041;578;605;27
/net/per610a/home/mvp/mvp_db/news7-lv/2012/2012_09_09_19_00/2012_09_09_19_00.mpg;Yoshihiko Noda.jpg;2397;2781;36037;119;139;20
/net/per610a/home/mvp/mvp_db/news7-lv/2012/2012_09_09_19_00/2012_09_09_19_00.mpg;Yoshihiko Noda.jpg;3909;3953;36037;195;197;2
/net/per610a/home/mvp/mvp_db/news7-lv/2012/2012_09_09_19_00/2012_09_09_19_00.mpg;Yoshihiko Noda.jpg;9929;10081;36037;496;504;8
/net/per610a/home/mvp/mvp_db/news7-lv/2012/2012_09_09_19_00/2012_09_09_19_00.mpg;Yoshihiko Noda.jpg;27345;27421;36037;1368;1371;3
/net/per610a/home/mvp/mvp_db/news7-lv/2012/2012_09_09_19_00/2012_09_09_19_00.mpg;Sadakazu TANIGAKI.jpg;11661;12365;36037;583;618;35
/net/per610a/home/mvp/mvp_db/news7-lv/2012/2012_09_10_19_00/2012_09_10_19_00.mpg;Shizuka KAMEI.jpg;2869;3645;38429;143;182;39
/net/per610a/home/mvp/mvp_db/news7-lv/2012/2012_09_10_19_00/2012_09_10_19_00.mpg;Katsuya OKADA.jpg;5821;5853;38429;291;292;1
/net/per610a/home/mvp/mvp_db/news7-lv/2012/2012_09_10_19_00/2012_09_10_19_00.mpg;Katsuya OKADA.jpg;16237;16297;38429;812;815;3
/net/per610a/home/mvp/mvp_db/news7-lv/2012/2012_09_10_19_00/2012_09_10_19_00.mpg;Toru Hashimoto.jpg;29737;30565;38429;1488;1529;41
/net/per610a/home/mvp/mvp_db/news7-lv/2012/2012_09_11_19_00/2012_09_11_19_00.mpg;Yoshihiko Noda.jpg;2277;2445;36041;113;122;9
/net/per610a/home/mvp/mvp_db/news7-lv/2012/2012_09_11_19_00/2012_09_11_19_00.mpg;Yoshihiko Noda.jpg;5505;5605;36041;275;280;5
/net/per610a/home/mvp/mvp_db/news7-lv/2012/2012_09_11_19_00/2012_09_11_19_00.mpg;Sadakazu TANIGAKI.jpg;10233;10257;36041;511;513;2
/net/per610a/home/mvp/mvp_db/news7-lv/2012/2012_09_11_19_00/2012_09_11_19_00.mpg;Sadakazu TANIGAKI.jpg;10489;10653;36041;524;532;8
/net/per610a/home/mvp/mvp_db/news7-lv/2012/2012_09_12_19_00/2012_09_12_19_00.mpg;Yoshihiko Noda.jpg;4445;4773;36033;222;238;16
/net/per610a/home/mvp/mvp_db/news7-lv/2012/2012_09_12_19_00/2012_09_12_19_00.mpg;Yoshihiko Noda.jpg;7125;7941;36033;356;397;41
/net/per610a/home/mvp/mvp_db/news7-lv/2012/2012_09_12_19_00/2012_09_12_19_00.mpg;Yoshihiko Noda.jpg;26573;26769;36033;1329;1339;10
/net/per610a/home/mvp/mvp_db/news7-lv/2012/2012_09_12_19_00/2012_09_12_19_00.mpg;Toru Hashimoto.jpg;14657;14945;36033;733;747;14
/net/per610a/home/mvp/mvp_db/news7-lv/2012/2012_09_13_19_00/2012_09_13_19_00.mpg;Yoshihiko Noda.jpg;8485;8529;36033;424;426;2
/net/per610a/home/mvp/mvp_db/news7-lv/2012/2012_09_13_19_00/2012_09_13_19_00.mpg;Yoshihiko Noda.jpg;9253;10649;36033;462;532;70
/net/per610a/home/mvp/mvp_db/news7-lv/2012/2012_09_14_19_00/2012_09_14_19_00.mpg;Shinzo ABE.jpg;321;373;72009;16;18;2
/net/per610a/home/mvp/mvp_db/news7-lv/2012/2012_09_14_19_00/2012_09_14_19_00.mpg;Shinzo ABE.jpg;62145;62197;72009;3110;3112;2
/net/per610a/home/mvp/mvp_db/news7-lv/2012/2012_09_14_19_00/2012_09_14_19_00.mpg;Shinzo ABE.jpg;13529;13553;72009;677;678;1
/net/per610a/home/mvp/mvp_db/news7-lv/2012/2012_09_14_19_00/2012_09_14_19_00.mpg;Shinzo ABE.jpg;13917;14085;72009;696;704;8
/net/per610a/home/mvp/mvp_db/news7-lv/2012/2012_09_14_19_00/2012_09_14_19_00.mpg;Shinzo ABE.jpg;29733;30169;72009;1488;1509;21
/net/per610a/home/mvp/mvp_db/news7-lv/2012/2012_09_14_19_00/2012_09_14_19_00.mpg;Shinzo ABE.jpg;30305;31621;72009;1516;1582;66
/net/per610a/home/mvp/mvp_db/news7-lv/2012/2012_09_14_19_00/2012_09_14_19_00.mpg;Shinzo ABE.jpg;35477;37889;72009;1775;1896;121
/net/per610a/home/mvp/mvp_db/news7-lv/2012/2012_09_14_19_00/2012_09_14_19_00.mpg;Shinzo ABE.jpg;43849;43849;72009;2194;2194;0
/net/per610a/home/mvp/mvp_db/news7-lv/2012/2012_09_14_19_00/2012_09_14_19_00.mpg;Shinzo ABE.jpg;44297;44329;72009;2217;2218;1
/net/per610a/home/mvp/mvp_db/news7-lv/2012/2012_09_14_19_00/2012_09_14_19_00.mpg;Shinzo ABE.jpg;53953;54685;72009;2700;2736;36
/net/per610a/home/mvp/mvp_db/news7-lv/2012/2012_09_14_19_00/2012_09_14_19_00.mpg;Shinzo ABE.jpg;54893;55497;72009;2747;2777;30
/net/per610a/home/mvp/mvp_db/news7-lv/2012/2012_09_14_19_00/2012_09_14_19_00.mpg;Shinzo ABE.jpg;61217;61301;72009;3063;3068;5
/net/per610a/home/mvp/mvp_db/news7-lv/2012/2012_09_14_19_00/2012_09_14_19_00.mpg;Shinzo ABE.jpg;61673;61725;72009;3086;3089;3
/net/per610a/home/mvp/mvp_db/news7-lv/2012/2012_09_14_19_00/2012_09_14_19_00.mpg;Yoshihiko Noda.jpg;62325;62373;72009;3119;3121;2
/net/per610a/home/mvp/mvp_db/news7-lv/2012/2012_09_14_19_00/2012_09_14_19_00.mpg;Yoshihiko Noda.jpg;63217;63685;72009;3163;3187;24
/net/per610a/home/mvp/mvp_db/news7-lv/2012/2012_09_15_19_00/2012_09_15_19_00.mpg;Shinzo ABE.jpg;14641;15873;36045;732;794;62
/net/per610a/home/mvp/mvp_db/news7-lv/2012/2012_09_15_19_00/2012_09_15_19_00.mpg;Shinzo ABE.jpg;16829;17269;36045;842;864;22
/net/per610a/home/mvp/mvp_db/news7-lv/2012/2012_09_16_19_00/2012_09_16_19_00.mpg;Ichiro OZAWA.jpg;15881;16277;36033;794;814;20
/net/per610a/home/mvp/mvp_db/news7-lv/2012/2012_09_16_19_00/2012_09_16_19_00.mpg;Ichiro OZAWA.jpg;16905;17565;36033;845;878;33
/net/per610a/home/mvp/mvp_db/news7-lv/2012/2012_09_16_19_00/2012_09_16_19_00.mpg;Yoshihiko Noda.jpg;16293;16389;36033;815;820;5
/net/per610a/home/mvp/mvp_db/news7-lv/2012/2012_09_19_19_00/2012_09_19_19_00.mpg;Yoshihiko Noda.jpg;26493;26565;71997;1325;1329;4
/net/per610a/home/mvp/mvp_db/news7-lv/2012/2012_09_19_19_00/2012_09_19_19_00.mpg;Yoshihiko Noda.jpg;39809;45905;71997;1992;2297;305
/net/per610a/home/mvp/mvp_db/news7-lv/2012/2012_09_19_19_00/2012_09_19_19_00.mpg;Yoshihiko Noda.jpg;26697;27773;71997;1336;1389;53
/net/per610a/home/mvp/mvp_db/news7-lv/2012/2012_09_19_19_00/2012_09_19_19_00.mpg;Yoshihiko Noda.jpg;39261;39797;71997;1964;1991;27
/net/per610a/home/mvp/mvp_db/news7-lv/2012/2012_09_19_19_00/2012_09_19_19_00.mpg;Yoshihiko Noda.jpg;46225;47185;71997;2313;2361;48
/net/per610a/home/mvp/mvp_db/news7-lv/2012/2012_09_19_19_00/2012_09_19_19_00.mpg;Shinzo ABE.jpg;60209;62329;71997;3013;3119;106
/net/per610a/home/mvp/mvp_db/news7-lv/2012/2012_09_20_19_00/2012_09_20_19_00.mpg;Shinzo ABE.jpg;16537;16629;36033;827;832;5
/net/per610a/home/mvp/mvp_db/news7-lv/2012/2012_09_20_19_00/2012_09_20_19_00.mpg;Shinzo ABE.jpg;16721;16729;36033;836;837;1
/net/per610a/home/mvp/mvp_db/news7-lv/2012/2012_09_20_19_00/2012_09_20_19_00.mpg;Shinzo ABE.jpg;16949;17181;36033;848;859;11
/net/per610a/home/mvp/mvp_db/news7-lv/2012/2012_09_21_19_00/2012_09_21_19_00.mpg;Yoshihiko Noda.jpg;197;525;38429;9;26;17
/net/per610a/home/mvp/mvp_db/news7-lv/2012/2012_09_21_19_00/2012_09_21_19_00.mpg;Yoshihiko Noda.jpg;1369;1373;38429;68;68;0
/net/per610a/home/mvp/mvp_db/news7-lv/2012/2012_09_21_19_00/2012_09_21_19_00.mpg;Yoshihiko Noda.jpg;3033;3409;38429;151;170;19
/net/per610a/home/mvp/mvp_db/news7-lv/2012/2012_09_21_19_00/2012_09_21_19_00.mpg;Yoshihiko Noda.jpg;5685;5797;38429;284;290;6
/net/per610a/home/mvp/mvp_db/news7-lv/2012/2012_09_21_19_00/2012_09_21_19_00.mpg;Yoshihiko Noda.jpg;6545;7301;38429;327;365;38
/net/per610a/home/mvp/mvp_db/news7-lv/2012/2012_09_21_19_00/2012_09_21_19_00.mpg;Yoshihiko Noda.jpg;11021;11401;38429;551;570;19
/net/per610a/home/mvp/mvp_db/news7-lv/2012/2012_09_21_19_00/2012_09_21_19_00.mpg;Shinzo ABE.jpg;11813;15993;38429;591;800;209
/net/per610a/home/mvp/mvp_db/news7-lv/2012/2012_09_22_19_00/2012_09_22_19_00.mpg;Yoshihiko Noda.jpg;9413;9797;36033;471;490;19
/net/per610a/home/mvp/mvp_db/news7-lv/2012/2012_09_22_19_00/2012_09_22_19_00.mpg;Yoshihiko Noda.jpg;9921;10157;36033;496;508;12
/net/per610a/home/mvp/mvp_db/news7-lv/2012/2012_09_22_19_00/2012_09_22_19_00.mpg;Yoshihiko Noda.jpg;10825;11045;36033;541;552;11
/net/per610a/home/mvp/mvp_db/news7-lv/2012/2012_09_22_19_00/2012_09_22_19_00.mpg;Yoshihiko Noda.jpg;11213;11301;36033;561;565;4
/net/per610a/home/mvp/mvp_db/news7-lv/2012/2012_09_22_19_00/2012_09_22_19_00.mpg;Natsuo YAMAGUCHI.jpg;17293;17517;36033;865;876;11
/net/per610a/home/mvp/mvp_db/news7-lv/2012/2012_09_22_19_00/2012_09_22_19_00.mpg;Natsuo YAMAGUCHI.jpg;17661;17845;36033;883;892;9
/net/per610a/home/mvp/mvp_db/news7-lv/2012/2012_09_22_19_00/2012_09_22_19_00.mpg;Natsuo YAMAGUCHI.jpg;18013;18133;36033;901;907;6
/net/per610a/home/mvp/mvp_db/news7-lv/2012/2012_09_23_19_00/2012_09_23_19_00.mpg;Yoshihiko Noda.jpg;1593;1993;36033;79;99;20
/net/per610a/home/mvp/mvp_db/news7-lv/2012/2012_09_23_19_00/2012_09_23_19_00.mpg;Yoshihiko Noda.jpg;23089;23285;36033;1155;1165;10
/net/per610a/home/mvp/mvp_db/news7-lv/2012/2012_09_23_19_00/2012_09_23_19_00.mpg;Yoshihiko Noda.jpg;34845;34869;36033;1743;1744;1
/net/per610a/home/mvp/mvp_db/news7-lv/2012/2012_09_23_19_00/2012_09_23_19_00.mpg;Yoshihiko Noda.jpg;35033;35329;36033;1752;1767;15
/net/per610a/home/mvp/mvp_db/news7-lv/2012/2012_09_23_19_00/2012_09_23_19_00.mpg;Ichiro Matsui.jpeg;15569;16073;36033;779;804;25
/net/per610a/home/mvp/mvp_db/news7-lv/2012/2012_09_24_19_00/2012_09_24_19_00.mpg;Shinzo ABE.jpg;17181;19633;36033;859;982;123
/net/per610a/home/mvp/mvp_db/news7-lv/2012/2012_09_26_19_00/2012_09_26_19_00.mpg;Shinzo ABE.jpg;37;45;36033;1;2;1
/net/per610a/home/mvp/mvp_db/news7-lv/2012/2012_09_26_19_00/2012_09_26_19_00.mpg;Shinzo ABE.jpg;165;177;36033;8;8;0
/net/per610a/home/mvp/mvp_db/news7-lv/2012/2012_09_26_19_00/2012_09_26_19_00.mpg;Shinzo ABE.jpg;249;409;36033;12;20;8
/net/per610a/home/mvp/mvp_db/news7-lv/2012/2012_09_26_19_00/2012_09_26_19_00.mpg;Shinzo ABE.jpg;981;993;36033;49;49;0
/net/per610a/home/mvp/mvp_db/news7-lv/2012/2012_09_26_19_00/2012_09_26_19_00.mpg;Shinzo ABE.jpg;1065;1085;36033;53;54;1
/net/per610a/home/mvp/mvp_db/news7-lv/2012/2012_09_26_19_00/2012_09_26_19_00.mpg;Shinzo ABE.jpg;1337;1401;36033;66;70;4
/net/per610a/home/mvp/mvp_db/news7-lv/2012/2012_09_26_19_00/2012_09_26_19_00.mpg;Shinzo ABE.jpg;2797;2861;36033;139;143;4
/net/per610a/home/mvp/mvp_db/news7-lv/2012/2012_09_26_19_00/2012_09_26_19_00.mpg;Shinzo ABE.jpg;3233;3233;36033;161;161;0
/net/per610a/home/mvp/mvp_db/news7-lv/2012/2012_09_26_19_00/2012_09_26_19_00.mpg;Shinzo ABE.jpg;10669;10685;36033;533;534;1
/net/per610a/home/mvp/mvp_db/news7-lv/2012/2012_09_26_19_00/2012_09_26_19_00.mpg;Shinzo ABE.jpg;13685;17149;36033;684;858;174
/net/per610a/home/mvp/mvp_db/news7-lv/2012/2012_09_26_19_00/2012_09_26_19_00.mpg;Shinzo ABE.jpg;18045;18565;36033;902;928;26
/net/per610a/home/mvp/mvp_db/news7-lv/2012/2012_09_26_19_00/2012_09_26_19_00.mpg;Shinzo ABE.jpg;12533;13021;36033;627;651;24
/net/per610a/home/mvp/mvp_db/news7-lv/2012/2012_09_26_19_00/2012_09_26_19_00.mpg;Shinzo ABE.jpg;13109;13193;36033;655;660;5
/net/per610a/home/mvp/mvp_db/news7-lv/2012/2012_09_26_19_00/2012_09_26_19_00.mpg;Shinzo ABE.jpg;13285;13345;36033;664;667;3
/net/per610a/home/mvp/mvp_db/news7-lv/2012/2012_09_26_19_00/2012_09_26_19_00.mpg;Yoshihiko Noda.jpg;18569;19529;36033;929;977;48
/net/per610a/home/mvp/mvp_db/news7-lv/2012/2012_09_27_19_00/2012_09_27_19_00.mpg;Yoshihiko Noda.jpg;6913;6985;36033;345;349;4
/net/per610a/home/mvp/mvp_db/news7-lv/2012/2012_09_27_19_00/2012_09_27_19_00.mpg;Yoshihiko Noda.jpg;9273;9697;36033;463;485;22
/net/per610a/home/mvp/mvp_db/news7-lv/2012/2012_09_27_19_00/2012_09_27_19_00.mpg;Shinzo ABE.jpg;11469;12549;36033;573;627;54
/net/per610a/home/mvp/mvp_db/news7-lv/2012/2012_09_27_19_00/2012_09_27_19_00.mpg;Shinzo ABE.jpg;13501;13573;36033;675;679;4
/net/per610a/home/mvp/mvp_db/news7-lv/2012/2012_09_27_19_00/2012_09_27_19_00.mpg;Yoshihiko Noda.jpg;13665;14473;36033;683;724;41
/net/per610a/home/mvp/mvp_db/news7-lv/2012/2012_09_28_19_00/2012_09_28_19_00.mpg;Shinzo ABE.jpg;5209;5453;36033;260;272;12
/net/per610a/home/mvp/mvp_db/news7-lv/2012/2012_09_28_19_00/2012_09_28_19_00.mpg;Shinzo ABE.jpg;8573;8593;36033;428;429;1
/net/per610a/home/mvp/mvp_db/news7-lv/2012/2012_09_28_19_00/2012_09_28_19_00.mpg;Shinzo ABE.jpg;9577;10249;36033;479;512;33
/net/per610a/home/mvp/mvp_db/news7-lv/2012/2012_09_28_19_00/2012_09_28_19_00.mpg;Yoshihiko Noda.jpg;5209;5717;36033;260;286;26
/net/per610a/home/mvp/mvp_db/news7-lv/2012/2012_09_28_19_00/2012_09_28_19_00.mpg;Yoshihiko Noda.jpg;5857;6449;36033;293;322;29
/net/per610a/home/mvp/mvp_db/news7-lv/2012/2012_09_28_19_00/2012_09_28_19_00.mpg;Yoshihiko Noda.jpg;7073;7673;36033;353;383;30
/net/per610a/home/mvp/mvp_db/news7-lv/2012/2012_09_28_19_00/2012_09_28_19_00.mpg;Yoshihiko Noda.jpg;7745;7873;36033;387;393;6
/net/per610a/home/mvp/mvp_db/news7-lv/2012/2012_09_29_19_00/2012_09_29_19_00.mpg;Yoshihiko Noda.jpg;18201;18649;38429;910;933;23
/net/per610a/home/mvp/mvp_db/news7-lv/2012/2012_09_29_19_00/2012_09_29_19_00.mpg;Yoshihiko Noda.jpg;19421;19713;38429;971;986;15
/net/per610a/home/mvp/mvp_db/news7-lv/2012/2012_09_29_19_00/2012_09_29_19_00.mpg;Katsuya OKADA.jpg;18745;19025;38429;938;952;14
/net/per610a/home/mvp/mvp_db/news7-lv/2012/2012_10_01_19_00/2012_10_01_19_00.mpg;Yoshihiko Noda.jpg;17;93;38429;0;4;4
/net/per610a/home/mvp/mvp_db/news7-lv/2012/2012_10_01_19_00/2012_10_01_19_00.mpg;Yoshihiko Noda.jpg;13605;13741;38429;680;687;7
/net/per610a/home/mvp/mvp_db/news7-lv/2012/2012_10_01_19_00/2012_10_01_19_00.mpg;Yoshihiko Noda.jpg;789;1221;38429;39;61;22
/net/per610a/home/mvp/mvp_db/news7-lv/2012/2012_10_01_19_00/2012_10_01_19_00.mpg;Yoshihiko Noda.jpg;3749;3933;38429;187;196;9
/net/per610a/home/mvp/mvp_db/news7-lv/2012/2012_10_01_19_00/2012_10_01_19_00.mpg;Yoshihiko Noda.jpg;10017;11009;38429;501;550;49
/net/per610a/home/mvp/mvp_db/news7-lv/2012/2012_10_01_19_00/2012_10_01_19_00.mpg;Yoshihiko Noda.jpg;18929;19437;38429;947;972;25
/net/per610a/home/mvp/mvp_db/news7-lv/2012/2012_10_01_19_00/2012_10_01_19_00.mpg;Katsuya OKADA.jpg;3965;4025;38429;198;201;3
/net/per610a/home/mvp/mvp_db/news7-lv/2012/2012_10_01_19_00/2012_10_01_19_00.mpg;Katsuya OKADA.jpg;12501;12693;38429;625;635;10
/net/per610a/home/mvp/mvp_db/news7-lv/2012/2012_10_01_19_00/2012_10_01_19_00.mpg;Yukio EDANO.jpg;5345;5577;38429;267;279;12
/net/per610a/home/mvp/mvp_db/news7-lv/2012/2012_10_01_19_00/2012_10_01_19_00.mpg;Shinzo ABE.jpg;16093;16917;38429;805;846;41
/net/per610a/home/mvp/mvp_db/news7-lv/2012/2012_10_01_19_00/2012_10_01_19_00.mpg;Shinzo ABE.jpg;18929;20021;38429;947;1001;54
/net/per610a/home/mvp/mvp_db/news7-lv/2012/2012_10_01_19_00/2012_10_01_19_00.mpg;Shinzo ABE.jpg;20385;20453;38429;1020;1023;3
/net/per610a/home/mvp/mvp_db/news7-lv/2012/2012_10_01_19_00/2012_10_01_19_00.mpg;Natsuo YAMAGUCHI.jpg;18929;19437;38429;947;972;25
/net/per610a/home/mvp/mvp_db/news7-lv/2012/2012_10_01_19_00/2012_10_01_19_00.mpg;Yukio EDANO.jpg;32685;33637;38429;1635;1683;48
/net/per610a/home/mvp/mvp_db/news7-lv/2012/2012_10_03_19_00/2012_10_03_19_00.mpg;Shinzo ABE.jpg;9969;10681;36029;498;534;36
/net/per610a/home/mvp/mvp_db/news7-lv/2012/2012_10_03_19_00/2012_10_03_19_00.mpg;Yoshihiko Noda.jpg;9973;9973;36029;499;499;0
/net/per610a/home/mvp/mvp_db/news7-lv/2012/2012_10_03_19_00/2012_10_03_19_00.mpg;Yoshihiko Noda.jpg;10085;10173;36029;504;509;5
/net/per610a/home/mvp/mvp_db/news7-lv/2012/2012_10_03_19_00/2012_10_03_19_00.mpg;Yoshihiko Noda.jpg;10253;10341;36029;513;517;4
/net/per610a/home/mvp/mvp_db/news7-lv/2012/2012_10_03_19_00/2012_10_03_19_00.mpg;Yoshihiko Noda.jpg;10425;10437;36029;521;522;1
/net/per610a/home/mvp/mvp_db/news7-lv/2012/2012_10_03_19_00/2012_10_03_19_00.mpg;Yoshihiko Noda.jpg;10513;10589;36029;526;529;3
/net/per610a/home/mvp/mvp_db/news7-lv/2012/2012_10_03_19_00/2012_10_03_19_00.mpg;Yoshihiko Noda.jpg;10681;10821;36029;534;541;7
/net/per610a/home/mvp/mvp_db/news7-lv/2012/2012_10_03_19_00/2012_10_03_19_00.mpg;Shinzo ABE.jpg;12629;13533;36029;631;677;46
/net/per610a/home/mvp/mvp_db/news7-lv/2012/2012_10_03_19_00/2012_10_03_19_00.mpg;Yorihisa Matsuno.png;13825;13917;36029;691;696;5
/net/per610a/home/mvp/mvp_db/news7-lv/2012/2012_10_03_19_00/2012_10_03_19_00.mpg;Yorihisa Matsuno.png;14001;14249;36029;700;713;13
/net/per610a/home/mvp/mvp_db/news7-lv/2012/2012_10_04_19_00/2012_10_04_19_00.mpg;Natsuo YAMAGUCHI.jpg;15985;16649;36033;799;833;34
/net/per610a/home/mvp/mvp_db/news7-lv/2012/2012_10_04_19_00/2012_10_04_19_00.mpg;Natsuo YAMAGUCHI.jpg;17845;18273;36033;892;914;22
/net/per610a/home/mvp/mvp_db/news7-lv/2012/2012_10_04_19_00/2012_10_04_19_00.mpg;Natsuo YAMAGUCHI.jpg;18409;18817;36033;921;941;20
/net/per610a/home/mvp/mvp_db/news7-lv/2012/2012_10_04_19_00/2012_10_04_19_00.mpg;Shinzo ABE.jpg;20949;21605;36033;1048;1081;33
/net/per610a/home/mvp/mvp_db/news7-lv/2012/2012_10_04_19_00/2012_10_04_19_00.mpg;Seiji MAEHARA.jpg;29017;29689;36033;1451;1485;34
/net/per610a/home/mvp/mvp_db/news7-lv/2012/2012_10_05_19_00/2012_10_05_19_00.mpg;Yoshihiko Noda.jpg;829;1381;36033;41;69;28
/net/per610a/home/mvp/mvp_db/news7-lv/2012/2012_10_05_19_00/2012_10_05_19_00.mpg;Yoshihiko Noda.jpg;1565;1877;36033;78;93;15
/net/per610a/home/mvp/mvp_db/news7-lv/2012/2012_10_05_19_00/2012_10_05_19_00.mpg;Shinzo ABE.jpg;829;1381;36033;41;69;28
/net/per610a/home/mvp/mvp_db/news7-lv/2012/2012_10_05_19_00/2012_10_05_19_00.mpg;Shinzo ABE.jpg;2249;2377;36033;112;118;6
/net/per610a/home/mvp/mvp_db/news7-lv/2012/2012_10_05_19_00/2012_10_05_19_00.mpg;Shinzo ABE.jpg;2505;4205;36033;125;210;85
/net/per610a/home/mvp/mvp_db/news7-lv/2012/2012_10_05_19_00/2012_10_05_19_00.mpg;Katsuya OKADA.jpg;4309;4765;36033;215;238;23
/net/per610a/home/mvp/mvp_db/news7-lv/2012/2012_10_06_19_00/2012_10_06_19_00.mpg;Shinzo ABE.jpg;12837;13513;36033;642;676;34
/net/per610a/home/mvp/mvp_db/news7-lv/2012/2012_10_06_19_00/2012_10_06_19_00.mpg;Shinzo ABE.jpg;13745;14845;36033;687;742;55
/net/per610a/home/mvp/mvp_db/news7-lv/2012/2012_10_06_19_00/2012_10_06_19_00.mpg;Katsuya OKADA.jpg;12837;13513;36033;642;676;34
/net/per610a/home/mvp/mvp_db/news7-lv/2012/2012_10_06_19_00/2012_10_06_19_00.mpg;Yoshihiko Noda.jpg;13517;13673;36033;676;684;8
/net/per610a/home/mvp/mvp_db/news7-lv/2012/2012_10_06_19_00/2012_10_06_19_00.mpg;Yoshihiko Noda.jpg;19825;19917;36033;991;996;5
/net/per610a/home/mvp/mvp_db/news7-lv/2012/2012_10_06_19_00/2012_10_06_19_00.mpg;Toru Hashimoto.jpg;16217;17201;36033;811;860;49
/net/per610a/home/mvp/mvp_db/news7-lv/2012/2012_10_07_19_00/2012_10_07_19_00.mpg;Yoshihiko Noda.jpg;11877;12657;36041;594;633;39
/net/per610a/home/mvp/mvp_db/news7-lv/2012/2012_10_07_19_00/2012_10_07_19_00.mpg;Yoshihiko Noda.jpg;14797;14861;36041;740;743;3
/net/per610a/home/mvp/mvp_db/news7-lv/2012/2012_10_07_19_00/2012_10_07_19_00.mpg;Yoshihiko Noda.jpg;15177;15381;36041;759;769;10
/net/per610a/home/mvp/mvp_db/news7-lv/2012/2012_10_07_19_00/2012_10_07_19_00.mpg;Yoshihiko Noda.jpg;15725;16437;36041;786;822;36
/net/per610a/home/mvp/mvp_db/news7-lv/2012/2012_10_09_19_00/2012_10_09_19_00.mpg;Yoshihiko Noda.jpg;19089;19457;36033;955;973;18
/net/per610a/home/mvp/mvp_db/news7-lv/2012/2012_10_09_19_00/2012_10_09_19_00.mpg;Yoshihiko Noda.jpg;20485;20677;36033;1025;1034;9
/net/per610a/home/mvp/mvp_db/news7-lv/2012/2012_10_09_19_00/2012_10_09_19_00.mpg;Yoshihiko Noda.jpg;21193;21261;36033;1060;1063;3
/net/per610a/home/mvp/mvp_db/news7-lv/2012/2012_10_09_19_00/2012_10_09_19_00.mpg;Yoshihiko Noda.jpg;22193;22585;36033;1110;1130;20
/net/per610a/home/mvp/mvp_db/news7-lv/2012/2012_10_09_19_00/2012_10_09_19_00.mpg;Shinzo ABE.jpg;21469;21837;36033;1074;1092;18
/net/per610a/home/mvp/mvp_db/news7-lv/2012/2012_10_09_19_00/2012_10_09_19_00.mpg;Shinzo ABE.jpg;22193;22585;36033;1110;1130;20
/net/per610a/home/mvp/mvp_db/news7-lv/2012/2012_10_10_19_00/2012_10_10_19_00.mpg;Shinzo ABE.jpg;8233;8709;36033;411;435;24
/net/per610a/home/mvp/mvp_db/news7-lv/2012/2012_10_10_19_00/2012_10_10_19_00.mpg;Shinzo ABE.jpg;9781;11385;36033;489;569;80
/net/per610a/home/mvp/mvp_db/news7-lv/2012/2012_10_10_19_00/2012_10_10_19_00.mpg;Yoshihiko Noda.jpg;9781;10017;36033;489;501;12
/net/per610a/home/mvp/mvp_db/news7-lv/2012/2012_10_11_19_00/2012_10_11_19_00.mpg;Yoshihiko Noda.jpg;5957;6021;36037;298;301;3
/net/per610a/home/mvp/mvp_db/news7-lv/2012/2012_10_11_19_00/2012_10_11_19_00.mpg;Yoshihiko Noda.jpg;6117;6117;36037;306;306;0
/net/per610a/home/mvp/mvp_db/news7-lv/2012/2012_10_11_19_00/2012_10_11_19_00.mpg;Yoshihiko Noda.jpg;6553;6569;36037;327;328;1
/net/per610a/home/mvp/mvp_db/news7-lv/2012/2012_10_11_19_00/2012_10_11_19_00.mpg;Yoshihiko Noda.jpg;7557;7621;36037;378;381;3
/net/per610a/home/mvp/mvp_db/news7-lv/2012/2012_10_11_19_00/2012_10_11_19_00.mpg;Yoshihiko Noda.jpg;8897;9345;36037;445;467;22
/net/per610a/home/mvp/mvp_db/news7-lv/2012/2012_10_11_19_00/2012_10_11_19_00.mpg;Shinzo ABE.jpg;8897;9345;36037;445;467;22
/net/per610a/home/mvp/mvp_db/news7-lv/2012/2012_10_12_19_00/2012_10_12_19_00.mpg;Yoshihiko Noda.jpg;1913;2029;36033;95;101;6
/net/per610a/home/mvp/mvp_db/news7-lv/2012/2012_10_12_19_00/2012_10_12_19_00.mpg;Katsuya OKADA.jpg;17269;18041;36033;864;902;38
/net/per610a/home/mvp/mvp_db/news7-lv/2012/2012_10_12_19_00/2012_10_12_19_00.mpg;Natsuo YAMAGUCHI.jpg;20097;20429;36033;1005;1022;17
/net/per610a/home/mvp/mvp_db/news7-lv/2012/2012_10_13_19_00/2012_10_13_19_00.mpg;Shinzo ABE.jpg;5481;7277;36033;274;364;90
/net/per610a/home/mvp/mvp_db/news7-lv/2012/2012_10_14_19_00/2012_10_14_19_00.mpg;Yoshihiko Noda.jpg;4741;5033;36033;237;251;14
/net/per610a/home/mvp/mvp_db/news7-lv/2012/2012_10_14_19_00/2012_10_14_19_00.mpg;Yoshihiko Noda.jpg;6289;7293;36033;314;364;50
/net/per610a/home/mvp/mvp_db/news7-lv/2012/2012_10_15_19_00/2012_10_15_19_00.mpg;Yoshimi WATANABE.jpg;10745;10761;36033;537;538;1
/net/per610a/home/mvp/mvp_db/news7-lv/2012/2012_10_15_19_00/2012_10_15_19_00.mpg;Yoshimi WATANABE.jpg;12309;12393;36033;615;620;5
/net/per610a/home/mvp/mvp_db/news7-lv/2012/2012_10_15_19_00/2012_10_15_19_00.mpg;Toru Hashimoto.jpg;10885;10905;36033;544;545;1
/net/per610a/home/mvp/mvp_db/news7-lv/2012/2012_10_15_19_00/2012_10_15_19_00.mpg;Toru Hashimoto.jpg;11025;11085;36033;551;554;3
/net/per610a/home/mvp/mvp_db/news7-lv/2012/2012_10_15_19_00/2012_10_15_19_00.mpg;Toru Hashimoto.jpg;11209;11237;36033;560;562;2
/net/per610a/home/mvp/mvp_db/news7-lv/2012/2012_10_15_19_00/2012_10_15_19_00.mpg;Toru Hashimoto.jpg;11353;11393;36033;568;570;2
/net/per610a/home/mvp/mvp_db/news7-lv/2012/2012_10_15_19_00/2012_10_15_19_00.mpg;Toru Hashimoto.jpg;12521;13281;36033;626;664;38
/net/per610a/home/mvp/mvp_db/news7-lv/2012/2012_10_17_19_00/2012_10_17_19_00.mpg;Shinzo ABE.jpg;31497;32353;36045;1576;1619;43
/net/per610a/home/mvp/mvp_db/news7-lv/2012/2012_10_18_19_00/2012_10_18_19_00.mpg;Shinzo ABE.jpg;809;1281;36033;40;64;24
/net/per610a/home/mvp/mvp_db/news7-lv/2012/2012_10_18_19_00/2012_10_18_19_00.mpg;Shinzo ABE.jpg;3389;3889;36033;169;194;25
/net/per610a/home/mvp/mvp_db/news7-lv/2012/2012_10_18_19_00/2012_10_18_19_00.mpg;Shinzo ABE.jpg;8569;9025;36033;428;451;23
/net/per610a/home/mvp/mvp_db/news7-lv/2012/2012_10_18_19_00/2012_10_18_19_00.mpg;Natsuo YAMAGUCHI.jpg;829;1281;36033;41;64;23
/net/per610a/home/mvp/mvp_db/news7-lv/2012/2012_10_18_19_00/2012_10_18_19_00.mpg;Natsuo YAMAGUCHI.jpg;3913;4465;36033;195;223;28
/net/per610a/home/mvp/mvp_db/news7-lv/2012/2012_10_18_19_00/2012_10_18_19_00.mpg;Natsuo YAMAGUCHI.jpg;6693;7297;36033;334;365;31
/net/per610a/home/mvp/mvp_db/news7-lv/2012/2012_10_18_19_00/2012_10_18_19_00.mpg;Natsuo YAMAGUCHI.jpg;8569;9025;36033;428;451;23
/net/per610a/home/mvp/mvp_db/news7-lv/2012/2012_10_18_19_00/2012_10_18_19_00.mpg;Yoshihiko Noda.jpg;6693;7297;36033;334;365;31
/net/per610a/home/mvp/mvp_db/news7-lv/2012/2012_10_18_19_00/2012_10_18_19_00.mpg;Yukio HATOYAMA.jpg;24425;24657;36033;1222;1233;11
/net/per610a/home/mvp/mvp_db/news7-lv/2012/2012_10_19_19_00/2012_10_19_19_00.mpg;Natsuo YAMAGUCHI.jpg;1785;1797;36033;89;89;0
/net/per610a/home/mvp/mvp_db/news7-lv/2012/2012_10_19_19_00/2012_10_19_19_00.mpg;Natsuo YAMAGUCHI.jpg;2929;3785;36033;146;189;43
/net/per610a/home/mvp/mvp_db/news7-lv/2012/2012_10_19_19_00/2012_10_19_19_00.mpg;Yoshihiko Noda.jpg;2929;3785;36033;146;189;43
/net/per610a/home/mvp/mvp_db/news7-lv/2012/2012_10_19_19_00/2012_10_19_19_00.mpg;Yoshihiko Noda.jpg;4605;6537;36033;230;327;97
/net/per610a/home/mvp/mvp_db/news7-lv/2012/2012_10_19_19_00/2012_10_19_19_00.mpg;Yoshihiko Noda.jpg;7429;7473;36033;371;373;2
/net/per610a/home/mvp/mvp_db/news7-lv/2012/2012_10_19_19_00/2012_10_19_19_00.mpg;Yoshihiko Noda.jpg;7681;8621;36033;384;431;47
/net/per610a/home/mvp/mvp_db/news7-lv/2012/2012_10_19_19_00/2012_10_19_19_00.mpg;Yoshihiko Noda.jpg;8941;10117;36033;447;506;59
/net/per610a/home/mvp/mvp_db/news7-lv/2012/2012_10_19_19_00/2012_10_19_19_00.mpg;Shinzo ABE.jpg;8301;8621;36033;415;431;16
/net/per610a/home/mvp/mvp_db/news7-lv/2012/2012_10_20_19_00/2012_10_20_19_00.mpg;Yoshihiko Noda.jpg;6589;6681;36041;329;334;5
/net/per610a/home/mvp/mvp_db/news7-lv/2012/2012_10_20_19_00/2012_10_20_19_00.mpg;Shinzo ABE.jpg;6697;6817;36041;335;341;6
/net/per610a/home/mvp/mvp_db/news7-lv/2012/2012_10_20_19_00/2012_10_20_19_00.mpg;Shinzo ABE.jpg;7745;7765;36041;387;388;1
/net/per610a/home/mvp/mvp_db/news7-lv/2012/2012_10_20_19_00/2012_10_20_19_00.mpg;Kenji Eda.jpg;19661;20097;36041;983;1005;22
/net/per610a/home/mvp/mvp_db/news7-lv/2012/2012_10_21_19_00/2012_10_21_19_00.mpg;Katsuya OKADA.jpg;6773;7757;36033;338;388;50
/net/per610a/home/mvp/mvp_db/news7-lv/2012/2012_10_21_19_00/2012_10_21_19_00.mpg;Shinzo ABE.jpg;9257;9661;36033;463;483;20
/net/per610a/home/mvp/mvp_db/news7-lv/2012/2012_10_21_19_00/2012_10_21_19_00.mpg;Natsuo YAMAGUCHI.jpg;11625;11821;36033;581;591;10
/net/per610a/home/mvp/mvp_db/news7-lv/2012/2012_10_22_19_00/2012_10_22_19_00.mpg;Yoshihiko Noda.jpg;9133;9509;36033;456;475;19
/net/per610a/home/mvp/mvp_db/news7-lv/2012/2012_10_22_19_00/2012_10_22_19_00.mpg;Yoshihiko Noda.jpg;9681;9865;36033;484;493;9
/net/per610a/home/mvp/mvp_db/news7-lv/2012/2012_10_22_19_00/2012_10_22_19_00.mpg;Yoshihiko Noda.jpg;9985;10069;36033;499;503;4
/net/per610a/home/mvp/mvp_db/news7-lv/2012/2012_10_22_19_00/2012_10_22_19_00.mpg;Yoshihiko Noda.jpg;11653;11745;36033;583;587;4
/net/per610a/home/mvp/mvp_db/news7-lv/2012/2012_10_22_19_00/2012_10_22_19_00.mpg;Kazuo SHII.jpg;10465;10649;36033;523;532;9
/net/per610a/home/mvp/mvp_db/news7-lv/2012/2012_10_22_19_00/2012_10_22_19_00.mpg;Mizuho FUKUSHIMA.jpg;10465;11501;36033;523;575;52
/net/per610a/home/mvp/mvp_db/news7-lv/2012/2012_10_22_19_00/2012_10_22_19_00.mpg;Mizuho FUKUSHIMA.jpg;11569;11637;36033;578;582;4
/net/per610a/home/mvp/mvp_db/news7-lv/2012/2012_10_22_19_00/2012_10_22_19_00.mpg;Yorihisa Matsuno.png;12029;12189;36033;601;609;8
/net/per610a/home/mvp/mvp_db/news7-lv/2012/2012_10_23_19_00/2012_10_23_19_00.mpg;Yoshihiko Noda.jpg;10133;10245;36033;507;512;5
/net/per610a/home/mvp/mvp_db/news7-lv/2012/2012_10_24_19_00/2012_10_24_19_00.mpg;Yoshihiko Noda.jpg;12069;12137;36033;603;607;4
/net/per610a/home/mvp/mvp_db/news7-lv/2012/2012_10_24_19_00/2012_10_24_19_00.mpg;Yoshihiko Noda.jpg;13533;13657;36033;677;683;6
/net/per610a/home/mvp/mvp_db/news7-lv/2012/2012_10_24_19_00/2012_10_24_19_00.mpg;Yoshihiko Noda.jpg;13789;13925;36033;689;696;7
/net/per610a/home/mvp/mvp_db/news7-lv/2012/2012_10_25_19_00/2012_10_25_19_00.mpg;Shintaro ISHIHARA.jpg;1517;1905;36037;75;95;20
/net/per610a/home/mvp/mvp_db/news7-lv/2012/2012_10_25_19_00/2012_10_25_19_00.mpg;Shintaro ISHIHARA.jpg;9169;9197;36037;458;460;2
/net/per610a/home/mvp/mvp_db/news7-lv/2012/2012_10_25_19_00/2012_10_25_19_00.mpg;Takeo Hiranuma.jpeg;3529;3753;36037;176;187;11
/net/per610a/home/mvp/mvp_db/news7-lv/2012/2012_10_25_19_00/2012_10_25_19_00.mpg;Shintaro ISHIHARA.jpg;4581;4733;36037;229;236;7
/net/per610a/home/mvp/mvp_db/news7-lv/2012/2012_10_25_19_00/2012_10_25_19_00.mpg;Toru Hashimoto.jpg;5333;5833;36037;266;291;25
/net/per610a/home/mvp/mvp_db/news7-lv/2012/2012_10_25_19_00/2012_10_25_19_00.mpg;Yoshimi WATANABE.jpg;5877;6389;36037;294;319;25
/net/per610a/home/mvp/mvp_db/news7-lv/2012/2012_10_25_19_00/2012_10_25_19_00.mpg;Yoshimi WATANABE.jpg;9449;10517;36037;472;526;54
/net/per610a/home/mvp/mvp_db/news7-lv/2012/2012_10_26_19_00/2012_10_26_19_00.mpg;Shintaro ISHIHARA.jpg;477;649;36033;23;32;9
/net/per610a/home/mvp/mvp_db/news7-lv/2012/2012_10_26_19_00/2012_10_26_19_00.mpg;Shintaro ISHIHARA.jpg;1557;3177;36033;77;158;81
/net/per610a/home/mvp/mvp_db/news7-lv/2012/2012_10_26_19_00/2012_10_26_19_00.mpg;Yoshihiko Noda.jpg;8229;8265;36033;411;413;2
/net/per610a/home/mvp/mvp_db/news7-lv/2012/2012_10_26_19_00/2012_10_26_19_00.mpg;Yoshihiko Noda.jpg;12025;12129;36033;601;606;5
/net/per610a/home/mvp/mvp_db/news7-lv/2012/2012_10_26_19_00/2012_10_26_19_00.mpg;Katsuya OKADA.jpg;29137;29317;36033;1457;1466;9
/net/per610a/home/mvp/mvp_db/news7-lv/2012/2012_10_26_19_00/2012_10_26_19_00.mpg;Katsuya OKADA.jpg;29789;30005;36033;1490;1501;11
/net/per610a/home/mvp/mvp_db/news7-lv/2012/2012_10_27_19_00/2012_10_27_19_00.mpg;Yoshihiko Noda.jpg;7673;8421;36033;383;421;38
/net/per610a/home/mvp/mvp_db/news7-lv/2012/2012_10_27_19_00/2012_10_27_19_00.mpg;Yoshihiko Noda.jpg;8501;8541;36033;425;427;2
/net/per610a/home/mvp/mvp_db/news7-lv/2012/2012_10_27_19_00/2012_10_27_19_00.mpg;Yoshihiko Noda.jpg;8617;8769;36033;431;438;7
/net/per610a/home/mvp/mvp_db/news7-lv/2012/2012_10_27_19_00/2012_10_27_19_00.mpg;Yoshihiko Noda.jpg;8869;9053;36033;443;452;9
/net/per610a/home/mvp/mvp_db/news7-lv/2012/2012_10_27_19_00/2012_10_27_19_00.mpg;Yoshihiko Noda.jpg;9521;10625;36033;476;531;55
/net/per610a/home/mvp/mvp_db/news7-lv/2012/2012_10_27_19_00/2012_10_27_19_00.mpg;Toru Hashimoto.jpg;11781;12677;36033;589;634;45
/net/per610a/home/mvp/mvp_db/news7-lv/2012/2012_10_29_19_00/2012_10_29_19_00.mpg;Yoshihiko Noda.jpg;1;41;36033;0;2;2
/net/per610a/home/mvp/mvp_db/news7-lv/2012/2012_10_29_19_00/2012_10_29_19_00.mpg;Yoshihiko Noda.jpg;1029;1581;36033;51;79;28
/net/per610a/home/mvp/mvp_db/news7-lv/2012/2012_10_29_19_00/2012_10_29_19_00.mpg;Yoshihiko Noda.jpg;1889;1977;36033;94;98;4
/net/per610a/home/mvp/mvp_db/news7-lv/2012/2012_10_29_19_00/2012_10_29_19_00.mpg;Yoshihiko Noda.jpg;2753;2761;36033;137;138;1
/net/per610a/home/mvp/mvp_db/news7-lv/2012/2012_10_29_19_00/2012_10_29_19_00.mpg;Yoshihiko Noda.jpg;4749;5617;36033;237;281;44
/net/per610a/home/mvp/mvp_db/news7-lv/2012/2012_10_29_19_00/2012_10_29_19_00.mpg;Yoshihiko Noda.jpg;13197;13281;36033;660;664;4
/net/per610a/home/mvp/mvp_db/news7-lv/2012/2012_10_29_19_00/2012_10_29_19_00.mpg;Yoshihiko Noda.jpg;13401;13885;36033;670;694;24
/net/per610a/home/mvp/mvp_db/news7-lv/2012/2012_10_29_19_00/2012_10_29_19_00.mpg;Seiji MAEHARA.jpg;12101;12357;36033;605;618;13
/net/per610a/home/mvp/mvp_db/news7-lv/2012/2012_10_30_19_00/2012_10_30_19_00.mpg;Yoshihiko Noda.jpg;21005;21489;36029;1051;1075;24
/net/per610a/home/mvp/mvp_db/news7-lv/2012/2012_10_30_19_00/2012_10_30_19_00.mpg;Yoshihiko Noda.jpg;22121;22477;36029;1107;1124;17
/net/per610a/home/mvp/mvp_db/news7-lv/2012/2012_10_30_19_00/2012_10_30_19_00.mpg;Shintaro ISHIHARA.jpg;24533;24629;36029;1227;1232;5
/net/per610a/home/mvp/mvp_db/news7-lv/2012/2012_10_30_19_00/2012_10_30_19_00.mpg;Shintaro ISHIHARA.jpg;24777;25293;36029;1239;1265;26
/net/per610a/home/mvp/mvp_db/news7-lv/2012/2012_10_30_19_00/2012_10_30_19_00.mpg;Takeo Hiranuma.jpeg;25341;25753;36029;1268;1288;20
/net/per610a/home/mvp/mvp_db/news7-lv/2012/2012_10_31_19_00/2012_10_31_19_00.mpg;Yoshihiko Noda.jpg;1;93;36033;0;4;4
/net/per610a/home/mvp/mvp_db/news7-lv/2012/2012_10_31_19_00/2012_10_31_19_00.mpg;Shinzo ABE.jpg;3977;4577;36033;198;229;31
/net/per610a/home/mvp/mvp_db/news7-lv/2012/2012_10_31_19_00/2012_10_31_19_00.mpg;Shinzo ABE.jpg;4833;4893;36033;241;244;3
/net/per610a/home/mvp/mvp_db/news7-lv/2012/2012_10_31_19_00/2012_10_31_19_00.mpg;Shintaro ISHIHARA.jpg;9729;9741;36033;486;487;1
/net/per610a/home/mvp/mvp_db/news7-lv/2012/2012_10_31_19_00/2012_10_31_19_00.mpg;Shintaro ISHIHARA.jpg;11029;11037;36033;551;552;1
/net/per610a/home/mvp/mvp_db/news7-lv/2012/2012_10_31_19_00/2012_10_31_19_00.mpg;Shintaro ISHIHARA.jpg;11145;11169;36033;557;558;1
/net/per610a/home/mvp/mvp_db/news7-lv/2012/2012_10_31_19_00/2012_10_31_19_00.mpg;Shintaro ISHIHARA.jpg;11629;11657;36033;581;583;2
/net/per610a/home/mvp/mvp_db/news7-lv/2012/2012_10_31_19_00/2012_10_31_19_00.mpg;Shintaro ISHIHARA.jpg;10265;10305;36033;513;515;2
/net/per610a/home/mvp/mvp_db/news7-lv/2012/2012_10_31_19_00/2012_10_31_19_00.mpg;Shintaro ISHIHARA.jpg;10417;10653;36033;521;533;12
/net/per610a/home/mvp/mvp_db/news7-lv/2012/2012_11_01_19_00/2012_11_01_19_00.mpg;Kenji Eda.jpg;12405;12817;36033;620;641;21
/net/per610a/home/mvp/mvp_db/news7-lv/2012/2012_11_02_19_00/2012_11_02_19_00.mpg;Yoshihiko Noda.jpg;28657;28813;36033;1433;1441;8
/net/per610a/home/mvp/mvp_db/news7-lv/2012/2012_11_02_19_00/2012_11_02_19_00.mpg;Yoshihiko Noda.jpg;30477;31189;36033;1524;1560;36
/net/per610a/home/mvp/mvp_db/news7-lv/2012/2012_11_03_19_00/2012_11_03_19_00.mpg;Katsuya OKADA.jpg;1025;1717;36033;51;85;34
/net/per610a/home/mvp/mvp_db/news7-lv/2012/2012_11_03_19_00/2012_11_03_19_00.mpg;Katsuya OKADA.jpg;2973;3769;36033;148;188;40
/net/per610a/home/mvp/mvp_db/news7-lv/2012/2012_11_03_19_00/2012_11_03_19_00.mpg;Shintaro ISHIHARA.jpg;3773;4049;36033;188;202;14
/net/per610a/home/mvp/mvp_db/news7-lv/2012/2012_11_03_19_00/2012_11_03_19_00.mpg;Toru Hashimoto.jpg;3773;4029;36033;188;201;13
/net/per610a/home/mvp/mvp_db/news7-lv/2012/2012_11_04_19_00/2012_11_04_19_00.mpg;Yoshihiko Noda.jpg;17993;18181;36037;900;909;9
/net/per610a/home/mvp/mvp_db/news7-lv/2012/2012_11_04_19_00/2012_11_04_19_00.mpg;Yoshihiko Noda.jpg;18829;19501;36037;942;975;33
/net/per610a/home/mvp/mvp_db/news7-lv/2012/2012_11_04_19_00/2012_11_04_19_00.mpg;Yoshihiko Noda.jpg;19589;19657;36037;980;983;3
/net/per610a/home/mvp/mvp_db/news7-lv/2012/2012_11_05_19_00/2012_11_05_19_00.mpg;Yoshihiko Noda.jpg;11829;12293;36033;591;615;24
/net/per610a/home/mvp/mvp_db/news7-lv/2012/2012_11_05_19_00/2012_11_05_19_00.mpg;Yoshihiko Noda.jpg;14929;14981;36033;747;749;2
/net/per610a/home/mvp/mvp_db/news7-lv/2012/2012_11_07_19_00/2012_11_07_19_00.mpg;Yoshihiko Noda.jpg;30985;31181;71993;1550;1560;10
/net/per610a/home/mvp/mvp_db/news7-lv/2012/2012_11_07_19_00/2012_11_07_19_00.mpg;Shinzo ABE.jpg;50473;50657;71993;2525;2535;10
/net/per610a/home/mvp/mvp_db/news7-lv/2012/2012_11_09_19_00/2012_11_09_19_00.mpg;Seiji MAEHARA.jpg;3525;3925;36041;176;196;20
/net/per610a/home/mvp/mvp_db/news7-lv/2012/2012_11_09_19_00/2012_11_09_19_00.mpg;Seiji MAEHARA.jpg;5965;6513;36041;298;325;27
/net/per610a/home/mvp/mvp_db/news7-lv/2012/2012_11_09_19_00/2012_11_09_19_00.mpg;Yukio EDANO.jpg;5637;5901;36041;281;295;14
/net/per610a/home/mvp/mvp_db/news7-lv/2012/2012_11_10_19_00/2012_11_10_19_00.mpg;Yoshihiko Noda.jpg;1;37;36033;0;1;1
/net/per610a/home/mvp/mvp_db/news7-lv/2012/2012_11_10_19_00/2012_11_10_19_00.mpg;Yoshihiko Noda.jpg;129;437;36033;6;21;15
/net/per610a/home/mvp/mvp_db/news7-lv/2012/2012_11_10_19_00/2012_11_10_19_00.mpg;Yoshihiko Noda.jpg;945;1489;36033;47;74;27
/net/per610a/home/mvp/mvp_db/news7-lv/2012/2012_11_10_19_00/2012_11_10_19_00.mpg;Yoshihiko Noda.jpg;1693;2109;36033;84;105;21
/net/per610a/home/mvp/mvp_db/news7-lv/2012/2012_11_10_19_00/2012_11_10_19_00.mpg;Yoshihiko Noda.jpg;3721;4337;36033;186;217;31
/net/per610a/home/mvp/mvp_db/news7-lv/2012/2012_11_11_19_00/2012_11_11_19_00.mpg;Shinzo ABE.jpg;6633;8093;36033;331;404;73
/net/per610a/home/mvp/mvp_db/news7-lv/2012/2012_11_11_19_00/2012_11_11_19_00.mpg;Yoshihiko Noda.jpg;6633;7321;36033;331;366;35
/net/per610a/home/mvp/mvp_db/news7-lv/2012/2012_11_11_19_00/2012_11_11_19_00.mpg;Yoshihiko Noda.jpg;9441;10049;36033;472;502;30
/net/per610a/home/mvp/mvp_db/news7-lv/2012/2012_11_11_19_00/2012_11_11_19_00.mpg;Yoshihiko Noda.jpg;11209;11565;36033;560;578;18
/net/per610a/home/mvp/mvp_db/news7-lv/2012/2012_11_12_19_00/2012_11_12_19_00.mpg;Yoshihiko Noda.jpg;57;93;36029;2;4;2
/net/per610a/home/mvp/mvp_db/news7-lv/2012/2012_11_12_19_00/2012_11_12_19_00.mpg;Yoshihiko Noda.jpg;7657;8053;36029;383;402;19
/net/per610a/home/mvp/mvp_db/news7-lv/2012/2012_11_12_19_00/2012_11_12_19_00.mpg;Yoshihiko Noda.jpg;9089;9145;36029;454;457;3
/net/per610a/home/mvp/mvp_db/news7-lv/2012/2012_11_12_19_00/2012_11_12_19_00.mpg;Yoshihiko Noda.jpg;9265;9789;36029;463;489;26
/net/per610a/home/mvp/mvp_db/news7-lv/2012/2012_11_12_19_00/2012_11_12_19_00.mpg;Yoshihiko Noda.jpg;129;201;36029;6;10;4
/net/per610a/home/mvp/mvp_db/news7-lv/2012/2012_11_12_19_00/2012_11_12_19_00.mpg;Yoshihiko Noda.jpg;317;449;36029;15;22;7
/net/per610a/home/mvp/mvp_db/news7-lv/2012/2012_11_12_19_00/2012_11_12_19_00.mpg;Yoshihiko Noda.jpg;989;1005;36029;49;50;1
/net/per610a/home/mvp/mvp_db/news7-lv/2012/2012_11_12_19_00/2012_11_12_19_00.mpg;Yoshihiko Noda.jpg;1993;2521;36029;99;126;27
/net/per610a/home/mvp/mvp_db/news7-lv/2012/2012_11_12_19_00/2012_11_12_19_00.mpg;Yoshihiko Noda.jpg;2677;2925;36029;133;146;13
/net/per610a/home/mvp/mvp_db/news7-lv/2012/2012_11_12_19_00/2012_11_12_19_00.mpg;Yoshihiko Noda.jpg;3021;4741;36029;151;237;86
/net/per610a/home/mvp/mvp_db/news7-lv/2012/2012_11_12_19_00/2012_11_12_19_00.mpg;Yoshihiko Noda.jpg;19157;19449;36029;958;973;15
/net/per610a/home/mvp/mvp_db/news7-lv/2012/2012_11_12_19_00/2012_11_12_19_00.mpg;Toru Hashimoto.jpg;12137;12661;36029;607;633;26
/net/per610a/home/mvp/mvp_db/news7-lv/2012/2012_11_12_19_00/2012_11_12_19_00.mpg;Toru Hashimoto.jpg;27169;27337;36029;1359;1368;9
/net/per610a/home/mvp/mvp_db/news7-lv/2012/2012_11_12_19_00/2012_11_12_19_00.mpg;Shintaro ISHIHARA.jpg;12137;12661;36029;607;633;26
/net/per610a/home/mvp/mvp_db/news7-lv/2012/2012_11_12_19_00/2012_11_12_19_00.mpg;Ichiro OZAWA.jpg;14965;15165;36029;748;758;10
/net/per610a/home/mvp/mvp_db/news7-lv/2012/2012_11_13_19_00/2012_11_13_19_00.mpg;Shintaro ISHIHARA.jpg;7377;8181;36041;369;409;40
/net/per610a/home/mvp/mvp_db/news7-lv/2012/2012_11_14_19_00/2012_11_14_19_00.mpg;Yoshihiko Noda.jpg;793;857;72005;39;42;3
/net/per610a/home/mvp/mvp_db/news7-lv/2012/2012_11_14_19_00/2012_11_14_19_00.mpg;Yoshihiko Noda.jpg;925;1221;72005;46;61;15
/net/per610a/home/mvp/mvp_db/news7-lv/2012/2012_11_14_19_00/2012_11_14_19_00.mpg;Yoshihiko Noda.jpg;3585;3725;72005;179;186;7
/net/per610a/home/mvp/mvp_db/news7-lv/2012/2012_11_14_19_00/2012_11_14_19_00.mpg;Yoshihiko Noda.jpg;6157;7077;72005;308;354;46
/net/per610a/home/mvp/mvp_db/news7-lv/2012/2012_11_14_19_00/2012_11_14_19_00.mpg;Yoshihiko Noda.jpg;14149;14225;72005;707;711;4
/net/per610a/home/mvp/mvp_db/news7-lv/2012/2012_11_14_19_00/2012_11_14_19_00.mpg;Yoshihiko Noda.jpg;36753;37077;72005;1839;1855;16
/net/per610a/home/mvp/mvp_db/news7-lv/2012/2012_11_14_19_00/2012_11_14_19_00.mpg;Yoshihiko Noda.jpg;37337;37581;72005;1868;1880;12
/net/per610a/home/mvp/mvp_db/news7-lv/2012/2012_11_14_19_00/2012_11_14_19_00.mpg;Yoshihiko Noda.jpg;48133;48409;72005;2408;2422;14
/net/per610a/home/mvp/mvp_db/news7-lv/2012/2012_11_14_19_00/2012_11_14_19_00.mpg;Yoshihiko Noda.jpg;48669;48945;72005;2435;2449;14
/net/per610a/home/mvp/mvp_db/news7-lv/2012/2012_11_14_19_00/2012_11_14_19_00.mpg;Shinzo ABE.jpg;10353;14145;72005;518;707;189
/net/per610a/home/mvp/mvp_db/news7-lv/2012/2012_11_14_19_00/2012_11_14_19_00.mpg;Katsuya OKADA.jpg;15525;34625;72005;776;1732;956
/net/per610a/home/mvp/mvp_db/news7-lv/2012/2012_11_15_19_00/2012_11_15_19_00.mpg;Shintaro ISHIHARA.jpg;293;353;36033;14;17;3
/net/per610a/home/mvp/mvp_db/news7-lv/2012/2012_11_15_19_00/2012_11_15_19_00.mpg;Shintaro ISHIHARA.jpg;9389;9449;36033;469;472;3
/net/per610a/home/mvp/mvp_db/news7-lv/2012/2012_11_15_19_00/2012_11_15_19_00.mpg;Shintaro ISHIHARA.jpg;9649;9981;36033;482;499;17
/net/per610a/home/mvp/mvp_db/news7-lv/2012/2012_11_15_19_00/2012_11_15_19_00.mpg;Shintaro ISHIHARA.jpg;10053;10057;36033;503;503;0
/net/per610a/home/mvp/mvp_db/news7-lv/2012/2012_11_16_19_00/2012_11_16_19_00.mpg;Yoshihiko Noda.jpg;1417;1425;71997;70;71;1
/net/per610a/home/mvp/mvp_db/news7-lv/2012/2012_11_16_19_00/2012_11_16_19_00.mpg;Yoshihiko Noda.jpg;3461;3605;71997;173;180;7
/net/per610a/home/mvp/mvp_db/news7-lv/2012/2012_11_16_19_00/2012_11_16_19_00.mpg;Yoshihiko Noda.jpg;8177;9345;71997;409;467;58
/net/per610a/home/mvp/mvp_db/news7-lv/2012/2012_11_16_19_00/2012_11_16_19_00.mpg;Yoshihiko Noda.jpg;59545;59969;71997;2979;3001;22
/net/per610a/home/mvp/mvp_db/news7-lv/2012/2012_11_16_19_00/2012_11_16_19_00.mpg;Toru Hashimoto.jpg;7029;7549;71997;351;377;26
/net/per610a/home/mvp/mvp_db/news7-lv/2012/2012_11_16_19_00/2012_11_16_19_00.mpg;Toru Hashimoto.jpg;46989;47165;71997;2351;2360;9
/net/per610a/home/mvp/mvp_db/news7-lv/2012/2012_11_16_19_00/2012_11_16_19_00.mpg;Toru Hashimoto.jpg;47261;57989;71997;2365;2901;536
/net/per610a/home/mvp/mvp_db/news7-lv/2012/2012_11_16_19_00/2012_11_16_19_00.mpg;Yasuo FUKUDA.jpg;19557;21669;71997;978;1084;106
/net/per610a/home/mvp/mvp_db/news7-lv/2012/2012_11_16_19_00/2012_11_16_19_00.mpg;Shintaro ISHIHARA.jpg;52581;52849;71997;2631;2644;13
/net/per610a/home/mvp/mvp_db/news7-lv/2012/2012_11_16_19_00/2012_11_16_19_00.mpg;Shinzo ABE.jpg;59545;59969;71997;2979;3001;22
/net/per610a/home/mvp/mvp_db/news7-lv/2012/2012_11_17_19_00/2012_11_17_19_00.mpg;Shintaro ISHIHARA.jpg;181;317;36033;9;15;6
/net/per610a/home/mvp/mvp_db/news7-lv/2012/2012_11_17_19_00/2012_11_17_19_00.mpg;Shintaro ISHIHARA.jpg;1701;1713;36033;85;85;0
/net/per610a/home/mvp/mvp_db/news7-lv/2012/2012_11_17_19_00/2012_11_17_19_00.mpg;Shintaro ISHIHARA.jpg;1913;3893;36033;95;194;99
/net/per610a/home/mvp/mvp_db/news7-lv/2012/2012_11_17_19_00/2012_11_17_19_00.mpg;Shintaro ISHIHARA.jpg;3961;3961;36033;198;198;0
/net/per610a/home/mvp/mvp_db/news7-lv/2012/2012_11_17_19_00/2012_11_17_19_00.mpg;Shintaro ISHIHARA.jpg;9093;9141;36033;454;457;3
/net/per610a/home/mvp/mvp_db/news7-lv/2012/2012_11_17_19_00/2012_11_17_19_00.mpg;Shinzo ABE.jpg;905;1329;36033;45;66;21
/net/per610a/home/mvp/mvp_db/news7-lv/2012/2012_11_17_19_00/2012_11_17_19_00.mpg;Shinzo ABE.jpg;5841;7241;36033;292;362;70
/net/per610a/home/mvp/mvp_db/news7-lv/2012/2012_11_17_19_00/2012_11_17_19_00.mpg;Yoshihiko Noda.jpg;905;1541;36033;45;77;32
/net/per610a/home/mvp/mvp_db/news7-lv/2012/2012_11_17_19_00/2012_11_17_19_00.mpg;Yoshihiko Noda.jpg;4609;5629;36033;230;281;51
/net/per610a/home/mvp/mvp_db/news7-lv/2012/2012_11_17_19_00/2012_11_17_19_00.mpg;Toru Hashimoto.jpg;3165;3165;36033;158;158;0
/net/per610a/home/mvp/mvp_db/news7-lv/2012/2012_11_17_19_00/2012_11_17_19_00.mpg;Toru Hashimoto.jpg;3965;4261;36033;198;213;15
/net/per610a/home/mvp/mvp_db/news7-lv/2012/2012_11_17_19_00/2012_11_17_19_00.mpg;Toru Hashimoto.jpg;7865;7989;36033;393;399;6
/net/per610a/home/mvp/mvp_db/news7-lv/2012/2012_11_17_19_00/2012_11_17_19_00.mpg;Toru Hashimoto.jpg;8081;8733;36033;404;436;32
/net/per610a/home/mvp/mvp_db/news7-lv/2012/2012_11_17_19_00/2012_11_17_19_00.mpg;Toru Hashimoto.jpg;9765;10785;36033;488;539;51
/net/per610a/home/mvp/mvp_db/news7-lv/2012/2012_11_17_19_00/2012_11_17_19_00.mpg;Shintaro ISHIHARA.jpg;7713;7989;36033;385;399;14
/net/per610a/home/mvp/mvp_db/news7-lv/2012/2012_11_17_19_00/2012_11_17_19_00.mpg;Shintaro ISHIHARA.jpg;8849;9053;36033;442;452;10
/net/per610a/home/mvp/mvp_db/news7-lv/2012/2012_11_17_19_00/2012_11_17_19_00.mpg;Shintaro ISHIHARA.jpg;9149;9397;36033;457;470;13
/net/per610a/home/mvp/mvp_db/news7-lv/2012/2012_11_17_19_00/2012_11_17_19_00.mpg;Shintaro ISHIHARA.jpg;9597;9613;36033;480;481;1
/net/per610a/home/mvp/mvp_db/news7-lv/2012/2012_11_17_19_00/2012_11_17_19_00.mpg;Natsuo YAMAGUCHI.jpg;11309;11861;36033;565;593;28
/net/per610a/home/mvp/mvp_db/news7-lv/2012/2012_11_18_19_00/2012_11_18_19_00.mpg;Yoshihiko Noda.jpg;913;2277;36037;45;113;68
/net/per610a/home/mvp/mvp_db/news7-lv/2012/2012_11_18_19_00/2012_11_18_19_00.mpg;Yoshihiko Noda.jpg;2541;5037;36037;127;252;125
/net/per610a/home/mvp/mvp_db/news7-lv/2012/2012_11_18_19_00/2012_11_18_19_00.mpg;Shinzo ABE.jpg;925;1545;36037;46;77;31
/net/per610a/home/mvp/mvp_db/news7-lv/2012/2012_11_19_19_00/2012_11_19_19_00.mpg;Kohei Otsuka.jpg;1889;1945;36033;94;97;3
/net/per610a/home/mvp/mvp_db/news7-lv/2012/2012_11_19_19_00/2012_11_19_19_00.mpg;Kohei Otsuka.jpg;2189;2341;36033;109;117;8
/net/per610a/home/mvp/mvp_db/news7-lv/2012/2012_11_19_19_00/2012_11_19_19_00.mpg;Shintaro ISHIHARA.jpg;7717;7797;36033;386;390;4
/net/per610a/home/mvp/mvp_db/news7-lv/2012/2012_11_19_19_00/2012_11_19_19_00.mpg;Shinzo ABE.jpg;10233;10745;36033;512;537;25
/net/per610a/home/mvp/mvp_db/news7-lv/2012/2012_11_19_19_00/2012_11_19_19_00.mpg;Yoshihiko Noda.jpg;10993;11129;36033;550;556;6
/net/per610a/home/mvp/mvp_db/news7-lv/2012/2012_11_19_19_00/2012_11_19_19_00.mpg;Yoshihiko Noda.jpg;26117;26609;36033;1306;1331;25
/net/per610a/home/mvp/mvp_db/news7-lv/2012/2012_11_19_19_00/2012_11_19_19_00.mpg;Yoshihiko Noda.jpg;26801;27129;36033;1341;1357;16
/net/per610a/home/mvp/mvp_db/news7-lv/2012/2012_11_20_19_00/2012_11_20_19_00.mpg;Yoshihiko Noda.jpg;1;25;36033;0;1;1
/net/per610a/home/mvp/mvp_db/news7-lv/2012/2012_11_20_19_00/2012_11_20_19_00.mpg;Yoshihiko Noda.jpg;129;253;36033;6;12;6
/net/per610a/home/mvp/mvp_db/news7-lv/2012/2012_11_20_19_00/2012_11_20_19_00.mpg;Yoshihiko Noda.jpg;2593;2849;36033;129;142;13
/net/per610a/home/mvp/mvp_db/news7-lv/2012/2012_11_20_19_00/2012_11_20_19_00.mpg;Yoshihiko Noda.jpg;4921;4981;36033;246;249;3
/net/per610a/home/mvp/mvp_db/news7-lv/2012/2012_11_20_19_00/2012_11_20_19_00.mpg;Yukio EDANO.jpg;3917;3973;36033;195;198;3
/net/per610a/home/mvp/mvp_db/news7-lv/2012/2012_11_20_19_00/2012_11_20_19_00.mpg;Yukio EDANO.jpg;4109;4441;36033;205;222;17
/net/per610a/home/mvp/mvp_db/news7-lv/2012/2012_11_20_19_00/2012_11_20_19_00.mpg;Yoshihiko Noda.jpg;6877;7377;36033;344;369;25
/net/per610a/home/mvp/mvp_db/news7-lv/2012/2012_11_20_19_00/2012_11_20_19_00.mpg;Yoshihiko Noda.jpg;9737;10805;36033;487;540;53
/net/per610a/home/mvp/mvp_db/news7-lv/2012/2012_11_20_19_00/2012_11_20_19_00.mpg;Shinzo ABE.jpg;9225;9721;36033;461;486;25
/net/per610a/home/mvp/mvp_db/news7-lv/2012/2012_11_20_19_00/2012_11_20_19_00.mpg;Shintaro ISHIHARA.jpg;12981;13333;36033;649;667;18
/net/per610a/home/mvp/mvp_db/news7-lv/2012/2012_11_20_19_00/2012_11_20_19_00.mpg;Ichiro Matsui.jpeg;13413;13725;36033;671;686;15
/net/per610a/home/mvp/mvp_db/news7-lv/2012/2012_11_20_19_00/2012_11_20_19_00.mpg;Toru Hashimoto.jpg;13849;14865;36033;692;743;51
/net/per610a/home/mvp/mvp_db/news7-lv/2012/2012_11_20_19_00/2012_11_20_19_00.mpg;Ichiro OZAWA.jpg;20285;20629;36033;1015;1032;17
/net/per610a/home/mvp/mvp_db/news7-lv/2012/2012_11_20_19_00/2012_11_20_19_00.mpg;Ichiro OZAWA.jpg;22161;22893;36033;1108;1145;37
/net/per610a/home/mvp/mvp_db/news7-lv/2012/2012_11_20_19_00/2012_11_20_19_00.mpg;Seiji MAEHARA.jpg;26985;27369;36033;1350;1369;19
/net/per610a/home/mvp/mvp_db/news7-lv/2012/2012_11_21_19_00/2012_11_21_19_00.mpg;Yukio HATOYAMA.jpg;85;97;36033;4;4;0
/net/per610a/home/mvp/mvp_db/news7-lv/2012/2012_11_21_19_00/2012_11_21_19_00.mpg;Yukio HATOYAMA.jpg;10349;10841;36033;517;542;25
/net/per610a/home/mvp/mvp_db/news7-lv/2012/2012_11_21_19_00/2012_11_21_19_00.mpg;Yukio HATOYAMA.jpg;11321;11549;36033;566;577;11
/net/per610a/home/mvp/mvp_db/news7-lv/2012/2012_11_21_19_00/2012_11_21_19_00.mpg;Shinzo ABE.jpg;957;1317;36033;47;65;18
/net/per610a/home/mvp/mvp_db/news7-lv/2012/2012_11_21_19_00/2012_11_21_19_00.mpg;Shinzo ABE.jpg;1393;1449;36033;69;72;3
/net/per610a/home/mvp/mvp_db/news7-lv/2012/2012_11_21_19_00/2012_11_21_19_00.mpg;Shinzo ABE.jpg;3997;4669;36033;199;233;34
/net/per610a/home/mvp/mvp_db/news7-lv/2012/2012_11_21_19_00/2012_11_21_19_00.mpg;Shinzo ABE.jpg;5037;5037;36033;252;252;0
/net/per610a/home/mvp/mvp_db/news7-lv/2012/2012_11_21_19_00/2012_11_21_19_00.mpg;Shinzo ABE.jpg;5265;5565;36033;263;278;15
/net/per610a/home/mvp/mvp_db/news7-lv/2012/2012_11_21_19_00/2012_11_21_19_00.mpg;Shinzo ABE.jpg;6045;6045;36033;302;302;0
/net/per610a/home/mvp/mvp_db/news7-lv/2012/2012_11_21_19_00/2012_11_21_19_00.mpg;Shinzo ABE.jpg;6285;6629;36033;314;331;17
/net/per610a/home/mvp/mvp_db/news7-lv/2012/2012_11_21_19_00/2012_11_21_19_00.mpg;Yoshihiko Noda.jpg;10345;10849;36033;517;542;25
/net/per610a/home/mvp/mvp_db/news7-lv/2012/2012_11_21_19_00/2012_11_21_19_00.mpg;Yoshihiko Noda.jpg;12105;14345;36033;605;717;112
/net/per610a/home/mvp/mvp_db/news7-lv/2012/2012_11_22_19_00/2012_11_22_19_00.mpg;Shinzo ABE.jpg;16309;16873;38433;816;844;28
/net/per610a/home/mvp/mvp_db/news7-lv/2012/2012_11_22_19_00/2012_11_22_19_00.mpg;Shinzo ABE.jpg;18481;18521;38433;924;926;2
/net/per610a/home/mvp/mvp_db/news7-lv/2012/2012_11_22_19_00/2012_11_22_19_00.mpg;Yoshihiko Noda.jpg;16309;18429;38433;816;922;106
/net/per610a/home/mvp/mvp_db/news7-lv/2012/2012_11_22_19_00/2012_11_22_19_00.mpg;Yoshihiko Noda.jpg;20913;21445;38433;1046;1073;27
/net/per610a/home/mvp/mvp_db/news7-lv/2012/2012_11_22_19_00/2012_11_22_19_00.mpg;Natsuo YAMAGUCHI.jpg;18857;19657;38433;943;983;40
/net/per610a/home/mvp/mvp_db/news7-lv/2012/2012_11_22_19_00/2012_11_22_19_00.mpg;Shizuka KAMEI.jpg;21669;22153;38433;1084;1108;24
/net/per610a/home/mvp/mvp_db/news7-lv/2012/2012_11_22_19_00/2012_11_22_19_00.mpg;Mizuho FUKUSHIMA.jpg;23697;24017;38433;1185;1201;16
/net/per610a/home/mvp/mvp_db/news7-lv/2012/2012_11_23_19_00/2012_11_23_19_00.mpg;Shinzo ABE.jpg;10529;11301;36033;526;565;39
/net/per610a/home/mvp/mvp_db/news7-lv/2012/2012_11_23_19_00/2012_11_23_19_00.mpg;Shinzo ABE.jpg;12857;14113;36033;643;706;63
/net/per610a/home/mvp/mvp_db/news7-lv/2012/2012_11_23_19_00/2012_11_23_19_00.mpg;Yoshihiko Noda.jpg;10529;11373;36033;526;569;43
/net/per610a/home/mvp/mvp_db/news7-lv/2012/2012_11_23_19_00/2012_11_23_19_00.mpg;Yoshihiko Noda.jpg;11449;12821;36033;572;641;69
/net/per610a/home/mvp/mvp_db/news7-lv/2012/2012_11_23_19_00/2012_11_23_19_00.mpg;Toru Hashimoto.jpg;14577;14849;36033;729;743;14
/net/per610a/home/mvp/mvp_db/news7-lv/2012/2012_11_23_19_00/2012_11_23_19_00.mpg;Kenji Eda.jpg;14577;15417;36033;729;771;42
/net/per610a/home/mvp/mvp_db/news7-lv/2012/2012_11_23_19_00/2012_11_23_19_00.mpg;Yoshimi WATANABE.jpg;14577;15417;36033;729;771;42
/net/per610a/home/mvp/mvp_db/news7-lv/2012/2012_11_24_19_00/2012_11_24_19_00.mpg;Yoshihiko Noda.jpg;105;445;36033;5;22;17
/net/per610a/home/mvp/mvp_db/news7-lv/2012/2012_11_24_19_00/2012_11_24_19_00.mpg;Yoshihiko Noda.jpg;4809;5609;36033;240;280;40
/net/per610a/home/mvp/mvp_db/news7-lv/2012/2012_11_24_19_00/2012_11_24_19_00.mpg;Yoshihiko Noda.jpg;8049;9757;36033;402;488;86
/net/per610a/home/mvp/mvp_db/news7-lv/2012/2012_11_24_19_00/2012_11_24_19_00.mpg;Shinzo ABE.jpg;8049;8201;36033;402;410;8
/net/per610a/home/mvp/mvp_db/news7-lv/2012/2012_11_24_19_00/2012_11_24_19_00.mpg;Toru Hashimoto.jpg;10449;11477;36033;522;574;52
/net/per610a/home/mvp/mvp_db/news7-lv/2012/2012_11_25_19_00/2012_11_25_19_00.mpg;Yoshihiko Noda.jpg;797;1569;36033;39;78;39
/net/per610a/home/mvp/mvp_db/news7-lv/2012/2012_11_25_19_00/2012_11_25_19_00.mpg;Shinzo ABE.jpg;801;2637;36033;40;131;91
/net/per610a/home/mvp/mvp_db/news7-lv/2012/2012_11_25_19_00/2012_11_25_19_00.mpg;Shinzo ABE.jpg;2961;4661;36033;148;233;85
/net/per610a/home/mvp/mvp_db/news7-lv/2012/2012_11_26_19_00/2012_11_26_19_00.mpg;Yoshihiko Noda.jpg;1145;1437;36033;57;71;14
/net/per610a/home/mvp/mvp_db/news7-lv/2012/2012_11_26_19_00/2012_11_26_19_00.mpg;Yoshihiko Noda.jpg;12017;12457;36033;601;623;22
/net/per610a/home/mvp/mvp_db/news7-lv/2012/2012_11_26_19_00/2012_11_26_19_00.mpg;Yoshihiko Noda.jpg;13009;13201;36033;650;660;10
/net/per610a/home/mvp/mvp_db/news7-lv/2012/2012_11_26_19_00/2012_11_26_19_00.mpg;Shinzo ABE.jpg;1165;1437;36033;58;71;13
/net/per610a/home/mvp/mvp_db/news7-lv/2012/2012_11_26_19_00/2012_11_26_19_00.mpg;Shinzo ABE.jpg;12017;12457;36033;601;623;22
/net/per610a/home/mvp/mvp_db/news7-lv/2012/2012_11_26_19_00/2012_11_26_19_00.mpg;Shinzo ABE.jpg;13785;14009;36033;689;700;11
/net/per610a/home/mvp/mvp_db/news7-lv/2012/2012_11_26_19_00/2012_11_26_19_00.mpg;Ichiro OZAWA.jpg;5501;6521;36033;275;326;51
/net/per610a/home/mvp/mvp_db/news7-lv/2012/2012_11_26_19_00/2012_11_26_19_00.mpg;Kazuo SHII.jpg;9573;9761;36033;479;488;9
/net/per610a/home/mvp/mvp_db/news7-lv/2012/2012_11_27_19_00/2012_11_27_19_00.mpg;Ichiro OZAWA.jpg;4229;5121;36041;211;256;45
/net/per610a/home/mvp/mvp_db/news7-lv/2012/2012_11_27_19_00/2012_11_27_19_00.mpg;Mizuho FUKUSHIMA.jpg;5749;6169;36041;287;308;21
/net/per610a/home/mvp/mvp_db/news7-lv/2012/2012_11_27_19_00/2012_11_27_19_00.mpg;Shinzo ABE.jpg;6721;7217;36041;336;361;25
/net/per610a/home/mvp/mvp_db/news7-lv/2012/2012_11_27_19_00/2012_11_27_19_00.mpg;Yoshihiko Noda.jpg;11489;11861;36041;574;593;19
/net/per610a/home/mvp/mvp_db/news7-lv/2012/2012_11_27_19_00/2012_11_27_19_00.mpg;Yoshihiko Noda.jpg;15149;16997;36041;757;850;93
/net/per610a/home/mvp/mvp_db/news7-lv/2012/2012_11_27_19_00/2012_11_27_19_00.mpg;Yoshihiko Noda.jpg;17165;17617;36041;858;881;23
/net/per610a/home/mvp/mvp_db/news7-lv/2012/2012_11_27_19_00/2012_11_27_19_00.mpg;Yoshihiko Noda.jpg;17709;18405;36041;885;920;35
/net/per610a/home/mvp/mvp_db/news7-lv/2012/2012_11_27_19_00/2012_11_27_19_00.mpg;Yoshihiko Noda.jpg;18965;19073;36041;948;954;6
/net/per610a/home/mvp/mvp_db/news7-lv/2012/2012_11_27_19_00/2012_11_27_19_00.mpg;Yoshihiko Noda.jpg;20005;20113;36041;1000;1006;6
/net/per610a/home/mvp/mvp_db/news7-lv/2012/2012_11_28_19_00/2012_11_28_19_00.mpg;Yoshihiko Noda.jpg;1445;2101;36033;72;105;33
/net/per610a/home/mvp/mvp_db/news7-lv/2012/2012_11_28_19_00/2012_11_28_19_00.mpg;Shinzo ABE.jpg;2105;2173;36033;105;108;3
/net/per610a/home/mvp/mvp_db/news7-lv/2012/2012_11_28_19_00/2012_11_28_19_00.mpg;Shinzo ABE.jpg;2317;2825;36033;115;141;26
/net/per610a/home/mvp/mvp_db/news7-lv/2012/2012_11_28_19_00/2012_11_28_19_00.mpg;Shizuka KAMEI.jpg;4345;4665;36033;217;233;16
/net/per610a/home/mvp/mvp_db/news7-lv/2012/2012_11_28_19_00/2012_11_28_19_00.mpg;Yoshimi WATANABE.jpg;9969;10265;36033;498;513;15
/net/per610a/home/mvp/mvp_db/news7-lv/2012/2012_11_28_19_00/2012_11_28_19_00.mpg;Yoshimi WATANABE.jpg;11253;12321;36033;563;616;53
/net/per610a/home/mvp/mvp_db/news7-lv/2012/2012_11_29_19_00/2012_11_29_19_00.mpg;Shintaro ISHIHARA.jpg;805;813;36045;40;40;0
/net/per610a/home/mvp/mvp_db/news7-lv/2012/2012_11_29_19_00/2012_11_29_19_00.mpg;Shintaro ISHIHARA.jpg;6889;6893;36045;344;344;0
/net/per610a/home/mvp/mvp_db/news7-lv/2012/2012_11_29_19_00/2012_11_29_19_00.mpg;Shintaro ISHIHARA.jpg;8637;8637;36045;432;432;0
/net/per610a/home/mvp/mvp_db/news7-lv/2012/2012_11_29_19_00/2012_11_29_19_00.mpg;Shintaro ISHIHARA.jpg;11857;11941;36045;593;597;4
/net/per610a/home/mvp/mvp_db/news7-lv/2012/2012_11_29_19_00/2012_11_29_19_00.mpg;Shintaro ISHIHARA.jpg;12249;12617;36045;613;631;18
/net/per610a/home/mvp/mvp_db/news7-lv/2012/2012_11_29_19_00/2012_11_29_19_00.mpg;Shintaro ISHIHARA.jpg;13093;13177;36045;655;659;4
/net/per610a/home/mvp/mvp_db/news7-lv/2012/2012_11_29_19_00/2012_11_29_19_00.mpg;Shinzo ABE.jpg;805;837;36045;40;41;1
/net/per610a/home/mvp/mvp_db/news7-lv/2012/2012_11_29_19_00/2012_11_29_19_00.mpg;Shinzo ABE.jpg;2561;3117;36045;128;156;28
/net/per610a/home/mvp/mvp_db/news7-lv/2012/2012_11_29_19_00/2012_11_29_19_00.mpg;Yoshihiko Noda.jpg;809;949;36045;40;47;7
/net/per610a/home/mvp/mvp_db/news7-lv/2012/2012_11_29_19_00/2012_11_29_19_00.mpg;Yoshihiko Noda.jpg;1213;2557;36045;60;127;67
/net/per610a/home/mvp/mvp_db/news7-lv/2012/2012_11_29_19_00/2012_11_29_19_00.mpg;Toru Hashimoto.jpg;813;877;36045;40;43;3
/net/per610a/home/mvp/mvp_db/news7-lv/2012/2012_11_29_19_00/2012_11_29_19_00.mpg;Toru Hashimoto.jpg;6889;7313;36045;344;366;22
/net/per610a/home/mvp/mvp_db/news7-lv/2012/2012_11_29_19_00/2012_11_29_19_00.mpg;Toru Hashimoto.jpg;8949;9541;36045;447;477;30
/net/per610a/home/mvp/mvp_db/news7-lv/2012/2012_11_29_19_00/2012_11_29_19_00.mpg;Toru Hashimoto.jpg;10073;10609;36045;504;530;26
/net/per610a/home/mvp/mvp_db/news7-lv/2012/2012_11_29_19_00/2012_11_29_19_00.mpg;Toru Hashimoto.jpg;11861;12069;36045;593;604;11
/net/per610a/home/mvp/mvp_db/news7-lv/2012/2012_11_29_19_00/2012_11_29_19_00.mpg;Toru Hashimoto.jpg;12245;12253;36045;612;613;1
/net/per610a/home/mvp/mvp_db/news7-lv/2012/2012_11_29_19_00/2012_11_29_19_00.mpg;Toru Hashimoto.jpg;13089;13177;36045;655;659;4
/net/per610a/home/mvp/mvp_db/news7-lv/2012/2012_11_29_19_00/2012_11_29_19_00.mpg;Shintaro ISHIHARA.jpg;6097;6145;36045;305;307;2
/net/per610a/home/mvp/mvp_db/news7-lv/2012/2012_11_29_19_00/2012_11_29_19_00.mpg;Shintaro ISHIHARA.jpg;6289;6777;36045;314;339;25
/net/per610a/home/mvp/mvp_db/news7-lv/2012/2012_11_29_19_00/2012_11_29_19_00.mpg;Shintaro ISHIHARA.jpg;8593;8653;36045;430;433;3
/net/per610a/home/mvp/mvp_db/news7-lv/2012/2012_11_29_19_00/2012_11_29_19_00.mpg;Shintaro ISHIHARA.jpg;8741;8817;36045;437;441;4
/net/per610a/home/mvp/mvp_db/news7-lv/2012/2012_11_29_19_00/2012_11_29_19_00.mpg;Shintaro ISHIHARA.jpg;8949;9073;36045;447;454;7
/net/per610a/home/mvp/mvp_db/news7-lv/2012/2012_11_29_19_00/2012_11_29_19_00.mpg;Shintaro ISHIHARA.jpg;9357;9413;36045;468;471;3
/net/per610a/home/mvp/mvp_db/news7-lv/2012/2012_11_29_19_00/2012_11_29_19_00.mpg;Shintaro ISHIHARA.jpg;9509;9509;36045;475;475;0
/net/per610a/home/mvp/mvp_db/news7-lv/2012/2012_11_29_19_00/2012_11_29_19_00.mpg;Shintaro ISHIHARA.jpg;10073;10609;36045;504;530;26
/net/per610a/home/mvp/mvp_db/news7-lv/2012/2012_11_30_19_00/2012_11_30_19_00.mpg;Yoshihiko Noda.jpg;945;1497;36033;47;74;27
/net/per610a/home/mvp/mvp_db/news7-lv/2012/2012_11_30_19_00/2012_11_30_19_00.mpg;Yoshihiko Noda.jpg;1569;2209;36033;78;110;32
/net/per610a/home/mvp/mvp_db/news7-lv/2012/2012_11_30_19_00/2012_11_30_19_00.mpg;Yoshihiko Noda.jpg;6765;7389;36033;338;369;31
/net/per610a/home/mvp/mvp_db/news7-lv/2012/2012_11_30_19_00/2012_11_30_19_00.mpg;Yoshihiko Noda.jpg;8893;8993;36033;444;449;5
/net/per610a/home/mvp/mvp_db/news7-lv/2012/2012_11_30_19_00/2012_11_30_19_00.mpg;Yoshihiko Noda.jpg;10109;10405;36033;505;520;15
/net/per610a/home/mvp/mvp_db/news7-lv/2012/2012_11_30_19_00/2012_11_30_19_00.mpg;Yoshihiko Noda.jpg;10569;10753;36033;528;538;10
/net/per610a/home/mvp/mvp_db/news7-lv/2012/2012_11_30_19_00/2012_11_30_19_00.mpg;Yoshihiko Noda.jpg;10817;11029;36033;541;551;10
/net/per610a/home/mvp/mvp_db/news7-lv/2012/2012_11_30_19_00/2012_11_30_19_00.mpg;Shinzo ABE.jpg;2213;2821;36033;110;141;31
/net/per610a/home/mvp/mvp_db/news7-lv/2012/2012_11_30_19_00/2012_11_30_19_00.mpg;Shinzo ABE.jpg;7445;8705;36033;372;435;63
/net/per610a/home/mvp/mvp_db/news7-lv/2012/2012_11_30_19_00/2012_11_30_19_00.mpg;Shinzo ABE.jpg;8897;10077;36033;445;504;59
/net/per610a/home/mvp/mvp_db/news7-lv/2012/2012_11_30_19_00/2012_11_30_19_00.mpg;Shinzo ABE.jpg;11033;11629;36033;552;581;29
/net/per610a/home/mvp/mvp_db/news7-lv/2012/2012_11_30_19_00/2012_11_30_19_00.mpg;Yukiko Kada.jpg;2849;5049;36033;142;252;110
/net/per610a/home/mvp/mvp_db/news7-lv/2012/2012_11_30_19_00/2012_11_30_19_00.mpg;Mizuho FUKUSHIMA.jpg;5073;6665;36033;253;333;80
/net/per610a/home/mvp/mvp_db/news7-lv/2012/2012_11_30_19_00/2012_11_30_19_00.mpg;Shintaro ISHIHARA.jpg;8741;8837;36033;437;442;5
/net/per610a/home/mvp/mvp_db/news7-lv/2012/2012_11_30_19_00/2012_11_30_19_00.mpg;Shintaro ISHIHARA.jpg;11765;11945;36033;588;597;9
/net/per610a/home/mvp/mvp_db/news7-lv/2012/2012_11_30_19_00/2012_11_30_19_00.mpg;Shintaro ISHIHARA.jpg;12029;13125;36033;601;656;55
/net/per610a/home/mvp/mvp_db/news7-lv/2012/2012_12_01_19_00/2012_12_01_19_00.mpg;Yoshihiko Noda.jpg;5749;5941;36033;287;297;10
/net/per610a/home/mvp/mvp_db/news7-lv/2012/2012_12_02_19_00/2012_12_02_19_00.mpg;Yoshihiko Noda.jpg;16897;17341;36029;845;867;22
/net/per610a/home/mvp/mvp_db/news7-lv/2012/2012_12_02_19_00/2012_12_02_19_00.mpg;Yukiko Kada.jpg;17345;18985;36029;867;950;83
/net/per610a/home/mvp/mvp_db/news7-lv/2012/2012_12_02_19_00/2012_12_02_19_00.mpg;Yukiko Kada.jpg;23761;23773;36029;1189;1189;0
/net/per610a/home/mvp/mvp_db/news7-lv/2012/2012_12_02_19_00/2012_12_02_19_00.mpg;Yukiko Kada.jpg;24997;25665;36029;1250;1284;34
/net/per610a/home/mvp/mvp_db/news7-lv/2012/2012_12_02_19_00/2012_12_02_19_00.mpg;Yukiko Kada.jpg;28333;28685;36029;1417;1435;18
/net/per610a/home/mvp/mvp_db/news7-lv/2012/2012_12_02_19_00/2012_12_02_19_00.mpg;Yukiko Kada.jpg;21953;22025;36029;1098;1102;4
/net/per610a/home/mvp/mvp_db/news7-lv/2012/2012_12_02_19_00/2012_12_02_19_00.mpg;Yukiko Kada.jpg;26849;27117;36029;1343;1357;14
/net/per610a/home/mvp/mvp_db/news7-lv/2012/2012_12_02_19_00/2012_12_02_19_00.mpg;Yukiko Kada.jpg;27225;27501;36029;1362;1376;14
/net/per610a/home/mvp/mvp_db/news7-lv/2012/2012_12_03_19_00/2012_12_03_19_00.mpg;Yoshihiko Noda.jpg;10277;12257;36033;514;613;99
/net/per610a/home/mvp/mvp_db/news7-lv/2012/2012_12_03_19_00/2012_12_03_19_00.mpg;Yoshihiko Noda.jpg;20341;20725;36033;1017;1037;20
/net/per610a/home/mvp/mvp_db/news7-lv/2012/2012_12_03_19_00/2012_12_03_19_00.mpg;Shinzo ABE.jpg;20341;20725;36033;1017;1037;20
/net/per610a/home/mvp/mvp_db/news7-lv/2012/2012_12_04_19_00/2012_12_04_19_00.mpg;Yoshihiko Noda.jpg;1317;1365;125953;65;68;3
/net/per610a/home/mvp/mvp_db/news7-lv/2012/2012_12_04_19_00/2012_12_04_19_00.mpg;Yoshihiko Noda.jpg;96429;102005;125953;4825;5104;279
/net/per610a/home/mvp/mvp_db/news7-lv/2012/2012_12_04_19_00/2012_12_04_19_00.mpg;Yoshihiko Noda.jpg;104613;109877;125953;5235;5498;263
/net/per610a/home/mvp/mvp_db/news7-lv/2012/2012_12_04_19_00/2012_12_04_19_00.mpg;Yoshihiko Noda.jpg;110137;116321;125953;5511;5820;309
/net/per610a/home/mvp/mvp_db/news7-lv/2012/2012_12_04_19_00/2012_12_04_19_00.mpg;Shinzo ABE.jpg;3753;4133;125953;187;206;19
/net/per610a/home/mvp/mvp_db/news7-lv/2012/2012_12_04_19_00/2012_12_04_19_00.mpg;Shinzo ABE.jpg;23765;26605;125953;1189;1331;142
/net/per610a/home/mvp/mvp_db/news7-lv/2012/2012_12_04_19_00/2012_12_04_19_00.mpg;Shinzo ABE.jpg;32077;38041;125953;1605;1903;298
/net/per610a/home/mvp/mvp_db/news7-lv/2012/2012_12_04_19_00/2012_12_04_19_00.mpg;Shinzo ABE.jpg;117453;117593;125953;5877;5884;7
/net/per610a/home/mvp/mvp_db/news7-lv/2012/2012_12_04_19_00/2012_12_04_19_00.mpg;Natsuo YAMAGUCHI.jpg;5349;6065;125953;267;303;36
/net/per610a/home/mvp/mvp_db/news7-lv/2012/2012_12_04_19_00/2012_12_04_19_00.mpg;Natsuo YAMAGUCHI.jpg;38241;38821;125953;1913;1942;29
/net/per610a/home/mvp/mvp_db/news7-lv/2012/2012_12_04_19_00/2012_12_04_19_00.mpg;Natsuo YAMAGUCHI.jpg;39053;39057;125953;1954;1954;0
/net/per610a/home/mvp/mvp_db/news7-lv/2012/2012_12_04_19_00/2012_12_04_19_00.mpg;Natsuo YAMAGUCHI.jpg;41097;41781;125953;2056;2090;34
/net/per610a/home/mvp/mvp_db/news7-lv/2012/2012_12_04_19_00/2012_12_04_19_00.mpg;Natsuo YAMAGUCHI.jpg;42341;46629;125953;2118;2333;215
/net/per610a/home/mvp/mvp_db/news7-lv/2012/2012_12_04_19_00/2012_12_04_19_00.mpg;Kazuo SHII.jpg;7045;7733;125953;352;386;34
/net/per610a/home/mvp/mvp_db/news7-lv/2012/2012_12_04_19_00/2012_12_04_19_00.mpg;Kazuo SHII.jpg;54133;55713;125953;2708;2788;80
/net/per610a/home/mvp/mvp_db/news7-lv/2012/2012_12_04_19_00/2012_12_04_19_00.mpg;Kazuo SHII.jpg;55925;59497;125953;2798;2977;179
/net/per610a/home/mvp/mvp_db/news7-lv/2012/2012_12_04_19_00/2012_12_04_19_00.mpg;Kazuo SHII.jpg;59709;60833;125953;2987;3044;57
/net/per610a/home/mvp/mvp_db/news7-lv/2012/2012_12_04_19_00/2012_12_04_19_00.mpg;Yoshimi WATANABE.jpg;7929;8477;125953;396;424;28
/net/per610a/home/mvp/mvp_db/news7-lv/2012/2012_12_04_19_00/2012_12_04_19_00.mpg;Yoshimi WATANABE.jpg;87205;88133;125953;4363;4410;47
/net/per610a/home/mvp/mvp_db/news7-lv/2012/2012_12_04_19_00/2012_12_04_19_00.mpg;Yoshimi WATANABE.jpg;91641;93281;125953;4585;4668;83
/net/per610a/home/mvp/mvp_db/news7-lv/2012/2012_12_04_19_00/2012_12_04_19_00.mpg;Mizuho FUKUSHIMA.jpg;8697;9173;125953;435;459;24
/net/per610a/home/mvp/mvp_db/news7-lv/2012/2012_12_04_19_00/2012_12_04_19_00.mpg;Mizuho FUKUSHIMA.jpg;71785;72917;125953;3592;3648;56
/net/per610a/home/mvp/mvp_db/news7-lv/2012/2012_12_04_19_00/2012_12_04_19_00.mpg;Yukiko Kada.jpg;61001;64841;125953;3052;3244;192
/net/per610a/home/mvp/mvp_db/news7-lv/2012/2012_12_04_19_00/2012_12_04_19_00.mpg;Yukiko Kada.jpg;65769;66453;125953;3291;3325;34
/net/per610a/home/mvp/mvp_db/news7-lv/2012/2012_12_04_19_00/2012_12_04_19_00.mpg;Yukiko Kada.jpg;66777;71505;125953;3341;3578;237
/net/per610a/home/mvp/mvp_db/news7-lv/2012/2012_12_04_19_00/2012_12_04_19_00.mpg;Yukiko Kada.jpg;117901;118169;125953;5900;5913;13
/net/per610a/home/mvp/mvp_db/news7-lv/2012/2012_12_05_19_00/2012_12_05_19_00.mpg;Yoshihiko Noda.jpg;6321;7753;36033;316;387;71
/net/per610a/home/mvp/mvp_db/news7-lv/2012/2012_12_06_19_00/2012_12_06_19_00.mpg;Yoshihiko Noda.jpg;10693;12201;36045;535;610;75
/net/per610a/home/mvp/mvp_db/news7-lv/2012/2012_12_06_19_00/2012_12_06_19_00.mpg;Shinzo ABE.jpg;12405;14461;36045;620;723;103
/net/per610a/home/mvp/mvp_db/news7-lv/2012/2012_12_06_19_00/2012_12_06_19_00.mpg;Shintaro ISHIHARA.jpg;22253;22393;36045;1113;1120;7
/net/per610a/home/mvp/mvp_db/news7-lv/2012/2012_12_08_19_00/2012_12_08_19_00.mpg;Naoto KAN.jpg;14993;15265;36033;750;763;13
/net/per610a/home/mvp/mvp_db/news7-lv/2012/2012_12_08_19_00/2012_12_08_19_00.mpg;Naoto KAN.jpg;18417;18629;36033;921;932;11
/net/per610a/home/mvp/mvp_db/news7-lv/2012/2012_12_08_19_00/2012_12_08_19_00.mpg;Naoto KAN.jpg;19257;19749;36033;963;988;25
/net/per610a/home/mvp/mvp_db/news7-lv/2012/2012_12_08_19_00/2012_12_08_19_00.mpg;Yukiko Kada.jpg;17789;18061;36033;890;903;13
/net/per610a/home/mvp/mvp_db/news7-lv/2012/2012_12_08_19_00/2012_12_08_19_00.mpg;Shintaro ISHIHARA.jpg;23357;23513;36033;1168;1176;8
/net/per610a/home/mvp/mvp_db/news7-lv/2012/2012_12_08_19_00/2012_12_08_19_00.mpg;Takeo Hiranuma.jpeg;23697;23745;36033;1185;1188;3
/net/per610a/home/mvp/mvp_db/news7-lv/2012/2012_12_08_19_00/2012_12_08_19_00.mpg;Takeo Hiranuma.jpeg;23897;24337;36033;1195;1217;22
/net/per610a/home/mvp/mvp_db/news7-lv/2012/2012_12_09_19_00/2012_12_09_19_00.mpg;Yoshihiko Noda.jpg;10269;11861;36045;513;593;80
/net/per610a/home/mvp/mvp_db/news7-lv/2012/2012_12_09_19_00/2012_12_09_19_00.mpg;Mizuho FUKUSHIMA.jpg;16665;17545;36045;834;878;44
/net/per610a/home/mvp/mvp_db/news7-lv/2012/2012_12_10_19_00/2012_12_10_19_00.mpg;Yoshihiko Noda.jpg;11433;12461;38429;572;623;51
/net/per610a/home/mvp/mvp_db/news7-lv/2012/2012_12_10_19_00/2012_12_10_19_00.mpg;Yoshihiko Noda.jpg;17181;17561;38429;859;878;19
/net/per610a/home/mvp/mvp_db/news7-lv/2012/2012_12_10_19_00/2012_12_10_19_00.mpg;Yoshihiko Noda.jpg;28485;28681;38429;1425;1435;10
/net/per610a/home/mvp/mvp_db/news7-lv/2012/2012_12_10_19_00/2012_12_10_19_00.mpg;Shintaro ISHIHARA.jpg;13921;14909;38429;696;746;50
/net/per610a/home/mvp/mvp_db/news7-lv/2012/2012_12_10_19_00/2012_12_10_19_00.mpg;Shinzo ABE.jpg;17181;17561;38429;859;878;19
/net/per610a/home/mvp/mvp_db/news7-lv/2012/2012_12_11_19_00/2012_12_11_19_00.mpg;Masashi Nakano.jpg;18961;18997;36037;948;950;2
/net/per610a/home/mvp/mvp_db/news7-lv/2012/2012_12_11_19_00/2012_12_11_19_00.mpg;Masashi Nakano.jpg;19417;19517;36037;971;976;5
/net/per610a/home/mvp/mvp_db/news7-lv/2012/2012_12_11_19_00/2012_12_11_19_00.mpg;Kazuo SHII.jpg;22569;22985;36037;1129;1149;20
/net/per610a/home/mvp/mvp_db/news7-lv/2012/2012_12_11_19_00/2012_12_11_19_00.mpg;Yoshihiko Noda.jpg;24005;24493;36037;1201;1225;24
/net/per610a/home/mvp/mvp_db/news7-lv/2012/2012_12_11_19_00/2012_12_11_19_00.mpg;Shinzo ABE.jpg;25393;25577;36037;1270;1279;9
/net/per610a/home/mvp/mvp_db/news7-lv/2012/2012_12_12_19_00/2012_12_12_19_00.mpg;Yoshihiko Noda.jpg;325;421;38429;16;21;5
/net/per610a/home/mvp/mvp_db/news7-lv/2012/2012_12_12_19_00/2012_12_12_19_00.mpg;Yoshihiko Noda.jpg;28893;29005;38429;1445;1451;6
/net/per610a/home/mvp/mvp_db/news7-lv/2012/2012_12_12_19_00/2012_12_12_19_00.mpg;Yoshihiko Noda.jpg;29101;29841;38429;1456;1493;37
/net/per610a/home/mvp/mvp_db/news7-lv/2012/2012_12_12_19_00/2012_12_12_19_00.mpg;Shinzo ABE.jpg;29937;30461;38429;1498;1524;26
/net/per610a/home/mvp/mvp_db/news7-lv/2012/2012_12_13_19_00/2012_12_13_19_00.mpg;Yukio HATOYAMA.jpg;6213;7965;36033;310;398;88
/net/per610a/home/mvp/mvp_db/news7-lv/2012/2012_12_13_19_00/2012_12_13_19_00.mpg;Yoshihiko Noda.jpg;23361;25433;36033;1168;1272;104
/net/per610a/home/mvp/mvp_db/news7-lv/2012/2012_12_13_19_00/2012_12_13_19_00.mpg;Kazuo SHII.jpg;26457;26733;36033;1323;1337;14
/net/per610a/home/mvp/mvp_db/news7-lv/2012/2012_12_14_19_00/2012_12_14_19_00.mpg;Yoshihiko Noda.jpg;20217;21709;36033;1011;1086;75
/net/per610a/home/mvp/mvp_db/news7-lv/2012/2012_12_15_19_00/2012_12_15_19_00.mpg;Yoshihiko Noda.jpg;8713;9593;36033;435;480;45
/net/per610a/home/mvp/mvp_db/news7-lv/2012/2012_12_17_19_00/2012_12_17_19_00.mpg;Shinzo ABE.jpg;105;145;36033;5;7;2
/net/per610a/home/mvp/mvp_db/news7-lv/2012/2012_12_17_19_00/2012_12_17_19_00.mpg;Shinzo ABE.jpg;7281;9053;36033;364;452;88
/net/per610a/home/mvp/mvp_db/news7-lv/2012/2012_12_17_19_00/2012_12_17_19_00.mpg;Shinzo ABE.jpg;9257;10669;36033;463;533;70
/net/per610a/home/mvp/mvp_db/news7-lv/2012/2012_12_17_19_00/2012_12_17_19_00.mpg;Shinzo ABE.jpg;14869;15033;36033;744;752;8
/net/per610a/home/mvp/mvp_db/news7-lv/2012/2012_12_17_19_00/2012_12_17_19_00.mpg;Shinzo ABE.jpg;15417;15533;36033;771;777;6
/net/per610a/home/mvp/mvp_db/news7-lv/2012/2012_12_17_19_00/2012_12_17_19_00.mpg;Shinzo ABE.jpg;24977;25245;36033;1249;1263;14
/net/per610a/home/mvp/mvp_db/news7-lv/2012/2012_12_17_19_00/2012_12_17_19_00.mpg;Shinzo ABE.jpg;25533;25541;36033;1277;1278;1
/net/per610a/home/mvp/mvp_db/news7-lv/2012/2012_12_17_19_00/2012_12_17_19_00.mpg;Natsuo YAMAGUCHI.jpg;729;1125;36033;36;56;20
/net/per610a/home/mvp/mvp_db/news7-lv/2012/2012_12_17_19_00/2012_12_17_19_00.mpg;Natsuo YAMAGUCHI.jpg;10737;11173;36033;537;559;22
/net/per610a/home/mvp/mvp_db/news7-lv/2012/2012_12_17_19_00/2012_12_17_19_00.mpg;Natsuo YAMAGUCHI.jpg;14869;15197;36033;744;760;16
/net/per610a/home/mvp/mvp_db/news7-lv/2012/2012_12_17_19_00/2012_12_17_19_00.mpg;Shinzo ABE.jpg;3141;3197;36033;157;159;2
/net/per610a/home/mvp/mvp_db/news7-lv/2012/2012_12_17_19_00/2012_12_17_19_00.mpg;Shinzo ABE.jpg;15757;15973;36033;788;799;11
/net/per610a/home/mvp/mvp_db/news7-lv/2012/2012_12_17_19_00/2012_12_17_19_00.mpg;Shinzo ABE.jpg;16981;17073;36033;849;854;5
/net/per610a/home/mvp/mvp_db/news7-lv/2012/2012_12_17_19_00/2012_12_17_19_00.mpg;Shinzo ABE.jpg;22797;23073;36033;1140;1154;14
/net/per610a/home/mvp/mvp_db/news7-lv/2012/2012_12_17_19_00/2012_12_17_19_00.mpg;Shinzo ABE.jpg;23665;23965;36033;1184;1199;15
/net/per610a/home/mvp/mvp_db/news7-lv/2012/2012_12_17_19_00/2012_12_17_19_00.mpg;Shinzo ABE.jpg;24589;24913;36033;1230;1246;16
/net/per610a/home/mvp/mvp_db/news7-lv/2012/2012_12_17_19_00/2012_12_17_19_00.mpg;Shinzo ABE.jpg;25905;25957;36033;1296;1298;2
/net/per610a/home/mvp/mvp_db/news7-lv/2012/2012_12_17_19_00/2012_12_17_19_00.mpg;Yukiko Kada.jpg;14197;14793;36033;710;740;30
/net/per610a/home/mvp/mvp_db/news7-lv/2012/2012_12_17_19_00/2012_12_17_19_00.mpg;Yoshihiko Noda.jpg;16721;16977;36033;836;849;13
/net/per610a/home/mvp/mvp_db/news7-lv/2012/2012_12_18_19_00/2012_12_18_19_00.mpg;Natsuo YAMAGUCHI.jpg;1933;2161;36033;96;108;12
/net/per610a/home/mvp/mvp_db/news7-lv/2012/2012_12_18_19_00/2012_12_18_19_00.mpg;Natsuo YAMAGUCHI.jpg;2449;2505;36033;122;125;3
/net/per610a/home/mvp/mvp_db/news7-lv/2012/2012_12_18_19_00/2012_12_18_19_00.mpg;Natsuo YAMAGUCHI.jpg;3793;4057;36033;189;203;14
/net/per610a/home/mvp/mvp_db/news7-lv/2012/2012_12_18_19_00/2012_12_18_19_00.mpg;Shinzo ABE.jpg;6765;7189;36033;338;359;21
/net/per610a/home/mvp/mvp_db/news7-lv/2012/2012_12_18_19_00/2012_12_18_19_00.mpg;Toru Hashimoto.jpg;11317;12377;36033;566;619;53
/net/per610a/home/mvp/mvp_db/news7-lv/2012/2012_12_18_19_00/2012_12_18_19_00.mpg;Yoshimi WATANABE.jpg;12401;13313;36033;620;666;46
/net/per610a/home/mvp/mvp_db/news7-lv/2012/2012_12_19_19_00/2012_12_19_19_00.mpg;Shinzo ABE.jpg;8249;8785;36033;412;439;27
/net/per610a/home/mvp/mvp_db/news7-lv/2012/2012_12_19_19_00/2012_12_19_19_00.mpg;Shinzo ABE.jpg;9013;9053;36033;450;452;2
/net/per610a/home/mvp/mvp_db/news7-lv/2012/2012_12_19_19_00/2012_12_19_19_00.mpg;Shinzo ABE.jpg;15753;15873;36033;788;794;6
/net/per610a/home/mvp/mvp_db/news7-lv/2012/2012_12_19_19_00/2012_12_19_19_00.mpg;Shinzo ABE.jpg;18373;18745;36033;919;937;18
/net/per610a/home/mvp/mvp_db/news7-lv/2012/2012_12_19_19_00/2012_12_19_19_00.mpg;Shinzo ABE.jpg;21877;21961;36033;1094;1098;4
/net/per610a/home/mvp/mvp_db/news7-lv/2012/2012_12_19_19_00/2012_12_19_19_00.mpg;Natsuo YAMAGUCHI.jpg;8249;8701;36033;412;435;23
/net/per610a/home/mvp/mvp_db/news7-lv/2012/2012_12_19_19_00/2012_12_19_19_00.mpg;Yoshihiko Noda.jpg;11945;12365;36033;597;618;21
/net/per610a/home/mvp/mvp_db/news7-lv/2012/2012_12_19_19_00/2012_12_19_19_00.mpg;Yoshihiko Noda.jpg;12737;12817;36033;637;641;4
/net/per610a/home/mvp/mvp_db/news7-lv/2012/2012_12_20_19_00/2012_12_20_19_00.mpg;Shinzo ABE.jpg;253;405;36033;12;20;8
/net/per610a/home/mvp/mvp_db/news7-lv/2012/2012_12_20_19_00/2012_12_20_19_00.mpg;Shinzo ABE.jpg;1005;1597;36033;50;79;29
/net/per610a/home/mvp/mvp_db/news7-lv/2012/2012_12_20_19_00/2012_12_20_19_00.mpg;Shinzo ABE.jpg;1749;2085;36033;87;104;17
/net/per610a/home/mvp/mvp_db/news7-lv/2012/2012_12_20_19_00/2012_12_20_19_00.mpg;Shinzo ABE.jpg;2921;3197;36033;146;159;13
/net/per610a/home/mvp/mvp_db/news7-lv/2012/2012_12_20_19_00/2012_12_20_19_00.mpg;Shinzo ABE.jpg;3421;3877;36033;171;193;22
/net/per610a/home/mvp/mvp_db/news7-lv/2012/2012_12_20_19_00/2012_12_20_19_00.mpg;Shinzo ABE.jpg;6117;6509;36033;306;325;19
/net/per610a/home/mvp/mvp_db/news7-lv/2012/2012_12_20_19_00/2012_12_20_19_00.mpg;Shinzo ABE.jpg;8681;8873;36033;434;443;9
/net/per610a/home/mvp/mvp_db/news7-lv/2012/2012_12_20_19_00/2012_12_20_19_00.mpg;Shinzo ABE.jpg;8941;9157;36033;447;458;11
/net/per610a/home/mvp/mvp_db/news7-lv/2012/2012_12_20_19_00/2012_12_20_19_00.mpg;Shinzo ABE.jpg;9321;9649;36033;466;482;16
/net/per610a/home/mvp/mvp_db/news7-lv/2012/2012_12_20_19_00/2012_12_20_19_00.mpg;Natsuo YAMAGUCHI.jpg;9781;10425;36033;489;521;32
/net/per610a/home/mvp/mvp_db/news7-lv/2012/2012_12_20_19_00/2012_12_20_19_00.mpg;Mizuho FUKUSHIMA.jpg;11977;12581;36033;599;629;30
/net/per610a/home/mvp/mvp_db/news7-lv/2012/2012_12_20_19_00/2012_12_20_19_00.mpg;Mizuho FUKUSHIMA.jpg;12697;12813;36033;635;641;6
/net/per610a/home/mvp/mvp_db/news7-lv/2012/2012_12_22_19_00/2012_12_22_19_00.mpg;Yoshihiko Noda.jpg;117;165;36033;5;8;3
/net/per610a/home/mvp/mvp_db/news7-lv/2012/2012_12_22_19_00/2012_12_22_19_00.mpg;Yoshihiko Noda.jpg;1553;1593;36033;77;79;2
/net/per610a/home/mvp/mvp_db/news7-lv/2012/2012_12_22_19_00/2012_12_22_19_00.mpg;Yoshihiko Noda.jpg;1741;1741;36033;87;87;0
/net/per610a/home/mvp/mvp_db/news7-lv/2012/2012_12_22_19_00/2012_12_22_19_00.mpg;Yoshihiko Noda.jpg;2521;3693;36033;126;184;58
/net/per610a/home/mvp/mvp_db/news7-lv/2012/2012_12_22_19_00/2012_12_22_19_00.mpg;Bairi Kaieda.jpg;3773;5685;36033;188;284;96
/net/per610a/home/mvp/mvp_db/news7-lv/2012/2012_12_22_19_00/2012_12_22_19_00.mpg;Shinzo ABE.jpg;5689;6217;36033;284;311;27
/net/per610a/home/mvp/mvp_db/news7-lv/2012/2012_12_22_19_00/2012_12_22_19_00.mpg;Shinzo ABE.jpg;7161;7201;36033;358;360;2
/net/per610a/home/mvp/mvp_db/news7-lv/2012/2012_12_22_19_00/2012_12_22_19_00.mpg;Shinzo ABE.jpg;7525;7525;36033;376;376;0
/net/per610a/home/mvp/mvp_db/news7-lv/2012/2012_12_22_19_00/2012_12_22_19_00.mpg;Shinzo ABE.jpg;8205;9057;36033;410;453;43
/net/per610a/home/mvp/mvp_db/news7-lv/2012/2012_12_22_19_00/2012_12_22_19_00.mpg;Shinzo ABE.jpg;9241;9937;36033;462;497;35
/net/per610a/home/mvp/mvp_db/news7-lv/2012/2012_12_23_19_00/2012_12_23_19_00.mpg;Bairi Kaieda.jpg;12645;13117;36033;632;656;24
/net/per610a/home/mvp/mvp_db/news7-lv/2012/2012_12_23_19_00/2012_12_23_19_00.mpg;Bairi Kaieda.jpg;14809;15473;36033;741;774;33
/net/per610a/home/mvp/mvp_db/news7-lv/2012/2012_12_24_19_00/2012_12_24_19_00.mpg;Bairi Kaieda.jpg;11801;12353;36033;590;618;28
/net/per610a/home/mvp/mvp_db/news7-lv/2012/2012_12_24_19_00/2012_12_24_19_00.mpg;Bairi Kaieda.jpg;12709;14265;36033;635;713;78
/net/per610a/home/mvp/mvp_db/news7-lv/2012/2012_12_25_19_00/2012_12_25_19_00.mpg;Shinzo ABE.jpg;5;61;36033;0;3;3
/net/per610a/home/mvp/mvp_db/news7-lv/2012/2012_12_25_19_00/2012_12_25_19_00.mpg;Shinzo ABE.jpg;129;197;36033;6;9;3
/net/per610a/home/mvp/mvp_db/news7-lv/2012/2012_12_25_19_00/2012_12_25_19_00.mpg;Shinzo ABE.jpg;929;929;36033;46;46;0
/net/per610a/home/mvp/mvp_db/news7-lv/2012/2012_12_25_19_00/2012_12_25_19_00.mpg;Shinzo ABE.jpg;1201;1353;36033;60;67;7
/net/per610a/home/mvp/mvp_db/news7-lv/2012/2012_12_25_19_00/2012_12_25_19_00.mpg;Shinzo ABE.jpg;1681;1745;36033;84;87;3
/net/per610a/home/mvp/mvp_db/news7-lv/2012/2012_12_25_19_00/2012_12_25_19_00.mpg;Shinzo ABE.jpg;5533;5589;36033;276;279;3
/net/per610a/home/mvp/mvp_db/news7-lv/2012/2012_12_25_19_00/2012_12_25_19_00.mpg;Shinzo ABE.jpg;8353;8565;36033;417;428;11
/net/per610a/home/mvp/mvp_db/news7-lv/2012/2012_12_25_19_00/2012_12_25_19_00.mpg;Shinzo ABE.jpg;9597;9729;36033;480;486;6
/net/per610a/home/mvp/mvp_db/news7-lv/2012/2012_12_25_19_00/2012_12_25_19_00.mpg;Bairi Kaieda.jpg;537;537;36033;26;26;0
/net/per610a/home/mvp/mvp_db/news7-lv/2012/2012_12_25_19_00/2012_12_25_19_00.mpg;Bairi Kaieda.jpg;10645;10697;36033;532;535;3
/net/per610a/home/mvp/mvp_db/news7-lv/2012/2012_12_25_19_00/2012_12_25_19_00.mpg;Bairi Kaieda.jpg;12745;12765;36033;637;638;1
/net/per610a/home/mvp/mvp_db/news7-lv/2012/2012_12_25_19_00/2012_12_25_19_00.mpg;Bairi Kaieda.jpg;13777;13829;36033;689;691;2
/net/per610a/home/mvp/mvp_db/news7-lv/2012/2012_12_25_19_00/2012_12_25_19_00.mpg;Bairi Kaieda.jpg;16441;16457;36033;822;823;1
/net/per610a/home/mvp/mvp_db/news7-lv/2012/2012_12_25_19_00/2012_12_25_19_00.mpg;Natsuo YAMAGUCHI.jpg;2217;2665;36033;110;133;23
/net/per610a/home/mvp/mvp_db/news7-lv/2012/2012_12_25_19_00/2012_12_25_19_00.mpg;Taro ASO.jpg;5889;6009;36033;294;300;6
/net/per610a/home/mvp/mvp_db/news7-lv/2012/2012_12_25_19_00/2012_12_25_19_00.mpg;Taro ASO.jpg;7661;8041;36033;383;402;19
/net/per610a/home/mvp/mvp_db/news7-lv/2012/2012_12_25_19_00/2012_12_25_19_00.mpg;Sadakazu TANIGAKI.jpg;9369;9613;36033;468;481;13
/net/per610a/home/mvp/mvp_db/news7-lv/2012/2012_12_25_19_00/2012_12_25_19_00.mpg;Ichiro OZAWA.jpg;12773;13753;36033;639;688;49
/net/per610a/home/mvp/mvp_db/news7-lv/2012/2012_12_25_19_00/2012_12_25_19_00.mpg;Bairi Kaieda.jpg;15925;16065;36033;796;803;7
/net/per610a/home/mvp/mvp_db/news7-lv/2012/2012_12_26_19_00/2012_12_26_19_00.mpg;Shinzo ABE.jpg;5;97;50421;0;4;4
/net/per610a/home/mvp/mvp_db/news7-lv/2012/2012_12_26_19_00/2012_12_26_19_00.mpg;Shinzo ABE.jpg;205;233;50421;10;11;1
/net/per610a/home/mvp/mvp_db/news7-lv/2012/2012_12_26_19_00/2012_12_26_19_00.mpg;Shinzo ABE.jpg;677;769;50421;33;38;5
/net/per610a/home/mvp/mvp_db/news7-lv/2012/2012_12_26_19_00/2012_12_26_19_00.mpg;Shinzo ABE.jpg;1257;1321;50421;62;66;4
/net/per610a/home/mvp/mvp_db/news7-lv/2012/2012_12_26_19_00/2012_12_26_19_00.mpg;Shinzo ABE.jpg;3785;4157;50421;189;208;19
/net/per610a/home/mvp/mvp_db/news7-lv/2012/2012_12_26_19_00/2012_12_26_19_00.mpg;Shinzo ABE.jpg;5005;5033;50421;250;251;1
/net/per610a/home/mvp/mvp_db/news7-lv/2012/2012_12_26_19_00/2012_12_26_19_00.mpg;Shinzo ABE.jpg;18413;18605;50421;921;930;9
/net/per610a/home/mvp/mvp_db/news7-lv/2012/2012_12_26_19_00/2012_12_26_19_00.mpg;Shinzo ABE.jpg;33797;34105;50421;1691;1706;15
/net/per610a/home/mvp/mvp_db/news7-lv/2012/2012_12_26_19_00/2012_12_26_19_00.mpg;Yoshihiko Noda.jpg;2809;2905;50421;140;145;5
/net/per610a/home/mvp/mvp_db/news7-lv/2012/2012_12_26_19_00/2012_12_26_19_00.mpg;Shinzo ABE.jpg;5265;5281;50421;263;264;1
/net/per610a/home/mvp/mvp_db/news7-lv/2012/2012_12_26_19_00/2012_12_26_19_00.mpg;Shinzo ABE.jpg;6681;7009;50421;334;350;16
/net/per610a/home/mvp/mvp_db/news7-lv/2012/2012_12_26_19_00/2012_12_26_19_00.mpg;Shinzo ABE.jpg;34525;34665;50421;1727;1734;7
/net/per610a/home/mvp/mvp_db/news7-lv/2012/2012_12_26_19_00/2012_12_26_19_00.mpg;Taro ASO.jpg;13281;13449;50421;664;672;8
/net/per610a/home/mvp/mvp_db/news7-lv/2012/2012_12_26_19_00/2012_12_26_19_00.mpg;Sadakazu TANIGAKI.jpg;13465;13589;50421;673;679;6
/net/per610a/home/mvp/mvp_db/news7-lv/2012/2012_12_26_19_00/2012_12_26_19_00.mpg;Taro ASO.jpg;18765;19133;50421;938;957;19
/net/per610a/home/mvp/mvp_db/news7-lv/2012/2012_12_26_19_00/2012_12_26_19_00.mpg;Taro ASO.jpg;20953;21573;50421;1048;1079;31
/net/per610a/home/mvp/mvp_db/news7-lv/2012/2012_12_26_19_00/2012_12_26_19_00.mpg;Natsuo YAMAGUCHI.jpg;33797;34105;50421;1691;1706;15
/net/per610a/home/mvp/mvp_db/news7-lv/2012/2012_12_26_19_00/2012_12_26_19_00.mpg;Yukiko Kada.jpg;44897;45301;50421;2246;2266;20
/net/per610a/home/mvp/mvp_db/news7-lv/2012/2012_12_27_19_00/2012_12_27_19_00.mpg;Shinzo ABE.jpg;145;161;36037;7;8;1
/net/per610a/home/mvp/mvp_db/news7-lv/2012/2012_12_27_19_00/2012_12_27_19_00.mpg;Shinzo ABE.jpg;1541;1677;36037;77;83;6
/net/per610a/home/mvp/mvp_db/news7-lv/2012/2012_12_27_19_00/2012_12_27_19_00.mpg;Shinzo ABE.jpg;1969;2225;36037;98;111;13
/net/per610a/home/mvp/mvp_db/news7-lv/2012/2012_12_27_19_00/2012_12_27_19_00.mpg;Shinzo ABE.jpg;2397;2893;36037;119;144;25
/net/per610a/home/mvp/mvp_db/news7-lv/2012/2012_12_27_19_00/2012_12_27_19_00.mpg;Shinzo ABE.jpg;9281;9541;36037;464;477;13
/net/per610a/home/mvp/mvp_db/news7-lv/2012/2012_12_28_19_00/2012_12_28_19_00.mpg;Shinzo ABE.jpg;10481;10969;36033;524;548;24
/net/per610a/home/mvp/mvp_db/news7-lv/2012/2012_12_28_19_00/2012_12_28_19_00.mpg;Shinzo ABE.jpg;11117;11421;36033;556;571;15
/net/per610a/home/mvp/mvp_db/news7-lv/2012/2012_12_28_19_00/2012_12_28_19_00.mpg;Shinzo ABE.jpg;11725;11793;36033;586;590;4
/net/per610a/home/mvp/mvp_db/news7-lv/2012/2012_12_28_19_00/2012_12_28_19_00.mpg;Shinzo ABE.jpg;11893;11993;36033;595;600;5
/net/per610a/home/mvp/mvp_db/news7-lv/2012/2012_12_28_19_00/2012_12_28_19_00.mpg;Shinzo ABE.jpg;12225;12745;36033;611;637;26
/net/per610a/home/mvp/mvp_db/news7-lv/2012/2012_12_28_19_00/2012_12_28_19_00.mpg;Shinzo ABE.jpg;13241;13481;36033;662;674;12
/net/per610a/home/mvp/mvp_db/news7-lv/2012/2012_12_28_19_00/2012_12_28_19_00.mpg;Shinzo ABE.jpg;17313;17337;36033;866;867;1
/net/per610a/home/mvp/mvp_db/news7-lv/2012/2012_12_28_19_00/2012_12_28_19_00.mpg;Shinzo ABE.jpg;21233;21453;36033;1062;1073;11
/net/per610a/home/mvp/mvp_db/news7-lv/2012/2012_12_28_19_00/2012_12_28_19_00.mpg;Shinzo ABE.jpg;21593;21737;36033;1080;1087;7
/net/per610a/home/mvp/mvp_db/news7-lv/2012/2012_12_28_19_00/2012_12_28_19_00.mpg;Shinzo ABE.jpg;23009;23125;36033;1151;1157;6
/net/per610a/home/mvp/mvp_db/news7-lv/2012/2012_12_28_19_00/2012_12_28_19_00.mpg;Ichiro OZAWA.jpg;24505;24505;36033;1226;1226;0
/net/per610a/home/mvp/mvp_db/news7-lv/2012/2012_12_28_19_00/2012_12_28_19_00.mpg;Ichiro OZAWA.jpg;26581;26653;36033;1330;1333;3
/net/per610a/home/mvp/mvp_db/news7-lv/2012/2012_12_28_19_00/2012_12_28_19_00.mpg;Ichiro OZAWA.jpg;27577;27577;36033;1379;1379;0
/net/per610a/home/mvp/mvp_db/news7-lv/2012/2012_12_28_19_00/2012_12_28_19_00.mpg;Ichiro OZAWA.jpg;27641;28417;36033;1383;1421;38
/net/per610a/home/mvp/mvp_db/news7-lv/2012/2012_12_28_19_00/2012_12_28_19_00.mpg;Yukiko Kada.jpg;25289;25361;36033;1265;1269;4
/net/per610a/home/mvp/mvp_db/news7-lv/2012/2012_12_28_19_00/2012_12_28_19_00.mpg;Yukiko Kada.jpg;25537;26285;36033;1277;1315;38
/net/per610a/home/mvp/mvp_db/news7-lv/2012/2012_12_28_19_00/2012_12_28_19_00.mpg;Yukiko Kada.jpg;27065;27541;36033;1354;1378;24
/net/per610a/home/mvp/mvp_db/news7-lv/2012/2012_12_28_19_00/2012_12_28_19_00.mpg;Bairi Kaieda.jpg;29425;29513;36033;1472;1476;4
/net/per610a/home/mvp/mvp_db/news7-lv/2012/2012_12_28_19_00/2012_12_28_19_00.mpg;Bairi Kaieda.jpg;29581;29585;36033;1480;1480;0
/net/per610a/home/mvp/mvp_db/news7-lv/2012/2012_12_28_19_00/2012_12_28_19_00.mpg;Bairi Kaieda.jpg;29925;30329;36033;1497;1517;20
/net/per610a/home/mvp/mvp_db/news7-lv/2012/2012_12_29_19_00/2012_12_29_19_00.mpg;Shinzo ABE.jpg;9265;9809;36033;463;490;27
/net/per610a/home/mvp/mvp_db/news7-lv/2012/2012_12_29_19_00/2012_12_29_19_00.mpg;Shinzo ABE.jpg;10361;10765;36033;518;538;20
/net/per610a/home/mvp/mvp_db/news7-lv/2012/2012_12_29_19_00/2012_12_29_19_00.mpg;Shinzo ABE.jpg;11269;11661;36033;563;583;20
/net/per610a/home/mvp/mvp_db/news7-lv/2012/2012_12_29_19_00/2012_12_29_19_00.mpg;Shinzo ABE.jpg;12521;13973;36033;626;699;73
/net/per610a/home/mvp/mvp_db/news7-lv/2013/2013_01_01_19_00/2013_01_01_19_00.mpg;Shinzo ABE.jpg;11849;12565;24045;592;628;36
/net/per610a/home/mvp/mvp_db/news7-lv/2013/2013_01_01_19_00/2013_01_01_19_00.mpg;Shinzo ABE.jpg;12993;13209;24045;650;660;10
/net/per610a/home/mvp/mvp_db/news7-lv/2013/2013_01_01_19_00/2013_01_01_19_00.mpg;Bairi Kaieda.jpg;11849;12565;24045;592;628;36
/net/per610a/home/mvp/mvp_db/news7-lv/2013/2013_01_01_19_00/2013_01_01_19_00.mpg;Bairi Kaieda.jpg;13969;13997;24045;698;700;2
/net/per610a/home/mvp/mvp_db/news7-lv/2013/2013_01_01_19_00/2013_01_01_19_00.mpg;Natsuo YAMAGUCHI.jpg;12789;12857;24045;639;643;4
/net/per610a/home/mvp/mvp_db/news7-lv/2013/2013_01_01_19_00/2013_01_01_19_00.mpg;Natsuo YAMAGUCHI.jpg;12989;13005;24045;649;650;1
/net/per610a/home/mvp/mvp_db/news7-lv/2013/2013_01_01_19_00/2013_01_01_19_00.mpg;Natsuo YAMAGUCHI.jpg;13277;13877;24045;664;694;30
/net/per610a/home/mvp/mvp_db/news7-lv/2013/2013_01_01_19_00/2013_01_01_19_00.mpg;Shinzo ABE.jpg;13457;13877;24045;673;694;21
/net/per610a/home/mvp/mvp_db/news7-lv/2013/2013_01_01_19_00/2013_01_01_19_00.mpg;Shintaro ISHIHARA.jpg;14261;14793;24045;713;740;27
/net/per610a/home/mvp/mvp_db/news7-lv/2013/2013_01_02_19_00/2013_01_02_19_00.mpg;Shinzo ABE.jpg;15605;16173;36033;780;809;29
/net/per610a/home/mvp/mvp_db/news7-lv/2013/2013_01_02_19_00/2013_01_02_19_00.mpg;Shinzo ABE.jpg;16633;17677;36033;832;884;52
/net/per610a/home/mvp/mvp_db/news7-lv/2013/2013_01_02_19_00/2013_01_02_19_00.mpg;Shinzo ABE.jpg;18037;18453;36033;902;923;21
/net/per610a/home/mvp/mvp_db/news7-lv/2013/2013_01_02_19_00/2013_01_02_19_00.mpg;Shinzo ABE.jpg;18513;18693;36033;926;935;9
/net/per610a/home/mvp/mvp_db/news7-lv/2013/2013_01_04_19_00/2013_01_04_19_00.mpg;Shinzo ABE.jpg;7297;7949;36033;365;397;32
/net/per610a/home/mvp/mvp_db/news7-lv/2013/2013_01_04_19_00/2013_01_04_19_00.mpg;Shinzo ABE.jpg;8497;10433;36033;425;522;97
/net/per610a/home/mvp/mvp_db/news7-lv/2013/2013_01_04_19_00/2013_01_04_19_00.mpg;Shinzo ABE.jpg;17701;17965;36033;885;898;13
/net/per610a/home/mvp/mvp_db/news7-lv/2013/2013_01_04_19_00/2013_01_04_19_00.mpg;Natsuo YAMAGUCHI.jpg;10797;11185;36033;540;559;19
/net/per610a/home/mvp/mvp_db/news7-lv/2013/2013_01_04_19_00/2013_01_04_19_00.mpg;Ichiro Matsui.jpeg;12269;12953;36033;613;648;35
/net/per610a/home/mvp/mvp_db/news7-lv/2013/2013_01_04_19_00/2013_01_04_19_00.mpg;Kazuo SHII.jpg;13153;13633;36033;658;682;24
/net/per610a/home/mvp/mvp_db/news7-lv/2013/2013_01_07_19_00/2013_01_07_19_00.mpg;Shinzo ABE.jpg;7825;8381;36033;391;419;28
/net/per610a/home/mvp/mvp_db/news7-lv/2013/2013_01_07_19_00/2013_01_07_19_00.mpg;Shinzo ABE.jpg;8689;8921;36033;434;446;12
/net/per610a/home/mvp/mvp_db/news7-lv/2013/2013_01_07_19_00/2013_01_07_19_00.mpg;Shinzo ABE.jpg;10821;10969;36033;541;548;7
/net/per610a/home/mvp/mvp_db/news7-lv/2013/2013_01_08_19_00/2013_01_08_19_00.mpg;Shinzo ABE.jpg;881;1389;36033;44;69;25
/net/per610a/home/mvp/mvp_db/news7-lv/2013/2013_01_08_19_00/2013_01_08_19_00.mpg;Shinzo ABE.jpg;3697;3701;36033;184;185;1
/net/per610a/home/mvp/mvp_db/news7-lv/2013/2013_01_08_19_00/2013_01_08_19_00.mpg;Shinzo ABE.jpg;4897;5405;36033;245;270;25
/net/per610a/home/mvp/mvp_db/news7-lv/2013/2013_01_08_19_00/2013_01_08_19_00.mpg;Toru Hashimoto.jpg;1565;1585;36033;78;79;1
/net/per610a/home/mvp/mvp_db/news7-lv/2013/2013_01_08_19_00/2013_01_08_19_00.mpg;Toru Hashimoto.jpg;19361;19765;36033;968;988;20
/net/per610a/home/mvp/mvp_db/news7-lv/2013/2013_01_09_19_00/2013_01_09_19_00.mpg;Shinzo ABE.jpg;10289;10901;36033;514;545;31
/net/per610a/home/mvp/mvp_db/news7-lv/2013/2013_01_09_19_00/2013_01_09_19_00.mpg;Shinzo ABE.jpg;12717;12737;36033;636;637;1
/net/per610a/home/mvp/mvp_db/news7-lv/2013/2013_01_09_19_00/2013_01_09_19_00.mpg;Shinzo ABE.jpg;13957;14101;36033;698;705;7
/net/per610a/home/mvp/mvp_db/news7-lv/2013/2013_01_09_19_00/2013_01_09_19_00.mpg;Shinzo ABE.jpg;11041;11477;36033;552;574;22
/net/per610a/home/mvp/mvp_db/news7-lv/2013/2013_01_09_19_00/2013_01_09_19_00.mpg;Yasuo FUKUDA.jpg;11925;12049;36033;596;602;6
/net/per610a/home/mvp/mvp_db/news7-lv/2013/2013_01_09_19_00/2013_01_09_19_00.mpg;Junichiro KOIZUMI.jpg;12113;12365;36033;606;618;12
/net/per610a/home/mvp/mvp_db/news7-lv/2013/2013_01_10_19_00/2013_01_10_19_00.mpg;Shinzo ABE.jpg;12357;12817;36033;618;641;23
/net/per610a/home/mvp/mvp_db/news7-lv/2013/2013_01_10_19_00/2013_01_10_19_00.mpg;Shinzo ABE.jpg;12913;12973;36033;646;649;3
/net/per610a/home/mvp/mvp_db/news7-lv/2013/2013_01_10_19_00/2013_01_10_19_00.mpg;Shinzo ABE.jpg;13125;13821;36033;656;691;35
/net/per610a/home/mvp/mvp_db/news7-lv/2013/2013_01_10_19_00/2013_01_10_19_00.mpg;Shinzo ABE.jpg;14189;14393;36033;709;720;11
/net/per610a/home/mvp/mvp_db/news7-lv/2013/2013_01_10_19_00/2013_01_10_19_00.mpg;Shinzo ABE.jpg;16381;16529;36033;819;827;8
/net/per610a/home/mvp/mvp_db/news7-lv/2013/2013_01_10_19_00/2013_01_10_19_00.mpg;Shinzo ABE.jpg;15033;15193;36033;752;760;8
/net/per610a/home/mvp/mvp_db/news7-lv/2013/2013_01_10_19_00/2013_01_10_19_00.mpg;Toru Hashimoto.jpg;17565;17921;36033;878;896;18
/net/per610a/home/mvp/mvp_db/news7-lv/2013/2013_01_10_19_00/2013_01_10_19_00.mpg;Toru Hashimoto.jpg;20601;20717;36033;1030;1036;6
/net/per610a/home/mvp/mvp_db/news7-lv/2013/2013_01_10_19_00/2013_01_10_19_00.mpg;Toru Hashimoto.jpg;20901;21029;36033;1045;1052;7
/net/per610a/home/mvp/mvp_db/news7-lv/2013/2013_01_11_19_00/2013_01_11_19_00.mpg;Shinzo ABE.jpg;6957;7205;36033;348;360;12
/net/per610a/home/mvp/mvp_db/news7-lv/2013/2013_01_11_19_00/2013_01_11_19_00.mpg;Shinzo ABE.jpg;9797;10213;36033;490;511;21
/net/per610a/home/mvp/mvp_db/news7-lv/2013/2013_01_11_19_00/2013_01_11_19_00.mpg;Toru Hashimoto.jpg;9297;9757;36033;465;488;23
/net/per610a/home/mvp/mvp_db/news7-lv/2013/2013_01_12_19_00/2013_01_12_19_00.mpg;Toru Hashimoto.jpg;3981;4421;36033;199;221;22
/net/per610a/home/mvp/mvp_db/news7-lv/2013/2013_01_12_19_00/2013_01_12_19_00.mpg;Toru Hashimoto.jpg;4485;4865;36033;224;243;19
/net/per610a/home/mvp/mvp_db/news7-lv/2013/2013_01_12_19_00/2013_01_12_19_00.mpg;Toru Hashimoto.jpg;5481;5849;36033;274;292;18
/net/per610a/home/mvp/mvp_db/news7-lv/2013/2013_01_12_19_00/2013_01_12_19_00.mpg;Shinzo ABE.jpg;6433;6889;36033;321;344;23
/net/per610a/home/mvp/mvp_db/news7-lv/2013/2013_01_12_19_00/2013_01_12_19_00.mpg;Shinzo ABE.jpg;7417;7445;36033;371;372;1
/net/per610a/home/mvp/mvp_db/news7-lv/2013/2013_01_12_19_00/2013_01_12_19_00.mpg;Shinzo ABE.jpg;7553;7725;36033;377;386;9
/net/per610a/home/mvp/mvp_db/news7-lv/2013/2013_01_12_19_00/2013_01_12_19_00.mpg;Shinzo ABE.jpg;9469;10145;36033;473;507;34
/net/per610a/home/mvp/mvp_db/news7-lv/2013/2013_01_13_19_00/2013_01_13_19_00.mpg;Shinzo ABE.jpg;8625;9337;36033;431;467;36
/net/per610a/home/mvp/mvp_db/news7-lv/2013/2013_01_13_19_00/2013_01_13_19_00.mpg;Shinzo ABE.jpg;9645;9877;36033;482;494;12
/net/per610a/home/mvp/mvp_db/news7-lv/2013/2013_01_15_19_00/2013_01_15_19_00.mpg;Shinzo ABE.jpg;7973;8085;36033;398;404;6
/net/per610a/home/mvp/mvp_db/news7-lv/2013/2013_01_15_19_00/2013_01_15_19_00.mpg;Shinzo ABE.jpg;8961;9053;36033;448;452;4
/net/per610a/home/mvp/mvp_db/news7-lv/2013/2013_01_15_19_00/2013_01_15_19_00.mpg;Shinzo ABE.jpg;13693;13825;36033;685;691;6
/net/per610a/home/mvp/mvp_db/news7-lv/2013/2013_01_15_19_00/2013_01_15_19_00.mpg;Shinzo ABE.jpg;8249;8545;36033;412;427;15
/net/per610a/home/mvp/mvp_db/news7-lv/2013/2013_01_15_19_00/2013_01_15_19_00.mpg;Shinzo ABE.jpg;11321;11497;36033;566;575;9
/net/per610a/home/mvp/mvp_db/news7-lv/2013/2013_01_15_19_00/2013_01_15_19_00.mpg;Shinzo ABE.jpg;11749;11985;36033;587;599;12
/net/per610a/home/mvp/mvp_db/news7-lv/2013/2013_01_15_19_00/2013_01_15_19_00.mpg;Shinzo ABE.jpg;12169;12469;36033;608;623;15
/net/per610a/home/mvp/mvp_db/news7-lv/2013/2013_01_15_19_00/2013_01_15_19_00.mpg;Shinzo ABE.jpg;28429;28473;36033;1422;1424;2
/net/per610a/home/mvp/mvp_db/news7-lv/2013/2013_01_15_19_00/2013_01_15_19_00.mpg;Shinzo ABE.jpg;28733;28801;36033;1437;1441;4
/net/per610a/home/mvp/mvp_db/news7-lv/2013/2013_01_15_19_00/2013_01_15_19_00.mpg;Shinzo ABE.jpg;28889;29257;36033;1445;1463;18
/net/per610a/home/mvp/mvp_db/news7-lv/2013/2013_01_15_19_00/2013_01_15_19_00.mpg;Naoto KAN.jpg;12477;12685;36033;624;634;10
/net/per610a/home/mvp/mvp_db/news7-lv/2013/2013_01_15_19_00/2013_01_15_19_00.mpg;Bairi Kaieda.jpg;16457;16973;36033;823;849;26
/net/per610a/home/mvp/mvp_db/news7-lv/2013/2013_01_16_19_00/2013_01_16_19_00.mpg;Shinzo ABE.jpg;425;513;38429;21;25;4
/net/per610a/home/mvp/mvp_db/news7-lv/2013/2013_01_16_19_00/2013_01_16_19_00.mpg;Shinzo ABE.jpg;597;757;38429;29;37;8
/net/per610a/home/mvp/mvp_db/news7-lv/2013/2013_01_16_19_00/2013_01_16_19_00.mpg;Shinzo ABE.jpg;18277;18789;38429;914;940;26
/net/per610a/home/mvp/mvp_db/news7-lv/2013/2013_01_16_19_00/2013_01_16_19_00.mpg;Shinzo ABE.jpg;19681;20025;38429;984;1002;18
/net/per610a/home/mvp/mvp_db/news7-lv/2013/2013_01_16_19_00/2013_01_16_19_00.mpg;Shinzo ABE.jpg;20641;20761;38429;1032;1038;6
/net/per610a/home/mvp/mvp_db/news7-lv/2013/2013_01_16_19_00/2013_01_16_19_00.mpg;Shinzo ABE.jpg;20957;21305;38429;1048;1066;18
/net/per610a/home/mvp/mvp_db/news7-lv/2013/2013_01_16_19_00/2013_01_16_19_00.mpg;Shinzo ABE.jpg;21465;21649;38429;1074;1083;9
/net/per610a/home/mvp/mvp_db/news7-lv/2013/2013_01_17_19_00/2013_01_17_19_00.mpg;Shinzo ABE.jpg;309;405;36033;15;20;5
/net/per610a/home/mvp/mvp_db/news7-lv/2013/2013_01_17_19_00/2013_01_17_19_00.mpg;Shinzo ABE.jpg;6741;7573;36033;337;378;41
/net/per610a/home/mvp/mvp_db/news7-lv/2013/2013_01_17_19_00/2013_01_17_19_00.mpg;Shinzo ABE.jpg;15709;16189;36033;786;810;24
/net/per610a/home/mvp/mvp_db/news7-lv/2013/2013_01_17_19_00/2013_01_17_19_00.mpg;Shinzo ABE.jpg;16473;16629;36033;824;832;8
/net/per610a/home/mvp/mvp_db/news7-lv/2013/2013_01_17_19_00/2013_01_17_19_00.mpg;Shinzo ABE.jpg;18861;18941;36033;943;947;4
/net/per610a/home/mvp/mvp_db/news7-lv/2013/2013_01_17_19_00/2013_01_17_19_00.mpg;Shinzo ABE.jpg;19037;19069;36033;952;954;2
/net/per610a/home/mvp/mvp_db/news7-lv/2013/2013_01_17_19_00/2013_01_17_19_00.mpg;Shinzo ABE.jpg;19545;19685;36033;977;984;7
/net/per610a/home/mvp/mvp_db/news7-lv/2013/2013_01_17_19_00/2013_01_17_19_00.mpg;Shinzo ABE.jpg;17117;17609;36033;856;881;25
/net/per610a/home/mvp/mvp_db/news7-lv/2013/2013_01_17_19_00/2013_01_17_19_00.mpg;Shinzo ABE.jpg;18153;18721;36033;908;936;28
/net/per610a/home/mvp/mvp_db/news7-lv/2013/2013_01_18_19_00/2013_01_18_19_00.mpg;Shinzo ABE.jpg;20401;22785;36033;1020;1140;120
/net/per610a/home/mvp/mvp_db/news7-lv/2013/2013_01_19_19_00/2013_01_19_19_00.mpg;Shinzo ABE.jpg;7161;8869;36033;358;443;85
/net/per610a/home/mvp/mvp_db/news7-lv/2013/2013_01_20_19_00/2013_01_20_19_00.mpg;Shinzo ABE.jpg;6897;7069;36033;345;353;8
/net/per610a/home/mvp/mvp_db/news7-lv/2013/2013_01_21_19_00/2013_01_21_19_00.mpg;Toru Hashimoto.jpg;553;669;36033;27;33;6
/net/per610a/home/mvp/mvp_db/news7-lv/2013/2013_01_21_19_00/2013_01_21_19_00.mpg;Toru Hashimoto.jpg;9573;10425;36033;479;521;42
/net/per610a/home/mvp/mvp_db/news7-lv/2013/2013_01_21_19_00/2013_01_21_19_00.mpg;Shinzo ABE.jpg;15445;15833;36033;772;792;20
/net/per610a/home/mvp/mvp_db/news7-lv/2013/2013_01_21_19_00/2013_01_21_19_00.mpg;Shinzo ABE.jpg;15937;15957;36033;797;798;1
/net/per610a/home/mvp/mvp_db/news7-lv/2013/2013_01_21_19_00/2013_01_21_19_00.mpg;Shinzo ABE.jpg;16061;16313;36033;803;816;13
/net/per610a/home/mvp/mvp_db/news7-lv/2013/2013_01_21_19_00/2013_01_21_19_00.mpg;Shinzo ABE.jpg;17021;17169;36033;851;859;8
/net/per610a/home/mvp/mvp_db/news7-lv/2013/2013_01_23_19_00/2013_01_23_19_00.mpg;Shinzo ABE.jpg;13245;13885;36033;662;694;32
/net/per610a/home/mvp/mvp_db/news7-lv/2013/2013_01_23_19_00/2013_01_23_19_00.mpg;Shinzo ABE.jpg;13969;14109;36033;698;705;7
/net/per610a/home/mvp/mvp_db/news7-lv/2013/2013_01_23_19_00/2013_01_23_19_00.mpg;Shinzo ABE.jpg;14677;15121;36033;734;756;22
/net/per610a/home/mvp/mvp_db/news7-lv/2013/2013_01_23_19_00/2013_01_23_19_00.mpg;Shinzo ABE.jpg;16117;16201;36033;806;810;4
/net/per610a/home/mvp/mvp_db/news7-lv/2013/2013_01_24_19_00/2013_01_24_19_00.mpg;Toru Hashimoto.jpg;4161;4445;36033;208;222;14
/net/per610a/home/mvp/mvp_db/news7-lv/2013/2013_01_24_19_00/2013_01_24_19_00.mpg;Shinzo ABE.jpg;19133;19609;36033;957;981;24
/net/per610a/home/mvp/mvp_db/news7-lv/2013/2013_01_24_19_00/2013_01_24_19_00.mpg;Shinzo ABE.jpg;19673;19673;36033;984;984;0
/net/per610a/home/mvp/mvp_db/news7-lv/2013/2013_01_24_19_00/2013_01_24_19_00.mpg;Shinzo ABE.jpg;20009;20369;36033;1001;1019;18
/net/per610a/home/mvp/mvp_db/news7-lv/2013/2013_01_24_19_00/2013_01_24_19_00.mpg;Shinzo ABE.jpg;20557;20789;36033;1028;1040;12
/net/per610a/home/mvp/mvp_db/news7-lv/2013/2013_01_25_19_00/2013_01_25_19_00.mpg;Shinzo ABE.jpg;4677;4705;38433;234;235;1
/net/per610a/home/mvp/mvp_db/news7-lv/2013/2013_01_25_19_00/2013_01_25_19_00.mpg;Shinzo ABE.jpg;4829;5129;38433;241;256;15
/net/per610a/home/mvp/mvp_db/news7-lv/2013/2013_01_25_19_00/2013_01_25_19_00.mpg;Shinzo ABE.jpg;18773;19233;38433;939;962;23
/net/per610a/home/mvp/mvp_db/news7-lv/2013/2013_01_25_19_00/2013_01_25_19_00.mpg;Natsuo YAMAGUCHI.jpg;23649;23849;38433;1183;1193;10
/net/per610a/home/mvp/mvp_db/news7-lv/2013/2013_01_25_19_00/2013_01_25_19_00.mpg;Natsuo YAMAGUCHI.jpg;24701;25077;38433;1235;1254;19
/net/per610a/home/mvp/mvp_db/news7-lv/2013/2013_01_26_19_00/2013_01_26_19_00.mpg;Shinzo ABE.jpg;5081;5661;36033;254;283;29
/net/per610a/home/mvp/mvp_db/news7-lv/2013/2013_01_26_19_00/2013_01_26_19_00.mpg;Shinzo ABE.jpg;8785;9249;36033;439;462;23
/net/per610a/home/mvp/mvp_db/news7-lv/2013/2013_01_26_19_00/2013_01_26_19_00.mpg;Shinzo ABE.jpg;9313;9333;36033;465;466;1
/net/per610a/home/mvp/mvp_db/news7-lv/2013/2013_01_26_19_00/2013_01_26_19_00.mpg;Shinzo ABE.jpg;11273;11653;36033;564;583;19
/net/per610a/home/mvp/mvp_db/news7-lv/2013/2013_01_26_19_00/2013_01_26_19_00.mpg;Shinzo ABE.jpg;12837;13333;36033;642;667;25
/net/per610a/home/mvp/mvp_db/news7-lv/2013/2013_01_26_19_00/2013_01_26_19_00.mpg;Natsuo YAMAGUCHI.jpg;12837;13333;36033;642;667;25
/net/per610a/home/mvp/mvp_db/news7-lv/2013/2013_01_26_19_00/2013_01_26_19_00.mpg;Natsuo YAMAGUCHI.jpg;13685;14049;36033;684;702;18
/net/per610a/home/mvp/mvp_db/news7-lv/2013/2013_01_26_19_00/2013_01_26_19_00.mpg;Mizuho FUKUSHIMA.jpg;18809;18813;36033;941;941;0
/net/per610a/home/mvp/mvp_db/news7-lv/2013/2013_01_26_19_00/2013_01_26_19_00.mpg;Mizuho FUKUSHIMA.jpg;21393;21605;36033;1070;1081;11
/net/per610a/home/mvp/mvp_db/news7-lv/2013/2013_01_27_19_00/2013_01_27_19_00.mpg;Yukio HATOYAMA.jpg;2537;2741;36033;126;137;11
/net/per610a/home/mvp/mvp_db/news7-lv/2013/2013_01_27_19_00/2013_01_27_19_00.mpg;Yukio HATOYAMA.jpg;4113;4461;36033;205;223;18
/net/per610a/home/mvp/mvp_db/news7-lv/2013/2013_01_27_19_00/2013_01_27_19_00.mpg;Yukio HATOYAMA.jpg;5401;5477;36033;270;274;4
/net/per610a/home/mvp/mvp_db/news7-lv/2013/2013_01_27_19_00/2013_01_27_19_00.mpg;Taro ASO.jpg;6297;6865;36033;315;343;28
/net/per610a/home/mvp/mvp_db/news7-lv/2013/2013_01_27_19_00/2013_01_27_19_00.mpg;Taro ASO.jpg;7041;7625;36033;352;381;29
/net/per610a/home/mvp/mvp_db/news7-lv/2013/2013_01_27_19_00/2013_01_27_19_00.mpg;Yoshimi WATANABE.jpg;10733;11441;36033;537;572;35
/net/per610a/home/mvp/mvp_db/news7-lv/2013/2013_01_27_19_00/2013_01_27_19_00.mpg;Yoshimi WATANABE.jpg;11585;12145;36033;579;607;28
/net/per610a/home/mvp/mvp_db/news7-lv/2013/2013_01_27_19_00/2013_01_27_19_00.mpg;Yoshimi WATANABE.jpg;13205;13321;36033;660;666;6
/net/per610a/home/mvp/mvp_db/news7-lv/2013/2013_01_27_19_00/2013_01_27_19_00.mpg;Kenji Eda.jpg;12217;12729;36033;611;636;25
/net/per610a/home/mvp/mvp_db/news7-lv/2013/2013_01_28_19_00/2013_01_28_19_00.mpg;Shinzo ABE.jpg;925;1393;36033;46;69;23
/net/per610a/home/mvp/mvp_db/news7-lv/2013/2013_01_28_19_00/2013_01_28_19_00.mpg;Shinzo ABE.jpg;1813;1825;36033;90;91;1
/net/per610a/home/mvp/mvp_db/news7-lv/2013/2013_01_28_19_00/2013_01_28_19_00.mpg;Shinzo ABE.jpg;3117;3145;36033;155;157;2
/net/per610a/home/mvp/mvp_db/news7-lv/2013/2013_01_28_19_00/2013_01_28_19_00.mpg;Shinzo ABE.jpg;10941;10981;36033;547;549;2
/net/per610a/home/mvp/mvp_db/news7-lv/2013/2013_01_28_19_00/2013_01_28_19_00.mpg;Shinzo ABE.jpg;11149;11509;36033;557;575;18
/net/per610a/home/mvp/mvp_db/news7-lv/2013/2013_01_28_19_00/2013_01_28_19_00.mpg;Bairi Kaieda.jpg;2353;2677;36033;117;133;16
/net/per610a/home/mvp/mvp_db/news7-lv/2013/2013_01_28_19_00/2013_01_28_19_00.mpg;Bairi Kaieda.jpg;7541;9617;36033;377;481;104
/net/per610a/home/mvp/mvp_db/news7-lv/2013/2013_01_29_19_00/2013_01_29_19_00.mpg;Shinzo ABE.jpg;113;277;36041;5;13;8
/net/per610a/home/mvp/mvp_db/news7-lv/2013/2013_01_29_19_00/2013_01_29_19_00.mpg;Shinzo ABE.jpg;1673;1701;36041;83;85;2
/net/per610a/home/mvp/mvp_db/news7-lv/2013/2013_01_29_19_00/2013_01_29_19_00.mpg;Shinzo ABE.jpg;1869;2129;36041;93;106;13
/net/per610a/home/mvp/mvp_db/news7-lv/2013/2013_01_29_19_00/2013_01_29_19_00.mpg;Shinzo ABE.jpg;4281;4529;36041;214;226;12
/net/per610a/home/mvp/mvp_db/news7-lv/2013/2013_01_29_19_00/2013_01_29_19_00.mpg;Shinzo ABE.jpg;4701;4869;36041;235;243;8
/net/per610a/home/mvp/mvp_db/news7-lv/2013/2013_01_29_19_00/2013_01_29_19_00.mpg;Shinzo ABE.jpg;13609;13685;36041;680;684;4
/net/per610a/home/mvp/mvp_db/news7-lv/2013/2013_01_29_19_00/2013_01_29_19_00.mpg;Shinzo ABE.jpg;28853;28889;36041;1443;1445;2
/net/per610a/home/mvp/mvp_db/news7-lv/2013/2013_01_29_19_00/2013_01_29_19_00.mpg;Shinzo ABE.jpg;29081;29265;36041;1454;1464;10
/net/per610a/home/mvp/mvp_db/news7-lv/2013/2013_01_30_19_00/2013_01_30_19_00.mpg;Bairi Kaieda.jpg;11641;12385;36033;582;619;37
/net/per610a/home/mvp/mvp_db/news7-lv/2013/2013_01_30_19_00/2013_01_30_19_00.mpg;Shinzo ABE.jpg;11641;12349;36033;582;617;35
/net/per610a/home/mvp/mvp_db/news7-lv/2013/2013_01_30_19_00/2013_01_30_19_00.mpg;Shinzo ABE.jpg;17029;17373;36033;852;869;17
/net/per610a/home/mvp/mvp_db/news7-lv/2013/2013_01_31_19_00/2013_01_31_19_00.mpg;Shinzo ABE.jpg;10077;10201;36033;504;510;6
/net/per610a/home/mvp/mvp_db/news7-lv/2013/2013_01_31_19_00/2013_01_31_19_00.mpg;Shinzo ABE.jpg;28173;28437;36033;1409;1422;13
/net/per610a/home/mvp/mvp_db/news7-lv/2013/2013_01_31_19_00/2013_01_31_19_00.mpg;Shinzo ABE.jpg;28729;28781;36033;1437;1440;3
/net/per610a/home/mvp/mvp_db/news7-lv/2013/2013_02_02_19_00/2013_02_02_19_00.mpg;Shinzo ABE.jpg;5737;5869;36033;287;293;6
/net/per610a/home/mvp/mvp_db/news7-lv/2013/2013_02_02_19_00/2013_02_02_19_00.mpg;Shinzo ABE.jpg;6401;6749;36033;320;337;17
/net/per610a/home/mvp/mvp_db/news7-lv/2013/2013_02_02_19_00/2013_02_02_19_00.mpg;Shinzo ABE.jpg;6817;6833;36033;341;341;0
/net/per610a/home/mvp/mvp_db/news7-lv/2013/2013_02_02_19_00/2013_02_02_19_00.mpg;Shinzo ABE.jpg;8309;9173;36033;415;458;43
/net/per610a/home/mvp/mvp_db/news7-lv/2013/2013_02_02_19_00/2013_02_02_19_00.mpg;Shinzo ABE.jpg;10145;10197;36033;507;510;3
/net/per610a/home/mvp/mvp_db/news7-lv/2013/2013_02_04_19_00/2013_02_04_19_00.mpg;Shinzo ABE.jpg;8837;8877;36033;442;444;2
/net/per610a/home/mvp/mvp_db/news7-lv/2013/2013_02_04_19_00/2013_02_04_19_00.mpg;Shinzo ABE.jpg;9357;9829;36033;468;491;23
/net/per610a/home/mvp/mvp_db/news7-lv/2013/2013_02_04_19_00/2013_02_04_19_00.mpg;Shinzo ABE.jpg;10705;10817;36033;535;541;6
/net/per610a/home/mvp/mvp_db/news7-lv/2013/2013_02_07_19_00/2013_02_07_19_00.mpg;Shinzo ABE.jpg;15533;15665;36033;777;783;6
/net/per610a/home/mvp/mvp_db/news7-lv/2013/2013_02_07_19_00/2013_02_07_19_00.mpg;Shinzo ABE.jpg;16897;16945;36033;845;847;2
/net/per610a/home/mvp/mvp_db/news7-lv/2013/2013_02_07_19_00/2013_02_07_19_00.mpg;Shinzo ABE.jpg;26821;27441;36033;1342;1373;31
/net/per610a/home/mvp/mvp_db/news7-lv/2013/2013_02_09_19_00/2013_02_09_19_00.mpg;Shinzo ABE.jpg;13577;13621;36033;679;681;2
/net/per610a/home/mvp/mvp_db/news7-lv/2013/2013_02_09_19_00/2013_02_09_19_00.mpg;Shinzo ABE.jpg;14193;14277;36033;710;714;4
/net/per610a/home/mvp/mvp_db/news7-lv/2013/2013_02_09_19_00/2013_02_09_19_00.mpg;Shinzo ABE.jpg;14949;15285;36033;748;764;16
/net/per610a/home/mvp/mvp_db/news7-lv/2013/2013_02_09_19_00/2013_02_09_19_00.mpg;Shinzo ABE.jpg;15669;16177;36033;784;809;25
/net/per610a/home/mvp/mvp_db/news7-lv/2013/2013_02_09_19_00/2013_02_09_19_00.mpg;Shinzo ABE.jpg;28041;29125;36033;1403;1457;54
/net/per610a/home/mvp/mvp_db/news7-lv/2013/2013_02_14_19_00/2013_02_14_19_00.mpg;Shinzo ABE.jpg;23885;24413;36033;1195;1221;26
/net/per610a/home/mvp/mvp_db/news7-lv/2013/2013_02_15_19_00/2013_02_15_19_00.mpg;Shinzo ABE.jpg;16737;17061;36033;837;853;16
/net/per610a/home/mvp/mvp_db/news7-lv/2013/2013_02_18_19_00/2013_02_18_19_00.mpg;Shinzo ABE.jpg;16325;16481;36037;816;824;8
/net/per610a/home/mvp/mvp_db/news7-lv/2013/2013_02_18_19_00/2013_02_18_19_00.mpg;Shinzo ABE.jpg;16577;16737;36037;829;837;8
/net/per610a/home/mvp/mvp_db/news7-lv/2013/2013_02_18_19_00/2013_02_18_19_00.mpg;Shinzo ABE.jpg;17241;17793;36037;862;890;28
/net/per610a/home/mvp/mvp_db/news7-lv/2013/2013_02_18_19_00/2013_02_18_19_00.mpg;Shinzo ABE.jpg;18445;18877;36037;922;944;22
/net/per610a/home/mvp/mvp_db/news7-lv/2013/2013_02_18_19_00/2013_02_18_19_00.mpg;Shinzo ABE.jpg;19501;20093;36037;975;1005;30
/net/per610a/home/mvp/mvp_db/news7-lv/2013/2013_02_18_19_00/2013_02_18_19_00.mpg;Yukio HATOYAMA.jpg;28529;28749;36037;1427;1438;11
/net/per610a/home/mvp/mvp_db/news7-lv/2013/2013_02_20_19_00/2013_02_20_19_00.mpg;Shinzo ABE.jpg;21869;21937;36033;1094;1097;3
/net/per610a/home/mvp/mvp_db/news7-lv/2013/2013_02_21_19_00/2013_02_21_19_00.mpg;Shinzo ABE.jpg;157;397;36033;7;19;12
/net/per610a/home/mvp/mvp_db/news7-lv/2013/2013_02_21_19_00/2013_02_21_19_00.mpg;Shinzo ABE.jpg;1053;1053;36033;52;52;0
/net/per610a/home/mvp/mvp_db/news7-lv/2013/2013_02_21_19_00/2013_02_21_19_00.mpg;Shinzo ABE.jpg;1389;1393;36033;69;69;0
/net/per610a/home/mvp/mvp_db/news7-lv/2013/2013_02_21_19_00/2013_02_21_19_00.mpg;Shinzo ABE.jpg;1489;2033;36033;74;101;27
/net/per610a/home/mvp/mvp_db/news7-lv/2013/2013_02_21_19_00/2013_02_21_19_00.mpg;Shinzo ABE.jpg;2289;2409;36033;114;120;6
/net/per610a/home/mvp/mvp_db/news7-lv/2013/2013_02_21_19_00/2013_02_21_19_00.mpg;Shinzo ABE.jpg;5301;5981;36033;265;299;34
/net/per610a/home/mvp/mvp_db/news7-lv/2013/2013_02_21_19_00/2013_02_21_19_00.mpg;Shinzo ABE.jpg;6389;6489;36033;319;324;5
/net/per610a/home/mvp/mvp_db/news7-lv/2013/2013_02_22_19_00/2013_02_22_19_00.mpg;Shinzo ABE.jpg;993;1445;36033;49;72;23
/net/per610a/home/mvp/mvp_db/news7-lv/2013/2013_02_22_19_00/2013_02_22_19_00.mpg;Shinzo ABE.jpg;1705;1709;36033;85;85;0
/net/per610a/home/mvp/mvp_db/news7-lv/2013/2013_02_22_19_00/2013_02_22_19_00.mpg;Shinzo ABE.jpg;1789;2185;36033;89;109;20
/net/per610a/home/mvp/mvp_db/news7-lv/2013/2013_02_22_19_00/2013_02_22_19_00.mpg;Shinzo ABE.jpg;2445;2549;36033;122;127;5
/net/per610a/home/mvp/mvp_db/news7-lv/2013/2013_02_22_19_00/2013_02_22_19_00.mpg;Shinzo ABE.jpg;3345;4049;36033;167;202;35
/net/per610a/home/mvp/mvp_db/news7-lv/2013/2013_02_22_19_00/2013_02_22_19_00.mpg;Shinzo ABE.jpg;4213;4357;36033;210;218;8
/net/per610a/home/mvp/mvp_db/news7-lv/2013/2013_02_22_19_00/2013_02_22_19_00.mpg;Shinzo ABE.jpg;4857;5137;36033;243;257;14
/net/per610a/home/mvp/mvp_db/news7-lv/2013/2013_02_22_19_00/2013_02_22_19_00.mpg;Shinzo ABE.jpg;6121;6525;36033;306;326;20
/net/per610a/home/mvp/mvp_db/news7-lv/2013/2013_02_22_19_00/2013_02_22_19_00.mpg;Shinzo ABE.jpg;7797;7885;36033;390;394;4
/net/per610a/home/mvp/mvp_db/news7-lv/2013/2013_02_23_19_00/2013_02_23_19_00.mpg;Shinzo ABE.jpg;909;909;36033;45;45;0
/net/per610a/home/mvp/mvp_db/news7-lv/2013/2013_02_23_19_00/2013_02_23_19_00.mpg;Shinzo ABE.jpg;1689;1733;36033;84;86;2
/net/per610a/home/mvp/mvp_db/news7-lv/2013/2013_02_23_19_00/2013_02_23_19_00.mpg;Shinzo ABE.jpg;2545;2601;36033;127;130;3
/net/per610a/home/mvp/mvp_db/news7-lv/2013/2013_02_23_19_00/2013_02_23_19_00.mpg;Shinzo ABE.jpg;3661;4125;36033;183;206;23
/net/per610a/home/mvp/mvp_db/news7-lv/2013/2013_02_23_19_00/2013_02_23_19_00.mpg;Shinzo ABE.jpg;4253;4565;36033;212;228;16
/net/per610a/home/mvp/mvp_db/news7-lv/2013/2013_02_23_19_00/2013_02_23_19_00.mpg;Shinzo ABE.jpg;4669;5341;36033;233;267;34
/net/per610a/home/mvp/mvp_db/news7-lv/2013/2013_02_23_19_00/2013_02_23_19_00.mpg;Shinzo ABE.jpg;5473;6609;36033;273;330;57
/net/per610a/home/mvp/mvp_db/news7-lv/2013/2013_02_23_19_00/2013_02_23_19_00.mpg;Shinzo ABE.jpg;6725;8305;36033;336;415;79
/net/per610a/home/mvp/mvp_db/news7-lv/2013/2013_02_23_19_00/2013_02_23_19_00.mpg;Shinzo ABE.jpg;15353;15433;36033;768;772;4
/net/per610a/home/mvp/mvp_db/news7-lv/2013/2013_02_23_19_00/2013_02_23_19_00.mpg;Shinzo ABE.jpg;15885;16637;36033;794;832;38
/net/per610a/home/mvp/mvp_db/news7-lv/2013/2013_02_23_19_00/2013_02_23_19_00.mpg;Shinzo ABE.jpg;16813;16905;36033;841;845;4
/net/per610a/home/mvp/mvp_db/news7-lv/2013/2013_02_24_19_00/2013_02_24_19_00.mpg;Bairi Kaieda.jpg;7957;8533;36033;398;426;28
/net/per610a/home/mvp/mvp_db/news7-lv/2013/2013_02_24_19_00/2013_02_24_19_00.mpg;Yorihisa Matsuno.png;10313;10697;36033;516;535;19
/net/per610a/home/mvp/mvp_db/news7-lv/2013/2013_02_25_19_00/2013_02_25_19_00.mpg;Natsuo YAMAGUCHI.jpg;2837;3365;36033;141;168;27
/net/per610a/home/mvp/mvp_db/news7-lv/2013/2013_02_25_19_00/2013_02_25_19_00.mpg;Yoshimi WATANABE.jpg;7725;8113;36033;386;405;19
/net/per610a/home/mvp/mvp_db/news7-lv/2013/2013_02_25_19_00/2013_02_25_19_00.mpg;Taro ASO.jpg;21129;21501;36033;1057;1075;18
/net/per610a/home/mvp/mvp_db/news7-lv/2013/2013_02_26_19_00/2013_02_26_19_00.mpg;Shinzo ABE.jpg;14137;14161;38429;707;708;1
/net/per610a/home/mvp/mvp_db/news7-lv/2013/2013_02_26_19_00/2013_02_26_19_00.mpg;Shinzo ABE.jpg;14237;14409;38429;712;721;9
/net/per610a/home/mvp/mvp_db/news7-lv/2013/2013_02_26_19_00/2013_02_26_19_00.mpg;Shinzo ABE.jpg;20257;20657;38429;1013;1033;20
/net/per610a/home/mvp/mvp_db/news7-lv/2013/2013_02_26_19_00/2013_02_26_19_00.mpg;Shinzo ABE.jpg;20993;21001;38429;1050;1050;0
/net/per610a/home/mvp/mvp_db/news7-lv/2013/2013_02_26_19_00/2013_02_26_19_00.mpg;Shinzo ABE.jpg;21445;21449;38429;1073;1073;0
/net/per610a/home/mvp/mvp_db/news7-lv/2013/2013_02_26_19_00/2013_02_26_19_00.mpg;Shinzo ABE.jpg;24733;24793;38429;1237;1240;3
/net/per610a/home/mvp/mvp_db/news7-lv/2013/2013_02_27_19_00/2013_02_27_19_00.mpg;Shinzo ABE.jpg;18473;18941;36033;924;947;23
/net/per610a/home/mvp/mvp_db/news7-lv/2013/2013_02_27_19_00/2013_02_27_19_00.mpg;Shinzo ABE.jpg;21401;21453;36033;1070;1073;3
/net/per610a/home/mvp/mvp_db/news7-lv/2013/2013_02_28_19_00/2013_02_28_19_00.mpg;Bairi Kaieda.jpg;12929;13177;36033;646;659;13
/net/per610a/home/mvp/mvp_db/news7-lv/2013/2013_02_28_19_00/2013_02_28_19_00.mpg;Bairi Kaieda.jpg;14897;14901;36033;745;745;0
/net/per610a/home/mvp/mvp_db/news7-lv/2013/2013_03_01_19_00/2013_03_01_19_00.mpg;Shinzo ABE.jpg;4753;4845;36033;237;242;5
/net/per610a/home/mvp/mvp_db/news7-lv/2013/2013_03_01_19_00/2013_03_01_19_00.mpg;Shinzo ABE.jpg;31225;31269;36033;1562;1564;2
/net/per610a/home/mvp/mvp_db/news7-lv/2013/2013_03_02_19_00/2013_03_02_19_00.mpg;Shinzo ABE.jpg;6297;6901;36033;315;345;30
/net/per610a/home/mvp/mvp_db/news7-lv/2013/2013_03_02_19_00/2013_03_02_19_00.mpg;Shinzo ABE.jpg;7381;7773;36033;369;388;19
/net/per610a/home/mvp/mvp_db/news7-lv/2013/2013_03_02_19_00/2013_03_02_19_00.mpg;Shinzo ABE.jpg;10693;10861;36033;535;543;8
/net/per610a/home/mvp/mvp_db/news7-lv/2013/2013_03_04_19_00/2013_03_04_19_00.mpg;Shinzo ABE.jpg;9477;9741;36033;474;487;13
/net/per610a/home/mvp/mvp_db/news7-lv/2013/2013_03_04_19_00/2013_03_04_19_00.mpg;Shinzo ABE.jpg;18753;19233;36033;938;962;24
/net/per610a/home/mvp/mvp_db/news7-lv/2013/2013_03_04_19_00/2013_03_04_19_00.mpg;Shinzo ABE.jpg;20221;20857;36033;1011;1043;32
/net/per610a/home/mvp/mvp_db/news7-lv/2013/2013_03_05_19_00/2013_03_05_19_00.mpg;Shinzo ABE.jpg;22681;23105;36033;1134;1156;22
/net/per610a/home/mvp/mvp_db/news7-lv/2013/2013_03_07_19_00/2013_03_07_19_00.mpg;Shinzo ABE.jpg;23677;24093;36037;1184;1205;21
/net/per610a/home/mvp/mvp_db/news7-lv/2013/2013_03_07_19_00/2013_03_07_19_00.mpg;Shinzo ABE.jpg;26365;26925;36037;1319;1347;28
/net/per610a/home/mvp/mvp_db/news7-lv/2013/2013_03_07_19_00/2013_03_07_19_00.mpg;Shinzo ABE.jpg;26997;27581;36037;1350;1379;29
/net/per610a/home/mvp/mvp_db/news7-lv/2013/2013_03_11_19_00/2013_03_11_19_00.mpg;Shinzo ABE.jpg;56137;56461;71997;2809;2825;16
/net/per610a/home/mvp/mvp_db/news7-lv/2013/2013_03_11_19_00/2013_03_11_19_00.mpg;Shinzo ABE.jpg;57241;57329;71997;2864;2868;4
/net/per610a/home/mvp/mvp_db/news7-lv/2013/2013_03_11_19_00/2013_03_11_19_00.mpg;Shinzo ABE.jpg;58721;58933;71997;2938;2949;11
/net/per610a/home/mvp/mvp_db/news7-lv/2013/2013_03_12_19_00/2013_03_12_19_00.mpg;Bairi Kaieda.jpg;16765;16909;36033;838;846;8
/net/per610a/home/mvp/mvp_db/news7-lv/2013/2013_03_13_19_00/2013_03_13_19_00.mpg;Shinzo ABE.jpg;4921;5185;36033;246;259;13
/net/per610a/home/mvp/mvp_db/news7-lv/2013/2013_03_13_19_00/2013_03_13_19_00.mpg;Shinzo ABE.jpg;17045;17149;36033;852;858;6
/net/per610a/home/mvp/mvp_db/news7-lv/2013/2013_03_13_19_00/2013_03_13_19_00.mpg;Shinzo ABE.jpg;19049;19169;36033;953;959;6
/net/per610a/home/mvp/mvp_db/news7-lv/2013/2013_03_14_19_00/2013_03_14_19_00.mpg;Bairi Kaieda.jpg;16021;16593;36033;801;830;29
/net/per610a/home/mvp/mvp_db/news7-lv/2013/2013_03_14_19_00/2013_03_14_19_00.mpg;Yorihisa Matsuno.png;16737;16845;36033;837;842;5
/net/per610a/home/mvp/mvp_db/news7-lv/2013/2013_03_14_19_00/2013_03_14_19_00.mpg;Shinzo ABE.jpg;17369;17585;36033;869;879;10
/net/per610a/home/mvp/mvp_db/news7-lv/2013/2013_03_15_19_00/2013_03_15_19_00.mpg;Shinzo ABE.jpg;917;1601;38429;45;80;35
/net/per610a/home/mvp/mvp_db/news7-lv/2013/2013_03_15_19_00/2013_03_15_19_00.mpg;Shinzo ABE.jpg;4121;5233;38429;206;261;55
/net/per610a/home/mvp/mvp_db/news7-lv/2013/2013_03_15_19_00/2013_03_15_19_00.mpg;Shinzo ABE.jpg;10037;10157;38429;502;508;6
/net/per610a/home/mvp/mvp_db/news7-lv/2013/2013_03_15_19_00/2013_03_15_19_00.mpg;Shinzo ABE.jpg;10497;10821;38429;525;541;16
/net/per610a/home/mvp/mvp_db/news7-lv/2013/2013_03_15_19_00/2013_03_15_19_00.mpg;Shinzo ABE.jpg;14697;15401;38429;735;770;35
/net/per610a/home/mvp/mvp_db/news7-lv/2013/2013_03_15_19_00/2013_03_15_19_00.mpg;Shinzo ABE.jpg;20889;21277;38429;1045;1064;19
/net/per610a/home/mvp/mvp_db/news7-lv/2013/2013_03_17_19_00/2013_03_17_19_00.mpg;Shinzo ABE.jpg;6793;6817;36033;339;341;2
/net/per610a/home/mvp/mvp_db/news7-lv/2013/2013_03_17_19_00/2013_03_17_19_00.mpg;Shinzo ABE.jpg;7037;7913;36033;352;395;43
/net/per610a/home/mvp/mvp_db/news7-lv/2013/2013_03_17_19_00/2013_03_17_19_00.mpg;Shinzo ABE.jpg;10249;10893;36033;512;545;33
/net/per610a/home/mvp/mvp_db/news7-lv/2013/2013_03_17_19_00/2013_03_17_19_00.mpg;Shinzo ABE.jpg;6837;6937;36033;342;347;5
/net/per610a/home/mvp/mvp_db/news7-lv/2013/2013_03_17_19_00/2013_03_17_19_00.mpg;Shinzo ABE.jpg;7921;8025;36033;396;401;5
/net/per610a/home/mvp/mvp_db/news7-lv/2013/2013_03_17_19_00/2013_03_17_19_00.mpg;Shinzo ABE.jpg;8713;8793;36033;435;439;4
/net/per610a/home/mvp/mvp_db/news7-lv/2013/2013_03_21_19_00/2013_03_21_19_00.mpg;Shinzo ABE.jpg;4037;4233;36033;202;211;9
/net/per610a/home/mvp/mvp_db/news7-lv/2013/2013_03_21_19_00/2013_03_21_19_00.mpg;Taro ASO.jpg;6101;6169;36033;305;308;3
/net/per610a/home/mvp/mvp_db/news7-lv/2013/2013_03_21_19_00/2013_03_21_19_00.mpg;Taro ASO.jpg;6301;6301;36033;315;315;0
/net/per610a/home/mvp/mvp_db/news7-lv/2013/2013_03_21_19_00/2013_03_21_19_00.mpg;Taro ASO.jpg;6445;6513;36033;322;325;3
/net/per610a/home/mvp/mvp_db/news7-lv/2013/2013_03_21_19_00/2013_03_21_19_00.mpg;Taro ASO.jpg;6709;6825;36033;335;341;6
/net/per610a/home/mvp/mvp_db/news7-lv/2013/2013_03_22_19_00/2013_03_22_19_00.mpg;Shinzo ABE.jpg;4093;4269;36029;204;213;9
/net/per610a/home/mvp/mvp_db/news7-lv/2013/2013_03_22_19_00/2013_03_22_19_00.mpg;Shinzo ABE.jpg;8309;8325;36029;415;416;1
/net/per610a/home/mvp/mvp_db/news7-lv/2013/2013_03_22_19_00/2013_03_22_19_00.mpg;Shinzo ABE.jpg;9513;10425;36029;476;521;45
/net/per610a/home/mvp/mvp_db/news7-lv/2013/2013_03_22_19_00/2013_03_22_19_00.mpg;Shinzo ABE.jpg;11285;12085;36029;564;604;40
/net/per610a/home/mvp/mvp_db/news7-lv/2013/2013_03_22_19_00/2013_03_22_19_00.mpg;Shinzo ABE.jpg;15301;15661;36029;765;783;18
/net/per610a/home/mvp/mvp_db/news7-lv/2013/2013_03_22_19_00/2013_03_22_19_00.mpg;Shinzo ABE.jpg;34697;35009;36029;1736;1751;15
/net/per610a/home/mvp/mvp_db/news7-lv/2013/2013_03_22_19_00/2013_03_22_19_00.mpg;Shinzo ABE.jpg;12149;12257;36029;607;613;6
/net/per610a/home/mvp/mvp_db/news7-lv/2013/2013_03_23_19_00/2013_03_23_19_00.mpg;Shinzo ABE.jpg;2381;2713;36041;119;135;16
/net/per610a/home/mvp/mvp_db/news7-lv/2013/2013_03_24_19_00/2013_03_24_19_00.mpg;Shinzo ABE.jpg;1141;2013;36041;57;100;43
/net/per610a/home/mvp/mvp_db/news7-lv/2013/2013_03_24_19_00/2013_03_24_19_00.mpg;Shinzo ABE.jpg;2693;4113;36041;134;205;71
/net/per610a/home/mvp/mvp_db/news7-lv/2013/2013_03_24_19_00/2013_03_24_19_00.mpg;Bairi Kaieda.jpg;4229;5253;36041;211;262;51
/net/per610a/home/mvp/mvp_db/news7-lv/2013/2013_03_25_19_00/2013_03_25_19_00.mpg;Shinzo ABE.jpg;393;505;36041;19;25;6
/net/per610a/home/mvp/mvp_db/news7-lv/2013/2013_03_25_19_00/2013_03_25_19_00.mpg;Shinzo ABE.jpg;6877;7049;36041;344;352;8
/net/per610a/home/mvp/mvp_db/news7-lv/2013/2013_03_25_19_00/2013_03_25_19_00.mpg;Shinzo ABE.jpg;15869;16457;36041;793;823;30
/net/per610a/home/mvp/mvp_db/news7-lv/2013/2013_03_25_19_00/2013_03_25_19_00.mpg;Shinzo ABE.jpg;17809;18433;36041;890;922;32
/net/per610a/home/mvp/mvp_db/news7-lv/2013/2013_03_25_19_00/2013_03_25_19_00.mpg;Shinzo ABE.jpg;19273;19385;36041;964;969;5
/net/per610a/home/mvp/mvp_db/news7-lv/2013/2013_03_28_19_00/2013_03_28_19_00.mpg;Bairi Kaieda.jpg;7293;7829;36033;364;391;27
/net/per610a/home/mvp/mvp_db/news7-lv/2013/2013_03_30_19_00/2013_03_30_19_00.mpg;Shinzo ABE.jpg;1413;1485;36033;70;74;4
/net/per610a/home/mvp/mvp_db/news7-lv/2013/2013_03_30_19_00/2013_03_30_19_00.mpg;Shinzo ABE.jpg;2549;2805;36033;127;140;13
/net/per610a/home/mvp/mvp_db/news7-lv/2013/2013_03_30_19_00/2013_03_30_19_00.mpg;Shinzo ABE.jpg;2901;2945;36033;145;147;2
/net/per610a/home/mvp/mvp_db/news7-lv/2013/2013_03_30_19_00/2013_03_30_19_00.mpg;Shinzo ABE.jpg;9165;9469;36033;458;473;15
/net/per610a/home/mvp/mvp_db/news7-lv/2013/2013_03_30_19_00/2013_03_30_19_00.mpg;Ichiro Matsui.jpeg;7889;7913;36033;394;395;1
/net/per610a/home/mvp/mvp_db/news7-lv/2013/2013_03_30_19_00/2013_03_30_19_00.mpg;Ichiro Matsui.jpeg;8013;9161;36033;400;458;58
/net/per610a/home/mvp/mvp_db/news7-lv/2013/2013_03_30_19_00/2013_03_30_19_00.mpg;Kenji Eda.jpg;7897;8205;36033;395;410;15
/net/per610a/home/mvp/mvp_db/news7-lv/2013/2013_03_31_19_00/2013_03_31_19_00.mpg;Shinzo ABE.jpg;26621;27073;36029;1332;1354;22
/net/per610a/home/mvp/mvp_db/news7-lv/2013/2013_04_02_19_00/2013_04_02_19_00.mpg;Yorihisa Matsuno.png;13705;14145;36033;685;707;22
/net/per610a/home/mvp/mvp_db/news7-lv/2013/2013_04_02_19_00/2013_04_02_19_00.mpg;Kenji Eda.jpg;14197;14569;36033;710;728;18
/net/per610a/home/mvp/mvp_db/news7-lv/2013/2013_04_02_19_00/2013_04_02_19_00.mpg;Natsuo YAMAGUCHI.jpg;14617;15277;36033;731;764;33
/net/per610a/home/mvp/mvp_db/news7-lv/2013/2013_04_04_19_00/2013_04_04_19_00.mpg;Taro ASO.jpg;2053;2517;36033;102;125;23
/net/per610a/home/mvp/mvp_db/news7-lv/2013/2013_04_08_19_00/2013_04_08_19_00.mpg;Shinzo ABE.jpg;4881;5445;36033;244;272;28
/net/per610a/home/mvp/mvp_db/news7-lv/2013/2013_04_08_19_00/2013_04_08_19_00.mpg;Shinzo ABE.jpg;21825;21929;36033;1092;1097;5
/net/per610a/home/mvp/mvp_db/news7-lv/2013/2013_04_10_19_00/2013_04_10_19_00.mpg;Yukiko Kada.jpg;22721;22969;36033;1136;1149;13
/net/per610a/home/mvp/mvp_db/news7-lv/2013/2013_04_11_19_00/2013_04_11_19_00.mpg;Yukio HATOYAMA.jpg;5157;5381;36041;257;269;12
/net/per610a/home/mvp/mvp_db/news7-lv/2013/2013_04_12_19_00/2013_04_12_19_00.mpg;Shinzo ABE.jpg;469;541;36033;23;27;4
/net/per610a/home/mvp/mvp_db/news7-lv/2013/2013_04_12_19_00/2013_04_12_19_00.mpg;Shinzo ABE.jpg;613;717;36033;30;35;5
/net/per610a/home/mvp/mvp_db/news7-lv/2013/2013_04_12_19_00/2013_04_12_19_00.mpg;Shinzo ABE.jpg;7641;8261;36033;382;413;31
/net/per610a/home/mvp/mvp_db/news7-lv/2013/2013_04_12_19_00/2013_04_12_19_00.mpg;Shinzo ABE.jpg;8401;8765;36033;420;438;18
/net/per610a/home/mvp/mvp_db/news7-lv/2013/2013_04_12_19_00/2013_04_12_19_00.mpg;Shinzo ABE.jpg;12393;12521;36033;620;626;6
/net/per610a/home/mvp/mvp_db/news7-lv/2013/2013_04_12_19_00/2013_04_12_19_00.mpg;Shinzo ABE.jpg;12673;13097;36033;634;655;21
/net/per610a/home/mvp/mvp_db/news7-lv/2013/2013_04_12_19_00/2013_04_12_19_00.mpg;Shinzo ABE.jpg;13729;13821;36033;686;691;5
/net/per610a/home/mvp/mvp_db/news7-lv/2013/2013_04_14_19_00/2013_04_14_19_00.mpg;Shinzo ABE.jpg;7817;8161;36037;391;408;17
/net/per610a/home/mvp/mvp_db/news7-lv/2013/2013_04_14_19_00/2013_04_14_19_00.mpg;Shinzo ABE.jpg;11453;11529;36037;573;576;3
/net/per610a/home/mvp/mvp_db/news7-lv/2013/2013_04_14_19_00/2013_04_14_19_00.mpg;Shinzo ABE.jpg;13577;14173;36037;679;709;30
/net/per610a/home/mvp/mvp_db/news7-lv/2013/2013_04_15_19_00/2013_04_15_19_00.mpg;Shinzo ABE.jpg;173;197;36033;8;9;1
/net/per610a/home/mvp/mvp_db/news7-lv/2013/2013_04_15_19_00/2013_04_15_19_00.mpg;Shinzo ABE.jpg;1353;1385;36033;67;69;2
/net/per610a/home/mvp/mvp_db/news7-lv/2013/2013_04_15_19_00/2013_04_15_19_00.mpg;Shinzo ABE.jpg;7213;7253;36033;360;362;2
/net/per610a/home/mvp/mvp_db/news7-lv/2013/2013_04_15_19_00/2013_04_15_19_00.mpg;Shinzo ABE.jpg;7437;7493;36033;372;374;2
/net/per610a/home/mvp/mvp_db/news7-lv/2013/2013_04_15_19_00/2013_04_15_19_00.mpg;Shinzo ABE.jpg;7565;7665;36033;378;383;5
/net/per610a/home/mvp/mvp_db/news7-lv/2013/2013_04_15_19_00/2013_04_15_19_00.mpg;Shinzo ABE.jpg;18361;18661;36033;918;933;15
/net/per610a/home/mvp/mvp_db/news7-lv/2013/2013_04_18_19_00/2013_04_18_19_00.mpg;Katsuya OKADA.jpg;20405;20501;36033;1021;1025;4
/net/per610a/home/mvp/mvp_db/news7-lv/2013/2013_04_19_19_00/2013_04_19_19_00.mpg;Shinzo ABE.jpg;7637;8165;37229;382;408;26
/net/per610a/home/mvp/mvp_db/news7-lv/2013/2013_04_19_19_00/2013_04_19_19_00.mpg;Shinzo ABE.jpg;9577;9653;37229;479;483;4
/net/per610a/home/mvp/mvp_db/news7-lv/2013/2013_04_19_19_00/2013_04_19_19_00.mpg;Shinzo ABE.jpg;10229;10273;37229;511;514;3
/net/per610a/home/mvp/mvp_db/news7-lv/2013/2013_04_19_19_00/2013_04_19_19_00.mpg;Shinzo ABE.jpg;10445;10793;37229;522;540;18
/net/per610a/home/mvp/mvp_db/news7-lv/2013/2013_04_19_19_00/2013_04_19_19_00.mpg;Shinzo ABE.jpg;11021;11197;37229;551;560;9
/net/per610a/home/mvp/mvp_db/news7-lv/2013/2013_04_20_19_00/2013_04_20_19_00.mpg;Shinzo ABE.jpg;11177;11189;36033;559;559;0
/net/per610a/home/mvp/mvp_db/news7-lv/2013/2013_04_20_19_00/2013_04_20_19_00.mpg;Shinzo ABE.jpg;11369;11789;36033;568;589;21
/net/per610a/home/mvp/mvp_db/news7-lv/2013/2013_04_20_19_00/2013_04_20_19_00.mpg;Bairi Kaieda.jpg;29629;30485;36033;1482;1525;43
/net/per610a/home/mvp/mvp_db/news7-lv/2013/2013_04_22_19_00/2013_04_22_19_00.mpg;Shinzo ABE.jpg;18329;19225;36033;917;961;44
/net/per610a/home/mvp/mvp_db/news7-lv/2013/2013_04_22_19_00/2013_04_22_19_00.mpg;Shinzo ABE.jpg;19329;19469;36033;967;974;7
/net/per610a/home/mvp/mvp_db/news7-lv/2013/2013_04_22_19_00/2013_04_22_19_00.mpg;Shinzo ABE.jpg;19841;20449;36033;992;1023;31
/net/per610a/home/mvp/mvp_db/news7-lv/2013/2013_04_23_19_00/2013_04_23_19_00.mpg;Shinzo ABE.jpg;7885;7905;36033;394;395;1
/net/per610a/home/mvp/mvp_db/news7-lv/2013/2013_04_23_19_00/2013_04_23_19_00.mpg;Shinzo ABE.jpg;8445;8609;36033;422;430;8
/net/per610a/home/mvp/mvp_db/news7-lv/2013/2013_04_23_19_00/2013_04_23_19_00.mpg;Shinzo ABE.jpg;11033;11405;36033;552;570;18
/net/per610a/home/mvp/mvp_db/news7-lv/2013/2013_04_23_19_00/2013_04_23_19_00.mpg;Shinzo ABE.jpg;11533;11553;36033;577;578;1
/net/per610a/home/mvp/mvp_db/news7-lv/2013/2013_04_23_19_00/2013_04_23_19_00.mpg;Shinzo ABE.jpg;11889;12021;36033;594;601;7
/net/per610a/home/mvp/mvp_db/news7-lv/2013/2013_04_23_19_00/2013_04_23_19_00.mpg;Shinzo ABE.jpg;12873;13297;36033;644;665;21
/net/per610a/home/mvp/mvp_db/news7-lv/2013/2013_04_23_19_00/2013_04_23_19_00.mpg;Shinzo ABE.jpg;13789;14605;36033;689;730;41
/net/per610a/home/mvp/mvp_db/news7-lv/2013/2013_04_23_19_00/2013_04_23_19_00.mpg;Shinzo ABE.jpg;14769;14949;36033;739;748;9
/net/per610a/home/mvp/mvp_db/news7-lv/2013/2013_04_23_19_00/2013_04_23_19_00.mpg;Shinzo ABE.jpg;16065;16537;36033;803;827;24
/net/per610a/home/mvp/mvp_db/news7-lv/2013/2013_04_23_19_00/2013_04_23_19_00.mpg;Shinzo ABE.jpg;16941;17665;36033;847;883;36
/net/per610a/home/mvp/mvp_db/news7-lv/2013/2013_04_24_19_00/2013_04_24_19_00.mpg;Shinzo ABE.jpg;881;1333;36033;44;66;22
/net/per610a/home/mvp/mvp_db/news7-lv/2013/2013_04_24_19_00/2013_04_24_19_00.mpg;Shinzo ABE.jpg;3937;5833;36033;196;291;95
/net/per610a/home/mvp/mvp_db/news7-lv/2013/2013_04_26_19_00/2013_04_26_19_00.mpg;Akihiro OHTA.jpg;17065;17165;36033;853;858;5
/net/per610a/home/mvp/mvp_db/news7-lv/2013/2013_04_26_19_00/2013_04_26_19_00.mpg;Taro ASO.jpg;20289;20469;36033;1015;1024;9
/net/per610a/home/mvp/mvp_db/news7-lv/2013/2013_04_27_19_00/2013_04_27_19_00.mpg;Shinzo ABE.jpg;22693;23345;36037;1135;1167;32
/net/per610a/home/mvp/mvp_db/news7-lv/2013/2013_04_28_19_00/2013_04_28_19_00.mpg;Shinzo ABE.jpg;173;333;36033;8;16;8
/net/per610a/home/mvp/mvp_db/news7-lv/2013/2013_04_28_19_00/2013_04_28_19_00.mpg;Shinzo ABE.jpg;1353;1545;36033;67;77;10
/net/per610a/home/mvp/mvp_db/news7-lv/2013/2013_04_28_19_00/2013_04_28_19_00.mpg;Shinzo ABE.jpg;2097;2393;36033;104;119;15
/net/per610a/home/mvp/mvp_db/news7-lv/2013/2013_04_28_19_00/2013_04_28_19_00.mpg;Shinzo ABE.jpg;2497;2885;36033;124;144;20
/net/per610a/home/mvp/mvp_db/news7-lv/2013/2013_04_28_19_00/2013_04_28_19_00.mpg;Shinzo ABE.jpg;7769;8317;36033;388;416;28
/net/per610a/home/mvp/mvp_db/news7-lv/2013/2013_04_28_19_00/2013_04_28_19_00.mpg;Shinzo ABE.jpg;24333;24981;36033;1217;1249;32
/net/per610a/home/mvp/mvp_db/news7-lv/2013/2013_04_29_19_00/2013_04_29_19_00.mpg;Shinzo ABE.jpg;113;237;36029;5;11;6
/net/per610a/home/mvp/mvp_db/news7-lv/2013/2013_04_29_19_00/2013_04_29_19_00.mpg;Shinzo ABE.jpg;1589;1649;36029;79;82;3
/net/per610a/home/mvp/mvp_db/news7-lv/2013/2013_04_29_19_00/2013_04_29_19_00.mpg;Shinzo ABE.jpg;2113;2325;36029;105;116;11
/net/per610a/home/mvp/mvp_db/news7-lv/2013/2013_04_29_19_00/2013_04_29_19_00.mpg;Shinzo ABE.jpg;3041;3481;36029;152;174;22
/net/per610a/home/mvp/mvp_db/news7-lv/2013/2013_04_29_19_00/2013_04_29_19_00.mpg;Shinzo ABE.jpg;3721;3749;36029;186;187;1
/net/per610a/home/mvp/mvp_db/news7-lv/2013/2013_04_29_19_00/2013_04_29_19_00.mpg;Shinzo ABE.jpg;4477;4781;36029;224;239;15
/net/per610a/home/mvp/mvp_db/news7-lv/2013/2013_04_29_19_00/2013_04_29_19_00.mpg;Shinzo ABE.jpg;7833;8129;36029;391;406;15
/net/per610a/home/mvp/mvp_db/news7-lv/2013/2013_04_29_19_00/2013_04_29_19_00.mpg;Shinzo ABE.jpg;6349;6661;36029;317;333;16
/net/per610a/home/mvp/mvp_db/news7-lv/2013/2013_04_30_19_00/2013_04_30_19_00.mpg;Shinzo ABE.jpg;19957;20845;36033;998;1043;45
/net/per610a/home/mvp/mvp_db/news7-lv/2013/2013_05_01_19_00/2013_05_01_19_00.mpg;Shinzo ABE.jpg;12097;12149;36033;605;607;2
/net/per610a/home/mvp/mvp_db/news7-lv/2013/2013_05_01_19_00/2013_05_01_19_00.mpg;Shinzo ABE.jpg;13085;13345;36033;654;667;13
/net/per610a/home/mvp/mvp_db/news7-lv/2013/2013_05_01_19_00/2013_05_01_19_00.mpg;Shinzo ABE.jpg;13805;13861;36033;690;693;3
/net/per610a/home/mvp/mvp_db/news7-lv/2013/2013_05_01_19_00/2013_05_01_19_00.mpg;Shinzo ABE.jpg;15037;15073;36033;752;754;2
/net/per610a/home/mvp/mvp_db/news7-lv/2013/2013_05_01_19_00/2013_05_01_19_00.mpg;Shinzo ABE.jpg;15221;15257;36033;761;763;2
/net/per610a/home/mvp/mvp_db/news7-lv/2013/2013_05_01_19_00/2013_05_01_19_00.mpg;Shinzo ABE.jpg;13377;13521;36033;669;676;7
/net/per610a/home/mvp/mvp_db/news7-lv/2013/2013_05_01_19_00/2013_05_01_19_00.mpg;Shinzo ABE.jpg;15489;15561;36033;775;778;3
/net/per610a/home/mvp/mvp_db/news7-lv/2013/2013_05_01_19_00/2013_05_01_19_00.mpg;Yukiko Kada.jpg;23341;23377;36033;1167;1169;2
/net/per610a/home/mvp/mvp_db/news7-lv/2013/2013_05_01_19_00/2013_05_01_19_00.mpg;Yukiko Kada.jpg;23549;23745;36033;1178;1188;10
/net/per610a/home/mvp/mvp_db/news7-lv/2013/2013_05_02_19_00/2013_05_02_19_00.mpg;Shinzo ABE.jpg;6517;6649;36033;326;332;6
/net/per610a/home/mvp/mvp_db/news7-lv/2013/2013_05_02_19_00/2013_05_02_19_00.mpg;Shinzo ABE.jpg;8177;8257;36033;409;413;4
/net/per610a/home/mvp/mvp_db/news7-lv/2013/2013_05_02_19_00/2013_05_02_19_00.mpg;Shinzo ABE.jpg;8977;9437;36033;449;472;23
/net/per610a/home/mvp/mvp_db/news7-lv/2013/2013_05_02_19_00/2013_05_02_19_00.mpg;Shinzo ABE.jpg;9609;9797;36033;480;490;10
/net/per610a/home/mvp/mvp_db/news7-lv/2013/2013_05_03_19_00/2013_05_03_19_00.mpg;Shinzo ABE.jpg;937;937;36041;46;46;0
/net/per610a/home/mvp/mvp_db/news7-lv/2013/2013_05_03_19_00/2013_05_03_19_00.mpg;Shinzo ABE.jpg;6633;7077;36041;331;354;23
/net/per610a/home/mvp/mvp_db/news7-lv/2013/2013_05_03_19_00/2013_05_03_19_00.mpg;Shinzo ABE.jpg;5341;5545;36041;267;277;10
/net/per610a/home/mvp/mvp_db/news7-lv/2013/2013_05_03_19_00/2013_05_03_19_00.mpg;Shinzo ABE.jpg;5717;6101;36041;286;305;19
/net/per610a/home/mvp/mvp_db/news7-lv/2013/2013_05_04_19_00/2013_05_04_19_00.mpg;Shinzo ABE.jpg;24085;24141;36045;1205;1208;3
/net/per610a/home/mvp/mvp_db/news7-lv/2013/2013_05_04_19_00/2013_05_04_19_00.mpg;Shinzo ABE.jpg;24305;24369;36045;1216;1219;3
/net/per610a/home/mvp/mvp_db/news7-lv/2013/2013_05_07_19_00/2013_05_07_19_00.mpg;Shinzo ABE.jpg;10937;11437;36033;547;572;25
/net/per610a/home/mvp/mvp_db/news7-lv/2013/2013_05_10_19_00/2013_05_10_19_00.mpg;Shinzo ABE.jpg;13493;13769;36033;675;688;13
/net/per610a/home/mvp/mvp_db/news7-lv/2013/2013_05_12_19_00/2013_05_12_19_00.mpg;Shinzo ABE.jpg;1313;1589;36041;65;79;14
/net/per610a/home/mvp/mvp_db/news7-lv/2013/2013_05_12_19_00/2013_05_12_19_00.mpg;Shinzo ABE.jpg;1861;2041;36041;93;102;9
/net/per610a/home/mvp/mvp_db/news7-lv/2013/2013_05_12_19_00/2013_05_12_19_00.mpg;Shinzo ABE.jpg;2577;2757;36041;128;137;9
/net/per610a/home/mvp/mvp_db/news7-lv/2013/2013_05_12_19_00/2013_05_12_19_00.mpg;Shinzo ABE.jpg;2881;3025;36041;144;151;7
/net/per610a/home/mvp/mvp_db/news7-lv/2013/2013_05_12_19_00/2013_05_12_19_00.mpg;Shinzo ABE.jpg;3125;4945;36041;156;247;91
/net/per610a/home/mvp/mvp_db/news7-lv/2013/2013_05_13_19_00/2013_05_13_19_00.mpg;Bairi Kaieda.jpg;11485;12597;36033;574;630;56
/net/per610a/home/mvp/mvp_db/news7-lv/2013/2013_05_13_19_00/2013_05_13_19_00.mpg;Shinzo ABE.jpg;14709;14897;36033;736;745;9
/net/per610a/home/mvp/mvp_db/news7-lv/2013/2013_05_13_19_00/2013_05_13_19_00.mpg;Shinzo ABE.jpg;15833;15937;36033;792;797;5
/net/per610a/home/mvp/mvp_db/news7-lv/2013/2013_05_13_19_00/2013_05_13_19_00.mpg;Shinzo ABE.jpg;22913;23385;36033;1146;1170;24
/net/per610a/home/mvp/mvp_db/news7-lv/2013/2013_05_13_19_00/2013_05_13_19_00.mpg;Shinzo ABE.jpg;23957;24001;36033;1198;1200;2
/net/per610a/home/mvp/mvp_db/news7-lv/2013/2013_05_14_19_00/2013_05_14_19_00.mpg;Toru Hashimoto.jpg;9085;9693;36033;454;485;31
/net/per610a/home/mvp/mvp_db/news7-lv/2013/2013_05_14_19_00/2013_05_14_19_00.mpg;Toru Hashimoto.jpg;9813;9929;36033;491;496;5
/net/per610a/home/mvp/mvp_db/news7-lv/2013/2013_05_15_19_00/2013_05_15_19_00.mpg;Sadakazu TANIGAKI.jpg;2805;3593;36041;140;179;39
/net/per610a/home/mvp/mvp_db/news7-lv/2013/2013_05_17_19_00/2013_05_17_19_00.mpg;Yoshimi WATANABE.jpg;20733;21481;36033;1037;1074;37
/net/per610a/home/mvp/mvp_db/news7-lv/2013/2013_05_18_19_00/2013_05_18_19_00.mpg;Shinzo ABE.jpg;3565;3957;36033;178;197;19
/net/per610a/home/mvp/mvp_db/news7-lv/2013/2013_05_18_19_00/2013_05_18_19_00.mpg;Shinzo ABE.jpg;11325;11345;36033;566;567;1
/net/per610a/home/mvp/mvp_db/news7-lv/2013/2013_05_18_19_00/2013_05_18_19_00.mpg;Shinzo ABE.jpg;11421;11569;36033;571;578;7
/net/per610a/home/mvp/mvp_db/news7-lv/2013/2013_05_18_19_00/2013_05_18_19_00.mpg;Shinzo ABE.jpg;12977;13029;36033;649;651;2
/net/per610a/home/mvp/mvp_db/news7-lv/2013/2013_05_18_19_00/2013_05_18_19_00.mpg;Shinzo ABE.jpg;13281;13649;36033;664;682;18
/net/per610a/home/mvp/mvp_db/news7-lv/2013/2013_05_19_19_00/2013_05_19_19_00.mpg;Toru Hashimoto.jpg;1041;1637;36033;52;81;29
/net/per610a/home/mvp/mvp_db/news7-lv/2013/2013_05_19_19_00/2013_05_19_19_00.mpg;Shintaro ISHIHARA.jpg;2925;3025;36033;146;151;5
/net/per610a/home/mvp/mvp_db/news7-lv/2013/2013_05_19_19_00/2013_05_19_19_00.mpg;Yoshimi WATANABE.jpg;3401;4241;36033;170;212;42
/net/per610a/home/mvp/mvp_db/news7-lv/2013/2013_05_19_19_00/2013_05_19_19_00.mpg;Shinzo ABE.jpg;6277;7565;36033;314;378;64
/net/per610a/home/mvp/mvp_db/news7-lv/2013/2013_05_20_19_00/2013_05_20_19_00.mpg;Shinzo ABE.jpg;8973;10001;36033;448;500;52
/net/per610a/home/mvp/mvp_db/news7-lv/2013/2013_05_20_19_00/2013_05_20_19_00.mpg;Shinzo ABE.jpg;22677;23109;36033;1134;1156;22
/net/per610a/home/mvp/mvp_db/news7-lv/2013/2013_05_20_19_00/2013_05_20_19_00.mpg;Yoshimi WATANABE.jpg;11957;12561;36033;598;628;30
/net/per610a/home/mvp/mvp_db/news7-lv/2013/2013_05_20_19_00/2013_05_20_19_00.mpg;Yoshimi WATANABE.jpg;13029;13549;36033;651;677;26
/net/per610a/home/mvp/mvp_db/news7-lv/2013/2013_05_20_19_00/2013_05_20_19_00.mpg;Yoshimi WATANABE.jpg;13613;13753;36033;681;688;7
/net/per610a/home/mvp/mvp_db/news7-lv/2013/2013_05_21_19_00/2013_05_21_19_00.mpg;Toru Hashimoto.jpg;18917;19401;36033;946;970;24
/net/per610a/home/mvp/mvp_db/news7-lv/2013/2013_05_21_19_00/2013_05_21_19_00.mpg;Toru Hashimoto.jpg;20729;21201;36033;1037;1060;23
/net/per610a/home/mvp/mvp_db/news7-lv/2013/2013_05_21_19_00/2013_05_21_19_00.mpg;Yoshimi WATANABE.jpg;19529;20009;36033;977;1001;24
/net/per610a/home/mvp/mvp_db/news7-lv/2013/2013_05_21_19_00/2013_05_21_19_00.mpg;Yoshimi WATANABE.jpg;20017;20021;36033;1001;1001;0
/net/per610a/home/mvp/mvp_db/news7-lv/2013/2013_05_21_19_00/2013_05_21_19_00.mpg;Yoshimi WATANABE.jpg;20369;20677;36033;1019;1034;15
/net/per610a/home/mvp/mvp_db/news7-lv/2013/2013_05_21_19_00/2013_05_21_19_00.mpg;Kenji Eda.jpg;20025;20109;36033;1002;1006;4
/net/per610a/home/mvp/mvp_db/news7-lv/2013/2013_05_22_19_00/2013_05_22_19_00.mpg;Shinzo ABE.jpg;20617;20789;36029;1031;1040;9
/net/per610a/home/mvp/mvp_db/news7-lv/2013/2013_05_22_19_00/2013_05_22_19_00.mpg;Shinzo ABE.jpg;21221;21457;36029;1061;1073;12
/net/per610a/home/mvp/mvp_db/news7-lv/2013/2013_05_23_19_00/2013_05_23_19_00.mpg;Bairi Kaieda.jpg;5565;6069;36033;278;303;25
/net/per610a/home/mvp/mvp_db/news7-lv/2013/2013_05_24_19_00/2013_05_24_19_00.mpg;Shinzo ABE.jpg;6429;7073;36033;321;353;32
/net/per610a/home/mvp/mvp_db/news7-lv/2013/2013_05_24_19_00/2013_05_24_19_00.mpg;Shinzo ABE.jpg;18841;19149;36033;942;958;16
/net/per610a/home/mvp/mvp_db/news7-lv/2013/2013_05_24_19_00/2013_05_24_19_00.mpg;Shinzo ABE.jpg;19633;20113;36033;982;1006;24
/net/per610a/home/mvp/mvp_db/news7-lv/2013/2013_05_24_19_00/2013_05_24_19_00.mpg;Shinzo ABE.jpg;20649;21357;36033;1033;1068;35
/net/per610a/home/mvp/mvp_db/news7-lv/2013/2013_05_24_19_00/2013_05_24_19_00.mpg;Shinzo ABE.jpg;26337;26701;36033;1317;1336;19
/net/per610a/home/mvp/mvp_db/news7-lv/2013/2013_05_25_19_00/2013_05_25_19_00.mpg;Shinzo ABE.jpg;7929;8341;36033;396;417;21
/net/per610a/home/mvp/mvp_db/news7-lv/2013/2013_05_25_19_00/2013_05_25_19_00.mpg;Shinzo ABE.jpg;9813;9857;36033;491;493;2
/net/per610a/home/mvp/mvp_db/news7-lv/2013/2013_05_25_19_00/2013_05_25_19_00.mpg;Shinzo ABE.jpg;16285;16905;36033;814;845;31
/net/per610a/home/mvp/mvp_db/news7-lv/2013/2013_05_26_19_00/2013_05_26_19_00.mpg;Shinzo ABE.jpg;1461;1481;36033;73;74;1
/net/per610a/home/mvp/mvp_db/news7-lv/2013/2013_05_26_19_00/2013_05_26_19_00.mpg;Shinzo ABE.jpg;1717;1777;36033;85;88;3
/net/per610a/home/mvp/mvp_db/news7-lv/2013/2013_05_26_19_00/2013_05_26_19_00.mpg;Shinzo ABE.jpg;2669;3009;36033;133;150;17
/net/per610a/home/mvp/mvp_db/news7-lv/2013/2013_05_26_19_00/2013_05_26_19_00.mpg;Shinzo ABE.jpg;3341;3413;36033;167;170;3
/net/per610a/home/mvp/mvp_db/news7-lv/2013/2013_05_26_19_00/2013_05_26_19_00.mpg;Shinzo ABE.jpg;3645;3965;36033;182;198;16
/net/per610a/home/mvp/mvp_db/news7-lv/2013/2013_05_26_19_00/2013_05_26_19_00.mpg;Shinzo ABE.jpg;5925;6553;36033;296;327;31
/net/per610a/home/mvp/mvp_db/news7-lv/2013/2013_05_27_19_00/2013_05_27_19_00.mpg;Toru Hashimoto.jpg;7861;8473;36033;393;423;30
/net/per610a/home/mvp/mvp_db/news7-lv/2013/2013_05_27_19_00/2013_05_27_19_00.mpg;Toru Hashimoto.jpg;8673;9017;36033;433;451;18
/net/per610a/home/mvp/mvp_db/news7-lv/2013/2013_05_27_19_00/2013_05_27_19_00.mpg;Toru Hashimoto.jpg;9153;10421;36033;457;521;64
/net/per610a/home/mvp/mvp_db/news7-lv/2013/2013_05_27_19_00/2013_05_27_19_00.mpg;Toru Hashimoto.jpg;10525;10801;36033;526;540;14
/net/per610a/home/mvp/mvp_db/news7-lv/2013/2013_05_27_19_00/2013_05_27_19_00.mpg;Bairi Kaieda.jpg;14185;14589;36033;709;729;20
/net/per610a/home/mvp/mvp_db/news7-lv/2013/2013_05_29_19_00/2013_05_29_19_00.mpg;Shinzo ABE.jpg;8105;8177;36037;405;409;4
/net/per610a/home/mvp/mvp_db/news7-lv/2013/2013_05_29_19_00/2013_05_29_19_00.mpg;Shinzo ABE.jpg;9477;9657;36037;474;483;9
/net/per610a/home/mvp/mvp_db/news7-lv/2013/2013_05_30_19_00/2013_05_30_19_00.mpg;Toru Hashimoto.jpg;12989;13629;36033;649;681;32
/net/per610a/home/mvp/mvp_db/news7-lv/2013/2013_05_31_19_00/2013_05_31_19_00.mpg;Shinzo ABE.jpg;2005;2181;36041;100;109;9
/net/per610a/home/mvp/mvp_db/news7-lv/2013/2013_05_31_19_00/2013_05_31_19_00.mpg;Shinzo ABE.jpg;4941;5057;36041;247;252;5
/net/per610a/home/mvp/mvp_db/news7-lv/2013/2013_06_01_19_00/2013_06_01_19_00.mpg;Shinzo ABE.jpg;4977;5081;36033;249;254;5
/net/per610a/home/mvp/mvp_db/news7-lv/2013/2013_06_01_19_00/2013_06_01_19_00.mpg;Shinzo ABE.jpg;7693;8337;36033;384;417;33
/net/per610a/home/mvp/mvp_db/news7-lv/2013/2013_06_02_19_00/2013_06_02_19_00.mpg;Shinzo ABE.jpg;1641;1697;36033;82;84;2
/net/per610a/home/mvp/mvp_db/news7-lv/2013/2013_06_02_19_00/2013_06_02_19_00.mpg;Shinzo ABE.jpg;1765;2193;36033;88;109;21
/net/per610a/home/mvp/mvp_db/news7-lv/2013/2013_06_02_19_00/2013_06_02_19_00.mpg;Shinzo ABE.jpg;2689;3245;36033;134;162;28
/net/per610a/home/mvp/mvp_db/news7-lv/2013/2013_06_02_19_00/2013_06_02_19_00.mpg;Shinzo ABE.jpg;5289;6033;36033;264;301;37
/net/per610a/home/mvp/mvp_db/news7-lv/2013/2013_06_02_19_00/2013_06_02_19_00.mpg;Toru Hashimoto.jpg;16353;16825;36033;818;841;23
/net/per610a/home/mvp/mvp_db/news7-lv/2013/2013_06_03_19_00/2013_06_03_19_00.mpg;Shinzo ABE.jpg;6953;7409;36033;347;370;23
/net/per610a/home/mvp/mvp_db/news7-lv/2013/2013_06_03_19_00/2013_06_03_19_00.mpg;Shinzo ABE.jpg;7833;7909;36033;391;395;4
/net/per610a/home/mvp/mvp_db/news7-lv/2013/2013_06_03_19_00/2013_06_03_19_00.mpg;Shinzo ABE.jpg;8149;8237;36033;407;412;5
/net/per610a/home/mvp/mvp_db/news7-lv/2013/2013_06_03_19_00/2013_06_03_19_00.mpg;Shinzo ABE.jpg;10345;10581;36033;517;529;12
/net/per610a/home/mvp/mvp_db/news7-lv/2013/2013_06_03_19_00/2013_06_03_19_00.mpg;Shinzo ABE.jpg;8397;8909;36033;420;445;25
/net/per610a/home/mvp/mvp_db/news7-lv/2013/2013_06_03_19_00/2013_06_03_19_00.mpg;Shinzo ABE.jpg;9233;9633;36033;461;482;21
/net/per610a/home/mvp/mvp_db/news7-lv/2013/2013_06_03_19_00/2013_06_03_19_00.mpg;Ichiro OZAWA.jpg;19729;21013;36033;987;1051;64
/net/per610a/home/mvp/mvp_db/news7-lv/2013/2013_06_03_19_00/2013_06_03_19_00.mpg;Ichiro OZAWA.jpg;21389;21893;36033;1070;1095;25
/net/per610a/home/mvp/mvp_db/news7-lv/2013/2013_06_05_19_00/2013_06_05_19_00.mpg;Shinzo ABE.jpg;257;365;36033;12;18;6
/net/per610a/home/mvp/mvp_db/news7-lv/2013/2013_06_05_19_00/2013_06_05_19_00.mpg;Shinzo ABE.jpg;969;1617;36033;48;80;32
/net/per610a/home/mvp/mvp_db/news7-lv/2013/2013_06_05_19_00/2013_06_05_19_00.mpg;Shinzo ABE.jpg;1801;3733;36033;90;186;96
/net/per610a/home/mvp/mvp_db/news7-lv/2013/2013_06_05_19_00/2013_06_05_19_00.mpg;Shinzo ABE.jpg;4429;5337;36033;221;267;46
/net/per610a/home/mvp/mvp_db/news7-lv/2013/2013_06_05_19_00/2013_06_05_19_00.mpg;Shinzo ABE.jpg;5689;5785;36033;284;289;5
/net/per610a/home/mvp/mvp_db/news7-lv/2013/2013_06_05_19_00/2013_06_05_19_00.mpg;Shinzo ABE.jpg;5933;6001;36033;296;300;4
/net/per610a/home/mvp/mvp_db/news7-lv/2013/2013_06_05_19_00/2013_06_05_19_00.mpg;Shinzo ABE.jpg;6513;6965;36033;325;348;23
/net/per610a/home/mvp/mvp_db/news7-lv/2013/2013_06_06_19_00/2013_06_06_19_00.mpg;Toru Hashimoto.jpg;11337;11857;36037;567;593;26
/net/per610a/home/mvp/mvp_db/news7-lv/2013/2013_06_06_19_00/2013_06_06_19_00.mpg;Toru Hashimoto.jpg;11993;12937;36037;600;647;47
/net/per610a/home/mvp/mvp_db/news7-lv/2013/2013_06_06_19_00/2013_06_06_19_00.mpg;Kazuo SHII.jpg;23733;24581;36037;1187;1229;42
/net/per610a/home/mvp/mvp_db/news7-lv/2013/2013_06_06_19_00/2013_06_06_19_00.mpg;Kazuo SHII.jpg;25417;26093;36037;1271;1305;34
/net/per610a/home/mvp/mvp_db/news7-lv/2013/2013_06_07_19_00/2013_06_07_19_00.mpg;Taro ASO.jpg;641;725;36033;32;36;4
/net/per610a/home/mvp/mvp_db/news7-lv/2013/2013_06_07_19_00/2013_06_07_19_00.mpg;Shinzo ABE.jpg;2097;2157;36033;104;107;3
/net/per610a/home/mvp/mvp_db/news7-lv/2013/2013_06_07_19_00/2013_06_07_19_00.mpg;Shinzo ABE.jpg;2361;2825;36033;118;141;23
/net/per610a/home/mvp/mvp_db/news7-lv/2013/2013_06_07_19_00/2013_06_07_19_00.mpg;Shinzo ABE.jpg;5801;6013;36033;290;300;10
/net/per610a/home/mvp/mvp_db/news7-lv/2013/2013_06_07_19_00/2013_06_07_19_00.mpg;Shinzo ABE.jpg;6113;6453;36033;305;322;17
/net/per610a/home/mvp/mvp_db/news7-lv/2013/2013_06_07_19_00/2013_06_07_19_00.mpg;Shinzo ABE.jpg;7365;7573;36033;368;378;10
/net/per610a/home/mvp/mvp_db/news7-lv/2013/2013_06_08_19_00/2013_06_08_19_00.mpg;Shinzo ABE.jpg;14849;15305;36037;742;765;23
/net/per610a/home/mvp/mvp_db/news7-lv/2013/2013_06_09_19_00/2013_06_09_19_00.mpg;Shinzo ABE.jpg;11489;12021;36033;574;601;27
/net/per610a/home/mvp/mvp_db/news7-lv/2013/2013_06_09_19_00/2013_06_09_19_00.mpg;Shinzo ABE.jpg;13049;13153;36033;652;658;6
/net/per610a/home/mvp/mvp_db/news7-lv/2013/2013_06_09_19_00/2013_06_09_19_00.mpg;Shinzo ABE.jpg;13285;14521;36033;664;726;62
/net/per610a/home/mvp/mvp_db/news7-lv/2013/2013_06_10_19_00/2013_06_10_19_00.mpg;Shinzo ABE.jpg;23069;23397;36033;1154;1170;16
/net/per610a/home/mvp/mvp_db/news7-lv/2013/2013_06_10_19_00/2013_06_10_19_00.mpg;Shinzo ABE.jpg;26285;26689;36033;1315;1335;20
/net/per610a/home/mvp/mvp_db/news7-lv/2013/2013_06_10_19_00/2013_06_10_19_00.mpg;Bairi Kaieda.jpg;28557;30617;36033;1428;1531;103
/net/per610a/home/mvp/mvp_db/news7-lv/2013/2013_06_11_19_00/2013_06_11_19_00.mpg;Shinzo ABE.jpg;5973;6097;36033;298;305;7
/net/per610a/home/mvp/mvp_db/news7-lv/2013/2013_06_11_19_00/2013_06_11_19_00.mpg;Shinzo ABE.jpg;6313;6613;36033;315;330;15
/net/per610a/home/mvp/mvp_db/news7-lv/2013/2013_06_11_19_00/2013_06_11_19_00.mpg;Shinzo ABE.jpg;13377;13417;36033;669;671;2
/net/per610a/home/mvp/mvp_db/news7-lv/2013/2013_06_12_19_00/2013_06_12_19_00.mpg;Akihiro OHTA.jpg;8785;8965;36033;439;448;9
/net/per610a/home/mvp/mvp_db/news7-lv/2013/2013_06_12_19_00/2013_06_12_19_00.mpg;Akihiro OHTA.jpg;9057;9281;36033;453;464;11
/net/per610a/home/mvp/mvp_db/news7-lv/2013/2013_06_13_19_00/2013_06_13_19_00.mpg;Shinzo ABE.jpg;19493;19785;36045;975;990;15
/net/per610a/home/mvp/mvp_db/news7-lv/2013/2013_06_13_19_00/2013_06_13_19_00.mpg;Shinzo ABE.jpg;20153;20313;36045;1008;1016;8
/net/per610a/home/mvp/mvp_db/news7-lv/2013/2013_06_14_19_00/2013_06_14_19_00.mpg;Bairi Kaieda.jpg;2489;2625;38429;124;131;7
/net/per610a/home/mvp/mvp_db/news7-lv/2013/2013_06_14_19_00/2013_06_14_19_00.mpg;Bairi Kaieda.jpg;2733;3873;38429;136;193;57
/net/per610a/home/mvp/mvp_db/news7-lv/2013/2013_06_14_19_00/2013_06_14_19_00.mpg;Shinzo ABE.jpg;3981;5089;38429;199;254;55
/net/per610a/home/mvp/mvp_db/news7-lv/2013/2013_06_14_19_00/2013_06_14_19_00.mpg;Shinzo ABE.jpg;33161;33369;38429;1659;1669;10
/net/per610a/home/mvp/mvp_db/news7-lv/2013/2013_06_14_19_00/2013_06_14_19_00.mpg;Shinzo ABE.jpg;33449;33653;38429;1673;1684;11
/net/per610a/home/mvp/mvp_db/news7-lv/2013/2013_06_14_19_00/2013_06_14_19_00.mpg;Shintaro ISHIHARA.jpg;6809;7537;38429;340;377;37
/net/per610a/home/mvp/mvp_db/news7-lv/2013/2013_06_14_19_00/2013_06_14_19_00.mpg;Yoshimi WATANABE.jpg;8833;9065;38429;442;453;11
/net/per610a/home/mvp/mvp_db/news7-lv/2013/2013_06_15_19_00/2013_06_15_19_00.mpg;Shinzo ABE.jpg;6341;6649;36041;317;332;15
/net/per610a/home/mvp/mvp_db/news7-lv/2013/2013_06_15_19_00/2013_06_15_19_00.mpg;Shinzo ABE.jpg;7557;8677;36041;378;434;56
/net/per610a/home/mvp/mvp_db/news7-lv/2013/2013_06_16_19_00/2013_06_16_19_00.mpg;Shinzo ABE.jpg;333;393;36037;16;19;3
/net/per610a/home/mvp/mvp_db/news7-lv/2013/2013_06_16_19_00/2013_06_16_19_00.mpg;Shinzo ABE.jpg;1789;1841;36037;89;92;3
/net/per610a/home/mvp/mvp_db/news7-lv/2013/2013_06_16_19_00/2013_06_16_19_00.mpg;Shinzo ABE.jpg;2013;2137;36037;100;106;6
/net/per610a/home/mvp/mvp_db/news7-lv/2013/2013_06_16_19_00/2013_06_16_19_00.mpg;Shinzo ABE.jpg;2705;2765;36037;135;138;3
/net/per610a/home/mvp/mvp_db/news7-lv/2013/2013_06_17_19_00/2013_06_17_19_00.mpg;Shinzo ABE.jpg;285;437;36033;14;21;7
/net/per610a/home/mvp/mvp_db/news7-lv/2013/2013_06_17_19_00/2013_06_17_19_00.mpg;Shinzo ABE.jpg;1225;1529;36033;61;76;15
/net/per610a/home/mvp/mvp_db/news7-lv/2013/2013_06_17_19_00/2013_06_17_19_00.mpg;Shinzo ABE.jpg;1957;2577;36033;97;128;31
/net/per610a/home/mvp/mvp_db/news7-lv/2013/2013_06_17_19_00/2013_06_17_19_00.mpg;Shinzo ABE.jpg;3981;4061;36033;199;203;4
/net/per610a/home/mvp/mvp_db/news7-lv/2013/2013_06_17_19_00/2013_06_17_19_00.mpg;Shinzo ABE.jpg;6145;6225;36033;307;311;4
/net/per610a/home/mvp/mvp_db/news7-lv/2013/2013_06_17_19_00/2013_06_17_19_00.mpg;Yoshimi WATANABE.jpg;25433;26913;36033;1272;1346;74
/net/per610a/home/mvp/mvp_db/news7-lv/2013/2013_06_17_19_00/2013_06_17_19_00.mpg;Yoshimi WATANABE.jpg;27233;28021;36033;1362;1402;40
/net/per610a/home/mvp/mvp_db/news7-lv/2013/2013_06_18_19_00/2013_06_18_19_00.mpg;Shinzo ABE.jpg;11797;12313;36041;590;615;25
/net/per610a/home/mvp/mvp_db/news7-lv/2013/2013_06_18_19_00/2013_06_18_19_00.mpg;Shinzo ABE.jpg;12653;12737;36041;632;637;5
/net/per610a/home/mvp/mvp_db/news7-lv/2013/2013_06_18_19_00/2013_06_18_19_00.mpg;Shinzo ABE.jpg;13413;13429;36041;671;671;0
/net/per610a/home/mvp/mvp_db/news7-lv/2013/2013_06_18_19_00/2013_06_18_19_00.mpg;Shinzo ABE.jpg;13753;13829;36041;688;691;3
/net/per610a/home/mvp/mvp_db/news7-lv/2013/2013_06_20_19_00/2013_06_20_19_00.mpg;Shinzo ABE.jpg;17305;17933;36037;865;897;32
/net/per610a/home/mvp/mvp_db/news7-lv/2013/2013_06_22_19_00/2013_06_22_19_00.mpg;Shinzo ABE.jpg;15209;15933;36033;761;797;36
/net/per610a/home/mvp/mvp_db/news7-lv/2013/2013_06_22_19_00/2013_06_22_19_00.mpg;Natsuo YAMAGUCHI.jpg;15937;17937;36033;797;897;100
/net/per610a/home/mvp/mvp_db/news7-lv/2013/2013_06_22_19_00/2013_06_22_19_00.mpg;Yoshimi WATANABE.jpg;17945;18169;36033;897;909;12
/net/per610a/home/mvp/mvp_db/news7-lv/2013/2013_06_23_19_00/2013_06_23_19_00.mpg;Shinzo ABE.jpg;4913;5613;36033;245;280;35
/net/per610a/home/mvp/mvp_db/news7-lv/2013/2013_06_24_19_00/2013_06_24_19_00.mpg;Natsuo YAMAGUCHI.jpg;1021;1437;36033;51;71;20
/net/per610a/home/mvp/mvp_db/news7-lv/2013/2013_06_24_19_00/2013_06_24_19_00.mpg;Shinzo ABE.jpg;1021;1437;36033;51;71;20
/net/per610a/home/mvp/mvp_db/news7-lv/2013/2013_06_24_19_00/2013_06_24_19_00.mpg;Shinzo ABE.jpg;3329;3509;36033;166;175;9
/net/per610a/home/mvp/mvp_db/news7-lv/2013/2013_06_24_19_00/2013_06_24_19_00.mpg;Shinzo ABE.jpg;9181;9217;36033;459;461;2
/net/per610a/home/mvp/mvp_db/news7-lv/2013/2013_06_24_19_00/2013_06_24_19_00.mpg;Shinzo ABE.jpg;9681;9761;36033;484;488;4
/net/per610a/home/mvp/mvp_db/news7-lv/2013/2013_06_24_19_00/2013_06_24_19_00.mpg;Shinzo ABE.jpg;15953;16325;36033;798;816;18
/net/per610a/home/mvp/mvp_db/news7-lv/2013/2013_06_24_19_00/2013_06_24_19_00.mpg;Bairi Kaieda.jpg;1037;1437;36033;51;71;20
/net/per610a/home/mvp/mvp_db/news7-lv/2013/2013_06_24_19_00/2013_06_24_19_00.mpg;Shintaro ISHIHARA.jpg;5237;5677;36033;262;284;22
/net/per610a/home/mvp/mvp_db/news7-lv/2013/2013_06_24_19_00/2013_06_24_19_00.mpg;Shintaro ISHIHARA.jpg;8445;8545;36033;422;427;5
/net/per610a/home/mvp/mvp_db/news7-lv/2013/2013_06_24_19_00/2013_06_24_19_00.mpg;Toru Hashimoto.jpg;5237;5517;36033;262;276;14
/net/per610a/home/mvp/mvp_db/news7-lv/2013/2013_06_24_19_00/2013_06_24_19_00.mpg;Yoshimi WATANABE.jpg;5717;6409;36033;286;320;34
/net/per610a/home/mvp/mvp_db/news7-lv/2013/2013_06_25_19_00/2013_06_25_19_00.mpg;Shinzo ABE.jpg;14033;14921;36045;702;746;44
/net/per610a/home/mvp/mvp_db/news7-lv/2013/2013_06_25_19_00/2013_06_25_19_00.mpg;Shinzo ABE.jpg;14241;14921;36045;712;746;34
/net/per610a/home/mvp/mvp_db/news7-lv/2013/2013_06_25_19_00/2013_06_25_19_00.mpg;Bairi Kaieda.jpg;20261;20693;36045;1014;1035;21
/net/per610a/home/mvp/mvp_db/news7-lv/2013/2013_06_26_19_00/2013_06_26_19_00.mpg;Shinzo ABE.jpg;253;253;36041;12;12;0
/net/per610a/home/mvp/mvp_db/news7-lv/2013/2013_06_26_19_00/2013_06_26_19_00.mpg;Shinzo ABE.jpg;5801;5881;36041;290;294;4
/net/per610a/home/mvp/mvp_db/news7-lv/2013/2013_06_26_19_00/2013_06_26_19_00.mpg;Shinzo ABE.jpg;6029;6193;36041;301;309;8
/net/per610a/home/mvp/mvp_db/news7-lv/2013/2013_06_26_19_00/2013_06_26_19_00.mpg;Shinzo ABE.jpg;6537;7013;36041;327;350;23
/net/per610a/home/mvp/mvp_db/news7-lv/2013/2013_06_26_19_00/2013_06_26_19_00.mpg;Shinzo ABE.jpg;9821;10725;36041;491;536;45
/net/per610a/home/mvp/mvp_db/news7-lv/2013/2013_06_26_19_00/2013_06_26_19_00.mpg;Shinzo ABE.jpg;11521;11641;36041;576;582;6
/net/per610a/home/mvp/mvp_db/news7-lv/2013/2013_06_26_19_00/2013_06_26_19_00.mpg;Shinzo ABE.jpg;11849;12157;36041;592;608;16
/net/per610a/home/mvp/mvp_db/news7-lv/2013/2013_06_26_19_00/2013_06_26_19_00.mpg;Natsuo YAMAGUCHI.jpg;11925;12157;36041;596;608;12
/net/per610a/home/mvp/mvp_db/news7-lv/2013/2013_06_27_19_00/2013_06_27_19_00.mpg;Natsuo YAMAGUCHI.jpg;19533;19537;36029;977;977;0
/net/per610a/home/mvp/mvp_db/news7-lv/2013/2013_06_27_19_00/2013_06_27_19_00.mpg;Natsuo YAMAGUCHI.jpg;22469;23421;36029;1124;1172;48
/net/per610a/home/mvp/mvp_db/news7-lv/2013/2013_06_27_19_00/2013_06_27_19_00.mpg;Natsuo YAMAGUCHI.jpg;24329;24853;36029;1217;1243;26
/net/per610a/home/mvp/mvp_db/news7-lv/2013/2013_06_27_19_00/2013_06_27_19_00.mpg;Natsuo YAMAGUCHI.jpg;25861;25965;36029;1294;1299;5
/net/per610a/home/mvp/mvp_db/news7-lv/2013/2013_06_27_19_00/2013_06_27_19_00.mpg;Natsuo YAMAGUCHI.jpg;26033;26785;36029;1302;1340;38
/net/per610a/home/mvp/mvp_db/news7-lv/2013/2013_06_27_19_00/2013_06_27_19_00.mpg;Toru Hashimoto.jpg;19537;19777;36029;977;989;12
/net/per610a/home/mvp/mvp_db/news7-lv/2013/2013_06_27_19_00/2013_06_27_19_00.mpg;Toru Hashimoto.jpg;19929;19957;36029;997;998;1
/net/per610a/home/mvp/mvp_db/news7-lv/2013/2013_06_27_19_00/2013_06_27_19_00.mpg;Toru Hashimoto.jpg;22101;22369;36029;1106;1119;13
/net/per610a/home/mvp/mvp_db/news7-lv/2013/2013_06_27_19_00/2013_06_27_19_00.mpg;Toru Hashimoto.jpg;22465;22473;36029;1124;1124;0
/net/per610a/home/mvp/mvp_db/news7-lv/2013/2013_06_27_19_00/2013_06_27_19_00.mpg;Toru Hashimoto.jpg;26789;27117;36029;1340;1357;17
/net/per610a/home/mvp/mvp_db/news7-lv/2013/2013_06_27_19_00/2013_06_27_19_00.mpg;Shintaro ISHIHARA.jpg;19929;19965;36029;997;999;2
/net/per610a/home/mvp/mvp_db/news7-lv/2013/2013_06_27_19_00/2013_06_27_19_00.mpg;Shintaro ISHIHARA.jpg;26789;27117;36029;1340;1357;17
/net/per610a/home/mvp/mvp_db/news7-lv/2013/2013_06_27_19_00/2013_06_27_19_00.mpg;Toru Hashimoto.jpg;25633;25749;36029;1282;1288;6
/net/per610a/home/mvp/mvp_db/news7-lv/2013/2013_07_01_19_00/2013_07_01_19_00.mpg;Shinzo ABE.jpg;27781;28149;36033;1390;1408;18
/net/per610a/home/mvp/mvp_db/news7-lv/2013/2013_07_03_19_00/2013_07_03_19_00.mpg;Taro ASO.jpg;2657;2725;36033;132;136;4
/net/per610a/home/mvp/mvp_db/news7-lv/2013/2013_07_03_19_00/2013_07_03_19_00.mpg;Taro ASO.jpg;3929;4133;36033;196;206;10
/net/per610a/home/mvp/mvp_db/news7-lv/2013/2013_07_03_19_00/2013_07_03_19_00.mpg;Shinzo ABE.jpg;10829;15125;36033;541;756;215
/net/per610a/home/mvp/mvp_db/news7-lv/2013/2013_07_03_19_00/2013_07_03_19_00.mpg;Shinzo ABE.jpg;15273;19493;36033;764;975;211
/net/per610a/home/mvp/mvp_db/news7-lv/2013/2013_07_04_19_00/2013_07_04_19_00.mpg;Shinzo ABE.jpg;1749;1917;125941;87;95;8
/net/per610a/home/mvp/mvp_db/news7-lv/2013/2013_07_04_19_00/2013_07_04_19_00.mpg;Shinzo ABE.jpg;2261;2577;125941;113;128;15
/net/per610a/home/mvp/mvp_db/news7-lv/2013/2013_07_04_19_00/2013_07_04_19_00.mpg;Shinzo ABE.jpg;23789;24373;125941;1190;1219;29
/net/per610a/home/mvp/mvp_db/news7-lv/2013/2013_07_04_19_00/2013_07_04_19_00.mpg;Shinzo ABE.jpg;31825;38305;125941;1592;1917;325
/net/per610a/home/mvp/mvp_db/news7-lv/2013/2013_07_04_19_00/2013_07_04_19_00.mpg;Shinzo ABE.jpg;38593;44641;125941;1931;2234;303
/net/per610a/home/mvp/mvp_db/news7-lv/2013/2013_07_04_19_00/2013_07_04_19_00.mpg;Shinzo ABE.jpg;110053;110857;125941;5507;5548;41
/net/per610a/home/mvp/mvp_db/news7-lv/2013/2013_07_04_19_00/2013_07_04_19_00.mpg;Bairi Kaieda.jpg;2853;3913;125941;142;195;53
/net/per610a/home/mvp/mvp_db/news7-lv/2013/2013_07_04_19_00/2013_07_04_19_00.mpg;Bairi Kaieda.jpg;44829;45213;125941;2243;2262;19
/net/per610a/home/mvp/mvp_db/news7-lv/2013/2013_07_04_19_00/2013_07_04_19_00.mpg;Bairi Kaieda.jpg;51761;57977;125941;2590;2901;311
/net/per610a/home/mvp/mvp_db/news7-lv/2013/2013_07_04_19_00/2013_07_04_19_00.mpg;Yoshimi WATANABE.jpg;6369;6549;125941;318;327;9
/net/per610a/home/mvp/mvp_db/news7-lv/2013/2013_07_04_19_00/2013_07_04_19_00.mpg;Yoshimi WATANABE.jpg;77341;77737;125941;3870;3890;20
/net/per610a/home/mvp/mvp_db/news7-lv/2013/2013_07_04_19_00/2013_07_04_19_00.mpg;Ichiro OZAWA.jpg;6553;7193;125941;327;359;32
/net/per610a/home/mvp/mvp_db/news7-lv/2013/2013_07_04_19_00/2013_07_04_19_00.mpg;Ichiro OZAWA.jpg;85753;86113;125941;4291;4309;18
/net/per610a/home/mvp/mvp_db/news7-lv/2013/2013_07_04_19_00/2013_07_04_19_00.mpg;Natsuo YAMAGUCHI.jpg;67561;67881;125941;3381;3397;16
/net/per610a/home/mvp/mvp_db/news7-lv/2013/2013_07_04_19_00/2013_07_04_19_00.mpg;Natsuo YAMAGUCHI.jpg;71385;77197;125941;3572;3863;291
/net/per610a/home/mvp/mvp_db/news7-lv/2013/2013_07_04_19_00/2013_07_04_19_00.mpg;Natsuo YAMAGUCHI.jpg;110053;110457;125941;5507;5528;21
/net/per610a/home/mvp/mvp_db/news7-lv/2013/2013_07_04_19_00/2013_07_04_19_00.mpg;Kazuo SHII.jpg;92901;93241;125941;4649;4666;17
/net/per610a/home/mvp/mvp_db/news7-lv/2013/2013_07_05_19_00/2013_07_05_19_00.mpg;Shinzo ABE.jpg;19877;21445;36033;994;1073;79
/net/per610a/home/mvp/mvp_db/news7-lv/2013/2013_07_06_19_00/2013_07_06_19_00.mpg;Natsuo YAMAGUCHI.jpg;22125;22809;36033;1107;1141;34
/net/per610a/home/mvp/mvp_db/news7-lv/2013/2013_07_08_19_00/2013_07_08_19_00.mpg;Shinzo ABE.jpg;28677;29057;36037;1434;1453;19
/net/per610a/home/mvp/mvp_db/news7-lv/2013/2013_07_11_19_00/2013_07_11_19_00.mpg;Kazuo SHII.jpg;20545;20641;38433;1027;1032;5
/net/per610a/home/mvp/mvp_db/news7-lv/2013/2013_07_11_19_00/2013_07_11_19_00.mpg;Kazuo SHII.jpg;20817;21077;38433;1041;1054;13
/net/per610a/home/mvp/mvp_db/news7-lv/2013/2013_07_12_19_00/2013_07_12_19_00.mpg;Bairi Kaieda.jpg;27465;27737;36033;1374;1387;13
/net/per610a/home/mvp/mvp_db/news7-lv/2013/2013_07_12_19_00/2013_07_12_19_00.mpg;Ichiro OZAWA.jpg;28825;29101;36033;1442;1456;14
/net/per610a/home/mvp/mvp_db/news7-lv/2013/2013_07_13_19_00/2013_07_13_19_00.mpg;Shinzo ABE.jpg;15605;16169;36033;780;809;29
/net/per610a/home/mvp/mvp_db/news7-lv/2013/2013_07_16_19_00/2013_07_16_19_00.mpg;Shinzo ABE.jpg;23921;24265;36033;1196;1214;18
/net/per610a/home/mvp/mvp_db/news7-lv/2013/2013_07_20_19_00/2013_07_20_19_00.mpg;Shinzo ABE.jpg;1393;1845;36033;69;92;23
/net/per610a/home/mvp/mvp_db/news7-lv/2013/2013_07_22_19_00/2013_07_22_19_00.mpg;Taro Yamamoto.jpg;5069;5305;36033;253;265;12
/net/per610a/home/mvp/mvp_db/news7-lv/2013/2013_07_22_19_00/2013_07_22_19_00.mpg;Shinzo ABE.jpg;6697;6805;36033;335;340;5
/net/per610a/home/mvp/mvp_db/news7-lv/2013/2013_07_22_19_00/2013_07_22_19_00.mpg;Shinzo ABE.jpg;8889;9305;36033;444;465;21
/net/per610a/home/mvp/mvp_db/news7-lv/2013/2013_07_22_19_00/2013_07_22_19_00.mpg;Shinzo ABE.jpg;15349;15713;36033;768;786;18
/net/per610a/home/mvp/mvp_db/news7-lv/2013/2013_07_22_19_00/2013_07_22_19_00.mpg;Shinzo ABE.jpg;16629;16825;36033;832;841;9
/net/per610a/home/mvp/mvp_db/news7-lv/2013/2013_07_22_19_00/2013_07_22_19_00.mpg;Shinzo ABE.jpg;17461;18177;36033;873;909;36
/net/per610a/home/mvp/mvp_db/news7-lv/2013/2013_07_22_19_00/2013_07_22_19_00.mpg;Shinzo ABE.jpg;18401;18473;36033;920;924;4
/net/per610a/home/mvp/mvp_db/news7-lv/2013/2013_07_22_19_00/2013_07_22_19_00.mpg;Shinzo ABE.jpg;18961;19309;36033;948;966;18
/net/per610a/home/mvp/mvp_db/news7-lv/2013/2013_07_22_19_00/2013_07_22_19_00.mpg;Shinzo ABE.jpg;19953;20045;36033;998;1003;5
/net/per610a/home/mvp/mvp_db/news7-lv/2013/2013_07_22_19_00/2013_07_22_19_00.mpg;Natsuo YAMAGUCHI.jpg;7205;7689;36033;360;384;24
/net/per610a/home/mvp/mvp_db/news7-lv/2013/2013_07_22_19_00/2013_07_22_19_00.mpg;Yorihisa Matsuno.png;12005;12189;36033;600;609;9
/net/per610a/home/mvp/mvp_db/news7-lv/2013/2013_07_22_19_00/2013_07_22_19_00.mpg;Taro ASO.jpg;14529;15009;36033;726;751;25
/net/per610a/home/mvp/mvp_db/news7-lv/2013/2013_07_24_19_00/2013_07_24_19_00.mpg;Bairi Kaieda.jpg;7341;7389;36041;367;369;2
/net/per610a/home/mvp/mvp_db/news7-lv/2013/2013_07_24_19_00/2013_07_24_19_00.mpg;Bairi Kaieda.jpg;10609;11141;36041;530;557;27
/net/per610a/home/mvp/mvp_db/news7-lv/2013/2013_07_24_19_00/2013_07_24_19_00.mpg;Naoto KAN.jpg;8753;9005;36041;437;450;13
/net/per610a/home/mvp/mvp_db/news7-lv/2013/2013_07_25_19_00/2013_07_25_19_00.mpg;Shinzo ABE.jpg;22341;22781;36029;1118;1140;22
/net/per610a/home/mvp/mvp_db/news7-lv/2013/2013_07_25_19_00/2013_07_25_19_00.mpg;Mizuho FUKUSHIMA.jpg;24489;24753;36029;1225;1238;13
/net/per610a/home/mvp/mvp_db/news7-lv/2013/2013_07_25_19_00/2013_07_25_19_00.mpg;Mizuho FUKUSHIMA.jpg;25905;26649;36029;1296;1333;37
/net/per610a/home/mvp/mvp_db/news7-lv/2013/2013_07_26_19_00/2013_07_26_19_00.mpg;Yukio HATOYAMA.jpg;10389;10473;36033;519;524;5
/net/per610a/home/mvp/mvp_db/news7-lv/2013/2013_07_26_19_00/2013_07_26_19_00.mpg;Yukio HATOYAMA.jpg;18961;19625;36033;948;981;33
/net/per610a/home/mvp/mvp_db/news7-lv/2013/2013_07_26_19_00/2013_07_26_19_00.mpg;Bairi Kaieda.jpg;15001;15313;36033;750;766;16
/net/per610a/home/mvp/mvp_db/news7-lv/2013/2013_07_26_19_00/2013_07_26_19_00.mpg;Bairi Kaieda.jpg;17901;18077;36033;895;904;9
/net/per610a/home/mvp/mvp_db/news7-lv/2013/2013_07_27_19_00/2013_07_27_19_00.mpg;Shinzo ABE.jpg;993;1497;36033;49;74;25
/net/per610a/home/mvp/mvp_db/news7-lv/2013/2013_07_27_19_00/2013_07_27_19_00.mpg;Shinzo ABE.jpg;1629;1669;36033;81;83;2
/net/per610a/home/mvp/mvp_db/news7-lv/2013/2013_07_27_19_00/2013_07_27_19_00.mpg;Shinzo ABE.jpg;2477;3793;36033;123;189;66
/net/per610a/home/mvp/mvp_db/news7-lv/2013/2013_07_27_19_00/2013_07_27_19_00.mpg;Shinzo ABE.jpg;5421;5853;36033;271;292;21
/net/per610a/home/mvp/mvp_db/news7-lv/2013/2013_07_27_19_00/2013_07_27_19_00.mpg;Shinzo ABE.jpg;6825;6993;36033;341;349;8
/net/per610a/home/mvp/mvp_db/news7-lv/2013/2013_07_27_19_00/2013_07_27_19_00.mpg;Toru Hashimoto.jpg;25097;25453;36033;1255;1273;18
/net/per610a/home/mvp/mvp_db/news7-lv/2013/2013_07_27_19_00/2013_07_27_19_00.mpg;Toru Hashimoto.jpg;25665;25789;36033;1284;1290;6
/net/per610a/home/mvp/mvp_db/news7-lv/2013/2013_07_27_19_00/2013_07_27_19_00.mpg;Toru Hashimoto.jpg;28145;29025;36033;1408;1452;44
/net/per610a/home/mvp/mvp_db/news7-lv/2013/2013_07_30_19_00/2013_07_30_19_00.mpg;Shinzo ABE.jpg;18673;19185;36033;934;959;25
/net/per610a/home/mvp/mvp_db/news7-lv/2013/2013_07_30_19_00/2013_07_30_19_00.mpg;Shinzo ABE.jpg;19557;20081;36033;978;1004;26
/net/per610a/home/mvp/mvp_db/news7-lv/2013/2013_07_30_19_00/2013_07_30_19_00.mpg;Shinzo ABE.jpg;20373;20613;36033;1019;1031;12
/net/per610a/home/mvp/mvp_db/news7-lv/2013/2013_08_02_19_00/2013_08_02_19_00.mpg;Shinzo ABE.jpg;4709;5361;36033;235;268;33
/net/per610a/home/mvp/mvp_db/news7-lv/2013/2013_08_02_19_00/2013_08_02_19_00.mpg;Shinzo ABE.jpg;30329;30537;36033;1517;1527;10
/net/per610a/home/mvp/mvp_db/news7-lv/2013/2013_08_02_19_00/2013_08_02_19_00.mpg;Shinzo ABE.jpg;30649;30661;36033;1533;1534;1
/net/per610a/home/mvp/mvp_db/news7-lv/2013/2013_08_02_19_00/2013_08_02_19_00.mpg;Taro ASO.jpg;5453;5817;36033;272;291;19
/net/per610a/home/mvp/mvp_db/news7-lv/2013/2013_08_02_19_00/2013_08_02_19_00.mpg;Taro ASO.jpg;29837;29881;36033;1492;1495;3
/net/per610a/home/mvp/mvp_db/news7-lv/2013/2013_08_04_19_00/2013_08_04_19_00.mpg;Shinzo ABE.jpg;6797;7629;36033;340;381;41
/net/per610a/home/mvp/mvp_db/news7-lv/2013/2013_08_04_19_00/2013_08_04_19_00.mpg;Shinzo ABE.jpg;30185;31137;36033;1510;1558;48
/net/per610a/home/mvp/mvp_db/news7-lv/2013/2013_08_07_19_00/2013_08_07_19_00.mpg;Kenji Eda.jpg;23885;24165;36029;1195;1209;14
/net/per610a/home/mvp/mvp_db/news7-lv/2013/2013_08_07_19_00/2013_08_07_19_00.mpg;Kenji Eda.jpg;27209;28153;36029;1361;1408;47
/net/per610a/home/mvp/mvp_db/news7-lv/2013/2013_08_07_19_00/2013_08_07_19_00.mpg;Yoshimi WATANABE.jpg;24817;24873;36029;1241;1244;3
/net/per610a/home/mvp/mvp_db/news7-lv/2013/2013_08_07_19_00/2013_08_07_19_00.mpg;Yoshimi WATANABE.jpg;25069;25693;36029;1254;1285;31
/net/per610a/home/mvp/mvp_db/news7-lv/2013/2013_08_07_19_00/2013_08_07_19_00.mpg;Yoshimi WATANABE.jpg;26177;27165;36029;1309;1359;50
/net/per610a/home/mvp/mvp_db/news7-lv/2013/2013_08_08_19_00/2013_08_08_19_00.mpg;Taro ASO.jpg;16809;16869;36033;841;844;3
/net/per610a/home/mvp/mvp_db/news7-lv/2013/2013_08_08_19_00/2013_08_08_19_00.mpg;Taro ASO.jpg;17313;17709;36033;866;886;20
/net/per610a/home/mvp/mvp_db/news7-lv/2013/2013_08_08_19_00/2013_08_08_19_00.mpg;Natsuo YAMAGUCHI.jpg;24525;24877;36033;1227;1244;17
/net/per610a/home/mvp/mvp_db/news7-lv/2013/2013_08_08_19_00/2013_08_08_19_00.mpg;Shinzo ABE.jpg;26393;27189;36033;1320;1360;40
/net/per610a/home/mvp/mvp_db/news7-lv/2013/2013_08_12_19_00/2013_08_12_19_00.mpg;Shinzo ABE.jpg;389;501;38433;19;25;6
/net/per610a/home/mvp/mvp_db/news7-lv/2013/2013_08_12_19_00/2013_08_12_19_00.mpg;Shinzo ABE.jpg;10209;12045;38433;510;602;92
/net/per610a/home/mvp/mvp_db/news7-lv/2013/2013_08_12_19_00/2013_08_12_19_00.mpg;Shinzo ABE.jpg;12489;12657;38433;624;633;9
/net/per610a/home/mvp/mvp_db/news7-lv/2013/2013_08_12_19_00/2013_08_12_19_00.mpg;Shinzo ABE.jpg;22489;23261;38433;1125;1163;38
/net/per610a/home/mvp/mvp_db/news7-lv/2013/2013_08_12_19_00/2013_08_12_19_00.mpg;Shinzo ABE.jpg;23405;23405;38433;1171;1171;0
/net/per610a/home/mvp/mvp_db/news7-lv/2013/2013_08_12_19_00/2013_08_12_19_00.mpg;Shinzo ABE.jpg;23469;23505;38433;1174;1176;2
/net/per610a/home/mvp/mvp_db/news7-lv/2013/2013_08_12_19_00/2013_08_12_19_00.mpg;Shinzo ABE.jpg;4661;5049;38433;233;252;19
/net/per610a/home/mvp/mvp_db/news7-lv/2013/2013_08_12_19_00/2013_08_12_19_00.mpg;Shinzo ABE.jpg;25665;25873;38433;1284;1294;10
/net/per610a/home/mvp/mvp_db/news7-lv/2013/2013_08_14_19_00/2013_08_14_19_00.mpg;Naoto KAN.jpg;11361;12117;36033;568;606;38
/net/per610a/home/mvp/mvp_db/news7-lv/2013/2013_08_14_19_00/2013_08_14_19_00.mpg;Naoto KAN.jpg;12577;12893;36033;629;645;16
/net/per610a/home/mvp/mvp_db/news7-lv/2013/2013_08_15_19_00/2013_08_15_19_00.mpg;Shinzo ABE.jpg;11385;11781;36033;569;589;20
/net/per610a/home/mvp/mvp_db/news7-lv/2013/2013_08_15_19_00/2013_08_15_19_00.mpg;Shinzo ABE.jpg;12089;12213;36033;604;611;7
/net/per610a/home/mvp/mvp_db/news7-lv/2013/2013_08_21_19_00/2013_08_21_19_00.mpg;Shinzo ABE.jpg;1;33;36033;0;1;1
/net/per610a/home/mvp/mvp_db/news7-lv/2013/2013_08_21_19_00/2013_08_21_19_00.mpg;Shinzo ABE.jpg;10389;10473;36033;519;524;5
/net/per610a/home/mvp/mvp_db/news7-lv/2013/2013_08_21_19_00/2013_08_21_19_00.mpg;Shinzo ABE.jpg;13905;13993;36033;695;700;5
/net/per610a/home/mvp/mvp_db/news7-lv/2013/2013_08_21_19_00/2013_08_21_19_00.mpg;Shinzo ABE.jpg;15029;15065;36033;752;753;1
/net/per610a/home/mvp/mvp_db/news7-lv/2013/2013_08_21_19_00/2013_08_21_19_00.mpg;Shinzo ABE.jpg;15225;15277;36033;761;764;3
/net/per610a/home/mvp/mvp_db/news7-lv/2013/2013_08_23_19_00/2013_08_23_19_00.mpg;Shinzo ABE.jpg;197;265;36033;9;13;4
/net/per610a/home/mvp/mvp_db/news7-lv/2013/2013_08_23_19_00/2013_08_23_19_00.mpg;Shinzo ABE.jpg;7461;7465;36033;373;373;0
/net/per610a/home/mvp/mvp_db/news7-lv/2013/2013_08_23_19_00/2013_08_23_19_00.mpg;Shinzo ABE.jpg;7529;7577;36033;376;379;3
/net/per610a/home/mvp/mvp_db/news7-lv/2013/2013_08_25_19_00/2013_08_25_19_00.mpg;Shinzo ABE.jpg;12417;12589;36033;621;629;8
/net/per610a/home/mvp/mvp_db/news7-lv/2013/2013_08_25_19_00/2013_08_25_19_00.mpg;Shinzo ABE.jpg;12817;13093;36033;641;655;14
/net/per610a/home/mvp/mvp_db/news7-lv/2013/2013_08_25_19_00/2013_08_25_19_00.mpg;Shinzo ABE.jpg;13241;13425;36033;662;671;9
/net/per610a/home/mvp/mvp_db/news7-lv/2013/2013_08_25_19_00/2013_08_25_19_00.mpg;Shinzo ABE.jpg;14401;14489;36033;720;724;4
/net/per610a/home/mvp/mvp_db/news7-lv/2013/2013_08_25_19_00/2013_08_25_19_00.mpg;Shinzo ABE.jpg;14569;14609;36033;728;730;2
/net/per610a/home/mvp/mvp_db/news7-lv/2013/2013_08_25_19_00/2013_08_25_19_00.mpg;Shinzo ABE.jpg;14941;15293;36033;747;765;18
/net/per610a/home/mvp/mvp_db/news7-lv/2013/2013_08_25_19_00/2013_08_25_19_00.mpg;Akihiro OHTA.jpg;23537;23621;36033;1177;1181;4
/net/per610a/home/mvp/mvp_db/news7-lv/2013/2013_08_26_19_00/2013_08_26_19_00.mpg;Shinzo ABE.jpg;925;1241;36033;46;62;16
/net/per610a/home/mvp/mvp_db/news7-lv/2013/2013_08_26_19_00/2013_08_26_19_00.mpg;Shinzo ABE.jpg;5937;6125;36033;297;306;9
/net/per610a/home/mvp/mvp_db/news7-lv/2013/2013_08_26_19_00/2013_08_26_19_00.mpg;Taro ASO.jpg;1573;1873;36033;78;93;15
/net/per610a/home/mvp/mvp_db/news7-lv/2013/2013_08_27_19_00/2013_08_27_19_00.mpg;Shinzo ABE.jpg;15701;15737;36033;785;787;2
/net/per610a/home/mvp/mvp_db/news7-lv/2013/2013_08_27_19_00/2013_08_27_19_00.mpg;Shinzo ABE.jpg;15949;16165;36033;798;808;10
/net/per610a/home/mvp/mvp_db/news7-lv/2013/2013_08_31_19_00/2013_08_31_19_00.mpg;Taro ASO.jpg;26613;26717;36033;1331;1336;5
/net/per610a/home/mvp/mvp_db/news7-lv/2013/2013_08_31_19_00/2013_08_31_19_00.mpg;Shinzo ABE.jpg;26797;26813;36033;1340;1341;1
/net/per610a/home/mvp/mvp_db/news7-lv/2013/2013_08_31_19_00/2013_08_31_19_00.mpg;Shinzo ABE.jpg;27097;28001;36033;1355;1401;46
/net/per610a/home/mvp/mvp_db/news7-lv/2013/2013_09_02_19_00/2013_09_02_19_00.mpg;Shinzo ABE.jpg;17641;18289;36033;882;915;33
/net/per610a/home/mvp/mvp_db/news7-lv/2013/2013_09_02_19_00/2013_09_02_19_00.mpg;Shinzo ABE.jpg;18433;18641;36033;922;932;10
/net/per610a/home/mvp/mvp_db/news7-lv/2013/2013_09_03_19_00/2013_09_03_19_00.mpg;Shinzo ABE.jpg;18005;18157;36033;900;908;8
/net/per610a/home/mvp/mvp_db/news7-lv/2013/2013_09_03_19_00/2013_09_03_19_00.mpg;Shinzo ABE.jpg;20045;20377;36033;1003;1019;16
/net/per610a/home/mvp/mvp_db/news7-lv/2013/2013_09_03_19_00/2013_09_03_19_00.mpg;Shinzo ABE.jpg;23637;24309;36033;1182;1216;34
/net/per610a/home/mvp/mvp_db/news7-lv/2013/2013_09_04_19_00/2013_09_04_19_00.mpg;Sadakazu TANIGAKI.jpg;20929;21237;36033;1047;1062;15
/net/per610a/home/mvp/mvp_db/news7-lv/2013/2013_09_05_19_00/2013_09_05_19_00.mpg;Shinzo ABE.jpg;6705;6813;36033;335;340;5
/net/per610a/home/mvp/mvp_db/news7-lv/2013/2013_09_05_19_00/2013_09_05_19_00.mpg;Shinzo ABE.jpg;6985;7345;36033;349;367;18
/net/per610a/home/mvp/mvp_db/news7-lv/2013/2013_09_05_19_00/2013_09_05_19_00.mpg;Shinzo ABE.jpg;7917;8189;36033;396;409;13
/net/per610a/home/mvp/mvp_db/news7-lv/2013/2013_09_05_19_00/2013_09_05_19_00.mpg;Shinzo ABE.jpg;9601;9681;36033;480;484;4
/net/per610a/home/mvp/mvp_db/news7-lv/2013/2013_09_07_19_00/2013_09_07_19_00.mpg;Shinzo ABE.jpg;5389;5449;36033;269;272;3
/net/per610a/home/mvp/mvp_db/news7-lv/2013/2013_09_07_19_00/2013_09_07_19_00.mpg;Shinzo ABE.jpg;20569;20689;36033;1029;1035;6
/net/per610a/home/mvp/mvp_db/news7-lv/2013/2013_09_07_19_00/2013_09_07_19_00.mpg;Kazuo SHII.jpg;28349;28501;36033;1418;1426;8
/net/per610a/home/mvp/mvp_db/news7-lv/2013/2013_09_08_19_00/2013_09_08_19_00.mpg;Shinzo ABE.jpg;2829;3169;71997;141;158;17
/net/per610a/home/mvp/mvp_db/news7-lv/2013/2013_09_08_19_00/2013_09_08_19_00.mpg;Shinzo ABE.jpg;3289;4021;71997;164;201;37
/net/per610a/home/mvp/mvp_db/news7-lv/2013/2013_09_08_19_00/2013_09_08_19_00.mpg;Shinzo ABE.jpg;9401;10089;71997;470;504;34
/net/per610a/home/mvp/mvp_db/news7-lv/2013/2013_09_08_19_00/2013_09_08_19_00.mpg;Shinzo ABE.jpg;49897;50349;71997;2497;2519;22
/net/per610a/home/mvp/mvp_db/news7-lv/2013/2013_09_08_19_00/2013_09_08_19_00.mpg;Shinzo ABE.jpg;50449;50857;71997;2524;2545;21
/net/per610a/home/mvp/mvp_db/news7-lv/2013/2013_09_08_19_00/2013_09_08_19_00.mpg;Shinzo ABE.jpg;50925;51017;71997;2548;2553;5
/net/per610a/home/mvp/mvp_db/news7-lv/2013/2013_09_08_19_00/2013_09_08_19_00.mpg;Shinzo ABE.jpg;51341;51701;71997;2569;2587;18
/net/per610a/home/mvp/mvp_db/news7-lv/2013/2013_09_08_19_00/2013_09_08_19_00.mpg;Shinzo ABE.jpg;54905;54937;71997;2747;2749;2
/net/per610a/home/mvp/mvp_db/news7-lv/2013/2013_09_09_19_00/2013_09_09_19_00.mpg;Shinzo ABE.jpg;6061;6085;36033;303;304;1
/net/per610a/home/mvp/mvp_db/news7-lv/2013/2013_09_09_19_00/2013_09_09_19_00.mpg;Shinzo ABE.jpg;17261;17377;36033;863;869;6
/net/per610a/home/mvp/mvp_db/news7-lv/2013/2013_09_09_19_00/2013_09_09_19_00.mpg;Naoto KAN.jpg;20861;20909;36033;1043;1046;3
/net/per610a/home/mvp/mvp_db/news7-lv/2013/2013_09_09_19_00/2013_09_09_19_00.mpg;Naoto KAN.jpg;21089;21113;36033;1055;1056;1
/net/per610a/home/mvp/mvp_db/news7-lv/2013/2013_09_09_19_00/2013_09_09_19_00.mpg;Naoto KAN.jpg;21209;21273;36033;1061;1064;3
/net/per610a/home/mvp/mvp_db/news7-lv/2013/2013_09_09_19_00/2013_09_09_19_00.mpg;Naoto KAN.jpg;22517;22625;36033;1126;1132;6
/net/per610a/home/mvp/mvp_db/news7-lv/2013/2013_09_10_19_00/2013_09_10_19_00.mpg;Shinzo ABE.jpg;7073;7125;36037;353;356;3
/net/per610a/home/mvp/mvp_db/news7-lv/2013/2013_09_10_19_00/2013_09_10_19_00.mpg;Shinzo ABE.jpg;7413;7657;36037;370;383;13
/net/per610a/home/mvp/mvp_db/news7-lv/2013/2013_09_10_19_00/2013_09_10_19_00.mpg;Shinzo ABE.jpg;31833;31881;36037;1592;1595;3
/net/per610a/home/mvp/mvp_db/news7-lv/2013/2013_09_10_19_00/2013_09_10_19_00.mpg;Shinzo ABE.jpg;32077;32453;36037;1604;1623;19
/net/per610a/home/mvp/mvp_db/news7-lv/2013/2013_09_11_19_00/2013_09_11_19_00.mpg;Shinzo ABE.jpg;4313;4361;36033;215;218;3
/net/per610a/home/mvp/mvp_db/news7-lv/2013/2013_09_11_19_00/2013_09_11_19_00.mpg;Shinzo ABE.jpg;4473;4665;36033;223;233;10
/net/per610a/home/mvp/mvp_db/news7-lv/2013/2013_09_11_19_00/2013_09_11_19_00.mpg;Shinzo ABE.jpg;4785;4857;36033;239;243;4
/net/per610a/home/mvp/mvp_db/news7-lv/2013/2013_09_11_19_00/2013_09_11_19_00.mpg;Shinzo ABE.jpg;28085;28321;36033;1405;1417;12
/net/per610a/home/mvp/mvp_db/news7-lv/2013/2013_09_11_19_00/2013_09_11_19_00.mpg;Shintaro ISHIHARA.jpg;22321;22509;36033;1116;1126;10
/net/per610a/home/mvp/mvp_db/news7-lv/2013/2013_09_16_19_00/2013_09_16_19_00.mpg;Shinzo ABE.jpg;46285;46373;72005;2316;2320;4
/net/per610a/home/mvp/mvp_db/news7-lv/2013/2013_09_16_19_00/2013_09_16_19_00.mpg;Shinzo ABE.jpg;48301;48561;72005;2416;2429;13
/net/per610a/home/mvp/mvp_db/news7-lv/2013/2013_09_16_19_00/2013_09_16_19_00.mpg;Shinzo ABE.jpg;48677;48753;72005;2435;2439;4
/net/per610a/home/mvp/mvp_db/news7-lv/2013/2013_09_16_19_00/2013_09_16_19_00.mpg;Shinzo ABE.jpg;50745;51645;72005;2539;2584;45
/net/per610a/home/mvp/mvp_db/news7-lv/2013/2013_09_16_19_00/2013_09_16_19_00.mpg;Yukio EDANO.jpg;62045;62993;72005;3104;3152;48
/net/per610a/home/mvp/mvp_db/news7-lv/2013/2013_09_17_19_00/2013_09_17_19_00.mpg;Shinzo ABE.jpg;17793;18517;36033;890;926;36
/net/per610a/home/mvp/mvp_db/news7-lv/2013/2013_09_17_19_00/2013_09_17_19_00.mpg;Shinzo ABE.jpg;19069;19193;36033;954;960;6
/net/per610a/home/mvp/mvp_db/news7-lv/2013/2013_09_17_19_00/2013_09_17_19_00.mpg;Natsuo YAMAGUCHI.jpg;20157;20537;36033;1008;1027;19
/net/per610a/home/mvp/mvp_db/news7-lv/2013/2013_09_17_19_00/2013_09_17_19_00.mpg;Natsuo YAMAGUCHI.jpg;20601;20805;36033;1030;1041;11
/net/per610a/home/mvp/mvp_db/news7-lv/2013/2013_09_18_19_00/2013_09_18_19_00.mpg;Taro ASO.jpg;949;1337;36033;47;66;19
/net/per610a/home/mvp/mvp_db/news7-lv/2013/2013_09_18_19_00/2013_09_18_19_00.mpg;Taro ASO.jpg;2625;3461;36033;131;173;42
/net/per610a/home/mvp/mvp_db/news7-lv/2013/2013_09_18_19_00/2013_09_18_19_00.mpg;Shinzo ABE.jpg;1361;1789;36033;68;89;21
/net/per610a/home/mvp/mvp_db/news7-lv/2013/2013_09_18_19_00/2013_09_18_19_00.mpg;Shinzo ABE.jpg;2625;3461;36033;131;173;42
/net/per610a/home/mvp/mvp_db/news7-lv/2013/2013_09_19_19_00/2013_09_19_19_00.mpg;Shinzo ABE.jpg;1253;1633;36029;62;81;19
/net/per610a/home/mvp/mvp_db/news7-lv/2013/2013_09_19_19_00/2013_09_19_19_00.mpg;Shinzo ABE.jpg;1977;1993;36029;98;99;1
/net/per610a/home/mvp/mvp_db/news7-lv/2013/2013_09_19_19_00/2013_09_19_19_00.mpg;Shinzo ABE.jpg;7925;8089;36029;396;404;8
/net/per610a/home/mvp/mvp_db/news7-lv/2013/2013_09_19_19_00/2013_09_19_19_00.mpg;Toru Hashimoto.jpg;22813;22853;36029;1141;1143;2
/net/per610a/home/mvp/mvp_db/news7-lv/2013/2013_09_19_19_00/2013_09_19_19_00.mpg;Toru Hashimoto.jpg;23933;24341;36029;1197;1218;21
/net/per610a/home/mvp/mvp_db/news7-lv/2013/2013_09_20_19_00/2013_09_20_19_00.mpg;Taro ASO.jpg;909;1413;36033;45;70;25
/net/per610a/home/mvp/mvp_db/news7-lv/2013/2013_09_20_19_00/2013_09_20_19_00.mpg;Taro ASO.jpg;1857;2517;36033;92;125;33
/net/per610a/home/mvp/mvp_db/news7-lv/2013/2013_09_20_19_00/2013_09_20_19_00.mpg;Shinzo ABE.jpg;1857;2517;36033;92;125;33
/net/per610a/home/mvp/mvp_db/news7-lv/2013/2013_09_20_19_00/2013_09_20_19_00.mpg;Shinzo ABE.jpg;20085;20317;36033;1005;1016;11
/net/per610a/home/mvp/mvp_db/news7-lv/2013/2013_09_21_19_00/2013_09_21_19_00.mpg;Shinzo ABE.jpg;8881;9369;36041;444;468;24
/net/per610a/home/mvp/mvp_db/news7-lv/2013/2013_09_21_19_00/2013_09_21_19_00.mpg;Shinzo ABE.jpg;9597;9929;36041;480;496;16
/net/per610a/home/mvp/mvp_db/news7-lv/2013/2013_09_21_19_00/2013_09_21_19_00.mpg;Shinzo ABE.jpg;12057;12873;36041;603;643;40
/net/per610a/home/mvp/mvp_db/news7-lv/2013/2013_09_23_19_00/2013_09_23_19_00.mpg;Shinzo ABE.jpg;12801;12957;36041;640;648;8
/net/per610a/home/mvp/mvp_db/news7-lv/2013/2013_09_23_19_00/2013_09_23_19_00.mpg;Shinzo ABE.jpg;27665;28501;36041;1383;1425;42
/net/per610a/home/mvp/mvp_db/news7-lv/2013/2013_09_24_19_00/2013_09_24_19_00.mpg;Shinzo ABE.jpg;7249;7425;36033;362;371;9
/net/per610a/home/mvp/mvp_db/news7-lv/2013/2013_09_24_19_00/2013_09_24_19_00.mpg;Natsuo YAMAGUCHI.jpg;9061;9689;36033;453;484;31
/net/per610a/home/mvp/mvp_db/news7-lv/2013/2013_09_26_19_00/2013_09_26_19_00.mpg;Natsuo YAMAGUCHI.jpg;12425;13209;36033;621;660;39
/net/per610a/home/mvp/mvp_db/news7-lv/2013/2013_09_27_19_00/2013_09_27_19_00.mpg;Shinzo ABE.jpg;9841;10273;36041;492;513;21
/net/per610a/home/mvp/mvp_db/news7-lv/2013/2013_09_29_19_00/2013_09_29_19_00.mpg;Natsuo YAMAGUCHI.jpg;10637;10973;36033;532;549;17
/net/per610a/home/mvp/mvp_db/news7-lv/2013/2013_09_30_19_00/2013_09_30_19_00.mpg;Shinzo ABE.jpg;5261;5785;36037;263;289;26
/net/per610a/home/mvp/mvp_db/news7-lv/2013/2013_09_30_19_00/2013_09_30_19_00.mpg;Shinzo ABE.jpg;27705;27789;36037;1386;1390;4
/net/per610a/home/mvp/mvp_db/news7-lv/2013/2013_10_01_19_00/2013_10_01_19_00.mpg;Shinzo ABE.jpg;249;549;38433;12;27;15
/net/per610a/home/mvp/mvp_db/news7-lv/2013/2013_10_01_19_00/2013_10_01_19_00.mpg;Shinzo ABE.jpg;733;1161;38433;36;58;22
/net/per610a/home/mvp/mvp_db/news7-lv/2013/2013_10_01_19_00/2013_10_01_19_00.mpg;Shinzo ABE.jpg;2005;2817;38433;100;140;40
/net/per610a/home/mvp/mvp_db/news7-lv/2013/2013_10_01_19_00/2013_10_01_19_00.mpg;Shinzo ABE.jpg;2921;2921;38433;146;146;0
/net/per610a/home/mvp/mvp_db/news7-lv/2013/2013_10_01_19_00/2013_10_01_19_00.mpg;Shinzo ABE.jpg;3373;3577;38433;168;178;10
/net/per610a/home/mvp/mvp_db/news7-lv/2013/2013_10_01_19_00/2013_10_01_19_00.mpg;Shinzo ABE.jpg;3697;3749;38433;184;187;3
/net/per610a/home/mvp/mvp_db/news7-lv/2013/2013_10_01_19_00/2013_10_01_19_00.mpg;Shinzo ABE.jpg;5249;5957;38433;262;298;36
/net/per610a/home/mvp/mvp_db/news7-lv/2013/2013_10_01_19_00/2013_10_01_19_00.mpg;Shinzo ABE.jpg;6537;10049;38433;327;502;175
/net/per610a/home/mvp/mvp_db/news7-lv/2013/2013_10_01_19_00/2013_10_01_19_00.mpg;Shinzo ABE.jpg;14061;14197;38433;703;710;7
/net/per610a/home/mvp/mvp_db/news7-lv/2013/2013_10_01_19_00/2013_10_01_19_00.mpg;Shinzo ABE.jpg;15445;15693;38433;772;785;13
/net/per610a/home/mvp/mvp_db/news7-lv/2013/2013_10_01_19_00/2013_10_01_19_00.mpg;Shinzo ABE.jpg;15913;16909;38433;796;846;50
/net/per610a/home/mvp/mvp_db/news7-lv/2013/2013_10_01_19_00/2013_10_01_19_00.mpg;Shinzo ABE.jpg;17993;18089;38433;900;905;5
/net/per610a/home/mvp/mvp_db/news7-lv/2013/2013_10_01_19_00/2013_10_01_19_00.mpg;Shinzo ABE.jpg;30009;30089;38433;1501;1505;4
/net/per610a/home/mvp/mvp_db/news7-lv/2013/2013_10_01_19_00/2013_10_01_19_00.mpg;Bairi Kaieda.jpg;10093;12109;38433;505;605;100
/net/per610a/home/mvp/mvp_db/news7-lv/2013/2013_10_02_19_00/2013_10_02_19_00.mpg;Shinzo ABE.jpg;18997;19393;36033;950;970;20
/net/per610a/home/mvp/mvp_db/news7-lv/2013/2013_10_04_19_00/2013_10_04_19_00.mpg;Taro ASO.jpg;3793;3937;36033;189;196;7
/net/per610a/home/mvp/mvp_db/news7-lv/2013/2013_10_06_19_00/2013_10_06_19_00.mpg;Shinzo ABE.jpg;10757;11301;36033;538;565;27
/net/per610a/home/mvp/mvp_db/news7-lv/2013/2013_10_08_19_00/2013_10_08_19_00.mpg;Yukio HATOYAMA.jpg;3693;3761;38429;184;188;4
/net/per610a/home/mvp/mvp_db/news7-lv/2013/2013_10_08_19_00/2013_10_08_19_00.mpg;Yukio HATOYAMA.jpg;5085;6133;38429;254;306;52
/net/per610a/home/mvp/mvp_db/news7-lv/2013/2013_10_08_19_00/2013_10_08_19_00.mpg;Yukio HATOYAMA.jpg;6409;6921;38429;320;346;26
/net/per610a/home/mvp/mvp_db/news7-lv/2013/2013_10_08_19_00/2013_10_08_19_00.mpg;Yukio HATOYAMA.jpg;7085;7473;38429;354;373;19
/net/per610a/home/mvp/mvp_db/news7-lv/2013/2013_10_08_19_00/2013_10_08_19_00.mpg;Shinzo ABE.jpg;14757;15193;38429;738;760;22
/net/per610a/home/mvp/mvp_db/news7-lv/2013/2013_10_08_19_00/2013_10_08_19_00.mpg;Shinzo ABE.jpg;15633;15853;38429;782;793;11
/net/per610a/home/mvp/mvp_db/news7-lv/2013/2013_10_08_19_00/2013_10_08_19_00.mpg;Shinzo ABE.jpg;16449;16541;38429;823;827;4
/net/per610a/home/mvp/mvp_db/news7-lv/2013/2013_10_08_19_00/2013_10_08_19_00.mpg;Shinzo ABE.jpg;16637;17573;38429;832;879;47
/net/per610a/home/mvp/mvp_db/news7-lv/2013/2013_10_09_19_00/2013_10_09_19_00.mpg;Shinzo ABE.jpg;10129;10297;36037;506;515;9
/net/per610a/home/mvp/mvp_db/news7-lv/2013/2013_10_09_19_00/2013_10_09_19_00.mpg;Shinzo ABE.jpg;10481;10641;36037;524;532;8
/net/per610a/home/mvp/mvp_db/news7-lv/2013/2013_10_09_19_00/2013_10_09_19_00.mpg;Shinzo ABE.jpg;10821;11089;36037;541;554;13
/net/per610a/home/mvp/mvp_db/news7-lv/2013/2013_10_09_19_00/2013_10_09_19_00.mpg;Shinzo ABE.jpg;13573;14537;36037;679;727;48
/net/per610a/home/mvp/mvp_db/news7-lv/2013/2013_10_09_19_00/2013_10_09_19_00.mpg;Shinzo ABE.jpg;24981;25041;36037;1249;1252;3
/net/per610a/home/mvp/mvp_db/news7-lv/2013/2013_10_10_19_00/2013_10_10_19_00.mpg;Shinzo ABE.jpg;6669;6729;36033;333;336;3
/net/per610a/home/mvp/mvp_db/news7-lv/2013/2013_10_10_19_00/2013_10_10_19_00.mpg;Shinzo ABE.jpg;12149;13245;36033;607;662;55
/net/per610a/home/mvp/mvp_db/news7-lv/2013/2013_10_10_19_00/2013_10_10_19_00.mpg;Shinzo ABE.jpg;15389;16313;36033;770;816;46
/net/per610a/home/mvp/mvp_db/news7-lv/2013/2013_10_10_19_00/2013_10_10_19_00.mpg;Natsuo YAMAGUCHI.jpg;11125;11445;36033;556;572;16
/net/per610a/home/mvp/mvp_db/news7-lv/2013/2013_10_14_19_00/2013_10_14_19_00.mpg;Tadatomo Yoshida.jpg;28005;28145;36033;1401;1408;7
/net/per610a/home/mvp/mvp_db/news7-lv/2013/2013_10_14_19_00/2013_10_14_19_00.mpg;Tadatomo Yoshida.jpg;28453;28973;36033;1423;1449;26
/net/per610a/home/mvp/mvp_db/news7-lv/2013/2013_10_15_19_00/2013_10_15_19_00.mpg;Shinzo ABE.jpg;15101;15733;38441;755;787;32
/net/per610a/home/mvp/mvp_db/news7-lv/2013/2013_10_15_19_00/2013_10_15_19_00.mpg;Shinzo ABE.jpg;15981;16633;38441;799;832;33
/net/per610a/home/mvp/mvp_db/news7-lv/2013/2013_10_15_19_00/2013_10_15_19_00.mpg;Shinzo ABE.jpg;19285;20325;38441;964;1016;52
/net/per610a/home/mvp/mvp_db/news7-lv/2013/2013_10_15_19_00/2013_10_15_19_00.mpg;Shinzo ABE.jpg;20417;20901;38441;1021;1045;24
/net/per610a/home/mvp/mvp_db/news7-lv/2013/2013_10_15_19_00/2013_10_15_19_00.mpg;Shinzo ABE.jpg;20977;21257;38441;1049;1063;14
/net/per610a/home/mvp/mvp_db/news7-lv/2013/2013_10_15_19_00/2013_10_15_19_00.mpg;Shinzo ABE.jpg;22385;22385;38441;1119;1119;0
/net/per610a/home/mvp/mvp_db/news7-lv/2013/2013_10_15_19_00/2013_10_15_19_00.mpg;Shinzo ABE.jpg;28365;28621;38441;1418;1431;13
/net/per610a/home/mvp/mvp_db/news7-lv/2013/2013_10_15_19_00/2013_10_15_19_00.mpg;Shinzo ABE.jpg;29341;29341;38441;1467;1467;0
/net/per610a/home/mvp/mvp_db/news7-lv/2013/2013_10_15_19_00/2013_10_15_19_00.mpg;Shinzo ABE.jpg;31677;32069;38441;1584;1604;20
/net/per610a/home/mvp/mvp_db/news7-lv/2013/2013_10_16_19_00/2013_10_16_19_00.mpg;Shinzo ABE.jpg;37097;37189;71997;1856;1861;5
/net/per610a/home/mvp/mvp_db/news7-lv/2013/2013_10_17_19_00/2013_10_17_19_00.mpg;Shinzo ABE.jpg;22001;22589;36041;1100;1130;30
/net/per610a/home/mvp/mvp_db/news7-lv/2013/2013_10_17_19_00/2013_10_17_19_00.mpg;Shinzo ABE.jpg;25313;25941;36041;1266;1297;31
/net/per610a/home/mvp/mvp_db/news7-lv/2013/2013_10_18_19_00/2013_10_18_19_00.mpg;Shinzo ABE.jpg;21569;22109;36033;1079;1106;27
/net/per610a/home/mvp/mvp_db/news7-lv/2013/2013_10_21_19_00/2013_10_21_19_00.mpg;Shinzo ABE.jpg;27665;27713;36033;1384;1386;2
/net/per610a/home/mvp/mvp_db/news7-lv/2013/2013_10_21_19_00/2013_10_21_19_00.mpg;Shinzo ABE.jpg;27801;29357;36033;1391;1468;77
/net/per610a/home/mvp/mvp_db/news7-lv/2013/2013_10_21_19_00/2013_10_21_19_00.mpg;Shinzo ABE.jpg;29437;29461;36033;1472;1474;2
/net/per610a/home/mvp/mvp_db/news7-lv/2013/2013_10_23_19_00/2013_10_23_19_00.mpg;Shinzo ABE.jpg;24757;24941;36041;1238;1247;9
/net/per610a/home/mvp/mvp_db/news7-lv/2013/2013_10_23_19_00/2013_10_23_19_00.mpg;Shinzo ABE.jpg;25349;25689;36041;1268;1285;17
/net/per610a/home/mvp/mvp_db/news7-lv/2013/2013_10_23_19_00/2013_10_23_19_00.mpg;Shinzo ABE.jpg;25753;25857;36041;1288;1293;5
/net/per610a/home/mvp/mvp_db/news7-lv/2013/2013_10_24_19_00/2013_10_24_19_00.mpg;Naoto KAN.jpg;12749;12829;36033;637;641;4
/net/per610a/home/mvp/mvp_db/news7-lv/2013/2013_10_24_19_00/2013_10_24_19_00.mpg;Kyoko Nakayama.jpg;13609;14013;36033;680;701;21
/net/per610a/home/mvp/mvp_db/news7-lv/2013/2013_10_27_19_00/2013_10_27_19_00.mpg;Shinzo ABE.jpg;8573;8913;36033;428;445;17
/net/per610a/home/mvp/mvp_db/news7-lv/2013/2013_10_27_19_00/2013_10_27_19_00.mpg;Shinzo ABE.jpg;9181;9241;36033;459;462;3
/net/per610a/home/mvp/mvp_db/news7-lv/2013/2013_10_27_19_00/2013_10_27_19_00.mpg;Shinzo ABE.jpg;9313;9761;36033;465;488;23
/net/per610a/home/mvp/mvp_db/news7-lv/2013/2013_10_27_19_00/2013_10_27_19_00.mpg;Shinzo ABE.jpg;10349;10441;36033;517;522;5
/net/per610a/home/mvp/mvp_db/news7-lv/2013/2013_10_31_19_00/2013_10_31_19_00.mpg;Shinzo ABE.jpg;20805;21093;36033;1041;1055;14
/net/per610a/home/mvp/mvp_db/news7-lv/2013/2013_10_31_19_00/2013_10_31_19_00.mpg;Shinzo ABE.jpg;23649;23697;36033;1183;1185;2
/net/per610a/home/mvp/mvp_db/news7-lv/2013/2013_11_01_19_00/2013_11_01_19_00.mpg;Shinzo ABE.jpg;4569;5053;36033;228;252;24
/net/per610a/home/mvp/mvp_db/news7-lv/2013/2013_11_01_19_00/2013_11_01_19_00.mpg;Shinzo ABE.jpg;5201;5253;36033;260;262;2
/net/per610a/home/mvp/mvp_db/news7-lv/2013/2013_11_02_19_00/2013_11_02_19_00.mpg;Shinzo ABE.jpg;3009;3121;36041;150;156;6
/net/per610a/home/mvp/mvp_db/news7-lv/2013/2013_11_02_19_00/2013_11_02_19_00.mpg;Shinzo ABE.jpg;3497;3729;36041;174;186;12
/net/per610a/home/mvp/mvp_db/news7-lv/2013/2013_11_02_19_00/2013_11_02_19_00.mpg;Shinzo ABE.jpg;6457;6493;36041;323;324;1
/net/per610a/home/mvp/mvp_db/news7-lv/2013/2013_11_02_19_00/2013_11_02_19_00.mpg;Shinzo ABE.jpg;6557;6681;36041;328;334;6
/net/per610a/home/mvp/mvp_db/news7-lv/2013/2013_11_02_19_00/2013_11_02_19_00.mpg;Shinzo ABE.jpg;6749;6945;36041;337;347;10
/net/per610a/home/mvp/mvp_db/news7-lv/2013/2013_11_05_19_00/2013_11_05_19_00.mpg;Shinzo ABE.jpg;20893;21185;36033;1045;1060;15
/net/per610a/home/mvp/mvp_db/news7-lv/2013/2013_11_05_19_00/2013_11_05_19_00.mpg;Shinzo ABE.jpg;21573;21813;36033;1079;1091;12
/net/per610a/home/mvp/mvp_db/news7-lv/2013/2013_11_05_19_00/2013_11_05_19_00.mpg;Shinzo ABE.jpg;24753;24925;36033;1238;1247;9
/net/per610a/home/mvp/mvp_db/news7-lv/2013/2013_11_05_19_00/2013_11_05_19_00.mpg;Shinzo ABE.jpg;21189;21473;36033;1060;1074;14
/net/per610a/home/mvp/mvp_db/news7-lv/2013/2013_11_05_19_00/2013_11_05_19_00.mpg;Junichiro KOIZUMI.jpg;27949;28217;36033;1398;1411;13
/net/per610a/home/mvp/mvp_db/news7-lv/2013/2013_11_06_19_00/2013_11_06_19_00.mpg;Shinzo ABE.jpg;7817;8181;36033;391;409;18
/net/per610a/home/mvp/mvp_db/news7-lv/2013/2013_11_06_19_00/2013_11_06_19_00.mpg;Shinzo ABE.jpg;24049;24769;36033;1203;1239;36
/net/per610a/home/mvp/mvp_db/news7-lv/2013/2013_11_06_19_00/2013_11_06_19_00.mpg;Shinzo ABE.jpg;25597;25849;36033;1280;1293;13
/net/per610a/home/mvp/mvp_db/news7-lv/2013/2013_11_07_19_00/2013_11_07_19_00.mpg;Shinzo ABE.jpg;22817;23273;36033;1141;1164;23
/net/per610a/home/mvp/mvp_db/news7-lv/2013/2013_11_09_19_00/2013_11_09_19_00.mpg;Shinzo ABE.jpg;26589;26593;36029;1330;1330;0
/net/per610a/home/mvp/mvp_db/news7-lv/2013/2013_11_09_19_00/2013_11_09_19_00.mpg;Shinzo ABE.jpg;27825;28705;36029;1392;1436;44
/net/per610a/home/mvp/mvp_db/news7-lv/2013/2013_11_09_19_00/2013_11_09_19_00.mpg;Yukio HATOYAMA.jpg;29121;29521;36029;1457;1477;20
/net/per610a/home/mvp/mvp_db/news7-lv/2013/2013_11_12_19_00/2013_11_12_19_00.mpg;Junichiro KOIZUMI.jpg;26489;26613;38433;1325;1331;6
/net/per610a/home/mvp/mvp_db/news7-lv/2013/2013_11_12_19_00/2013_11_12_19_00.mpg;Junichiro KOIZUMI.jpg;27145;27877;38433;1358;1394;36
/net/per610a/home/mvp/mvp_db/news7-lv/2013/2013_11_12_19_00/2013_11_12_19_00.mpg;Junichiro KOIZUMI.jpg;28717;29493;38433;1436;1475;39
/net/per610a/home/mvp/mvp_db/news7-lv/2013/2013_11_13_19_00/2013_11_13_19_00.mpg;Taro ASO.jpg;27197;27773;36041;1360;1389;29
/net/per610a/home/mvp/mvp_db/news7-lv/2013/2013_11_13_19_00/2013_11_13_19_00.mpg;Bairi Kaieda.jpg;28057;28157;36041;1403;1408;5
/net/per610a/home/mvp/mvp_db/news7-lv/2013/2013_11_14_19_00/2013_11_14_19_00.mpg;Yoshimi WATANABE.jpg;26993;27529;36033;1350;1377;27
/net/per610a/home/mvp/mvp_db/news7-lv/2013/2013_11_14_19_00/2013_11_14_19_00.mpg;Shinzo ABE.jpg;28569;28649;36033;1429;1433;4
/net/per610a/home/mvp/mvp_db/news7-lv/2013/2013_11_14_19_00/2013_11_14_19_00.mpg;Sadakazu TANIGAKI.jpg;28833;29437;36033;1442;1472;30
/net/per610a/home/mvp/mvp_db/news7-lv/2013/2013_11_16_19_00/2013_11_16_19_00.mpg;Natsuo YAMAGUCHI.jpg;21413;21841;36041;1071;1092;21
/net/per610a/home/mvp/mvp_db/news7-lv/2013/2013_11_16_19_00/2013_11_16_19_00.mpg;Takeo Hiranuma.jpeg;21909;22021;36041;1096;1101;5
/net/per610a/home/mvp/mvp_db/news7-lv/2013/2013_11_17_19_00/2013_11_17_19_00.mpg;Bairi Kaieda.jpg;9433;10053;36033;472;503;31
/net/per610a/home/mvp/mvp_db/news7-lv/2013/2013_11_17_19_00/2013_11_17_19_00.mpg;Bairi Kaieda.jpg;11453;12513;36033;573;626;53
/net/per610a/home/mvp/mvp_db/news7-lv/2013/2013_11_18_19_00/2013_11_18_19_00.mpg;Shinzo ABE.jpg;1209;1697;36033;60;84;24
/net/per610a/home/mvp/mvp_db/news7-lv/2013/2013_11_18_19_00/2013_11_18_19_00.mpg;Shinzo ABE.jpg;1909;2089;36033;95;104;9
/net/per610a/home/mvp/mvp_db/news7-lv/2013/2013_11_18_19_00/2013_11_18_19_00.mpg;Shinzo ABE.jpg;8781;8805;36033;439;440;1
/net/per610a/home/mvp/mvp_db/news7-lv/2013/2013_11_18_19_00/2013_11_18_19_00.mpg;Shinzo ABE.jpg;10177;10273;36033;509;514;5
/net/per610a/home/mvp/mvp_db/news7-lv/2013/2013_11_18_19_00/2013_11_18_19_00.mpg;Shinzo ABE.jpg;26933;27609;36033;1347;1381;34
/net/per610a/home/mvp/mvp_db/news7-lv/2013/2013_11_18_19_00/2013_11_18_19_00.mpg;Bairi Kaieda.jpg;6341;6553;36033;317;327;10
/net/per610a/home/mvp/mvp_db/news7-lv/2013/2013_11_18_19_00/2013_11_18_19_00.mpg;Yoshimi WATANABE.jpg;8937;9101;36033;447;455;8
/net/per610a/home/mvp/mvp_db/news7-lv/2013/2013_11_19_19_00/2013_11_19_19_00.mpg;Yoshimi WATANABE.jpg;2321;2841;36033;116;142;26
/net/per610a/home/mvp/mvp_db/news7-lv/2013/2013_11_19_19_00/2013_11_19_19_00.mpg;Toru Hashimoto.jpg;4569;4809;36033;228;240;12
/net/per610a/home/mvp/mvp_db/news7-lv/2013/2013_11_19_19_00/2013_11_19_19_00.mpg;Bairi Kaieda.jpg;5837;5989;36033;292;299;7
/net/per610a/home/mvp/mvp_db/news7-lv/2013/2013_11_19_19_00/2013_11_19_19_00.mpg;Bairi Kaieda.jpg;6373;6569;36033;318;328;10
/net/per610a/home/mvp/mvp_db/news7-lv/2013/2013_11_19_19_00/2013_11_19_19_00.mpg;Bairi Kaieda.jpg;6737;7097;36033;337;355;18
/net/per610a/home/mvp/mvp_db/news7-lv/2013/2013_11_19_19_00/2013_11_19_19_00.mpg;Shinzo ABE.jpg;25549;25577;36033;1278;1279;1
/net/per610a/home/mvp/mvp_db/news7-lv/2013/2013_11_19_19_00/2013_11_19_19_00.mpg;Shinzo ABE.jpg;26605;26625;36033;1331;1332;1
/net/per610a/home/mvp/mvp_db/news7-lv/2013/2013_11_19_19_00/2013_11_19_19_00.mpg;Shinzo ABE.jpg;26709;27233;36033;1336;1362;26
/net/per610a/home/mvp/mvp_db/news7-lv/2013/2013_11_20_19_00/2013_11_20_19_00.mpg;Shinzo ABE.jpg;16461;16489;36033;823;825;2
/net/per610a/home/mvp/mvp_db/news7-lv/2013/2013_11_20_19_00/2013_11_20_19_00.mpg;Shinzo ABE.jpg;16621;16713;36033;831;836;5
/net/per610a/home/mvp/mvp_db/news7-lv/2013/2013_11_21_19_00/2013_11_21_19_00.mpg;Yorihisa Matsuno.png;6117;6217;36033;306;311;5
/net/per610a/home/mvp/mvp_db/news7-lv/2013/2013_11_21_19_00/2013_11_21_19_00.mpg;Toranosuke Katayama.jpg;6441;6621;36033;322;331;9
/net/per610a/home/mvp/mvp_db/news7-lv/2013/2013_11_21_19_00/2013_11_21_19_00.mpg;Toru Hashimoto.jpg;7513;7749;36033;375;387;12
/net/per610a/home/mvp/mvp_db/news7-lv/2013/2013_11_21_19_00/2013_11_21_19_00.mpg;Kazuo SHII.jpg;9925;10485;36033;496;524;28
/net/per610a/home/mvp/mvp_db/news7-lv/2013/2013_11_22_19_00/2013_11_22_19_00.mpg;Shinzo ABE.jpg;13805;14253;36033;690;713;23
/net/per610a/home/mvp/mvp_db/news7-lv/2013/2013_11_22_19_00/2013_11_22_19_00.mpg;Shinzo ABE.jpg;17909;17973;36033;896;899;3
/net/per610a/home/mvp/mvp_db/news7-lv/2013/2013_11_22_19_00/2013_11_22_19_00.mpg;Shinzo ABE.jpg;27849;28525;36033;1393;1427;34
/net/per610a/home/mvp/mvp_db/news7-lv/2013/2013_11_25_19_00/2013_11_25_19_00.mpg;Shinzo ABE.jpg;11609;12161;36033;580;608;28
/net/per610a/home/mvp/mvp_db/news7-lv/2013/2013_11_25_19_00/2013_11_25_19_00.mpg;Bairi Kaieda.jpg;12273;12717;36033;614;636;22
/net/per610a/home/mvp/mvp_db/news7-lv/2013/2013_11_25_19_00/2013_11_25_19_00.mpg;Yoshimi WATANABE.jpg;12793;12849;36033;640;642;2
/net/per610a/home/mvp/mvp_db/news7-lv/2013/2013_11_25_19_00/2013_11_25_19_00.mpg;Yoshimi WATANABE.jpg;13017;13289;36033;651;664;13
/net/per610a/home/mvp/mvp_db/news7-lv/2013/2013_11_25_19_00/2013_11_25_19_00.mpg;Takeo Hiranuma.jpeg;13521;13633;36033;676;682;6
/net/per610a/home/mvp/mvp_db/news7-lv/2013/2013_11_25_19_00/2013_11_25_19_00.mpg;Toranosuke Katayama.jpg;13641;13965;36033;682;698;16
/net/per610a/home/mvp/mvp_db/news7-lv/2013/2013_11_26_19_00/2013_11_26_19_00.mpg;Shinzo ABE.jpg;2869;2929;36033;143;146;3
/net/per610a/home/mvp/mvp_db/news7-lv/2013/2013_11_26_19_00/2013_11_26_19_00.mpg;Shinzo ABE.jpg;18081;18137;36033;904;907;3
/net/per610a/home/mvp/mvp_db/news7-lv/2013/2013_11_26_19_00/2013_11_26_19_00.mpg;Yorihisa Matsuno.png;7429;7709;36033;371;385;14
/net/per610a/home/mvp/mvp_db/news7-lv/2013/2013_11_26_19_00/2013_11_26_19_00.mpg;Yorihisa Matsuno.png;13009;13121;36033;650;656;6
/net/per610a/home/mvp/mvp_db/news7-lv/2013/2013_11_26_19_00/2013_11_26_19_00.mpg;Masashi Nakano.jpg;21921;22185;36033;1096;1110;14
/net/per610a/home/mvp/mvp_db/news7-lv/2013/2013_11_28_19_00/2013_11_28_19_00.mpg;Yoshimi WATANABE.jpg;9617;11297;36037;481;565;84
/net/per610a/home/mvp/mvp_db/news7-lv/2013/2013_11_29_19_00/2013_11_29_19_00.mpg;Yukio HATOYAMA.jpg;9669;10913;36033;483;546;63
/net/per610a/home/mvp/mvp_db/news7-lv/2013/2013_11_29_19_00/2013_11_29_19_00.mpg;Kenji Eda.jpg;25385;26377;36033;1270;1319;49
/net/per610a/home/mvp/mvp_db/news7-lv/2013/2013_11_29_19_00/2013_11_29_19_00.mpg;Kenji Eda.jpg;28085;28357;36033;1405;1418;13
/net/per610a/home/mvp/mvp_db/news7-lv/2013/2013_11_29_19_00/2013_11_29_19_00.mpg;Yoshimi WATANABE.jpg;27509;28041;36033;1376;1403;27
/net/per610a/home/mvp/mvp_db/news7-lv/2013/2013_11_29_19_00/2013_11_29_19_00.mpg;Shinzo ABE.jpg;29137;29273;36033;1457;1464;7
/net/per610a/home/mvp/mvp_db/news7-lv/2013/2013_11_30_19_00/2013_11_30_19_00.mpg;Shinzo ABE.jpg;12401;12669;36033;620;633;13
/net/per610a/home/mvp/mvp_db/news7-lv/2013/2013_12_01_19_00/2013_12_01_19_00.mpg;Shinzo ABE.jpg;6041;7153;36033;302;357;55
/net/per610a/home/mvp/mvp_db/news7-lv/2013/2013_12_01_19_00/2013_12_01_19_00.mpg;Shinzo ABE.jpg;8525;9337;36033;426;467;41
/net/per610a/home/mvp/mvp_db/news7-lv/2013/2013_12_01_19_00/2013_12_01_19_00.mpg;Shinzo ABE.jpg;28345;28617;36033;1418;1431;13
/net/per610a/home/mvp/mvp_db/news7-lv/2013/2013_12_02_19_00/2013_12_02_19_00.mpg;Shinzo ABE.jpg;1673;1753;36033;83;87;4
/net/per610a/home/mvp/mvp_db/news7-lv/2013/2013_12_02_19_00/2013_12_02_19_00.mpg;Natsuo YAMAGUCHI.jpg;3849;4061;36033;192;203;11
/net/per610a/home/mvp/mvp_db/news7-lv/2013/2013_12_03_19_00/2013_12_03_19_00.mpg;Shinzo ABE.jpg;1;105;38429;0;5;5
/net/per610a/home/mvp/mvp_db/news7-lv/2013/2013_12_03_19_00/2013_12_03_19_00.mpg;Shinzo ABE.jpg;261;277;38429;13;13;0
/net/per610a/home/mvp/mvp_db/news7-lv/2013/2013_12_03_19_00/2013_12_03_19_00.mpg;Shinzo ABE.jpg;1153;1177;38429;57;58;1
/net/per610a/home/mvp/mvp_db/news7-lv/2013/2013_12_03_19_00/2013_12_03_19_00.mpg;Shinzo ABE.jpg;1649;1841;38429;82;92;10
/net/per610a/home/mvp/mvp_db/news7-lv/2013/2013_12_03_19_00/2013_12_03_19_00.mpg;Shinzo ABE.jpg;4645;4645;38429;232;232;0
/net/per610a/home/mvp/mvp_db/news7-lv/2013/2013_12_03_19_00/2013_12_03_19_00.mpg;Shinzo ABE.jpg;4761;4821;38429;238;241;3
/net/per610a/home/mvp/mvp_db/news7-lv/2013/2013_12_03_19_00/2013_12_03_19_00.mpg;Shinzo ABE.jpg;5617;5713;38429;281;285;4
/net/per610a/home/mvp/mvp_db/news7-lv/2013/2013_12_03_19_00/2013_12_03_19_00.mpg;Shinzo ABE.jpg;33453;36841;38429;1673;1843;170
/net/per610a/home/mvp/mvp_db/news7-lv/2013/2013_12_03_19_00/2013_12_03_19_00.mpg;Natsuo YAMAGUCHI.jpg;10053;10393;38429;503;520;17
/net/per610a/home/mvp/mvp_db/news7-lv/2013/2013_12_04_19_00/2013_12_04_19_00.mpg;Shinzo ABE.jpg;2293;3697;36029;114;185;71
/net/per610a/home/mvp/mvp_db/news7-lv/2013/2013_12_04_19_00/2013_12_04_19_00.mpg;Shinzo ABE.jpg;4505;4841;36029;225;242;17
/net/per610a/home/mvp/mvp_db/news7-lv/2013/2013_12_04_19_00/2013_12_04_19_00.mpg;Shinzo ABE.jpg;5053;5153;36029;252;257;5
/net/per610a/home/mvp/mvp_db/news7-lv/2013/2013_12_04_19_00/2013_12_04_19_00.mpg;Shinzo ABE.jpg;13769;13861;36029;689;693;4
/net/per610a/home/mvp/mvp_db/news7-lv/2013/2013_12_04_19_00/2013_12_04_19_00.mpg;Shinzo ABE.jpg;15721;16453;36029;786;823;37
/net/per610a/home/mvp/mvp_db/news7-lv/2013/2013_12_05_19_00/2013_12_05_19_00.mpg;Shinzo ABE.jpg;2993;3093;36033;149;154;5
/net/per610a/home/mvp/mvp_db/news7-lv/2013/2013_12_05_19_00/2013_12_05_19_00.mpg;Shinzo ABE.jpg;20113;20217;36033;1006;1011;5
/net/per610a/home/mvp/mvp_db/news7-lv/2013/2013_12_05_19_00/2013_12_05_19_00.mpg;Kazuo SHII.jpg;8661;9885;36033;433;494;61
/net/per610a/home/mvp/mvp_db/news7-lv/2013/2013_12_05_19_00/2013_12_05_19_00.mpg;Shinzo ABE.jpg;16521;16985;36033;826;849;23
/net/per610a/home/mvp/mvp_db/news7-lv/2013/2013_12_05_19_00/2013_12_05_19_00.mpg;Shinzo ABE.jpg;17057;17069;36033;853;854;1
/net/per610a/home/mvp/mvp_db/news7-lv/2013/2013_12_05_19_00/2013_12_05_19_00.mpg;Shinzo ABE.jpg;17149;17297;36033;858;865;7
/net/per610a/home/mvp/mvp_db/news7-lv/2013/2013_12_06_19_00/2013_12_06_19_00.mpg;Shinzo ABE.jpg;1273;1361;36045;63;68;5
/net/per610a/home/mvp/mvp_db/news7-lv/2013/2013_12_08_19_00/2013_12_08_19_00.mpg;Kenji Eda.jpg;473;565;36033;23;28;5
/net/per610a/home/mvp/mvp_db/news7-lv/2013/2013_12_08_19_00/2013_12_08_19_00.mpg;Kenji Eda.jpg;689;753;36033;34;37;3
/net/per610a/home/mvp/mvp_db/news7-lv/2013/2013_12_08_19_00/2013_12_08_19_00.mpg;Kenji Eda.jpg;1001;1785;36033;50;89;39
/net/per610a/home/mvp/mvp_db/news7-lv/2013/2013_12_08_19_00/2013_12_08_19_00.mpg;Kenji Eda.jpg;1889;2973;36033;94;148;54
/net/per610a/home/mvp/mvp_db/news7-lv/2013/2013_12_08_19_00/2013_12_08_19_00.mpg;Yoshimi WATANABE.jpg;1009;1605;36033;50;80;30
/net/per610a/home/mvp/mvp_db/news7-lv/2013/2013_12_08_19_00/2013_12_08_19_00.mpg;Yoshimi WATANABE.jpg;3093;3909;36033;154;195;41
/net/per610a/home/mvp/mvp_db/news7-lv/2013/2013_12_08_19_00/2013_12_08_19_00.mpg;Kenji Eda.jpg;4341;5061;36033;217;253;36
/net/per610a/home/mvp/mvp_db/news7-lv/2013/2013_12_09_19_00/2013_12_09_19_00.mpg;Shinzo ABE.jpg;1093;1701;38429;54;85;31
/net/per610a/home/mvp/mvp_db/news7-lv/2013/2013_12_09_19_00/2013_12_09_19_00.mpg;Shinzo ABE.jpg;1837;5973;38429;91;298;207
/net/per610a/home/mvp/mvp_db/news7-lv/2013/2013_12_09_19_00/2013_12_09_19_00.mpg;Shinzo ABE.jpg;6817;7353;38429;341;367;26
/net/per610a/home/mvp/mvp_db/news7-lv/2013/2013_12_09_19_00/2013_12_09_19_00.mpg;Shinzo ABE.jpg;8245;8309;38429;412;415;3
/net/per610a/home/mvp/mvp_db/news7-lv/2013/2013_12_09_19_00/2013_12_09_19_00.mpg;Shinzo ABE.jpg;8057;8121;38429;403;406;3
/net/per610a/home/mvp/mvp_db/news7-lv/2013/2013_12_09_19_00/2013_12_09_19_00.mpg;Shinzo ABE.jpg;9729;9749;38429;486;487;1
/net/per610a/home/mvp/mvp_db/news7-lv/2013/2013_12_09_19_00/2013_12_09_19_00.mpg;Shinzo ABE.jpg;9857;9901;38429;493;495;2
/net/per610a/home/mvp/mvp_db/news7-lv/2013/2013_12_09_19_00/2013_12_09_19_00.mpg;Shinzo ABE.jpg;9981;10053;38429;499;503;4
/net/per610a/home/mvp/mvp_db/news7-lv/2013/2013_12_09_19_00/2013_12_09_19_00.mpg;Kenji Eda.jpg;18545;18829;38429;927;942;15
/net/per610a/home/mvp/mvp_db/news7-lv/2013/2013_12_09_19_00/2013_12_09_19_00.mpg;Kenji Eda.jpg;19185;19889;38429;960;995;35
/net/per610a/home/mvp/mvp_db/news7-lv/2013/2013_12_09_19_00/2013_12_09_19_00.mpg;Kenji Eda.jpg;23537;23773;38429;1177;1189;12
/net/per610a/home/mvp/mvp_db/news7-lv/2013/2013_12_09_19_00/2013_12_09_19_00.mpg;Yorihisa Matsuno.png;22501;23181;38429;1125;1159;34
/net/per610a/home/mvp/mvp_db/news7-lv/2013/2013_12_09_19_00/2013_12_09_19_00.mpg;Yorihisa Matsuno.png;23581;23773;38429;1180;1189;9
/net/per610a/home/mvp/mvp_db/news7-lv/2013/2013_12_10_19_00/2013_12_10_19_00.mpg;Yorihisa Matsuno.png;13993;14301;36029;700;715;15
/net/per610a/home/mvp/mvp_db/news7-lv/2013/2013_12_10_19_00/2013_12_10_19_00.mpg;Yorihisa Matsuno.png;16861;16921;36029;843;846;3
/net/per610a/home/mvp/mvp_db/news7-lv/2013/2013_12_10_19_00/2013_12_10_19_00.mpg;Kenji Eda.jpg;13993;14513;36029;700;726;26
/net/per610a/home/mvp/mvp_db/news7-lv/2013/2013_12_10_19_00/2013_12_10_19_00.mpg;Kenji Eda.jpg;16041;16289;36029;802;815;13
/net/per610a/home/mvp/mvp_db/news7-lv/2013/2013_12_10_19_00/2013_12_10_19_00.mpg;Yoshimi WATANABE.jpg;14517;14869;36029;726;744;18
/net/per610a/home/mvp/mvp_db/news7-lv/2013/2013_12_10_19_00/2013_12_10_19_00.mpg;Yoshimi WATANABE.jpg;15189;15273;36029;760;764;4
/net/per610a/home/mvp/mvp_db/news7-lv/2013/2013_12_10_19_00/2013_12_10_19_00.mpg;Yoshimi WATANABE.jpg;15489;15565;36029;775;778;3
/net/per610a/home/mvp/mvp_db/news7-lv/2013/2013_12_11_19_00/2013_12_11_19_00.mpg;Kenji Eda.jpg;28681;28749;36033;1435;1438;3
/net/per610a/home/mvp/mvp_db/news7-lv/2013/2013_12_11_19_00/2013_12_11_19_00.mpg;Kenji Eda.jpg;28909;28949;36033;1446;1448;2
/net/per610a/home/mvp/mvp_db/news7-lv/2013/2013_12_11_19_00/2013_12_11_19_00.mpg;Kenji Eda.jpg;29357;29653;36033;1468;1483;15
/net/per610a/home/mvp/mvp_db/news7-lv/2013/2013_12_12_19_00/2013_12_12_19_00.mpg;Shinzo ABE.jpg;1493;1609;36033;74;80;6
/net/per610a/home/mvp/mvp_db/news7-lv/2013/2013_12_12_19_00/2013_12_12_19_00.mpg;Shinzo ABE.jpg;5949;6453;36033;297;322;25
/net/per610a/home/mvp/mvp_db/news7-lv/2013/2013_12_12_19_00/2013_12_12_19_00.mpg;Shinzo ABE.jpg;6645;6881;36033;332;344;12
/net/per610a/home/mvp/mvp_db/news7-lv/2013/2013_12_12_19_00/2013_12_12_19_00.mpg;Shinzo ABE.jpg;9461;9753;36033;473;488;15
/net/per610a/home/mvp/mvp_db/news7-lv/2013/2013_12_12_19_00/2013_12_12_19_00.mpg;Shinzo ABE.jpg;27061;27269;36033;1354;1364;10
/net/per610a/home/mvp/mvp_db/news7-lv/2013/2013_12_13_19_00/2013_12_13_19_00.mpg;Ichiro OZAWA.jpg;17849;18301;36033;893;915;22
/net/per610a/home/mvp/mvp_db/news7-lv/2013/2013_12_13_19_00/2013_12_13_19_00.mpg;Shinzo ABE.jpg;20133;20197;36033;1007;1010;3
/net/per610a/home/mvp/mvp_db/news7-lv/2013/2013_12_13_19_00/2013_12_13_19_00.mpg;Shinzo ABE.jpg;20261;20265;36033;1013;1014;1
/net/per610a/home/mvp/mvp_db/news7-lv/2013/2013_12_13_19_00/2013_12_13_19_00.mpg;Shinzo ABE.jpg;20329;20365;36033;1017;1019;2
/net/per610a/home/mvp/mvp_db/news7-lv/2013/2013_12_13_19_00/2013_12_13_19_00.mpg;Shinzo ABE.jpg;20865;20969;36033;1044;1049;5
/net/per610a/home/mvp/mvp_db/news7-lv/2013/2013_12_13_19_00/2013_12_13_19_00.mpg;Shinzo ABE.jpg;21469;21513;36033;1074;1076;2
/net/per610a/home/mvp/mvp_db/news7-lv/2013/2013_12_13_19_00/2013_12_13_19_00.mpg;Shinzo ABE.jpg;22437;22717;36033;1122;1136;14
/net/per610a/home/mvp/mvp_db/news7-lv/2013/2013_12_13_19_00/2013_12_13_19_00.mpg;Shinzo ABE.jpg;23205;23337;36033;1161;1167;6
/net/per610a/home/mvp/mvp_db/news7-lv/2013/2013_12_13_19_00/2013_12_13_19_00.mpg;Shinzo ABE.jpg;23373;23561;36033;1169;1178;9
/net/per610a/home/mvp/mvp_db/news7-lv/2013/2013_12_14_19_00/2013_12_14_19_00.mpg;Shinzo ABE.jpg;2977;3005;36033;148;150;2
/net/per610a/home/mvp/mvp_db/news7-lv/2013/2013_12_14_19_00/2013_12_14_19_00.mpg;Shinzo ABE.jpg;3153;3237;36033;157;161;4
/net/per610a/home/mvp/mvp_db/news7-lv/2013/2013_12_14_19_00/2013_12_14_19_00.mpg;Shinzo ABE.jpg;6169;9049;36033;308;452;144
/net/per610a/home/mvp/mvp_db/news7-lv/2013/2013_12_14_19_00/2013_12_14_19_00.mpg;Shinzo ABE.jpg;9365;9421;36033;468;471;3
/net/per610a/home/mvp/mvp_db/news7-lv/2013/2013_12_14_19_00/2013_12_14_19_00.mpg;Shinzo ABE.jpg;10905;11401;36033;545;570;25
/net/per610a/home/mvp/mvp_db/news7-lv/2013/2013_12_14_19_00/2013_12_14_19_00.mpg;Shinzo ABE.jpg;17901;18581;36033;895;929;34
/net/per610a/home/mvp/mvp_db/news7-lv/2013/2013_12_15_19_00/2013_12_15_19_00.mpg;Shinzo ABE.jpg;8613;8673;36033;430;433;3
/net/per610a/home/mvp/mvp_db/news7-lv/2013/2013_12_15_19_00/2013_12_15_19_00.mpg;Shinzo ABE.jpg;8789;9057;36033;439;453;14
/net/per610a/home/mvp/mvp_db/news7-lv/2013/2013_12_15_19_00/2013_12_15_19_00.mpg;Shinzo ABE.jpg;9125;9481;36033;456;474;18
/net/per610a/home/mvp/mvp_db/news7-lv/2013/2013_12_15_19_00/2013_12_15_19_00.mpg;Shinzo ABE.jpg;10321;10497;36033;516;525;9
/net/per610a/home/mvp/mvp_db/news7-lv/2013/2013_12_15_19_00/2013_12_15_19_00.mpg;Shinzo ABE.jpg;10689;11153;36033;534;558;24
/net/per610a/home/mvp/mvp_db/news7-lv/2013/2013_12_17_19_00/2013_12_17_19_00.mpg;Shinzo ABE.jpg;2145;2729;36033;107;136;29
/net/per610a/home/mvp/mvp_db/news7-lv/2013/2013_12_17_19_00/2013_12_17_19_00.mpg;Shinzo ABE.jpg;3337;3373;36033;166;168;2
/net/per610a/home/mvp/mvp_db/news7-lv/2013/2013_12_17_19_00/2013_12_17_19_00.mpg;Shinzo ABE.jpg;3505;3693;36033;175;184;9
/net/per610a/home/mvp/mvp_db/news7-lv/2013/2013_12_17_19_00/2013_12_17_19_00.mpg;Shinzo ABE.jpg;9969;10237;36033;498;512;14
/net/per610a/home/mvp/mvp_db/news7-lv/2013/2013_12_17_19_00/2013_12_17_19_00.mpg;Shinzo ABE.jpg;11997;12253;36033;600;613;13
/net/per610a/home/mvp/mvp_db/news7-lv/2013/2013_12_17_19_00/2013_12_17_19_00.mpg;Shinzo ABE.jpg;15413;15801;36033;771;790;19
/net/per610a/home/mvp/mvp_db/news7-lv/2013/2013_12_18_19_00/2013_12_18_19_00.mpg;Kenji Eda.jpg;7885;8397;36033;394;420;26
/net/per610a/home/mvp/mvp_db/news7-lv/2013/2013_12_18_19_00/2013_12_18_19_00.mpg;Kenji Eda.jpg;8593;8877;36033;429;444;15
/net/per610a/home/mvp/mvp_db/news7-lv/2013/2013_12_18_19_00/2013_12_18_19_00.mpg;Kenji Eda.jpg;9505;9761;36033;475;488;13
/net/per610a/home/mvp/mvp_db/news7-lv/2013/2013_12_18_19_00/2013_12_18_19_00.mpg;Kenji Eda.jpg;9825;10297;36033;491;515;24
/net/per610a/home/mvp/mvp_db/news7-lv/2013/2013_12_18_19_00/2013_12_18_19_00.mpg;Shintaro ISHIHARA.jpg;13033;13057;36033;652;653;1
/net/per610a/home/mvp/mvp_db/news7-lv/2013/2013_12_18_19_00/2013_12_18_19_00.mpg;Shintaro ISHIHARA.jpg;19193;19697;36033;960;985;25
/net/per610a/home/mvp/mvp_db/news7-lv/2013/2013_12_18_19_00/2013_12_18_19_00.mpg;Bairi Kaieda.jpg;13449;13553;36033;672;678;6
/net/per610a/home/mvp/mvp_db/news7-lv/2013/2013_12_18_19_00/2013_12_18_19_00.mpg;Shinzo ABE.jpg;18493;18597;36033;925;930;5
/net/per610a/home/mvp/mvp_db/news7-lv/2013/2013_12_18_19_00/2013_12_18_19_00.mpg;Shinzo ABE.jpg;18757;19085;36033;938;954;16
/net/per610a/home/mvp/mvp_db/news7-lv/2013/2013_12_19_19_00/2013_12_19_19_00.mpg;Shintaro ISHIHARA.jpg;5361;6033;39629;268;301;33
/net/per610a/home/mvp/mvp_db/news7-lv/2013/2013_12_19_19_00/2013_12_19_19_00.mpg;Shinzo ABE.jpg;13649;13861;39629;682;693;11
/net/per610a/home/mvp/mvp_db/news7-lv/2013/2013_12_19_19_00/2013_12_19_19_00.mpg;Bairi Kaieda.jpg;14129;14253;39629;707;713;6
/net/per610a/home/mvp/mvp_db/news7-lv/2013/2013_12_20_19_00/2013_12_20_19_00.mpg;Taro ASO.jpg;2649;2809;36033;132;140;8
/net/per610a/home/mvp/mvp_db/news7-lv/2013/2013_12_20_19_00/2013_12_20_19_00.mpg;Taro ASO.jpg;2897;2993;36033;144;149;5
/net/per610a/home/mvp/mvp_db/news7-lv/2013/2013_12_20_19_00/2013_12_20_19_00.mpg;Shinzo ABE.jpg;4949;5113;36033;247;255;8
/net/per610a/home/mvp/mvp_db/news7-lv/2013/2013_12_21_19_00/2013_12_21_19_00.mpg;Shinzo ABE.jpg;1061;1641;36033;53;82;29
/net/per610a/home/mvp/mvp_db/news7-lv/2013/2013_12_21_19_00/2013_12_21_19_00.mpg;Shinzo ABE.jpg;3761;3761;36033;188;188;0
/net/per610a/home/mvp/mvp_db/news7-lv/2013/2013_12_21_19_00/2013_12_21_19_00.mpg;Shinzo ABE.jpg;7113;7169;36033;355;358;3
/net/per610a/home/mvp/mvp_db/news7-lv/2013/2013_12_21_19_00/2013_12_21_19_00.mpg;Shinzo ABE.jpg;1705;1773;36033;85;88;3
/net/per610a/home/mvp/mvp_db/news7-lv/2013/2013_12_21_19_00/2013_12_21_19_00.mpg;Shinzo ABE.jpg;1921;1957;36033;96;97;1
/net/per610a/home/mvp/mvp_db/news7-lv/2013/2013_12_21_19_00/2013_12_21_19_00.mpg;Shinzo ABE.jpg;3073;3149;36033;153;157;4
/net/per610a/home/mvp/mvp_db/news7-lv/2013/2013_12_21_19_00/2013_12_21_19_00.mpg;Shinzo ABE.jpg;5853;5873;36033;292;293;1
/net/per610a/home/mvp/mvp_db/news7-lv/2013/2013_12_21_19_00/2013_12_21_19_00.mpg;Natsuo YAMAGUCHI.jpg;4913;5209;36033;245;260;15
/net/per610a/home/mvp/mvp_db/news7-lv/2013/2013_12_22_19_00/2013_12_22_19_00.mpg;Yoshimi WATANABE.jpg;18253;20169;36041;913;1008;95
/net/per610a/home/mvp/mvp_db/news7-lv/2013/2013_12_23_19_00/2013_12_23_19_00.mpg;Shinzo ABE.jpg;1137;1701;36033;56;85;29
/net/per610a/home/mvp/mvp_db/news7-lv/2013/2013_12_24_19_00/2013_12_24_19_00.mpg;Shinzo ABE.jpg;969;1753;36033;48;87;39
/net/per610a/home/mvp/mvp_db/news7-lv/2013/2013_12_24_19_00/2013_12_24_19_00.mpg;Shinzo ABE.jpg;2429;2789;36033;121;139;18
/net/per610a/home/mvp/mvp_db/news7-lv/2013/2013_12_25_19_00/2013_12_25_19_00.mpg;Shinzo ABE.jpg;89;245;36033;4;12;8
/net/per610a/home/mvp/mvp_db/news7-lv/2013/2013_12_25_19_00/2013_12_25_19_00.mpg;Shinzo ABE.jpg;6145;7301;36033;307;365;58
/net/per610a/home/mvp/mvp_db/news7-lv/2013/2013_12_25_19_00/2013_12_25_19_00.mpg;Shinzo ABE.jpg;9229;9741;36033;461;487;26
/net/per610a/home/mvp/mvp_db/news7-lv/2013/2013_12_26_19_00/2013_12_26_19_00.mpg;Shinzo ABE.jpg;1073;1201;39629;53;60;7
/net/per610a/home/mvp/mvp_db/news7-lv/2013/2013_12_26_19_00/2013_12_26_19_00.mpg;Shinzo ABE.jpg;1709;3493;39629;85;174;89
/net/per610a/home/mvp/mvp_db/news7-lv/2013/2013_12_26_19_00/2013_12_26_19_00.mpg;Shinzo ABE.jpg;4781;4853;39629;239;242;3
/net/per610a/home/mvp/mvp_db/news7-lv/2013/2013_12_26_19_00/2013_12_26_19_00.mpg;Shinzo ABE.jpg;6797;8097;39629;340;405;65
/net/per610a/home/mvp/mvp_db/news7-lv/2013/2013_12_26_19_00/2013_12_26_19_00.mpg;Shinzo ABE.jpg;24309;24341;39629;1216;1218;2
/net/per610a/home/mvp/mvp_db/news7-lv/2013/2013_12_26_19_00/2013_12_26_19_00.mpg;Shinzo ABE.jpg;26241;26369;39629;1313;1319;6
/net/per610a/home/mvp/mvp_db/news7-lv/2013/2013_12_26_19_00/2013_12_26_19_00.mpg;Shinzo ABE.jpg;26773;26857;39629;1339;1343;4
/net/per610a/home/mvp/mvp_db/news7-lv/2013/2013_12_26_19_00/2013_12_26_19_00.mpg;Natsuo YAMAGUCHI.jpg;9553;10297;39629;478;515;37
/net/per610a/home/mvp/mvp_db/news7-lv/2013/2013_12_26_19_00/2013_12_26_19_00.mpg;Bairi Kaieda.jpg;10337;13253;39629;517;663;146
/net/per610a/home/mvp/mvp_db/news7-lv/2013/2013_12_27_19_00/2013_12_27_19_00.mpg;Shinzo ABE.jpg;7969;8801;36033;398;440;42
/net/per610a/home/mvp/mvp_db/news7-lv/2013/2013_12_27_19_00/2013_12_27_19_00.mpg;Shinzo ABE.jpg;11549;12357;36033;577;618;41
/net/per610a/home/mvp/mvp_db/news7-lv/2013/2013_12_30_19_00/2013_12_30_19_00.mpg;Shinzo ABE.jpg;4353;4441;36033;217;222;5
/net/per610a/home/mvp/mvp_db/news7-lv/2013/2013_12_30_19_00/2013_12_30_19_00.mpg;Shinzo ABE.jpg;6793;7169;36033;339;358;19
/net/per610a/home/mvp/mvp_db/news7-lv/2013/2013_12_30_19_00/2013_12_30_19_00.mpg;Shinzo ABE.jpg;8857;8925;36033;443;446;3
/net/per610a/home/mvp/mvp_db/news7-lv/2013/2013_12_30_19_00/2013_12_30_19_00.mpg;Shinzo ABE.jpg;9389;9421;36033;469;471;2
/net/per610a/home/mvp/mvp_db/news7-lv/2013/2013_12_30_19_00/2013_12_30_19_00.mpg;Shinzo ABE.jpg;27449;27785;36033;1373;1390;17
/net/per610a/home/mvp/mvp_db/news7-lv/2014/2014_01_01_19_00/2014_01_01_19_00.mpg;Shinzo ABE.jpg;15189;15237;24045;759;762;3
/net/per610a/home/mvp/mvp_db/news7-lv/2014/2014_01_01_19_00/2014_01_01_19_00.mpg;Shinzo ABE.jpg;15321;15561;24045;766;778;12
/net/per610a/home/mvp/mvp_db/news7-lv/2014/2014_01_04_19_00/2014_01_04_19_00.mpg;Shinzo ABE.jpg;20513;20849;36033;1026;1043;17
/net/per610a/home/mvp/mvp_db/news7-lv/2014/2014_01_04_19_00/2014_01_04_19_00.mpg;Shinzo ABE.jpg;20921;22669;36033;1046;1134;88
/net/per610a/home/mvp/mvp_db/news7-lv/2014/2014_01_04_19_00/2014_01_04_19_00.mpg;Shinzo ABE.jpg;22809;23109;36033;1141;1156;15
/net/per610a/home/mvp/mvp_db/news7-lv/2014/2014_01_04_19_00/2014_01_04_19_00.mpg;Kazuo SHII.jpg;23113;24925;36033;1156;1247;91
/net/per610a/home/mvp/mvp_db/news7-lv/2014/2014_01_05_19_00/2014_01_05_19_00.mpg;Shinzo ABE.jpg;28089;28857;36033;1405;1443;38
/net/per610a/home/mvp/mvp_db/news7-lv/2014/2014_01_06_19_00/2014_01_06_19_00.mpg;Shinzo ABE.jpg;417;601;36033;20;30;10
/net/per610a/home/mvp/mvp_db/news7-lv/2014/2014_01_06_19_00/2014_01_06_19_00.mpg;Shinzo ABE.jpg;7613;8053;36033;380;402;22
/net/per610a/home/mvp/mvp_db/news7-lv/2014/2014_01_06_19_00/2014_01_06_19_00.mpg;Shinzo ABE.jpg;8933;9781;36033;446;489;43
/net/per610a/home/mvp/mvp_db/news7-lv/2014/2014_01_06_19_00/2014_01_06_19_00.mpg;Shinzo ABE.jpg;9901;10261;36033;495;513;18
/net/per610a/home/mvp/mvp_db/news7-lv/2014/2014_01_06_19_00/2014_01_06_19_00.mpg;Shinzo ABE.jpg;10797;10933;36033;540;547;7
/net/per610a/home/mvp/mvp_db/news7-lv/2014/2014_01_06_19_00/2014_01_06_19_00.mpg;Bairi Kaieda.jpg;12613;12697;36033;631;635;4
/net/per610a/home/mvp/mvp_db/news7-lv/2014/2014_01_06_19_00/2014_01_06_19_00.mpg;Bairi Kaieda.jpg;12761;13469;36033;638;673;35
/net/per610a/home/mvp/mvp_db/news7-lv/2014/2014_01_07_19_00/2014_01_07_19_00.mpg;Shinzo ABE.jpg;3429;3577;36033;171;178;7
/net/per610a/home/mvp/mvp_db/news7-lv/2014/2014_01_07_19_00/2014_01_07_19_00.mpg;Shinzo ABE.jpg;4077;4325;36033;204;216;12
/net/per610a/home/mvp/mvp_db/news7-lv/2014/2014_01_07_19_00/2014_01_07_19_00.mpg;Shinzo ABE.jpg;6681;6965;36033;334;348;14
/net/per610a/home/mvp/mvp_db/news7-lv/2014/2014_01_07_19_00/2014_01_07_19_00.mpg;Shinzo ABE.jpg;18577;18585;36033;929;929;0
/net/per610a/home/mvp/mvp_db/news7-lv/2014/2014_01_07_19_00/2014_01_07_19_00.mpg;Shinzo ABE.jpg;18669;18669;36033;934;934;0
/net/per610a/home/mvp/mvp_db/news7-lv/2014/2014_01_07_19_00/2014_01_07_19_00.mpg;Shinzo ABE.jpg;18849;18913;36033;943;946;3
/net/per610a/home/mvp/mvp_db/news7-lv/2014/2014_01_07_19_00/2014_01_07_19_00.mpg;Yoshimi WATANABE.jpg;8625;9493;36033;431;475;44
/net/per610a/home/mvp/mvp_db/news7-lv/2014/2014_01_07_19_00/2014_01_07_19_00.mpg;Shintaro ISHIHARA.jpg;22417;22569;36033;1121;1129;8
/net/per610a/home/mvp/mvp_db/news7-lv/2014/2014_01_11_19_00/2014_01_11_19_00.mpg;Shinzo ABE.jpg;797;861;36029;39;43;4
/net/per610a/home/mvp/mvp_db/news7-lv/2014/2014_01_11_19_00/2014_01_11_19_00.mpg;Shinzo ABE.jpg;11101;11317;36029;555;566;11
/net/per610a/home/mvp/mvp_db/news7-lv/2014/2014_01_11_19_00/2014_01_11_19_00.mpg;Shinzo ABE.jpg;12205;12373;36029;610;619;9
/net/per610a/home/mvp/mvp_db/news7-lv/2014/2014_01_11_19_00/2014_01_11_19_00.mpg;Shinzo ABE.jpg;909;1013;36029;45;50;5
/net/per610a/home/mvp/mvp_db/news7-lv/2014/2014_01_11_19_00/2014_01_11_19_00.mpg;Shinzo ABE.jpg;11381;11417;36029;569;571;2
/net/per610a/home/mvp/mvp_db/news7-lv/2014/2014_01_11_19_00/2014_01_11_19_00.mpg;Shinzo ABE.jpg;12033;12057;36029;602;603;1
/net/per610a/home/mvp/mvp_db/news7-lv/2014/2014_01_12_19_00/2014_01_12_19_00.mpg;Shinzo ABE.jpg;21197;21209;36033;1060;1061;1
/net/per610a/home/mvp/mvp_db/news7-lv/2014/2014_01_12_19_00/2014_01_12_19_00.mpg;Shinzo ABE.jpg;21317;21441;36033;1066;1072;6
/net/per610a/home/mvp/mvp_db/news7-lv/2014/2014_01_12_19_00/2014_01_12_19_00.mpg;Shinzo ABE.jpg;21897;22141;36033;1095;1107;12
/net/per610a/home/mvp/mvp_db/news7-lv/2014/2014_01_12_19_00/2014_01_12_19_00.mpg;Shinzo ABE.jpg;22625;22721;36033;1132;1136;4
/net/per610a/home/mvp/mvp_db/news7-lv/2014/2014_01_14_19_00/2014_01_14_19_00.mpg;Bairi Kaieda.jpg;3725;4101;36033;186;205;19
/net/per610a/home/mvp/mvp_db/news7-lv/2014/2014_01_14_19_00/2014_01_14_19_00.mpg;Shinzo ABE.jpg;17905;17925;36033;895;896;1
/net/per610a/home/mvp/mvp_db/news7-lv/2014/2014_01_14_19_00/2014_01_14_19_00.mpg;Shinzo ABE.jpg;21009;21093;36033;1051;1055;4
/net/per610a/home/mvp/mvp_db/news7-lv/2014/2014_01_14_19_00/2014_01_14_19_00.mpg;Shinzo ABE.jpg;21193;21665;36033;1060;1084;24
/net/per610a/home/mvp/mvp_db/news7-lv/2014/2014_01_14_19_00/2014_01_14_19_00.mpg;Shinzo ABE.jpg;19013;19413;36033;951;971;20
/net/per610a/home/mvp/mvp_db/news7-lv/2014/2014_01_14_19_00/2014_01_14_19_00.mpg;Shinzo ABE.jpg;22381;23909;36033;1119;1196;77
/net/per610a/home/mvp/mvp_db/news7-lv/2014/2014_01_15_19_00/2014_01_15_19_00.mpg;Shinzo ABE.jpg;9153;9561;36033;457;478;21
/net/per610a/home/mvp/mvp_db/news7-lv/2014/2014_01_15_19_00/2014_01_15_19_00.mpg;Shinzo ABE.jpg;19693;19877;36033;985;994;9
/net/per610a/home/mvp/mvp_db/news7-lv/2014/2014_01_16_19_00/2014_01_16_19_00.mpg;Shinzo ABE.jpg;7725;7785;36033;386;389;3
/net/per610a/home/mvp/mvp_db/news7-lv/2014/2014_01_16_19_00/2014_01_16_19_00.mpg;Shinzo ABE.jpg;7905;8393;36033;395;419;24
/net/per610a/home/mvp/mvp_db/news7-lv/2014/2014_01_18_19_00/2014_01_18_19_00.mpg;Shinzo ABE.jpg;7153;7349;36041;357;367;10
/net/per610a/home/mvp/mvp_db/news7-lv/2014/2014_01_18_19_00/2014_01_18_19_00.mpg;Shinzo ABE.jpg;7445;7909;36041;372;395;23
/net/per610a/home/mvp/mvp_db/news7-lv/2014/2014_01_18_19_00/2014_01_18_19_00.mpg;Shinzo ABE.jpg;9501;9949;36041;475;497;22
/net/per610a/home/mvp/mvp_db/news7-lv/2014/2014_01_18_19_00/2014_01_18_19_00.mpg;Kenji Eda.jpg;12345;12421;36041;617;621;4
/net/per610a/home/mvp/mvp_db/news7-lv/2014/2014_01_18_19_00/2014_01_18_19_00.mpg;Kenji Eda.jpg;12821;13753;36041;641;688;47
/net/per610a/home/mvp/mvp_db/news7-lv/2014/2014_01_19_19_00/2014_01_19_19_00.mpg;Natsuo YAMAGUCHI.jpg;7669;8093;36033;383;404;21
/net/per610a/home/mvp/mvp_db/news7-lv/2014/2014_01_21_19_00/2014_01_21_19_00.mpg;Shinzo ABE.jpg;23821;24453;36033;1191;1223;32
/net/per610a/home/mvp/mvp_db/news7-lv/2014/2014_01_23_19_00/2014_01_23_19_00.mpg;Kazuo SHII.jpg;2461;2489;38433;123;124;1
/net/per610a/home/mvp/mvp_db/news7-lv/2014/2014_01_23_19_00/2014_01_23_19_00.mpg;Kazuo SHII.jpg;2637;2985;38433;131;149;18
/net/per610a/home/mvp/mvp_db/news7-lv/2014/2014_01_23_19_00/2014_01_23_19_00.mpg;Shintaro ISHIHARA.jpg;4345;4365;38433;217;218;1
/net/per610a/home/mvp/mvp_db/news7-lv/2014/2014_01_23_19_00/2014_01_23_19_00.mpg;Shintaro ISHIHARA.jpg;4449;4745;38433;222;237;15
/net/per610a/home/mvp/mvp_db/news7-lv/2014/2014_01_24_19_00/2014_01_24_19_00.mpg;Shinzo ABE.jpg;5729;5845;36033;286;292;6
/net/per610a/home/mvp/mvp_db/news7-lv/2014/2014_01_24_19_00/2014_01_24_19_00.mpg;Shinzo ABE.jpg;6325;6357;36033;316;318;2
/net/per610a/home/mvp/mvp_db/news7-lv/2014/2014_01_24_19_00/2014_01_24_19_00.mpg;Shinzo ABE.jpg;6461;6525;36033;323;326;3
/net/per610a/home/mvp/mvp_db/news7-lv/2014/2014_01_24_19_00/2014_01_24_19_00.mpg;Shinzo ABE.jpg;9573;9993;36033;479;500;21
/net/per610a/home/mvp/mvp_db/news7-lv/2014/2014_01_24_19_00/2014_01_24_19_00.mpg;Shinzo ABE.jpg;14041;14529;36033;702;726;24
/net/per610a/home/mvp/mvp_db/news7-lv/2014/2014_01_24_19_00/2014_01_24_19_00.mpg;Sadakazu TANIGAKI.jpg;22745;23253;36033;1138;1163;25
/net/per610a/home/mvp/mvp_db/news7-lv/2014/2014_01_25_19_00/2014_01_25_19_00.mpg;Shinzo ABE.jpg;13265;13677;36029;663;684;21
/net/per610a/home/mvp/mvp_db/news7-lv/2014/2014_01_25_19_00/2014_01_25_19_00.mpg;Ichiro OZAWA.jpg;25873;26869;36029;1294;1344;50
/net/per610a/home/mvp/mvp_db/news7-lv/2014/2014_01_26_19_00/2014_01_26_19_00.mpg;Shinzo ABE.jpg;9977;11041;36033;499;552;53
/net/per610a/home/mvp/mvp_db/news7-lv/2014/2014_01_28_19_00/2014_01_28_19_00.mpg;Shinzo ABE.jpg;929;1489;36033;46;74;28
/net/per610a/home/mvp/mvp_db/news7-lv/2014/2014_01_28_19_00/2014_01_28_19_00.mpg;Shinzo ABE.jpg;1517;1565;36033;75;78;3
/net/per610a/home/mvp/mvp_db/news7-lv/2014/2014_01_28_19_00/2014_01_28_19_00.mpg;Shinzo ABE.jpg;2917;3145;36033;145;157;12
/net/per610a/home/mvp/mvp_db/news7-lv/2014/2014_01_28_19_00/2014_01_28_19_00.mpg;Yorihisa Matsuno.png;5745;6053;36033;287;302;15
/net/per610a/home/mvp/mvp_db/news7-lv/2014/2014_01_29_19_00/2014_01_29_19_00.mpg;Shinzo ABE.jpg;785;1217;36029;39;60;21
/net/per610a/home/mvp/mvp_db/news7-lv/2014/2014_01_29_19_00/2014_01_29_19_00.mpg;Shinzo ABE.jpg;5865;6353;36029;293;317;24
/net/per610a/home/mvp/mvp_db/news7-lv/2014/2014_01_29_19_00/2014_01_29_19_00.mpg;Shinzo ABE.jpg;6825;7149;36029;341;357;16
/net/per610a/home/mvp/mvp_db/news7-lv/2014/2014_01_29_19_00/2014_01_29_19_00.mpg;Yoshimi WATANABE.jpg;3205;5841;36029;160;292;132
/net/per610a/home/mvp/mvp_db/news7-lv/2014/2014_01_29_19_00/2014_01_29_19_00.mpg;Ichiro OZAWA.jpg;7469;7601;36029;373;380;7
/net/per610a/home/mvp/mvp_db/news7-lv/2014/2014_01_30_19_00/2014_01_30_19_00.mpg;Shinzo ABE.jpg;20709;21141;36033;1036;1057;21
/net/per610a/home/mvp/mvp_db/news7-lv/2014/2014_01_31_19_00/2014_01_31_19_00.mpg;Taro ASO.jpg;4929;5285;36033;246;264;18
/net/per610a/home/mvp/mvp_db/news7-lv/2014/2014_01_31_19_00/2014_01_31_19_00.mpg;Shinzo ABE.jpg;16345;16725;36033;817;836;19
/net/per610a/home/mvp/mvp_db/news7-lv/2014/2014_01_31_19_00/2014_01_31_19_00.mpg;Shinzo ABE.jpg;17065;17105;36033;853;855;2
/net/per610a/home/mvp/mvp_db/news7-lv/2014/2014_01_31_19_00/2014_01_31_19_00.mpg;Shinzo ABE.jpg;17925;18617;36033;896;931;35
/net/per610a/home/mvp/mvp_db/news7-lv/2014/2014_01_31_19_00/2014_01_31_19_00.mpg;Kazuo SHII.jpg;30937;31201;36033;1548;1561;13
/net/per610a/home/mvp/mvp_db/news7-lv/2014/2014_02_01_19_00/2014_02_01_19_00.mpg;Toru Hashimoto.jpg;1345;1681;36041;67;84;17
/net/per610a/home/mvp/mvp_db/news7-lv/2014/2014_02_01_19_00/2014_02_01_19_00.mpg;Toru Hashimoto.jpg;1777;2553;36041;88;127;39
/net/per610a/home/mvp/mvp_db/news7-lv/2014/2014_02_01_19_00/2014_02_01_19_00.mpg;Toru Hashimoto.jpg;2661;3381;36041;133;169;36
/net/per610a/home/mvp/mvp_db/news7-lv/2014/2014_02_01_19_00/2014_02_01_19_00.mpg;Toru Hashimoto.jpg;5969;6429;36041;298;321;23
/net/per610a/home/mvp/mvp_db/news7-lv/2014/2014_02_01_19_00/2014_02_01_19_00.mpg;Toru Hashimoto.jpg;7353;7745;36041;367;387;20
/net/per610a/home/mvp/mvp_db/news7-lv/2014/2014_02_01_19_00/2014_02_01_19_00.mpg;Shintaro ISHIHARA.jpg;7353;7745;36041;367;387;20
/net/per610a/home/mvp/mvp_db/news7-lv/2014/2014_02_03_19_00/2014_02_03_19_00.mpg;Shinzo ABE.jpg;25853;26269;36033;1293;1314;21
/net/per610a/home/mvp/mvp_db/news7-lv/2014/2014_02_03_19_00/2014_02_03_19_00.mpg;Shinzo ABE.jpg;28081;28557;36033;1405;1428;23
/net/per610a/home/mvp/mvp_db/news7-lv/2014/2014_02_03_19_00/2014_02_03_19_00.mpg;Shinzo ABE.jpg;28809;29413;36033;1441;1471;30
/net/per610a/home/mvp/mvp_db/news7-lv/2014/2014_02_04_19_00/2014_02_04_19_00.mpg;Shinzo ABE.jpg;17473;17581;36033;874;879;5
/net/per610a/home/mvp/mvp_db/news7-lv/2014/2014_02_06_19_00/2014_02_06_19_00.mpg;Shinzo ABE.jpg;16205;16369;36033;810;819;9
/net/per610a/home/mvp/mvp_db/news7-lv/2014/2014_02_06_19_00/2014_02_06_19_00.mpg;Shinzo ABE.jpg;31017;31697;36033;1552;1586;34
/net/per610a/home/mvp/mvp_db/news7-lv/2014/2014_02_06_19_00/2014_02_06_19_00.mpg;Shinzo ABE.jpg;17721;17825;36033;886;891;5
/net/per610a/home/mvp/mvp_db/news7-lv/2014/2014_02_06_19_00/2014_02_06_19_00.mpg;Shinzo ABE.jpg;18129;18233;36033;907;912;5
/net/per610a/home/mvp/mvp_db/news7-lv/2014/2014_02_06_19_00/2014_02_06_19_00.mpg;Shinzo ABE.jpg;27405;27569;36033;1371;1379;8
/net/per610a/home/mvp/mvp_db/news7-lv/2014/2014_02_06_19_00/2014_02_06_19_00.mpg;Shinzo ABE.jpg;28317;28413;36033;1416;1421;5
/net/per610a/home/mvp/mvp_db/news7-lv/2014/2014_02_06_19_00/2014_02_06_19_00.mpg;Shinzo ABE.jpg;29077;29105;36033;1454;1456;2
/net/per610a/home/mvp/mvp_db/news7-lv/2014/2014_02_06_19_00/2014_02_06_19_00.mpg;Shinzo ABE.jpg;29185;29385;36033;1460;1470;10
/net/per610a/home/mvp/mvp_db/news7-lv/2014/2014_02_07_19_00/2014_02_07_19_00.mpg;Shinzo ABE.jpg;24029;24565;36029;1202;1229;27
/net/per610a/home/mvp/mvp_db/news7-lv/2014/2014_02_07_19_00/2014_02_07_19_00.mpg;Shinzo ABE.jpg;27549;28009;36029;1378;1401;23
/net/per610a/home/mvp/mvp_db/news7-lv/2014/2014_02_08_19_00/2014_02_08_19_00.mpg;Shinzo ABE.jpg;31469;32025;48021;1574;1602;28
/net/per610a/home/mvp/mvp_db/news7-lv/2014/2014_02_08_19_00/2014_02_08_19_00.mpg;Shinzo ABE.jpg;32489;32497;48021;1625;1626;1
/net/per610a/home/mvp/mvp_db/news7-lv/2014/2014_02_08_19_00/2014_02_08_19_00.mpg;Toru Hashimoto.jpg;38873;39169;48021;1945;1960;15
/net/per610a/home/mvp/mvp_db/news7-lv/2014/2014_02_08_19_00/2014_02_08_19_00.mpg;Toru Hashimoto.jpg;40273;41261;48021;2015;2064;49
/net/per610a/home/mvp/mvp_db/news7-lv/2014/2014_02_10_19_00/2014_02_10_19_00.mpg;Junichiro KOIZUMI.jpg;16049;16381;36033;803;819;16
/net/per610a/home/mvp/mvp_db/news7-lv/2014/2014_02_10_19_00/2014_02_10_19_00.mpg;Shinzo ABE.jpg;16393;16909;36033;820;846;26
/net/per610a/home/mvp/mvp_db/news7-lv/2014/2014_02_10_19_00/2014_02_10_19_00.mpg;Shinzo ABE.jpg;22901;23265;36033;1145;1164;19
/net/per610a/home/mvp/mvp_db/news7-lv/2014/2014_02_10_19_00/2014_02_10_19_00.mpg;Shinzo ABE.jpg;18313;18473;36033;916;924;8
/net/per610a/home/mvp/mvp_db/news7-lv/2014/2014_02_10_19_00/2014_02_10_19_00.mpg;Shinzo ABE.jpg;19045;19129;36033;952;957;5
/net/per610a/home/mvp/mvp_db/news7-lv/2014/2014_02_10_19_00/2014_02_10_19_00.mpg;Shinzo ABE.jpg;21985;22009;36033;1100;1101;1
/net/per610a/home/mvp/mvp_db/news7-lv/2014/2014_02_10_19_00/2014_02_10_19_00.mpg;Toru Hashimoto.jpg;24369;24937;36033;1219;1247;28
/net/per610a/home/mvp/mvp_db/news7-lv/2014/2014_02_14_19_00/2014_02_14_19_00.mpg;Toru Hashimoto.jpg;30213;30217;36033;1511;1511;0
/net/per610a/home/mvp/mvp_db/news7-lv/2014/2014_02_14_19_00/2014_02_14_19_00.mpg;Toru Hashimoto.jpg;31657;32153;36033;1584;1608;24
/net/per610a/home/mvp/mvp_db/news7-lv/2014/2014_02_16_19_00/2014_02_16_19_00.mpg;Nariaki Nakayama.png;18369;18565;36033;919;928;9
/net/per610a/home/mvp/mvp_db/news7-lv/2014/2014_02_19_19_00/2014_02_19_19_00.mpg;Shinzo ABE.jpg;27669;27813;36033;1384;1391;7
/net/per610a/home/mvp/mvp_db/news7-lv/2014/2014_02_23_19_00/2014_02_23_19_00.mpg;Yoshimi WATANABE.jpg;28029;28785;36033;1402;1440;38
/net/per610a/home/mvp/mvp_db/news7-lv/2014/2014_02_23_19_00/2014_02_23_19_00.mpg;Yoshimi WATANABE.jpg;29393;29805;36033;1470;1491;21
/net/per610a/home/mvp/mvp_db/news7-lv/2014/2014_02_23_19_00/2014_02_23_19_00.mpg;Yoshimi WATANABE.jpg;29877;29941;36033;1494;1498;4
/net/per610a/home/mvp/mvp_db/news7-lv/2014/2014_02_23_19_00/2014_02_23_19_00.mpg;Yoshimi WATANABE.jpg;30729;30865;36033;1537;1544;7
/net/per610a/home/mvp/mvp_db/news7-lv/2014/2014_02_25_19_00/2014_02_25_19_00.mpg;Shinzo ABE.jpg;7321;7793;36033;366;389;23
/net/per610a/home/mvp/mvp_db/news7-lv/2014/2014_02_25_19_00/2014_02_25_19_00.mpg;Shinzo ABE.jpg;12849;12941;36033;642;647;5
/net/per610a/home/mvp/mvp_db/news7-lv/2014/2014_02_25_19_00/2014_02_25_19_00.mpg;Shinzo ABE.jpg;21897;22277;36033;1095;1114;19
/net/per610a/home/mvp/mvp_db/news7-lv/2014/2014_02_25_19_00/2014_02_25_19_00.mpg;Shinzo ABE.jpg;22765;23085;36033;1139;1155;16
/net/per610a/home/mvp/mvp_db/news7-lv/2014/2014_02_25_19_00/2014_02_25_19_00.mpg;Shinzo ABE.jpg;23817;24281;36033;1191;1214;23
/net/per610a/home/mvp/mvp_db/news7-lv/2014/2014_02_25_19_00/2014_02_25_19_00.mpg;Shinzo ABE.jpg;25037;25081;36033;1252;1254;2
/net/per610a/home/mvp/mvp_db/news7-lv/2014/2014_02_25_19_00/2014_02_25_19_00.mpg;Shinzo ABE.jpg;26905;27037;36033;1346;1352;6
/net/per610a/home/mvp/mvp_db/news7-lv/2014/2014_02_25_19_00/2014_02_25_19_00.mpg;Natsuo YAMAGUCHI.jpg;21897;22277;36033;1095;1114;19
/net/per610a/home/mvp/mvp_db/news7-lv/2014/2014_02_25_19_00/2014_02_25_19_00.mpg;Natsuo YAMAGUCHI.jpg;22765;23085;36033;1139;1155;16
/net/per610a/home/mvp/mvp_db/news7-lv/2014/2014_02_27_19_00/2014_02_27_19_00.mpg;Ichiro OZAWA.jpg;1133;1177;36033;56;58;2
/net/per610a/home/mvp/mvp_db/news7-lv/2014/2014_02_27_19_00/2014_02_27_19_00.mpg;Ichiro OZAWA.jpg;1369;1593;36033;68;79;11
/net/per610a/home/mvp/mvp_db/news7-lv/2014/2014_02_27_19_00/2014_02_27_19_00.mpg;Ichiro OZAWA.jpg;2265;2361;36033;113;118;5
/net/per610a/home/mvp/mvp_db/news7-lv/2014/2014_02_27_19_00/2014_02_27_19_00.mpg;Shinzo ABE.jpg;2673;3681;36033;133;184;51
/net/per610a/home/mvp/mvp_db/news7-lv/2014/2014_02_27_19_00/2014_02_27_19_00.mpg;Katsuya OKADA.jpg;4121;4633;36033;206;231;25
/net/per610a/home/mvp/mvp_db/news7-lv/2014/2014_02_27_19_00/2014_02_27_19_00.mpg;Katsuya OKADA.jpg;4757;4973;36033;238;248;10
/net/per610a/home/mvp/mvp_db/news7-lv/2014/2014_02_27_19_00/2014_02_27_19_00.mpg;Katsuya OKADA.jpg;5281;5341;36033;264;267;3
/net/per610a/home/mvp/mvp_db/news7-lv/2014/2014_02_27_19_00/2014_02_27_19_00.mpg;Katsuya OKADA.jpg;5521;5589;36033;276;279;3
/net/per610a/home/mvp/mvp_db/news7-lv/2014/2014_02_27_19_00/2014_02_27_19_00.mpg;Katsuya OKADA.jpg;5729;5941;36033;286;297;11
/net/per610a/home/mvp/mvp_db/news7-lv/2014/2014_02_27_19_00/2014_02_27_19_00.mpg;Natsuo YAMAGUCHI.jpg;28609;28661;36033;1431;1434;3
/net/per610a/home/mvp/mvp_db/news7-lv/2014/2014_02_27_19_00/2014_02_27_19_00.mpg;Natsuo YAMAGUCHI.jpg;29241;29569;36033;1463;1479;16
/net/per610a/home/mvp/mvp_db/news7-lv/2014/2014_02_28_19_00/2014_02_28_19_00.mpg;Shinzo ABE.jpg;7445;8165;36033;372;408;36
/net/per610a/home/mvp/mvp_db/news7-lv/2014/2014_02_28_19_00/2014_02_28_19_00.mpg;Shinzo ABE.jpg;14289;14389;36033;714;719;5
/net/per610a/home/mvp/mvp_db/news7-lv/2014/2014_02_28_19_00/2014_02_28_19_00.mpg;Shinzo ABE.jpg;12853;13029;36033;643;651;8
/net/per610a/home/mvp/mvp_db/news7-lv/2014/2014_02_28_19_00/2014_02_28_19_00.mpg;Shinzo ABE.jpg;13489;13553;36033;674;678;4
/net/per610a/home/mvp/mvp_db/news7-lv/2014/2014_03_03_19_00/2014_03_03_19_00.mpg;Shinzo ABE.jpg;13045;13141;36033;652;657;5
/net/per610a/home/mvp/mvp_db/news7-lv/2014/2014_03_03_19_00/2014_03_03_19_00.mpg;Shinzo ABE.jpg;26713;26881;36033;1336;1345;9
/net/per610a/home/mvp/mvp_db/news7-lv/2014/2014_03_03_19_00/2014_03_03_19_00.mpg;Shinzo ABE.jpg;13421;13825;36033;671;691;20
/net/per610a/home/mvp/mvp_db/news7-lv/2014/2014_03_03_19_00/2014_03_03_19_00.mpg;Shinzo ABE.jpg;26189;26657;36033;1310;1333;23
/net/per610a/home/mvp/mvp_db/news7-lv/2014/2014_03_03_19_00/2014_03_03_19_00.mpg;Shinzo ABE.jpg;26997;27705;36033;1350;1386;36
/net/per610a/home/mvp/mvp_db/news7-lv/2014/2014_03_04_19_00/2014_03_04_19_00.mpg;Shinzo ABE.jpg;25621;26109;36033;1282;1306;24
/net/per610a/home/mvp/mvp_db/news7-lv/2014/2014_03_04_19_00/2014_03_04_19_00.mpg;Shinzo ABE.jpg;26293;26337;36033;1315;1317;2
/net/per610a/home/mvp/mvp_db/news7-lv/2014/2014_03_04_19_00/2014_03_04_19_00.mpg;Shinzo ABE.jpg;27273;27729;36033;1364;1387;23
/net/per610a/home/mvp/mvp_db/news7-lv/2014/2014_03_04_19_00/2014_03_04_19_00.mpg;Shinzo ABE.jpg;28089;28453;36033;1405;1423;18
/net/per610a/home/mvp/mvp_db/news7-lv/2014/2014_03_06_19_00/2014_03_06_19_00.mpg;Shinzo ABE.jpg;22961;23121;36033;1148;1156;8
/net/per610a/home/mvp/mvp_db/news7-lv/2014/2014_03_06_19_00/2014_03_06_19_00.mpg;Shinzo ABE.jpg;23709;24117;36033;1186;1206;20
/net/per610a/home/mvp/mvp_db/news7-lv/2014/2014_03_07_19_00/2014_03_07_19_00.mpg;Shinzo ABE.jpg;16057;16717;36029;803;836;33
/net/per610a/home/mvp/mvp_db/news7-lv/2014/2014_03_08_19_00/2014_03_08_19_00.mpg;Shinzo ABE.jpg;17229;17393;36029;862;870;8
/net/per610a/home/mvp/mvp_db/news7-lv/2014/2014_03_08_19_00/2014_03_08_19_00.mpg;Shinzo ABE.jpg;19465;19501;36029;974;975;1
/net/per610a/home/mvp/mvp_db/news7-lv/2014/2014_03_08_19_00/2014_03_08_19_00.mpg;Shinzo ABE.jpg;19569;19769;36029;979;989;10
/net/per610a/home/mvp/mvp_db/news7-lv/2014/2014_03_08_19_00/2014_03_08_19_00.mpg;Shinzo ABE.jpg;20845;21249;36029;1043;1063;20
/net/per610a/home/mvp/mvp_db/news7-lv/2014/2014_03_09_19_00/2014_03_09_19_00.mpg;Nariaki Nakayama.png;12613;12917;36029;631;646;15
/net/per610a/home/mvp/mvp_db/news7-lv/2014/2014_03_09_19_00/2014_03_09_19_00.mpg;Toru Hashimoto.jpg;22805;22997;36029;1141;1150;9
/net/per610a/home/mvp/mvp_db/news7-lv/2014/2014_03_10_19_00/2014_03_10_19_00.mpg;Shinzo ABE.jpg;2589;3445;36033;129;172;43
/net/per610a/home/mvp/mvp_db/news7-lv/2014/2014_03_10_19_00/2014_03_10_19_00.mpg;Shinzo ABE.jpg;26497;26557;36033;1325;1328;3
/net/per610a/home/mvp/mvp_db/news7-lv/2014/2014_03_10_19_00/2014_03_10_19_00.mpg;Shinzo ABE.jpg;29085;29265;36033;1455;1464;9
/net/per610a/home/mvp/mvp_db/news7-lv/2014/2014_03_12_19_00/2014_03_12_19_00.mpg;Yoshihiko Noda.jpg;12517;12609;36029;626;630;4
/net/per610a/home/mvp/mvp_db/news7-lv/2014/2014_03_12_19_00/2014_03_12_19_00.mpg;Yoshihiko Noda.jpg;12681;12777;36029;634;639;5
/net/per610a/home/mvp/mvp_db/news7-lv/2014/2014_03_13_19_00/2014_03_13_19_00.mpg;Shinzo ABE.jpg;29141;29997;36033;1458;1500;42
/net/per610a/home/mvp/mvp_db/news7-lv/2014/2014_03_15_19_00/2014_03_15_19_00.mpg;Shinzo ABE.jpg;18541;18869;36033;927;944;17
/net/per610a/home/mvp/mvp_db/news7-lv/2014/2014_03_17_19_00/2014_03_17_19_00.mpg;Shinzo ABE.jpg;19049;19145;36033;953;957;4
/net/per610a/home/mvp/mvp_db/news7-lv/2014/2014_03_17_19_00/2014_03_17_19_00.mpg;Shinzo ABE.jpg;26889;26949;36033;1345;1348;3
/net/per610a/home/mvp/mvp_db/news7-lv/2014/2014_03_18_19_00/2014_03_18_19_00.mpg;Natsuo YAMAGUCHI.jpg;5197;5417;36033;260;271;11
/net/per610a/home/mvp/mvp_db/news7-lv/2014/2014_03_20_19_00/2014_03_20_19_00.mpg;Shinzo ABE.jpg;905;1013;36033;45;50;5
/net/per610a/home/mvp/mvp_db/news7-lv/2014/2014_03_20_19_00/2014_03_20_19_00.mpg;Shinzo ABE.jpg;1225;1225;36033;61;61;0
/net/per610a/home/mvp/mvp_db/news7-lv/2014/2014_03_20_19_00/2014_03_20_19_00.mpg;Shinzo ABE.jpg;1353;1409;36033;67;70;3
/net/per610a/home/mvp/mvp_db/news7-lv/2014/2014_03_20_19_00/2014_03_20_19_00.mpg;Shinzo ABE.jpg;2077;2085;36033;103;104;1
/net/per610a/home/mvp/mvp_db/news7-lv/2014/2014_03_20_19_00/2014_03_20_19_00.mpg;Shinzo ABE.jpg;3221;3301;36033;161;165;4
/net/per610a/home/mvp/mvp_db/news7-lv/2014/2014_03_20_19_00/2014_03_20_19_00.mpg;Shinzo ABE.jpg;3477;3573;36033;173;178;5
/net/per610a/home/mvp/mvp_db/news7-lv/2014/2014_03_20_19_00/2014_03_20_19_00.mpg;Shinzo ABE.jpg;7825;8137;36033;391;407;16
/net/per610a/home/mvp/mvp_db/news7-lv/2014/2014_03_20_19_00/2014_03_20_19_00.mpg;Shinzo ABE.jpg;8437;8477;36033;422;424;2
/net/per610a/home/mvp/mvp_db/news7-lv/2014/2014_03_20_19_00/2014_03_20_19_00.mpg;Shinzo ABE.jpg;9345;9517;36033;467;476;9
/net/per610a/home/mvp/mvp_db/news7-lv/2014/2014_03_20_19_00/2014_03_20_19_00.mpg;Shinzo ABE.jpg;9921;9973;36033;496;499;3
/net/per610a/home/mvp/mvp_db/news7-lv/2014/2014_03_20_19_00/2014_03_20_19_00.mpg;Shinzo ABE.jpg;10893;11009;36033;545;550;5
/net/per610a/home/mvp/mvp_db/news7-lv/2014/2014_03_20_19_00/2014_03_20_19_00.mpg;Shinzo ABE.jpg;23749;24413;36033;1188;1221;33
/net/per610a/home/mvp/mvp_db/news7-lv/2014/2014_03_21_19_00/2014_03_21_19_00.mpg;Shinzo ABE.jpg;1241;1449;36033;62;72;10
/net/per610a/home/mvp/mvp_db/news7-lv/2014/2014_03_21_19_00/2014_03_21_19_00.mpg;Shinzo ABE.jpg;1561;1657;36033;78;82;4
/net/per610a/home/mvp/mvp_db/news7-lv/2014/2014_03_21_19_00/2014_03_21_19_00.mpg;Shinzo ABE.jpg;3949;4117;36033;197;206;9
/net/per610a/home/mvp/mvp_db/news7-lv/2014/2014_03_21_19_00/2014_03_21_19_00.mpg;Shinzo ABE.jpg;26053;26493;36033;1303;1325;22
/net/per610a/home/mvp/mvp_db/news7-lv/2014/2014_03_21_19_00/2014_03_21_19_00.mpg;Shinzo ABE.jpg;26793;27173;36033;1340;1359;19
/net/per610a/home/mvp/mvp_db/news7-lv/2014/2014_03_24_19_00/2014_03_24_19_00.mpg;Toru Hashimoto.jpg;21273;21649;36033;1064;1083;19
/net/per610a/home/mvp/mvp_db/news7-lv/2014/2014_03_24_19_00/2014_03_24_19_00.mpg;Toru Hashimoto.jpg;22233;23077;36033;1112;1154;42
/net/per610a/home/mvp/mvp_db/news7-lv/2014/2014_03_24_19_00/2014_03_24_19_00.mpg;Toru Hashimoto.jpg;23769;23977;36033;1189;1199;10
/net/per610a/home/mvp/mvp_db/news7-lv/2014/2014_03_25_19_00/2014_03_25_19_00.mpg;Shinzo ABE.jpg;21589;22029;36041;1080;1102;22
/net/per610a/home/mvp/mvp_db/news7-lv/2014/2014_03_25_19_00/2014_03_25_19_00.mpg;Natsuo YAMAGUCHI.jpg;23813;24377;36041;1191;1219;28
/net/per610a/home/mvp/mvp_db/news7-lv/2014/2014_03_26_19_00/2014_03_26_19_00.mpg;Shinzo ABE.jpg;89;189;36029;4;9;5
/net/per610a/home/mvp/mvp_db/news7-lv/2014/2014_03_26_19_00/2014_03_26_19_00.mpg;Shinzo ABE.jpg;1361;1393;36029;68;69;1
/net/per610a/home/mvp/mvp_db/news7-lv/2014/2014_03_26_19_00/2014_03_26_19_00.mpg;Shinzo ABE.jpg;2289;2789;36029;114;139;25
/net/per610a/home/mvp/mvp_db/news7-lv/2014/2014_03_27_19_00/2014_03_27_19_00.mpg;Yoshimi WATANABE.jpg;17973;18517;40825;899;926;27
/net/per610a/home/mvp/mvp_db/news7-lv/2014/2014_03_27_19_00/2014_03_27_19_00.mpg;Yoshimi WATANABE.jpg;19061;21585;40825;953;1080;127
/net/per610a/home/mvp/mvp_db/news7-lv/2014/2014_03_27_19_00/2014_03_27_19_00.mpg;Yoshimi WATANABE.jpg;22109;22289;40825;1106;1115;9
/net/per610a/home/mvp/mvp_db/news7-lv/2014/2014_03_27_19_00/2014_03_27_19_00.mpg;Keiichiro Asao.jpg;22345;22725;40825;1118;1137;19
/net/per610a/home/mvp/mvp_db/news7-lv/2014/2014_03_31_19_00/2014_03_31_19_00.mpg;Shinzo ABE.jpg;10761;10833;37233;538;542;4
/net/per610a/home/mvp/mvp_db/news7-lv/2014/2014_03_31_19_00/2014_03_31_19_00.mpg;Shinzo ABE.jpg;11001;11061;37233;550;553;3
/net/per610a/home/mvp/mvp_db/news7-lv/2014/2014_03_31_19_00/2014_03_31_19_00.mpg;Shinzo ABE.jpg;12921;13381;37233;646;669;23
/net/per610a/home/mvp/mvp_db/news7-lv/2014/2014_04_01_19_00/2014_04_01_19_00.mpg;Shinzo ABE.jpg;11113;11797;36033;556;590;34
/net/per610a/home/mvp/mvp_db/news7-lv/2014/2014_04_01_19_00/2014_04_01_19_00.mpg;Shinzo ABE.jpg;19125;19389;36033;956;970;14
/net/per610a/home/mvp/mvp_db/news7-lv/2014/2014_04_01_19_00/2014_04_01_19_00.mpg;Shinzo ABE.jpg;20121;20209;36033;1006;1011;5
/net/per610a/home/mvp/mvp_db/news7-lv/2014/2014_04_01_19_00/2014_04_01_19_00.mpg;Shinzo ABE.jpg;28697;28985;36033;1435;1450;15
/net/per610a/home/mvp/mvp_db/news7-lv/2014/2014_04_01_19_00/2014_04_01_19_00.mpg;Taro ASO.jpg;18845;19097;36033;942;955;13
/net/per610a/home/mvp/mvp_db/news7-lv/2014/2014_04_01_19_00/2014_04_01_19_00.mpg;Taro ASO.jpg;20237;20589;36033;1012;1030;18
/net/per610a/home/mvp/mvp_db/news7-lv/2014/2014_04_03_19_00/2014_04_03_19_00.mpg;Natsuo YAMAGUCHI.jpg;829;841;36033;41;42;1
/net/per610a/home/mvp/mvp_db/news7-lv/2014/2014_04_03_19_00/2014_04_03_19_00.mpg;Natsuo YAMAGUCHI.jpg;2137;3641;36033;106;182;76
/net/per610a/home/mvp/mvp_db/news7-lv/2014/2014_04_06_19_00/2014_04_06_19_00.mpg;Shinzo ABE.jpg;14233;14753;36033;712;738;26
/net/per610a/home/mvp/mvp_db/news7-lv/2014/2014_04_07_19_00/2014_04_07_19_00.mpg;Keiichiro Asao.jpg;5589;7745;38441;279;387;108
/net/per610a/home/mvp/mvp_db/news7-lv/2014/2014_04_07_19_00/2014_04_07_19_00.mpg;Keiichiro Asao.jpg;10677;10897;38441;534;545;11
/net/per610a/home/mvp/mvp_db/news7-lv/2014/2014_04_07_19_00/2014_04_07_19_00.mpg;Shinzo ABE.jpg;21001;21065;38441;1050;1053;3
/net/per610a/home/mvp/mvp_db/news7-lv/2014/2014_04_07_19_00/2014_04_07_19_00.mpg;Shinzo ABE.jpg;21181;21725;38441;1059;1086;27
/net/per610a/home/mvp/mvp_db/news7-lv/2014/2014_04_07_19_00/2014_04_07_19_00.mpg;Shinzo ABE.jpg;21845;21897;38441;1092;1095;3
/net/per610a/home/mvp/mvp_db/news7-lv/2014/2014_04_07_19_00/2014_04_07_19_00.mpg;Shinzo ABE.jpg;22597;22717;38441;1130;1136;6
/net/per610a/home/mvp/mvp_db/news7-lv/2014/2014_04_07_19_00/2014_04_07_19_00.mpg;Shinzo ABE.jpg;23029;24173;38441;1152;1209;57
/net/per610a/home/mvp/mvp_db/news7-lv/2014/2014_04_08_19_00/2014_04_08_19_00.mpg;Shinzo ABE.jpg;22625;22717;36033;1132;1136;4
/net/per610a/home/mvp/mvp_db/news7-lv/2014/2014_04_09_19_00/2014_04_09_19_00.mpg;Keiichiro Asao.jpg;27885;28501;36033;1395;1426;31
/net/per610a/home/mvp/mvp_db/news7-lv/2014/2014_04_10_19_00/2014_04_10_19_00.mpg;Shinzo ABE.jpg;5857;6037;36033;293;302;9
/net/per610a/home/mvp/mvp_db/news7-lv/2014/2014_04_10_19_00/2014_04_10_19_00.mpg;Shinzo ABE.jpg;9265;9681;36033;463;484;21
/net/per610a/home/mvp/mvp_db/news7-lv/2014/2014_04_10_19_00/2014_04_10_19_00.mpg;Shinzo ABE.jpg;9921;10289;36033;496;514;18
/net/per610a/home/mvp/mvp_db/news7-lv/2014/2014_04_11_19_00/2014_04_11_19_00.mpg;Shinzo ABE.jpg;19017;19057;36033;951;953;2
/net/per610a/home/mvp/mvp_db/news7-lv/2014/2014_04_11_19_00/2014_04_11_19_00.mpg;Shinzo ABE.jpg;26837;27269;36033;1342;1364;22
/net/per610a/home/mvp/mvp_db/news7-lv/2014/2014_04_11_19_00/2014_04_11_19_00.mpg;Akihiro OHTA.jpg;22477;22673;36033;1124;1134;10
/net/per610a/home/mvp/mvp_db/news7-lv/2014/2014_04_12_19_00/2014_04_12_19_00.mpg;Shinzo ABE.jpg;809;817;36029;40;40;0
/net/per610a/home/mvp/mvp_db/news7-lv/2014/2014_04_12_19_00/2014_04_12_19_00.mpg;Shinzo ABE.jpg;10525;10525;36029;526;526;0
/net/per610a/home/mvp/mvp_db/news7-lv/2014/2014_04_12_19_00/2014_04_12_19_00.mpg;Shinzo ABE.jpg;10637;10789;36029;532;539;7
/net/per610a/home/mvp/mvp_db/news7-lv/2014/2014_04_12_19_00/2014_04_12_19_00.mpg;Shinzo ABE.jpg;12013;12049;36029;601;602;1
/net/per610a/home/mvp/mvp_db/news7-lv/2014/2014_04_12_19_00/2014_04_12_19_00.mpg;Shinzo ABE.jpg;12149;12181;36029;607;609;2
/net/per610a/home/mvp/mvp_db/news7-lv/2014/2014_04_12_19_00/2014_04_12_19_00.mpg;Shinzo ABE.jpg;12365;12425;36029;618;621;3
/net/per610a/home/mvp/mvp_db/news7-lv/2014/2014_04_13_19_00/2014_04_13_19_00.mpg;Shinzo ABE.jpg;9877;10309;36033;494;515;21
/net/per610a/home/mvp/mvp_db/news7-lv/2014/2014_04_14_19_00/2014_04_14_19_00.mpg;Shinzo ABE.jpg;10957;11137;36041;548;557;9
/net/per610a/home/mvp/mvp_db/news7-lv/2014/2014_04_14_19_00/2014_04_14_19_00.mpg;Shinzo ABE.jpg;21193;21737;36041;1060;1087;27
/net/per610a/home/mvp/mvp_db/news7-lv/2014/2014_04_14_19_00/2014_04_14_19_00.mpg;Shinzo ABE.jpg;22377;22433;36041;1119;1122;3
/net/per610a/home/mvp/mvp_db/news7-lv/2014/2014_04_14_19_00/2014_04_14_19_00.mpg;Shinzo ABE.jpg;24777;25157;36041;1239;1258;19
/net/per610a/home/mvp/mvp_db/news7-lv/2014/2014_04_14_19_00/2014_04_14_19_00.mpg;Bairi Kaieda.jpg;13473;13897;36041;674;695;21
/net/per610a/home/mvp/mvp_db/news7-lv/2014/2014_04_18_19_00/2014_04_18_19_00.mpg;Akihiro OHTA.jpg;10533;11133;36033;527;557;30
/net/per610a/home/mvp/mvp_db/news7-lv/2014/2014_04_21_19_00/2014_04_21_19_00.mpg;Shinzo ABE.jpg;757;1205;36033;37;60;23
/net/per610a/home/mvp/mvp_db/news7-lv/2014/2014_04_21_19_00/2014_04_21_19_00.mpg;Shinzo ABE.jpg;3825;3913;36033;191;195;4
/net/per610a/home/mvp/mvp_db/news7-lv/2014/2014_04_21_19_00/2014_04_21_19_00.mpg;Shinzo ABE.jpg;4193;4225;36033;209;211;2
/net/per610a/home/mvp/mvp_db/news7-lv/2014/2014_04_23_19_00/2014_04_23_19_00.mpg;Shinzo ABE.jpg;1101;1365;36033;55;68;13
/net/per610a/home/mvp/mvp_db/news7-lv/2014/2014_04_23_19_00/2014_04_23_19_00.mpg;Shinzo ABE.jpg;12709;13277;36033;635;664;29
/net/per610a/home/mvp/mvp_db/news7-lv/2014/2014_04_23_19_00/2014_04_23_19_00.mpg;Shinzo ABE.jpg;5957;6361;36033;298;318;20
/net/per610a/home/mvp/mvp_db/news7-lv/2014/2014_04_23_19_00/2014_04_23_19_00.mpg;Shinzo ABE.jpg;28845;29305;36033;1443;1466;23
/net/per610a/home/mvp/mvp_db/news7-lv/2014/2014_04_24_19_00/2014_04_24_19_00.mpg;Shinzo ABE.jpg;6721;6921;36037;336;346;10
/net/per610a/home/mvp/mvp_db/news7-lv/2014/2014_04_24_19_00/2014_04_24_19_00.mpg;Shinzo ABE.jpg;7789;8201;36037;389;410;21
/net/per610a/home/mvp/mvp_db/news7-lv/2014/2014_04_24_19_00/2014_04_24_19_00.mpg;Shinzo ABE.jpg;8577;8645;36037;429;432;3
/net/per610a/home/mvp/mvp_db/news7-lv/2014/2014_04_24_19_00/2014_04_24_19_00.mpg;Shinzo ABE.jpg;8745;9537;36037;437;477;40
/net/per610a/home/mvp/mvp_db/news7-lv/2014/2014_04_24_19_00/2014_04_24_19_00.mpg;Shinzo ABE.jpg;11781;12085;36037;589;604;15
/net/per610a/home/mvp/mvp_db/news7-lv/2014/2014_04_24_19_00/2014_04_24_19_00.mpg;Shinzo ABE.jpg;12165;12493;36037;608;625;17
/net/per610a/home/mvp/mvp_db/news7-lv/2014/2014_04_24_19_00/2014_04_24_19_00.mpg;Shinzo ABE.jpg;17641;17785;36037;882;889;7
/net/per610a/home/mvp/mvp_db/news7-lv/2014/2014_04_24_19_00/2014_04_24_19_00.mpg;Shinzo ABE.jpg;21465;21525;36037;1073;1076;3
/net/per610a/home/mvp/mvp_db/news7-lv/2014/2014_04_24_19_00/2014_04_24_19_00.mpg;Shinzo ABE.jpg;29097;29153;36037;1455;1458;3
/net/per610a/home/mvp/mvp_db/news7-lv/2014/2014_04_24_19_00/2014_04_24_19_00.mpg;Yoshimi WATANABE.jpg;30985;31241;36037;1550;1563;13
/net/per610a/home/mvp/mvp_db/news7-lv/2014/2014_04_25_19_00/2014_04_25_19_00.mpg;Shinzo ABE.jpg;7569;7977;36033;378;399;21
/net/per610a/home/mvp/mvp_db/news7-lv/2014/2014_04_25_19_00/2014_04_25_19_00.mpg;Shinzo ABE.jpg;10161;10393;36033;508;520;12
/net/per610a/home/mvp/mvp_db/news7-lv/2014/2014_04_25_19_00/2014_04_25_19_00.mpg;Shinzo ABE.jpg;10577;11649;36033;529;582;53
/net/per610a/home/mvp/mvp_db/news7-lv/2014/2014_04_25_19_00/2014_04_25_19_00.mpg;Shinzo ABE.jpg;13749;14441;36033;687;722;35
/net/per610a/home/mvp/mvp_db/news7-lv/2014/2014_04_26_19_00/2014_04_26_19_00.mpg;Shinzo ABE.jpg;9013;9385;36033;450;469;19
/net/per610a/home/mvp/mvp_db/news7-lv/2014/2014_04_26_19_00/2014_04_26_19_00.mpg;Shinzo ABE.jpg;9961;11117;36033;498;556;58
/net/per610a/home/mvp/mvp_db/news7-lv/2014/2014_04_30_19_00/2014_04_30_19_00.mpg;Shinzo ABE.jpg;24637;24637;36033;1232;1232;0
/net/per610a/home/mvp/mvp_db/news7-lv/2014/2014_04_30_19_00/2014_04_30_19_00.mpg;Shinzo ABE.jpg;24773;25005;36033;1239;1251;12
/net/per610a/home/mvp/mvp_db/news7-lv/2014/2014_04_30_19_00/2014_04_30_19_00.mpg;Shinzo ABE.jpg;25325;27001;36033;1267;1351;84
/net/per610a/home/mvp/mvp_db/news7-lv/2014/2014_05_01_19_00/2014_05_01_19_00.mpg;Shinzo ABE.jpg;33829;35181;36021;1692;1759;67
/net/per610a/home/mvp/mvp_db/news7-lv/2014/2014_05_04_19_00/2014_05_04_19_00.mpg;Shinzo ABE.jpg;6009;6725;36017;300;336;36
/net/per610a/home/mvp/mvp_db/news7-lv/2014/2014_05_04_19_00/2014_05_04_19_00.mpg;Shinzo ABE.jpg;27553;27917;36017;1378;1396;18
/net/per610a/home/mvp/mvp_db/news7-lv/2014/2014_05_05_19_00/2014_05_05_19_00.mpg;Shinzo ABE.jpg;12821;12893;36013;641;645;4
/net/per610a/home/mvp/mvp_db/news7-lv/2014/2014_05_05_19_00/2014_05_05_19_00.mpg;Shinzo ABE.jpg;30089;30169;36013;1505;1509;4
/net/per610a/home/mvp/mvp_db/news7-lv/2014/2014_05_05_19_00/2014_05_05_19_00.mpg;Shinzo ABE.jpg;31161;31801;36013;1559;1591;32
/net/per610a/home/mvp/mvp_db/news7-lv/2014/2014_05_06_19_00/2014_05_06_19_00.mpg;Shinzo ABE.jpg;17537;18849;36021;877;942;65
/net/per610a/home/mvp/mvp_db/news7-lv/2014/2014_05_06_19_00/2014_05_06_19_00.mpg;Shinzo ABE.jpg;18917;21305;36021;946;1065;119
/net/per610a/home/mvp/mvp_db/news7-lv/2014/2014_05_07_19_00/2014_05_07_19_00.mpg;Shinzo ABE.jpg;7349;8077;36021;367;404;37
/net/per610a/home/mvp/mvp_db/news7-lv/2014/2014_05_09_19_00/2014_05_09_19_00.mpg;Shinzo ABE.jpg;2621;3137;36021;131;156;25
/net/per610a/home/mvp/mvp_db/news7-lv/2014/2014_05_09_19_00/2014_05_09_19_00.mpg;Shinzo ABE.jpg;3397;3881;36021;169;194;25
/net/per610a/home/mvp/mvp_db/news7-lv/2014/2014_05_09_19_00/2014_05_09_19_00.mpg;Shinzo ABE.jpg;5505;5577;36021;275;278;3
/net/per610a/home/mvp/mvp_db/news7-lv/2014/2014_05_12_19_00/2014_05_12_19_00.mpg;Shinzo ABE.jpg;29325;29389;36017;1467;1470;3
/net/per610a/home/mvp/mvp_db/news7-lv/2014/2014_05_12_19_00/2014_05_12_19_00.mpg;Shinzo ABE.jpg;29605;29741;36017;1481;1487;6
/net/per610a/home/mvp/mvp_db/news7-lv/2014/2014_05_14_19_00/2014_05_14_19_00.mpg;Shinzo ABE.jpg;30165;30273;36021;1509;1514;5
/net/per610a/home/mvp/mvp_db/news7-lv/2014/2014_05_14_19_00/2014_05_14_19_00.mpg;Shinzo ABE.jpg;30361;30457;36021;1518;1523;5
/net/per610a/home/mvp/mvp_db/news7-lv/2014/2014_05_15_19_00/2014_05_15_19_00.mpg;Shinzo ABE.jpg;493;821;38421;24;41;17
/net/per610a/home/mvp/mvp_db/news7-lv/2014/2014_05_15_19_00/2014_05_15_19_00.mpg;Shinzo ABE.jpg;8797;9201;38421;440;460;20
/net/per610a/home/mvp/mvp_db/news7-lv/2014/2014_05_15_19_00/2014_05_15_19_00.mpg;Shinzo ABE.jpg;9493;9693;38421;475;485;10
/net/per610a/home/mvp/mvp_db/news7-lv/2014/2014_05_15_19_00/2014_05_15_19_00.mpg;Shinzo ABE.jpg;9777;12829;38421;489;642;153
/net/per610a/home/mvp/mvp_db/news7-lv/2014/2014_05_15_19_00/2014_05_15_19_00.mpg;Shinzo ABE.jpg;13185;13969;38421;659;699;40
/net/per610a/home/mvp/mvp_db/news7-lv/2014/2014_05_15_19_00/2014_05_15_19_00.mpg;Shinzo ABE.jpg;14345;15261;38421;717;763;46
/net/per610a/home/mvp/mvp_db/news7-lv/2014/2014_05_15_19_00/2014_05_15_19_00.mpg;Shinzo ABE.jpg;15933;16585;38421;797;830;33
/net/per610a/home/mvp/mvp_db/news7-lv/2014/2014_05_15_19_00/2014_05_15_19_00.mpg;Shinzo ABE.jpg;29993;30129;38421;1501;1507;6
/net/per610a/home/mvp/mvp_db/news7-lv/2014/2014_05_15_19_00/2014_05_15_19_00.mpg;Shinzo ABE.jpg;31113;31357;38421;1557;1569;12
/net/per610a/home/mvp/mvp_db/news7-lv/2014/2014_05_16_19_00/2014_05_16_19_00.mpg;Natsuo YAMAGUCHI.jpg;22257;23053;36013;1113;1153;40
/net/per610a/home/mvp/mvp_db/news7-lv/2014/2014_05_17_19_00/2014_05_17_19_00.mpg;Shinzo ABE.jpg;10485;10829;36021;524;541;17
/net/per610a/home/mvp/mvp_db/news7-lv/2014/2014_05_17_19_00/2014_05_17_19_00.mpg;Shinzo ABE.jpg;11045;11145;36021;552;557;5
/net/per610a/home/mvp/mvp_db/news7-lv/2014/2014_05_17_19_00/2014_05_17_19_00.mpg;Shinzo ABE.jpg;11301;11337;36021;565;567;2
/net/per610a/home/mvp/mvp_db/news7-lv/2014/2014_05_17_19_00/2014_05_17_19_00.mpg;Shinzo ABE.jpg;11601;11621;36021;580;581;1
/net/per610a/home/mvp/mvp_db/news7-lv/2014/2014_05_17_19_00/2014_05_17_19_00.mpg;Shinzo ABE.jpg;12085;12137;36021;604;607;3
/net/per610a/home/mvp/mvp_db/news7-lv/2014/2014_05_17_19_00/2014_05_17_19_00.mpg;Natsuo YAMAGUCHI.jpg;15641;16485;36021;782;824;42
/net/per610a/home/mvp/mvp_db/news7-lv/2014/2014_05_17_19_00/2014_05_17_19_00.mpg;Natsuo YAMAGUCHI.jpg;16689;16761;36021;834;838;4
/net/per610a/home/mvp/mvp_db/news7-lv/2014/2014_05_19_19_00/2014_05_19_19_00.mpg;Natsuo YAMAGUCHI.jpg;20889;21521;36017;1045;1076;31
/net/per610a/home/mvp/mvp_db/news7-lv/2014/2014_05_19_19_00/2014_05_19_19_00.mpg;Natsuo YAMAGUCHI.jpg;23409;23441;36017;1171;1172;1
/net/per610a/home/mvp/mvp_db/news7-lv/2014/2014_05_19_19_00/2014_05_19_19_00.mpg;Shinzo ABE.jpg;27681;28193;36017;1384;1410;26
/net/per610a/home/mvp/mvp_db/news7-lv/2014/2014_05_20_19_00/2014_05_20_19_00.mpg;Shinzo ABE.jpg;15405;15405;36013;770;770;0
/net/per610a/home/mvp/mvp_db/news7-lv/2014/2014_05_20_19_00/2014_05_20_19_00.mpg;Shinzo ABE.jpg;15493;15617;36013;775;781;6
/net/per610a/home/mvp/mvp_db/news7-lv/2014/2014_05_20_19_00/2014_05_20_19_00.mpg;Natsuo YAMAGUCHI.jpg;19777;20201;36013;989;1010;21
/net/per610a/home/mvp/mvp_db/news7-lv/2014/2014_05_22_19_00/2014_05_22_19_00.mpg;Shinzo ABE.jpg;28077;28541;36017;1404;1427;23
/net/per610a/home/mvp/mvp_db/news7-lv/2014/2014_05_25_19_00/2014_05_25_19_00.mpg;Yukio HATOYAMA.jpg;357;461;36017;17;23;6
/net/per610a/home/mvp/mvp_db/news7-lv/2014/2014_05_25_19_00/2014_05_25_19_00.mpg;Yukio HATOYAMA.jpg;8757;9145;36017;438;457;19
/net/per610a/home/mvp/mvp_db/news7-lv/2014/2014_05_28_19_00/2014_05_28_19_00.mpg;Shintaro ISHIHARA.jpg;97;117;36013;4;5;1
/net/per610a/home/mvp/mvp_db/news7-lv/2014/2014_05_28_19_00/2014_05_28_19_00.mpg;Shintaro ISHIHARA.jpg;237;305;36013;11;15;4
/net/per610a/home/mvp/mvp_db/news7-lv/2014/2014_05_28_19_00/2014_05_28_19_00.mpg;Shintaro ISHIHARA.jpg;2337;2465;36013;116;123;7
/net/per610a/home/mvp/mvp_db/news7-lv/2014/2014_05_28_19_00/2014_05_28_19_00.mpg;Shintaro ISHIHARA.jpg;2601;2665;36013;130;133;3
/net/per610a/home/mvp/mvp_db/news7-lv/2014/2014_05_28_19_00/2014_05_28_19_00.mpg;Shintaro ISHIHARA.jpg;4385;4437;36013;219;222;3
/net/per610a/home/mvp/mvp_db/news7-lv/2014/2014_05_28_19_00/2014_05_28_19_00.mpg;Toru Hashimoto.jpg;1961;2033;36013;98;101;3
/net/per610a/home/mvp/mvp_db/news7-lv/2014/2014_05_28_19_00/2014_05_28_19_00.mpg;Toru Hashimoto.jpg;2337;2465;36013;116;123;7
/net/per610a/home/mvp/mvp_db/news7-lv/2014/2014_05_28_19_00/2014_05_28_19_00.mpg;Ichiro Matsui.jpeg;3209;4265;36013;160;213;53
/net/per610a/home/mvp/mvp_db/news7-lv/2014/2014_05_28_19_00/2014_05_28_19_00.mpg;Ichiro OZAWA.jpg;14881;15369;36013;744;769;25
/net/per610a/home/mvp/mvp_db/news7-lv/2014/2014_05_28_19_00/2014_05_28_19_00.mpg;Ichiro OZAWA.jpg;16957;17717;36013;848;886;38
/net/per610a/home/mvp/mvp_db/news7-lv/2014/2014_05_29_19_00/2014_05_29_19_00.mpg;Shinzo ABE.jpg;549;1953;38421;27;97;70
/net/per610a/home/mvp/mvp_db/news7-lv/2014/2014_05_29_19_00/2014_05_29_19_00.mpg;Shinzo ABE.jpg;2153;2341;38421;107;117;10
/net/per610a/home/mvp/mvp_db/news7-lv/2014/2014_05_29_19_00/2014_05_29_19_00.mpg;Shinzo ABE.jpg;12757;13409;38421;638;670;32
/net/per610a/home/mvp/mvp_db/news7-lv/2014/2014_05_29_19_00/2014_05_29_19_00.mpg;Shinzo ABE.jpg;17057;17853;38421;853;893;40
/net/per610a/home/mvp/mvp_db/news7-lv/2014/2014_05_29_19_00/2014_05_29_19_00.mpg;Shinzo ABE.jpg;17973;18005;38421;899;900;1
/net/per610a/home/mvp/mvp_db/news7-lv/2014/2014_05_29_19_00/2014_05_29_19_00.mpg;Shinzo ABE.jpg;34717;36117;38421;1736;1806;70
/net/per610a/home/mvp/mvp_db/news7-lv/2014/2014_05_29_19_00/2014_05_29_19_00.mpg;Shintaro ISHIHARA.jpg;18689;18781;38421;934;939;5
/net/per610a/home/mvp/mvp_db/news7-lv/2014/2014_05_29_19_00/2014_05_29_19_00.mpg;Shintaro ISHIHARA.jpg;18869;19245;38421;943;962;19
/net/per610a/home/mvp/mvp_db/news7-lv/2014/2014_05_29_19_00/2014_05_29_19_00.mpg;Shintaro ISHIHARA.jpg;19861;19981;38421;993;999;6
/net/per610a/home/mvp/mvp_db/news7-lv/2014/2014_05_29_19_00/2014_05_29_19_00.mpg;Shintaro ISHIHARA.jpg;25269;25421;38421;1264;1271;7
/net/per610a/home/mvp/mvp_db/news7-lv/2014/2014_05_29_19_00/2014_05_29_19_00.mpg;Shintaro ISHIHARA.jpg;26925;27469;38421;1346;1374;28
/net/per610a/home/mvp/mvp_db/news7-lv/2014/2014_05_29_19_00/2014_05_29_19_00.mpg;Toru Hashimoto.jpg;19853;19981;38421;993;999;6
/net/per610a/home/mvp/mvp_db/news7-lv/2014/2014_05_29_19_00/2014_05_29_19_00.mpg;Toru Hashimoto.jpg;20605;20709;38421;1030;1035;5
/net/per610a/home/mvp/mvp_db/news7-lv/2014/2014_05_29_19_00/2014_05_29_19_00.mpg;Toru Hashimoto.jpg;21049;21177;38421;1052;1059;7
/net/per610a/home/mvp/mvp_db/news7-lv/2014/2014_05_29_19_00/2014_05_29_19_00.mpg;Toru Hashimoto.jpg;26925;27621;38421;1346;1381;35
/net/per610a/home/mvp/mvp_db/news7-lv/2014/2014_05_29_19_00/2014_05_29_19_00.mpg;Kenji Eda.jpg;23677;24357;38421;1184;1218;34
/net/per610a/home/mvp/mvp_db/news7-lv/2014/2014_05_29_19_00/2014_05_29_19_00.mpg;Yorihisa Matsuno.png;25425;25657;38421;1271;1283;12
/net/per610a/home/mvp/mvp_db/news7-lv/2014/2014_05_30_19_00/2014_05_30_19_00.mpg;Shinzo ABE.jpg;1077;1509;36021;53;75;22
/net/per610a/home/mvp/mvp_db/news7-lv/2014/2014_05_30_19_00/2014_05_30_19_00.mpg;Shinzo ABE.jpg;9737;9989;36021;487;499;12
/net/per610a/home/mvp/mvp_db/news7-lv/2014/2014_05_30_19_00/2014_05_30_19_00.mpg;Shinzo ABE.jpg;1569;1829;36021;78;91;13
/net/per610a/home/mvp/mvp_db/news7-lv/2014/2014_05_30_19_00/2014_05_30_19_00.mpg;Shinzo ABE.jpg;8689;8873;36021;434;443;9
/net/per610a/home/mvp/mvp_db/news7-lv/2014/2014_05_30_19_00/2014_05_30_19_00.mpg;Shinzo ABE.jpg;10285;10357;36021;514;518;4
/net/per610a/home/mvp/mvp_db/news7-lv/2014/2014_05_30_19_00/2014_05_30_19_00.mpg;Shinzo ABE.jpg;17593;17693;36021;880;885;5
/net/per610a/home/mvp/mvp_db/news7-lv/2014/2014_05_31_19_00/2014_05_31_19_00.mpg;Shinzo ABE.jpg;2005;2601;36017;100;130;30
/net/per610a/home/mvp/mvp_db/news7-lv/2014/2014_05_31_19_00/2014_05_31_19_00.mpg;Kenji Eda.jpg;11797;12445;36017;590;622;32
/net/per610a/home/mvp/mvp_db/news7-lv/2014/2014_05_31_19_00/2014_05_31_19_00.mpg;Kenji Eda.jpg;12873;14757;36017;644;738;94
/net/per610a/home/mvp/mvp_db/news7-lv/2014/2014_06_03_19_00/2014_06_03_19_00.mpg;Natsuo YAMAGUCHI.jpg;30849;31473;38421;1543;1574;31
/net/per610a/home/mvp/mvp_db/news7-lv/2014/2014_06_03_19_00/2014_06_03_19_00.mpg;Shinzo ABE.jpg;32817;33605;38421;1641;1681;40
/net/per610a/home/mvp/mvp_db/news7-lv/2014/2014_06_04_19_00/2014_06_04_19_00.mpg;Shinzo ABE.jpg;16153;16181;36017;808;809;1
/net/per610a/home/mvp/mvp_db/news7-lv/2014/2014_06_04_19_00/2014_06_04_19_00.mpg;Shinzo ABE.jpg;17577;17653;36017;879;883;4
/net/per610a/home/mvp/mvp_db/news7-lv/2014/2014_06_05_19_00/2014_06_05_19_00.mpg;Shinzo ABE.jpg;14993;15085;36021;750;754;4
/net/per610a/home/mvp/mvp_db/news7-lv/2014/2014_06_05_19_00/2014_06_05_19_00.mpg;Shinzo ABE.jpg;15605;15673;36021;780;784;4
/net/per610a/home/mvp/mvp_db/news7-lv/2014/2014_06_05_19_00/2014_06_05_19_00.mpg;Shinzo ABE.jpg;16549;16933;36021;827;847;20
/net/per610a/home/mvp/mvp_db/news7-lv/2014/2014_06_05_19_00/2014_06_05_19_00.mpg;Shinzo ABE.jpg;19009;19069;36021;950;953;3
/net/per610a/home/mvp/mvp_db/news7-lv/2014/2014_06_05_19_00/2014_06_05_19_00.mpg;Shinzo ABE.jpg;19577;19849;36021;979;992;13
/net/per610a/home/mvp/mvp_db/news7-lv/2014/2014_06_05_19_00/2014_06_05_19_00.mpg;Toru Hashimoto.jpg;24365;24877;36021;1218;1244;26
/net/per610a/home/mvp/mvp_db/news7-lv/2014/2014_06_05_19_00/2014_06_05_19_00.mpg;Toru Hashimoto.jpg;25421;25701;36021;1271;1285;14
/net/per610a/home/mvp/mvp_db/news7-lv/2014/2014_06_05_19_00/2014_06_05_19_00.mpg;Toru Hashimoto.jpg;25817;26065;36021;1291;1303;12
/net/per610a/home/mvp/mvp_db/news7-lv/2014/2014_06_05_19_00/2014_06_05_19_00.mpg;Toru Hashimoto.jpg;26437;27013;36021;1322;1351;29
/net/per610a/home/mvp/mvp_db/news7-lv/2014/2014_06_05_19_00/2014_06_05_19_00.mpg;Toru Hashimoto.jpg;28889;29321;36021;1445;1466;21
/net/per610a/home/mvp/mvp_db/news7-lv/2014/2014_06_05_19_00/2014_06_05_19_00.mpg;Shintaro ISHIHARA.jpg;25421;25701;36021;1271;1285;14
/net/per610a/home/mvp/mvp_db/news7-lv/2014/2014_06_05_19_00/2014_06_05_19_00.mpg;Shintaro ISHIHARA.jpg;28893;29085;36021;1445;1455;10
/net/per610a/home/mvp/mvp_db/news7-lv/2014/2014_06_05_19_00/2014_06_05_19_00.mpg;Takeo Hiranuma.jpeg;27405;27469;36021;1370;1374;4
/net/per610a/home/mvp/mvp_db/news7-lv/2014/2014_06_05_19_00/2014_06_05_19_00.mpg;Takeo Hiranuma.jpeg;27813;27857;36021;1391;1393;2
/net/per610a/home/mvp/mvp_db/news7-lv/2014/2014_06_05_19_00/2014_06_05_19_00.mpg;Kyoko Nakayama.jpg;27633;27725;36021;1382;1386;4
/net/per610a/home/mvp/mvp_db/news7-lv/2014/2014_06_07_19_00/2014_06_07_19_00.mpg;Seiji MAEHARA.jpg;21025;22917;36021;1051;1146;95
/net/per610a/home/mvp/mvp_db/news7-lv/2014/2014_06_07_19_00/2014_06_07_19_00.mpg;Bairi Kaieda.jpg;21025;21449;36021;1051;1073;22
/net/per610a/home/mvp/mvp_db/news7-lv/2014/2014_06_09_19_00/2014_06_09_19_00.mpg;Shinzo ABE.jpg;8913;9177;36017;445;459;14
/net/per610a/home/mvp/mvp_db/news7-lv/2014/2014_06_09_19_00/2014_06_09_19_00.mpg;Shinzo ABE.jpg;10009;10185;36017;500;509;9
/net/per610a/home/mvp/mvp_db/news7-lv/2014/2014_06_09_19_00/2014_06_09_19_00.mpg;Shinzo ABE.jpg;11409;11473;36017;570;574;4
/net/per610a/home/mvp/mvp_db/news7-lv/2014/2014_06_09_19_00/2014_06_09_19_00.mpg;Shinzo ABE.jpg;12137;12585;36017;607;629;22
/net/per610a/home/mvp/mvp_db/news7-lv/2014/2014_06_09_19_00/2014_06_09_19_00.mpg;Shinzo ABE.jpg;14769;16305;36017;738;815;77
/net/per610a/home/mvp/mvp_db/news7-lv/2014/2014_06_09_19_00/2014_06_09_19_00.mpg;Shinzo ABE.jpg;10293;10405;36017;514;520;6
/net/per610a/home/mvp/mvp_db/news7-lv/2014/2014_06_09_19_00/2014_06_09_19_00.mpg;Shinzo ABE.jpg;17745;17797;36017;887;890;3
/net/per610a/home/mvp/mvp_db/news7-lv/2014/2014_06_09_19_00/2014_06_09_19_00.mpg;Shinzo ABE.jpg;24445;24985;36017;1223;1250;27
/net/per610a/home/mvp/mvp_db/news7-lv/2014/2014_06_09_19_00/2014_06_09_19_00.mpg;Toru Hashimoto.jpg;13133;13281;36017;657;664;7
/net/per610a/home/mvp/mvp_db/news7-lv/2014/2014_06_09_19_00/2014_06_09_19_00.mpg;Shintaro ISHIHARA.jpg;13133;13281;36017;657;664;7
/net/per610a/home/mvp/mvp_db/news7-lv/2014/2014_06_10_19_00/2014_06_10_19_00.mpg;Natsuo YAMAGUCHI.jpg;3053;3581;36025;152;179;27
/net/per610a/home/mvp/mvp_db/news7-lv/2014/2014_06_10_19_00/2014_06_10_19_00.mpg;Shinzo ABE.jpg;3661;3733;36025;183;186;3
/net/per610a/home/mvp/mvp_db/news7-lv/2014/2014_06_10_19_00/2014_06_10_19_00.mpg;Shinzo ABE.jpg;3873;4233;36025;193;211;18
/net/per610a/home/mvp/mvp_db/news7-lv/2014/2014_06_10_19_00/2014_06_10_19_00.mpg;Shinzo ABE.jpg;23169;23233;36025;1159;1162;3
/net/per610a/home/mvp/mvp_db/news7-lv/2014/2014_06_10_19_00/2014_06_10_19_00.mpg;Shinzo ABE.jpg;23617;23649;36025;1181;1183;2
/net/per610a/home/mvp/mvp_db/news7-lv/2014/2014_06_10_19_00/2014_06_10_19_00.mpg;Shinzo ABE.jpg;25005;25269;36025;1251;1264;13
/net/per610a/home/mvp/mvp_db/news7-lv/2014/2014_06_10_19_00/2014_06_10_19_00.mpg;Shinzo ABE.jpg;25365;25721;36025;1269;1287;18
/net/per610a/home/mvp/mvp_db/news7-lv/2014/2014_06_10_19_00/2014_06_10_19_00.mpg;Shinzo ABE.jpg;27057;27085;36025;1354;1355;1
/net/per610a/home/mvp/mvp_db/news7-lv/2014/2014_06_10_19_00/2014_06_10_19_00.mpg;Toru Hashimoto.jpg;29485;29797;36025;1475;1491;16
/net/per610a/home/mvp/mvp_db/news7-lv/2014/2014_06_11_19_00/2014_06_11_19_00.mpg;Shinzo ABE.jpg;24309;24685;36013;1216;1235;19
/net/per610a/home/mvp/mvp_db/news7-lv/2014/2014_06_11_19_00/2014_06_11_19_00.mpg;Natsuo YAMAGUCHI.jpg;31345;32037;36013;1568;1603;35
/net/per610a/home/mvp/mvp_db/news7-lv/2014/2014_06_12_19_00/2014_06_12_19_00.mpg;Shinzo ABE.jpg;2165;2533;36021;108;126;18
/net/per610a/home/mvp/mvp_db/news7-lv/2014/2014_06_12_19_00/2014_06_12_19_00.mpg;Shinzo ABE.jpg;30101;30157;36021;1505;1508;3
/net/per610a/home/mvp/mvp_db/news7-lv/2014/2014_06_12_19_00/2014_06_12_19_00.mpg;Natsuo YAMAGUCHI.jpg;2989;3217;36021;149;160;11
/net/per610a/home/mvp/mvp_db/news7-lv/2014/2014_06_13_19_00/2014_06_13_19_00.mpg;Shinzo ABE.jpg;1289;1585;36017;64;79;15
/net/per610a/home/mvp/mvp_db/news7-lv/2014/2014_06_13_19_00/2014_06_13_19_00.mpg;Shinzo ABE.jpg;1929;2441;36017;96;122;26
/net/per610a/home/mvp/mvp_db/news7-lv/2014/2014_06_13_19_00/2014_06_13_19_00.mpg;Shinzo ABE.jpg;4525;4853;36017;226;242;16
/net/per610a/home/mvp/mvp_db/news7-lv/2014/2014_06_13_19_00/2014_06_13_19_00.mpg;Shinzo ABE.jpg;5829;6329;36017;291;316;25
/net/per610a/home/mvp/mvp_db/news7-lv/2014/2014_06_13_19_00/2014_06_13_19_00.mpg;Shinzo ABE.jpg;13197;13657;36017;660;683;23
/net/per610a/home/mvp/mvp_db/news7-lv/2014/2014_06_13_19_00/2014_06_13_19_00.mpg;Shinzo ABE.jpg;25545;28733;36017;1278;1437;159
/net/per610a/home/mvp/mvp_db/news7-lv/2014/2014_06_13_19_00/2014_06_13_19_00.mpg;Taro ASO.jpg;4169;4421;36017;208;221;13
/net/per610a/home/mvp/mvp_db/news7-lv/2014/2014_06_14_19_00/2014_06_14_19_00.mpg;Shinzo ABE.jpg;10813;11325;36013;541;566;25
/net/per610a/home/mvp/mvp_db/news7-lv/2014/2014_06_14_19_00/2014_06_14_19_00.mpg;Shinzo ABE.jpg;12353;13053;36013;618;653;35
/net/per610a/home/mvp/mvp_db/news7-lv/2014/2014_06_16_19_00/2014_06_16_19_00.mpg;Shinzo ABE.jpg;18897;19153;36017;945;958;13
/net/per610a/home/mvp/mvp_db/news7-lv/2014/2014_06_16_19_00/2014_06_16_19_00.mpg;Shinzo ABE.jpg;20769;20857;36017;1039;1043;4
/net/per610a/home/mvp/mvp_db/news7-lv/2014/2014_06_16_19_00/2014_06_16_19_00.mpg;Shinzo ABE.jpg;21409;21485;36017;1071;1074;3
/net/per610a/home/mvp/mvp_db/news7-lv/2014/2014_06_16_19_00/2014_06_16_19_00.mpg;Shinzo ABE.jpg;21973;22449;36017;1099;1123;24
/net/per610a/home/mvp/mvp_db/news7-lv/2014/2014_06_16_19_00/2014_06_16_19_00.mpg;Natsuo YAMAGUCHI.jpg;25101;25565;36017;1255;1279;24
/net/per610a/home/mvp/mvp_db/news7-lv/2014/2014_06_17_19_00/2014_06_17_19_00.mpg;Natsuo YAMAGUCHI.jpg;20905;21285;36013;1046;1065;19
/net/per610a/home/mvp/mvp_db/news7-lv/2014/2014_06_17_19_00/2014_06_17_19_00.mpg;Shinzo ABE.jpg;30521;30761;36013;1527;1539;12
/net/per610a/home/mvp/mvp_db/news7-lv/2014/2014_06_18_19_00/2014_06_18_19_00.mpg;Ichiro OZAWA.jpg;8185;8385;36013;409;419;10
/net/per610a/home/mvp/mvp_db/news7-lv/2014/2014_06_19_19_00/2014_06_19_19_00.mpg;Shinzo ABE.jpg;24417;24753;36021;1221;1238;17
/net/per610a/home/mvp/mvp_db/news7-lv/2014/2014_06_20_19_00/2014_06_20_19_00.mpg;Ichiro OZAWA.jpg;4233;4465;36013;211;223;12
/net/per610a/home/mvp/mvp_db/news7-lv/2014/2014_06_20_19_00/2014_06_20_19_00.mpg;Shinzo ABE.jpg;8429;8897;36013;421;445;24
/net/per610a/home/mvp/mvp_db/news7-lv/2014/2014_06_20_19_00/2014_06_20_19_00.mpg;Shinzo ABE.jpg;11969;12045;36013;598;602;4
/net/per610a/home/mvp/mvp_db/news7-lv/2014/2014_06_20_19_00/2014_06_20_19_00.mpg;Shinzo ABE.jpg;14265;14577;36013;713;729;16
/net/per610a/home/mvp/mvp_db/news7-lv/2014/2014_06_20_19_00/2014_06_20_19_00.mpg;Natsuo YAMAGUCHI.jpg;14265;14577;36013;713;729;16
/net/per610a/home/mvp/mvp_db/news7-lv/2014/2014_06_22_19_00/2014_06_22_19_00.mpg;Toru Hashimoto.jpg;9073;9637;36085;454;482;28
/net/per610a/home/mvp/mvp_db/news7-lv/2014/2014_06_22_19_00/2014_06_22_19_00.mpg;Toru Hashimoto.jpg;9765;9809;36085;488;490;2
/net/per610a/home/mvp/mvp_db/news7-lv/2014/2014_06_22_19_00/2014_06_22_19_00.mpg;Toru Hashimoto.jpg;9969;10589;36085;498;529;31
/net/per610a/home/mvp/mvp_db/news7-lv/2014/2014_06_22_19_00/2014_06_22_19_00.mpg;Toru Hashimoto.jpg;11477;11557;36085;574;578;4
/net/per610a/home/mvp/mvp_db/news7-lv/2014/2014_06_22_19_00/2014_06_22_19_00.mpg;Toru Hashimoto.jpg;11877;11893;36085;594;595;1
/net/per610a/home/mvp/mvp_db/news7-lv/2014/2014_06_22_19_00/2014_06_22_19_00.mpg;Toru Hashimoto.jpg;12681;12813;36085;634;641;7
/net/per610a/home/mvp/mvp_db/news7-lv/2014/2014_06_22_19_00/2014_06_22_19_00.mpg;Shintaro ISHIHARA.jpg;9073;9637;36085;454;482;28
/net/per610a/home/mvp/mvp_db/news7-lv/2014/2014_06_22_19_00/2014_06_22_19_00.mpg;Shintaro ISHIHARA.jpg;10769;11233;36085;538;562;24
/net/per610a/home/mvp/mvp_db/news7-lv/2014/2014_06_24_19_00/2014_06_24_19_00.mpg;Shinzo ABE.jpg;7373;7605;36077;368;380;12
/net/per610a/home/mvp/mvp_db/news7-lv/2014/2014_06_24_19_00/2014_06_24_19_00.mpg;Shinzo ABE.jpg;13645;13725;36077;682;686;4
/net/per610a/home/mvp/mvp_db/news7-lv/2014/2014_06_24_19_00/2014_06_24_19_00.mpg;Shinzo ABE.jpg;18113;18261;36077;906;913;7
/net/per610a/home/mvp/mvp_db/news7-lv/2014/2014_06_24_19_00/2014_06_24_19_00.mpg;Shinzo ABE.jpg;18545;18681;36077;927;934;7
/net/per610a/home/mvp/mvp_db/news7-lv/2014/2014_06_24_19_00/2014_06_24_19_00.mpg;Shinzo ABE.jpg;19697;19805;36077;985;990;5
/net/per610a/home/mvp/mvp_db/news7-lv/2014/2014_06_24_19_00/2014_06_24_19_00.mpg;Shinzo ABE.jpg;24269;24805;36077;1214;1241;27
/net/per610a/home/mvp/mvp_db/news7-lv/2014/2014_06_26_19_00/2014_06_26_19_00.mpg;Natsuo YAMAGUCHI.jpg;1105;1589;36085;55;79;24
/net/per610a/home/mvp/mvp_db/news7-lv/2014/2014_06_26_19_00/2014_06_26_19_00.mpg;Natsuo YAMAGUCHI.jpg;2469;2909;36085;123;145;22
/net/per610a/home/mvp/mvp_db/news7-lv/2014/2014_06_26_19_00/2014_06_26_19_00.mpg;Shintaro ISHIHARA.jpg;23769;24025;36085;1189;1202;13
/net/per610a/home/mvp/mvp_db/news7-lv/2014/2014_06_26_19_00/2014_06_26_19_00.mpg;Shintaro ISHIHARA.jpg;24201;24549;36085;1211;1228;17
/net/per610a/home/mvp/mvp_db/news7-lv/2014/2014_06_26_19_00/2014_06_26_19_00.mpg;Shintaro ISHIHARA.jpg;24769;24809;36085;1239;1241;2
/net/per610a/home/mvp/mvp_db/news7-lv/2014/2014_06_26_19_00/2014_06_26_19_00.mpg;Toru Hashimoto.jpg;24201;24549;36085;1211;1228;17
/net/per610a/home/mvp/mvp_db/news7-lv/2014/2014_06_27_19_00/2014_06_27_19_00.mpg;Bairi Kaieda.jpg;4513;5025;36081;225;251;26
/net/per610a/home/mvp/mvp_db/news7-lv/2014/2014_06_27_19_00/2014_06_27_19_00.mpg;Natsuo YAMAGUCHI.jpg;5709;5789;36081;285;289;4
/net/per610a/home/mvp/mvp_db/news7-lv/2014/2014_06_28_19_00/2014_06_28_19_00.mpg;Natsuo YAMAGUCHI.jpg;745;1265;36085;37;63;26
/net/per610a/home/mvp/mvp_db/news7-lv/2014/2014_06_28_19_00/2014_06_28_19_00.mpg;Natsuo YAMAGUCHI.jpg;2241;3345;36085;112;167;55
/net/per610a/home/mvp/mvp_db/news7-lv/2014/2014_06_29_19_00/2014_06_29_19_00.mpg;Shinzo ABE.jpg;3889;4197;36085;194;210;16
/net/per610a/home/mvp/mvp_db/news7-lv/2014/2014_06_29_19_00/2014_06_29_19_00.mpg;Ichiro OZAWA.jpg;4437;5673;36085;222;283;61
/net/per610a/home/mvp/mvp_db/news7-lv/2014/2014_06_30_19_00/2014_06_30_19_00.mpg;Natsuo YAMAGUCHI.jpg;1221;1293;36085;61;64;3
/net/per610a/home/mvp/mvp_db/news7-lv/2014/2014_06_30_19_00/2014_06_30_19_00.mpg;Natsuo YAMAGUCHI.jpg;2085;2477;36085;104;123;19
/net/per610a/home/mvp/mvp_db/news7-lv/2014/2014_06_30_19_00/2014_06_30_19_00.mpg;Ichiro OZAWA.jpg;9317;9601;36085;466;480;14
/net/per610a/home/mvp/mvp_db/news7-lv/2014/2014_06_30_19_00/2014_06_30_19_00.mpg;Ichiro OZAWA.jpg;10093;10205;36085;505;510;5
/net/per610a/home/mvp/mvp_db/news7-lv/2014/2014_07_01_19_00/2014_07_01_19_00.mpg;Shinzo ABE.jpg;1597;1957;38481;79;97;18
/net/per610a/home/mvp/mvp_db/news7-lv/2014/2014_07_01_19_00/2014_07_01_19_00.mpg;Shinzo ABE.jpg;4537;5097;38481;227;255;28
/net/per610a/home/mvp/mvp_db/news7-lv/2014/2014_07_01_19_00/2014_07_01_19_00.mpg;Shinzo ABE.jpg;6633;9417;38481;331;471;140
/net/per610a/home/mvp/mvp_db/news7-lv/2014/2014_07_01_19_00/2014_07_01_19_00.mpg;Shinzo ABE.jpg;15373;16093;38481;769;805;36
/net/per610a/home/mvp/mvp_db/news7-lv/2014/2014_07_01_19_00/2014_07_01_19_00.mpg;Shinzo ABE.jpg;16253;16329;38481;813;817;4
/net/per610a/home/mvp/mvp_db/news7-lv/2014/2014_07_01_19_00/2014_07_01_19_00.mpg;Shinzo ABE.jpg;20449;24089;38481;1023;1205;182
/net/per610a/home/mvp/mvp_db/news7-lv/2014/2014_07_01_19_00/2014_07_01_19_00.mpg;Shinzo ABE.jpg;27965;28205;38481;1399;1411;12
/net/per610a/home/mvp/mvp_db/news7-lv/2014/2014_07_01_19_00/2014_07_01_19_00.mpg;Shinzo ABE.jpg;28841;28897;38481;1443;1446;3
/net/per610a/home/mvp/mvp_db/news7-lv/2014/2014_07_01_19_00/2014_07_01_19_00.mpg;Shinzo ABE.jpg;29333;29361;38481;1468;1469;1
/net/per610a/home/mvp/mvp_db/news7-lv/2014/2014_07_01_19_00/2014_07_01_19_00.mpg;Shinzo ABE.jpg;31069;31137;38481;1555;1558;3
/net/per610a/home/mvp/mvp_db/news7-lv/2014/2014_07_01_19_00/2014_07_01_19_00.mpg;Natsuo YAMAGUCHI.jpg;4393;4469;38481;219;223;4
/net/per610a/home/mvp/mvp_db/news7-lv/2014/2014_07_01_19_00/2014_07_01_19_00.mpg;Natsuo YAMAGUCHI.jpg;9493;10885;38481;475;544;69
/net/per610a/home/mvp/mvp_db/news7-lv/2014/2014_07_03_19_00/2014_07_03_19_00.mpg;Shinzo ABE.jpg;5377;6617;36077;269;331;62
/net/per610a/home/mvp/mvp_db/news7-lv/2014/2014_07_03_19_00/2014_07_03_19_00.mpg;Shinzo ABE.jpg;8041;8341;36077;402;417;15
/net/per610a/home/mvp/mvp_db/news7-lv/2014/2014_07_03_19_00/2014_07_03_19_00.mpg;Shinzo ABE.jpg;21369;21825;36077;1069;1091;22
/net/per610a/home/mvp/mvp_db/news7-lv/2014/2014_07_04_19_00/2014_07_04_19_00.mpg;Ichiro OZAWA.jpg;3085;3085;36085;154;154;0
/net/per610a/home/mvp/mvp_db/news7-lv/2014/2014_07_04_19_00/2014_07_04_19_00.mpg;Ichiro OZAWA.jpg;3333;3761;36085;166;188;22
/net/per610a/home/mvp/mvp_db/news7-lv/2014/2014_07_07_19_00/2014_07_07_19_00.mpg;Takeo Hiranuma.jpeg;23857;24377;38481;1193;1219;26
/net/per610a/home/mvp/mvp_db/news7-lv/2014/2014_07_07_19_00/2014_07_07_19_00.mpg;Yukiko Kada.jpg;26665;26821;38481;1333;1341;8
/net/per610a/home/mvp/mvp_db/news7-lv/2014/2014_07_07_19_00/2014_07_07_19_00.mpg;Yukiko Kada.jpg;32305;32389;38481;1616;1620;4
/net/per610a/home/mvp/mvp_db/news7-lv/2014/2014_07_07_19_00/2014_07_07_19_00.mpg;Yukiko Kada.jpg;32745;33029;38481;1638;1652;14
/net/per610a/home/mvp/mvp_db/news7-lv/2014/2014_07_09_19_00/2014_07_09_19_00.mpg;Shinzo ABE.jpg;27525;27761;38481;1377;1389;12
/net/per610a/home/mvp/mvp_db/news7-lv/2014/2014_07_11_19_00/2014_07_11_19_00.mpg;Shinzo ABE.jpg;28637;29033;36081;1433;1453;20
/net/per610a/home/mvp/mvp_db/news7-lv/2014/2014_07_11_19_00/2014_07_11_19_00.mpg;Shinzo ABE.jpg;30689;31573;36081;1536;1580;44
/net/per610a/home/mvp/mvp_db/news7-lv/2014/2014_07_13_19_00/2014_07_13_19_00.mpg;Shinzo ABE.jpg;11693;11873;36089;585;594;9
/net/per610a/home/mvp/mvp_db/news7-lv/2014/2014_07_13_19_00/2014_07_13_19_00.mpg;Shinzo ABE.jpg;14741;15729;36089;737;787;50
/net/per610a/home/mvp/mvp_db/news7-lv/2014/2014_07_14_19_00/2014_07_14_19_00.mpg;Shinzo ABE.jpg;73;97;36089;3;4;1
/net/per610a/home/mvp/mvp_db/news7-lv/2014/2014_07_14_19_00/2014_07_14_19_00.mpg;Shinzo ABE.jpg;177;209;36089;8;10;2
/net/per610a/home/mvp/mvp_db/news7-lv/2014/2014_07_14_19_00/2014_07_14_19_00.mpg;Shinzo ABE.jpg;5765;6497;36089;288;325;37
/net/per610a/home/mvp/mvp_db/news7-lv/2014/2014_07_14_19_00/2014_07_14_19_00.mpg;Shinzo ABE.jpg;7237;7345;36089;362;367;5
/net/per610a/home/mvp/mvp_db/news7-lv/2014/2014_07_14_19_00/2014_07_14_19_00.mpg;Shinzo ABE.jpg;9369;10029;36089;468;501;33
/net/per610a/home/mvp/mvp_db/news7-lv/2014/2014_07_14_19_00/2014_07_14_19_00.mpg;Shinzo ABE.jpg;10429;11149;36089;521;557;36
/net/per610a/home/mvp/mvp_db/news7-lv/2014/2014_07_14_19_00/2014_07_14_19_00.mpg;Shinzo ABE.jpg;11509;12277;36089;575;614;39
/net/per610a/home/mvp/mvp_db/news7-lv/2014/2014_07_14_19_00/2014_07_14_19_00.mpg;Shinzo ABE.jpg;12649;13225;36089;632;661;29
/net/per610a/home/mvp/mvp_db/news7-lv/2014/2014_07_14_19_00/2014_07_14_19_00.mpg;Shinzo ABE.jpg;16065;17981;36089;803;899;96
/net/per610a/home/mvp/mvp_db/news7-lv/2014/2014_07_14_19_00/2014_07_14_19_00.mpg;Shinzo ABE.jpg;21101;21109;36089;1055;1056;1
/net/per610a/home/mvp/mvp_db/news7-lv/2014/2014_07_14_19_00/2014_07_14_19_00.mpg;Shinzo ABE.jpg;21805;21833;36089;1091;1092;1
/net/per610a/home/mvp/mvp_db/news7-lv/2014/2014_07_14_19_00/2014_07_14_19_00.mpg;Shinzo ABE.jpg;19757;20185;36089;988;1010;22
/net/per610a/home/mvp/mvp_db/news7-lv/2014/2014_07_14_19_00/2014_07_14_19_00.mpg;Shinzo ABE.jpg;22049;22121;36089;1103;1107;4
/net/per610a/home/mvp/mvp_db/news7-lv/2014/2014_07_14_19_00/2014_07_14_19_00.mpg;Shinzo ABE.jpg;22757;22977;36089;1138;1149;11
/net/per610a/home/mvp/mvp_db/news7-lv/2014/2014_07_14_19_00/2014_07_14_19_00.mpg;Shinzo ABE.jpg;25373;25821;36089;1269;1292;23
/net/per610a/home/mvp/mvp_db/news7-lv/2014/2014_07_14_19_00/2014_07_14_19_00.mpg;Shinzo ABE.jpg;26137;26385;36089;1307;1320;13
/net/per610a/home/mvp/mvp_db/news7-lv/2014/2014_07_14_19_00/2014_07_14_19_00.mpg;Shinzo ABE.jpg;24053;24325;36089;1203;1217;14
/net/per610a/home/mvp/mvp_db/news7-lv/2014/2014_07_15_19_00/2014_07_15_19_00.mpg;Shinzo ABE.jpg;15105;15109;36085;755;756;1
/net/per610a/home/mvp/mvp_db/news7-lv/2014/2014_07_15_19_00/2014_07_15_19_00.mpg;Shinzo ABE.jpg;15961;16573;36085;798;829;31
/net/per610a/home/mvp/mvp_db/news7-lv/2014/2014_07_15_19_00/2014_07_15_19_00.mpg;Shinzo ABE.jpg;16885;17325;36085;845;867;22
/net/per610a/home/mvp/mvp_db/news7-lv/2014/2014_07_15_19_00/2014_07_15_19_00.mpg;Shinzo ABE.jpg;19757;19893;36085;988;995;7
/net/per610a/home/mvp/mvp_db/news7-lv/2014/2014_07_16_19_00/2014_07_16_19_00.mpg;Shinzo ABE.jpg;9437;9885;36085;472;494;22
/net/per610a/home/mvp/mvp_db/news7-lv/2014/2014_07_16_19_00/2014_07_16_19_00.mpg;Natsuo YAMAGUCHI.jpg;16565;16985;36085;829;850;21
/net/per610a/home/mvp/mvp_db/news7-lv/2014/2014_07_17_19_00/2014_07_17_19_00.mpg;Shinzo ABE.jpg;18853;19417;36085;943;971;28
/net/per610a/home/mvp/mvp_db/news7-lv/2014/2014_07_17_19_00/2014_07_17_19_00.mpg;Shinzo ABE.jpg;19481;19817;36085;974;991;17
/net/per610a/home/mvp/mvp_db/news7-lv/2014/2014_07_17_19_00/2014_07_17_19_00.mpg;Shinzo ABE.jpg;20677;20793;36085;1034;1040;6
/net/per610a/home/mvp/mvp_db/news7-lv/2014/2014_07_17_19_00/2014_07_17_19_00.mpg;Shinzo ABE.jpg;30061;30073;36085;1504;1505;1
/net/per610a/home/mvp/mvp_db/news7-lv/2014/2014_07_18_19_00/2014_07_18_19_00.mpg;Shinzo ABE.jpg;12421;12933;36081;621;646;25
/net/per610a/home/mvp/mvp_db/news7-lv/2014/2014_07_19_19_00/2014_07_19_19_00.mpg;Shinzo ABE.jpg;20621;22473;36085;1032;1124;92
/net/per610a/home/mvp/mvp_db/news7-lv/2014/2014_07_20_19_00/2014_07_20_19_00.mpg;Shinzo ABE.jpg;20665;22369;36089;1034;1119;85
/net/per610a/home/mvp/mvp_db/news7-lv/2014/2014_07_20_19_00/2014_07_20_19_00.mpg;Shinzo ABE.jpg;22449;22885;36089;1123;1145;22
/net/per610a/home/mvp/mvp_db/news7-lv/2014/2014_07_22_19_00/2014_07_22_19_00.mpg;Taro ASO.jpg;13361;13797;36081;668;690;22
/net/per610a/home/mvp/mvp_db/news7-lv/2014/2014_07_22_19_00/2014_07_22_19_00.mpg;Shinzo ABE.jpg;20757;21393;36081;1038;1070;32
/net/per610a/home/mvp/mvp_db/news7-lv/2014/2014_07_22_19_00/2014_07_22_19_00.mpg;Shinzo ABE.jpg;23905;23937;36081;1195;1197;2
/net/per610a/home/mvp/mvp_db/news7-lv/2014/2014_07_22_19_00/2014_07_22_19_00.mpg;Shinzo ABE.jpg;24025;24217;36081;1201;1211;10
/net/per610a/home/mvp/mvp_db/news7-lv/2014/2014_07_31_19_00/2014_07_31_19_00.mpg;Bairi Kaieda.jpg;20045;20417;36085;1003;1021;18
/net/per610a/home/mvp/mvp_db/news7-lv/2014/2014_07_31_19_00/2014_07_31_19_00.mpg;Ichiro OZAWA.jpg;25917;26037;36085;1297;1303;6
/net/per610a/home/mvp/mvp_db/news7-lv/2014/2014_08_01_19_00/2014_08_01_19_00.mpg;Shintaro ISHIHARA.jpg;28213;28357;36089;1411;1419;8
/net/per610a/home/mvp/mvp_db/news7-lv/2014/2014_08_01_19_00/2014_08_01_19_00.mpg;Shintaro ISHIHARA.jpg;28501;28517;36089;1426;1427;1
/net/per610a/home/mvp/mvp_db/news7-lv/2014/2014_08_01_19_00/2014_08_01_19_00.mpg;Shintaro ISHIHARA.jpg;29893;29909;36089;1495;1496;1
/net/per610a/home/mvp/mvp_db/news7-lv/2014/2014_08_02_19_00/2014_08_02_19_00.mpg;Shinzo ABE.jpg;22025;22105;36085;1102;1106;4
/net/per610a/home/mvp/mvp_db/news7-lv/2014/2014_08_02_19_00/2014_08_02_19_00.mpg;Shinzo ABE.jpg;22733;22965;36085;1137;1149;12
/net/per610a/home/mvp/mvp_db/news7-lv/2014/2014_08_02_19_00/2014_08_02_19_00.mpg;Shinzo ABE.jpg;23561;23609;36085;1179;1181;2
/net/per610a/home/mvp/mvp_db/news7-lv/2014/2014_08_03_19_00/2014_08_03_19_00.mpg;Toru Hashimoto.jpg;20489;21153;38485;1025;1058;33
/net/per610a/home/mvp/mvp_db/news7-lv/2014/2014_08_03_19_00/2014_08_03_19_00.mpg;Toru Hashimoto.jpg;21689;21793;38485;1085;1090;5
/net/per610a/home/mvp/mvp_db/news7-lv/2014/2014_08_03_19_00/2014_08_03_19_00.mpg;Toru Hashimoto.jpg;22045;22217;38485;1103;1111;8
/net/per610a/home/mvp/mvp_db/news7-lv/2014/2014_08_03_19_00/2014_08_03_19_00.mpg;Kenji Eda.jpg;21477;21613;38485;1074;1081;7
/net/per610a/home/mvp/mvp_db/news7-lv/2014/2014_08_04_19_00/2014_08_04_19_00.mpg;Shinzo ABE.jpg;24597;25313;36085;1231;1266;35
/net/per610a/home/mvp/mvp_db/news7-lv/2014/2014_08_09_19_00/2014_08_09_19_00.mpg;Shinzo ABE.jpg;39793;40441;48069;1990;2023;33
/net/per610a/home/mvp/mvp_db/news7-lv/2014/2014_08_11_19_00/2014_08_11_19_00.mpg;Shinzo ABE.jpg;19013;19029;36085;951;952;1
/net/per610a/home/mvp/mvp_db/news7-lv/2014/2014_08_11_19_00/2014_08_11_19_00.mpg;Shinzo ABE.jpg;19837;20205;36085;992;1011;19
/net/per610a/home/mvp/mvp_db/news7-lv/2014/2014_08_11_19_00/2014_08_11_19_00.mpg;Shinzo ABE.jpg;20477;20537;36085;1024;1027;3
/net/per610a/home/mvp/mvp_db/news7-lv/2014/2014_08_11_19_00/2014_08_11_19_00.mpg;Shinzo ABE.jpg;20725;20857;36085;1037;1043;6
/net/per610a/home/mvp/mvp_db/news7-lv/2014/2014_08_11_19_00/2014_08_11_19_00.mpg;Shinzo ABE.jpg;21001;21661;36085;1051;1084;33
/net/per610a/home/mvp/mvp_db/news7-lv/2014/2014_08_11_19_00/2014_08_11_19_00.mpg;Shinzo ABE.jpg;19125;19133;36085;957;957;0
/net/per610a/home/mvp/mvp_db/news7-lv/2014/2014_08_11_19_00/2014_08_11_19_00.mpg;Shinzo ABE.jpg;19217;19437;36085;961;972;11
/net/per610a/home/mvp/mvp_db/news7-lv/2014/2014_08_13_19_00/2014_08_13_19_00.mpg;Shinzo ABE.jpg;25013;25293;36081;1251;1265;14
/net/per610a/home/mvp/mvp_db/news7-lv/2014/2014_08_15_19_00/2014_08_15_19_00.mpg;Shinzo ABE.jpg;17377;17485;36085;869;875;6
/net/per610a/home/mvp/mvp_db/news7-lv/2014/2014_08_15_19_00/2014_08_15_19_00.mpg;Shinzo ABE.jpg;17557;17593;36085;878;880;2
/net/per610a/home/mvp/mvp_db/news7-lv/2014/2014_08_21_19_00/2014_08_21_19_00.mpg;Yukiko Kada.jpg;7617;7901;36077;381;395;14
/net/per610a/home/mvp/mvp_db/news7-lv/2014/2014_08_21_19_00/2014_08_21_19_00.mpg;Shinzo ABE.jpg;21293;21597;36077;1065;1080;15
/net/per610a/home/mvp/mvp_db/news7-lv/2014/2014_08_21_19_00/2014_08_21_19_00.mpg;Shinzo ABE.jpg;21753;21929;36077;1088;1097;9
/net/per610a/home/mvp/mvp_db/news7-lv/2014/2014_08_25_19_00/2014_08_25_19_00.mpg;Shinzo ABE.jpg;4673;4673;36085;233;233;0
/net/per610a/home/mvp/mvp_db/news7-lv/2014/2014_08_25_19_00/2014_08_25_19_00.mpg;Shinzo ABE.jpg;5013;5501;36085;250;275;25
/net/per610a/home/mvp/mvp_db/news7-lv/2014/2014_08_25_19_00/2014_08_25_19_00.mpg;Shinzo ABE.jpg;14393;14573;36085;720;729;9
/net/per610a/home/mvp/mvp_db/news7-lv/2014/2014_08_28_19_00/2014_08_28_19_00.mpg;Shinzo ABE.jpg;24313;24689;36089;1216;1235;19
/net/per610a/home/mvp/mvp_db/news7-lv/2014/2014_08_29_19_00/2014_08_29_19_00.mpg;Shinzo ABE.jpg;93;117;36085;4;5;1
/net/per610a/home/mvp/mvp_db/news7-lv/2014/2014_08_29_19_00/2014_08_29_19_00.mpg;Shinzo ABE.jpg;1249;1545;36085;62;77;15
/net/per610a/home/mvp/mvp_db/news7-lv/2014/2014_08_29_19_00/2014_08_29_19_00.mpg;Shinzo ABE.jpg;7009;7105;36085;350;355;5
/net/per610a/home/mvp/mvp_db/news7-lv/2014/2014_08_29_19_00/2014_08_29_19_00.mpg;Shinzo ABE.jpg;393;481;36085;19;24;5
/net/per610a/home/mvp/mvp_db/news7-lv/2014/2014_08_29_19_00/2014_08_29_19_00.mpg;Shinzo ABE.jpg;713;1213;36085;35;60;25
/net/per610a/home/mvp/mvp_db/news7-lv/2014/2014_08_29_19_00/2014_08_29_19_00.mpg;Shinzo ABE.jpg;1569;2117;36085;78;105;27
/net/per610a/home/mvp/mvp_db/news7-lv/2014/2014_08_29_19_00/2014_08_29_19_00.mpg;Shinzo ABE.jpg;4917;5109;36085;246;255;9
/net/per610a/home/mvp/mvp_db/news7-lv/2014/2014_08_29_19_00/2014_08_29_19_00.mpg;Shinzo ABE.jpg;5841;6321;36085;292;316;24
/net/per610a/home/mvp/mvp_db/news7-lv/2014/2014_08_29_19_00/2014_08_29_19_00.mpg;Natsuo YAMAGUCHI.jpg;4341;4345;36085;217;217;0
/net/per610a/home/mvp/mvp_db/news7-lv/2014/2014_08_29_19_00/2014_08_29_19_00.mpg;Natsuo YAMAGUCHI.jpg;4453;4597;36085;222;230;8
/net/per610a/home/mvp/mvp_db/news7-lv/2014/2014_08_31_19_00/2014_08_31_19_00.mpg;Shinzo ABE.jpg;32953;33573;36081;1648;1679;31
/net/per610a/home/mvp/mvp_db/news7-lv/2014/2014_09_02_19_00/2014_09_02_19_00.mpg;Shinzo ABE.jpg;1397;1649;36085;69;82;13
/net/per610a/home/mvp/mvp_db/news7-lv/2014/2014_09_02_19_00/2014_09_02_19_00.mpg;Shinzo ABE.jpg;1729;1733;36085;86;86;0
/net/per610a/home/mvp/mvp_db/news7-lv/2014/2014_09_02_19_00/2014_09_02_19_00.mpg;Shinzo ABE.jpg;1873;1993;36085;93;99;6
/net/per610a/home/mvp/mvp_db/news7-lv/2014/2014_09_02_19_00/2014_09_02_19_00.mpg;Shinzo ABE.jpg;3833;3949;36085;191;197;6
/net/per610a/home/mvp/mvp_db/news7-lv/2014/2014_09_03_19_00/2014_09_03_19_00.mpg;Shinzo ABE.jpg;177;277;38481;8;13;5
/net/per610a/home/mvp/mvp_db/news7-lv/2014/2014_09_03_19_00/2014_09_03_19_00.mpg;Shinzo ABE.jpg;15353;15509;38481;768;776;8
/net/per610a/home/mvp/mvp_db/news7-lv/2014/2014_09_03_19_00/2014_09_03_19_00.mpg;Shinzo ABE.jpg;16581;16713;38481;829;836;7
/net/per610a/home/mvp/mvp_db/news7-lv/2014/2014_09_03_19_00/2014_09_03_19_00.mpg;Shinzo ABE.jpg;17685;17765;38481;885;889;4
/net/per610a/home/mvp/mvp_db/news7-lv/2014/2014_09_03_19_00/2014_09_03_19_00.mpg;Sadakazu TANIGAKI.jpg;1049;1393;38481;52;69;17
/net/per610a/home/mvp/mvp_db/news7-lv/2014/2014_09_03_19_00/2014_09_03_19_00.mpg;Sadakazu TANIGAKI.jpg;3557;3561;38481;178;178;0
/net/per610a/home/mvp/mvp_db/news7-lv/2014/2014_09_03_19_00/2014_09_03_19_00.mpg;Shinzo ABE.jpg;2193;2193;38481;109;109;0
/net/per610a/home/mvp/mvp_db/news7-lv/2014/2014_09_03_19_00/2014_09_03_19_00.mpg;Shinzo ABE.jpg;10097;11949;38481;505;598;93
/net/per610a/home/mvp/mvp_db/news7-lv/2014/2014_09_03_19_00/2014_09_03_19_00.mpg;Shinzo ABE.jpg;12057;12773;38481;603;639;36
/net/per610a/home/mvp/mvp_db/news7-lv/2014/2014_09_03_19_00/2014_09_03_19_00.mpg;Shinzo ABE.jpg;15773;16577;38481;789;829;40
/net/per610a/home/mvp/mvp_db/news7-lv/2014/2014_09_03_19_00/2014_09_03_19_00.mpg;Shinzo ABE.jpg;16861;17285;38481;843;865;22
/net/per610a/home/mvp/mvp_db/news7-lv/2014/2014_09_03_19_00/2014_09_03_19_00.mpg;Sadakazu TANIGAKI.jpg;2261;2765;38481;113;138;25
/net/per610a/home/mvp/mvp_db/news7-lv/2014/2014_09_04_19_00/2014_09_04_19_00.mpg;Natsuo YAMAGUCHI.jpg;28697;29349;36085;1436;1468;32
/net/per610a/home/mvp/mvp_db/news7-lv/2014/2014_09_05_19_00/2014_09_05_19_00.mpg;Shinzo ABE.jpg;13905;13949;36085;695;698;3
/net/per610a/home/mvp/mvp_db/news7-lv/2014/2014_09_05_19_00/2014_09_05_19_00.mpg;Shinzo ABE.jpg;14021;14037;36085;701;702;1
/net/per610a/home/mvp/mvp_db/news7-lv/2014/2014_09_05_19_00/2014_09_05_19_00.mpg;Shinzo ABE.jpg;14525;14881;36085;726;744;18
/net/per610a/home/mvp/mvp_db/news7-lv/2014/2014_09_06_19_00/2014_09_06_19_00.mpg;Ichiro OZAWA.jpg;16881;17085;36085;844;855;11
/net/per610a/home/mvp/mvp_db/news7-lv/2014/2014_09_07_19_00/2014_09_07_19_00.mpg;Kenji Eda.jpg;30501;30841;36081;1525;1542;17
/net/per610a/home/mvp/mvp_db/news7-lv/2014/2014_09_08_19_00/2014_09_08_19_00.mpg;Shinzo ABE.jpg;14333;14657;36085;717;733;16
/net/per610a/home/mvp/mvp_db/news7-lv/2014/2014_09_08_19_00/2014_09_08_19_00.mpg;Shinzo ABE.jpg;16721;16757;36085;836;838;2
/net/per610a/home/mvp/mvp_db/news7-lv/2014/2014_09_08_19_00/2014_09_08_19_00.mpg;Shinzo ABE.jpg;17669;17797;36085;884;890;6
/net/per610a/home/mvp/mvp_db/news7-lv/2014/2014_09_08_19_00/2014_09_08_19_00.mpg;Shinzo ABE.jpg;21633;21757;36085;1082;1088;6
/net/per610a/home/mvp/mvp_db/news7-lv/2014/2014_09_08_19_00/2014_09_08_19_00.mpg;Sadakazu TANIGAKI.jpg;16853;16913;36085;843;846;3
/net/per610a/home/mvp/mvp_db/news7-lv/2014/2014_09_08_19_00/2014_09_08_19_00.mpg;Sadakazu TANIGAKI.jpg;17069;17277;36085;854;864;10
/net/per610a/home/mvp/mvp_db/news7-lv/2014/2014_09_08_19_00/2014_09_08_19_00.mpg;Sadakazu TANIGAKI.jpg;17369;17525;36085;869;877;8
/net/per610a/home/mvp/mvp_db/news7-lv/2014/2014_09_10_19_00/2014_09_10_19_00.mpg;Shinzo ABE.jpg;28653;29073;38481;1433;1454;21
/net/per610a/home/mvp/mvp_db/news7-lv/2014/2014_09_10_19_00/2014_09_10_19_00.mpg;Shinzo ABE.jpg;31261;31333;38481;1563;1567;4
/net/per610a/home/mvp/mvp_db/news7-lv/2014/2014_09_10_19_00/2014_09_10_19_00.mpg;Ichiro OZAWA.jpg;32509;32557;38481;1626;1628;2
/net/per610a/home/mvp/mvp_db/news7-lv/2014/2014_09_10_19_00/2014_09_10_19_00.mpg;Ichiro OZAWA.jpg;32629;33477;38481;1632;1674;42
/net/per610a/home/mvp/mvp_db/news7-lv/2014/2014_09_11_19_00/2014_09_11_19_00.mpg;Shinzo ABE.jpg;30549;30577;36085;1528;1530;2
/net/per610a/home/mvp/mvp_db/news7-lv/2014/2014_09_11_19_00/2014_09_11_19_00.mpg;Shinzo ABE.jpg;31157;31749;36085;1559;1588;29
/net/per610a/home/mvp/mvp_db/news7-lv/2014/2014_09_12_19_00/2014_09_12_19_00.mpg;Shinzo ABE.jpg;20733;21413;36081;1037;1071;34
/net/per610a/home/mvp/mvp_db/news7-lv/2014/2014_09_12_19_00/2014_09_12_19_00.mpg;Shinzo ABE.jpg;23313;23677;36081;1166;1185;19
/net/per610a/home/mvp/mvp_db/news7-lv/2014/2014_09_13_19_00/2014_09_13_19_00.mpg;Shinzo ABE.jpg;11637;12269;36085;582;614;32
/net/per610a/home/mvp/mvp_db/news7-lv/2014/2014_09_13_19_00/2014_09_13_19_00.mpg;Shinzo ABE.jpg;12597;13081;36085;630;654;24
/net/per610a/home/mvp/mvp_db/news7-lv/2014/2014_09_13_19_00/2014_09_13_19_00.mpg;Sadakazu TANIGAKI.jpg;19749;20833;36085;988;1042;54
/net/per610a/home/mvp/mvp_db/news7-lv/2014/2014_09_13_19_00/2014_09_13_19_00.mpg;Sadakazu TANIGAKI.jpg;20897;21069;36085;1045;1054;9
/net/per610a/home/mvp/mvp_db/news7-lv/2014/2014_09_14_19_00/2014_09_14_19_00.mpg;Shinzo ABE.jpg;12853;13213;36085;643;661;18
/net/per610a/home/mvp/mvp_db/news7-lv/2014/2014_09_14_19_00/2014_09_14_19_00.mpg;Shinzo ABE.jpg;26197;26901;36085;1311;1346;35
/net/per610a/home/mvp/mvp_db/news7-lv/2014/2014_09_16_19_00/2014_09_16_19_00.mpg;Bairi Kaieda.jpg;22217;22597;36085;1111;1130;19
/net/per610a/home/mvp/mvp_db/news7-lv/2014/2014_09_16_19_00/2014_09_16_19_00.mpg;Bairi Kaieda.jpg;22665;22697;36085;1134;1135;1
/net/per610a/home/mvp/mvp_db/news7-lv/2014/2014_09_16_19_00/2014_09_16_19_00.mpg;Bairi Kaieda.jpg;24713;24765;36085;1236;1239;3
/net/per610a/home/mvp/mvp_db/news7-lv/2014/2014_09_16_19_00/2014_09_16_19_00.mpg;Katsuya OKADA.jpg;22665;22705;36085;1134;1136;2
/net/per610a/home/mvp/mvp_db/news7-lv/2014/2014_09_16_19_00/2014_09_16_19_00.mpg;Katsuya OKADA.jpg;25121;25137;36085;1257;1258;1
/net/per610a/home/mvp/mvp_db/news7-lv/2014/2014_09_16_19_00/2014_09_16_19_00.mpg;Katsuya OKADA.jpg;25297;25453;36085;1266;1273;7
/net/per610a/home/mvp/mvp_db/news7-lv/2014/2014_09_16_19_00/2014_09_16_19_00.mpg;Yukio EDANO.jpg;22885;22933;36085;1145;1147;2
/net/per610a/home/mvp/mvp_db/news7-lv/2014/2014_09_16_19_00/2014_09_16_19_00.mpg;Yukio EDANO.jpg;23341;24669;36085;1168;1234;66
/net/per610a/home/mvp/mvp_db/news7-lv/2014/2014_09_17_19_00/2014_09_17_19_00.mpg;Shinzo ABE.jpg;17173;17177;36085;859;859;0
/net/per610a/home/mvp/mvp_db/news7-lv/2014/2014_09_17_19_00/2014_09_17_19_00.mpg;Shinzo ABE.jpg;20209;20841;36085;1011;1043;32
/net/per610a/home/mvp/mvp_db/news7-lv/2014/2014_09_17_19_00/2014_09_17_19_00.mpg;Shinzo ABE.jpg;21301;21665;36085;1066;1084;18
/net/per610a/home/mvp/mvp_db/news7-lv/2014/2014_09_17_19_00/2014_09_17_19_00.mpg;Shinzo ABE.jpg;21833;21845;36085;1092;1093;1
/net/per610a/home/mvp/mvp_db/news7-lv/2014/2014_09_17_19_00/2014_09_17_19_00.mpg;Shinzo ABE.jpg;22345;22881;36085;1118;1145;27
/net/per610a/home/mvp/mvp_db/news7-lv/2014/2014_09_17_19_00/2014_09_17_19_00.mpg;Ichiro OZAWA.jpg;23565;24361;36085;1179;1219;40
/net/per610a/home/mvp/mvp_db/news7-lv/2014/2014_09_18_19_00/2014_09_18_19_00.mpg;Sadakazu TANIGAKI.jpg;26729;26865;36085;1337;1344;7
/net/per610a/home/mvp/mvp_db/news7-lv/2014/2014_09_19_19_00/2014_09_19_19_00.mpg;Shinzo ABE.jpg;21917;22713;36085;1096;1136;40
/net/per610a/home/mvp/mvp_db/news7-lv/2014/2014_09_19_19_00/2014_09_19_19_00.mpg;Yukiko Kada.jpg;22897;23017;36085;1145;1151;6
/net/per610a/home/mvp/mvp_db/news7-lv/2014/2014_09_21_19_00/2014_09_21_19_00.mpg;Shinzo ABE.jpg;7701;8853;36085;385;443;58
/net/per610a/home/mvp/mvp_db/news7-lv/2014/2014_09_21_19_00/2014_09_21_19_00.mpg;Shinzo ABE.jpg;8961;9049;36085;448;452;4
/net/per610a/home/mvp/mvp_db/news7-lv/2014/2014_09_21_19_00/2014_09_21_19_00.mpg;Ichiro OZAWA.jpg;12797;13057;36085;640;653;13
/net/per610a/home/mvp/mvp_db/news7-lv/2014/2014_09_21_19_00/2014_09_21_19_00.mpg;Kenji Eda.jpg;19465;19857;36085;974;993;19
/net/per610a/home/mvp/mvp_db/news7-lv/2014/2014_09_21_19_00/2014_09_21_19_00.mpg;Kenji Eda.jpg;20489;20825;36085;1025;1042;17
/net/per610a/home/mvp/mvp_db/news7-lv/2014/2014_09_21_19_00/2014_09_21_19_00.mpg;Kenji Eda.jpg;21609;21677;36085;1081;1084;3
/net/per610a/home/mvp/mvp_db/news7-lv/2014/2014_09_21_19_00/2014_09_21_19_00.mpg;Toru Hashimoto.jpg;19977;20485;36085;999;1025;26
/net/per610a/home/mvp/mvp_db/news7-lv/2014/2014_09_21_19_00/2014_09_21_19_00.mpg;Toru Hashimoto.jpg;21517;21577;36085;1076;1079;3
/net/per610a/home/mvp/mvp_db/news7-lv/2014/2014_09_21_19_00/2014_09_21_19_00.mpg;Taro ASO.jpg;28281;28465;36085;1415;1424;9
/net/per610a/home/mvp/mvp_db/news7-lv/2014/2014_09_23_19_00/2014_09_23_19_00.mpg;Shinzo ABE.jpg;8041;8841;36085;402;442;40
/net/per610a/home/mvp/mvp_db/news7-lv/2014/2014_09_23_19_00/2014_09_23_19_00.mpg;Shinzo ABE.jpg;9497;9637;36085;475;482;7
/net/per610a/home/mvp/mvp_db/news7-lv/2014/2014_09_23_19_00/2014_09_23_19_00.mpg;Shinzo ABE.jpg;9973;10337;36085;499;517;18
/net/per610a/home/mvp/mvp_db/news7-lv/2014/2014_09_25_19_00/2014_09_25_19_00.mpg;Yukio EDANO.jpg;31421;31657;36093;1572;1584;12
/net/per610a/home/mvp/mvp_db/news7-lv/2014/2014_09_26_19_00/2014_09_26_19_00.mpg;Shinzo ABE.jpg;9301;9553;36085;465;478;13
/net/per610a/home/mvp/mvp_db/news7-lv/2014/2014_09_26_19_00/2014_09_26_19_00.mpg;Shinzo ABE.jpg;14189;14249;36085;710;713;3
/net/per610a/home/mvp/mvp_db/news7-lv/2014/2014_09_26_19_00/2014_09_26_19_00.mpg;Shinzo ABE.jpg;14509;14633;36085;726;732;6
/net/per610a/home/mvp/mvp_db/news7-lv/2014/2014_09_26_19_00/2014_09_26_19_00.mpg;Shinzo ABE.jpg;14769;14933;36085;739;747;8
/net/per610a/home/mvp/mvp_db/news7-lv/2014/2014_09_26_19_00/2014_09_26_19_00.mpg;Shinzo ABE.jpg;15181;15181;36085;759;759;0
/net/per610a/home/mvp/mvp_db/news7-lv/2014/2014_09_26_19_00/2014_09_26_19_00.mpg;Shinzo ABE.jpg;15701;16085;36085;785;805;20
/net/per610a/home/mvp/mvp_db/news7-lv/2014/2014_09_26_19_00/2014_09_26_19_00.mpg;Shinzo ABE.jpg;16225;16401;36085;812;820;8
/net/per610a/home/mvp/mvp_db/news7-lv/2014/2014_09_26_19_00/2014_09_26_19_00.mpg;Shinzo ABE.jpg;16517;16765;36085;826;839;13
/net/per610a/home/mvp/mvp_db/news7-lv/2014/2014_09_26_19_00/2014_09_26_19_00.mpg;Shinzo ABE.jpg;17365;17489;36085;869;875;6
/net/per610a/home/mvp/mvp_db/news7-lv/2014/2014_09_26_19_00/2014_09_26_19_00.mpg;Shinzo ABE.jpg;18609;19141;36085;931;957;26
/net/per610a/home/mvp/mvp_db/news7-lv/2014/2014_09_26_19_00/2014_09_26_19_00.mpg;Shinzo ABE.jpg;19289;19797;36085;965;990;25
/net/per610a/home/mvp/mvp_db/news7-lv/2014/2014_09_29_19_00/2014_09_29_19_00.mpg;Sadakazu TANIGAKI.jpg;17981;20233;38485;899;1012;113
/net/per610a/home/mvp/mvp_db/news7-lv/2014/2014_09_29_19_00/2014_09_29_19_00.mpg;Ichiro OZAWA.jpg;30133;30165;38485;1508;1509;1
/net/per610a/home/mvp/mvp_db/news7-lv/2014/2014_09_29_19_00/2014_09_29_19_00.mpg;Ichiro OZAWA.jpg;31809;32301;38485;1591;1616;25
/net/per610a/home/mvp/mvp_db/news7-lv/2014/2014_09_30_19_00/2014_09_30_19_00.mpg;Shinzo ABE.jpg;149;749;36081;7;37;30
/net/per610a/home/mvp/mvp_db/news7-lv/2014/2014_09_30_19_00/2014_09_30_19_00.mpg;Ichiro OZAWA.jpg;2057;2729;36081;102;136;34
/net/per610a/home/mvp/mvp_db/news7-lv/2014/2014_09_30_19_00/2014_09_30_19_00.mpg;Kenji Eda.jpg;29033;30001;36081;1452;1500;48
/net/per610a/home/mvp/mvp_db/news7-lv/2014/2014_10_07_19_00/2014_10_07_19_00.mpg;Shinzo ABE.jpg;58613;58661;72041;2933;2935;2
/net/per610a/home/mvp/mvp_db/news7-lv/2014/2014_10_07_19_00/2014_10_07_19_00.mpg;Shinzo ABE.jpg;58917;59157;72041;2948;2960;12
/net/per610a/home/mvp/mvp_db/news7-lv/2014/2014_10_07_19_00/2014_10_07_19_00.mpg;Shinzo ABE.jpg;59845;61465;72041;2994;3075;81
/net/per610a/home/mvp/mvp_db/news7-lv/2014/2014_10_14_19_00/2014_10_14_19_00.mpg;Shinzo ABE.jpg;1205;1421;36085;60;71;11
/net/per610a/home/mvp/mvp_db/news7-lv/2014/2014_10_14_19_00/2014_10_14_19_00.mpg;Shinzo ABE.jpg;1789;1993;36085;89;99;10
/net/per610a/home/mvp/mvp_db/news7-lv/2014/2014_10_14_19_00/2014_10_14_19_00.mpg;Shinzo ABE.jpg;22133;22133;36085;1107;1107;0
/net/per610a/home/mvp/mvp_db/news7-lv/2014/2014_10_14_19_00/2014_10_14_19_00.mpg;Shinzo ABE.jpg;22421;22829;36085;1122;1142;20
/net/per610a/home/mvp/mvp_db/news7-lv/2014/2014_10_14_19_00/2014_10_14_19_00.mpg;Shinzo ABE.jpg;25397;25745;36085;1271;1288;17
/net/per610a/home/mvp/mvp_db/news7-lv/2014/2014_10_14_19_00/2014_10_14_19_00.mpg;Shinzo ABE.jpg;27989;28433;36085;1400;1423;23
/net/per610a/home/mvp/mvp_db/news7-lv/2014/2014_10_14_19_00/2014_10_14_19_00.mpg;Shinzo ABE.jpg;23581;23949;36085;1180;1198;18
/net/per610a/home/mvp/mvp_db/news7-lv/2014/2014_10_14_19_00/2014_10_14_19_00.mpg;Shinzo ABE.jpg;24745;24821;36085;1238;1242;4
/net/per610a/home/mvp/mvp_db/news7-lv/2014/2014_10_15_19_00/2014_10_15_19_00.mpg;Shinzo ABE.jpg;32513;32537;36089;1627;1628;1
/net/per610a/home/mvp/mvp_db/news7-lv/2014/2014_10_15_19_00/2014_10_15_19_00.mpg;Shinzo ABE.jpg;32625;32817;36089;1632;1642;10
/net/per610a/home/mvp/mvp_db/news7-lv/2014/2014_10_17_19_00/2014_10_17_19_00.mpg;Shinzo ABE.jpg;165;189;36085;8;9;1
/net/per610a/home/mvp/mvp_db/news7-lv/2014/2014_10_17_19_00/2014_10_17_19_00.mpg;Shinzo ABE.jpg;10477;11173;36085;524;559;35
/net/per610a/home/mvp/mvp_db/news7-lv/2014/2014_10_17_19_00/2014_10_17_19_00.mpg;Shinzo ABE.jpg;17245;17281;36085;863;864;1
/net/per610a/home/mvp/mvp_db/news7-lv/2014/2014_10_17_19_00/2014_10_17_19_00.mpg;Sadakazu TANIGAKI.jpg;6129;7105;36085;306;355;49
/net/per610a/home/mvp/mvp_db/news7-lv/2014/2014_10_17_19_00/2014_10_17_19_00.mpg;Shinzo ABE.jpg;15809;16233;36085;791;812;21
/net/per610a/home/mvp/mvp_db/news7-lv/2014/2014_10_18_19_00/2014_10_18_19_00.mpg;Yukiko Kada.jpg;8277;8585;36081;414;429;15
/net/per610a/home/mvp/mvp_db/news7-lv/2014/2014_10_19_19_00/2014_10_19_19_00.mpg;Shinzo ABE.jpg;1257;1769;36081;62;88;26
/net/per610a/home/mvp/mvp_db/news7-lv/2014/2014_10_19_19_00/2014_10_19_19_00.mpg;Shinzo ABE.jpg;5809;5813;36081;290;290;0
/net/per610a/home/mvp/mvp_db/news7-lv/2014/2014_10_20_19_00/2014_10_20_19_00.mpg;Shinzo ABE.jpg;409;441;38481;20;22;2
/net/per610a/home/mvp/mvp_db/news7-lv/2014/2014_10_20_19_00/2014_10_20_19_00.mpg;Shinzo ABE.jpg;22529;23429;38481;1127;1172;45
/net/per610a/home/mvp/mvp_db/news7-lv/2014/2014_10_20_19_00/2014_10_20_19_00.mpg;Shinzo ABE.jpg;23565;23877;38481;1178;1194;16
/net/per610a/home/mvp/mvp_db/news7-lv/2014/2014_10_20_19_00/2014_10_20_19_00.mpg;Shinzo ABE.jpg;5885;5921;38481;294;296;2
/net/per610a/home/mvp/mvp_db/news7-lv/2014/2014_10_20_19_00/2014_10_20_19_00.mpg;Shinzo ABE.jpg;23881;24197;38481;1194;1210;16
/net/per610a/home/mvp/mvp_db/news7-lv/2014/2014_10_20_19_00/2014_10_20_19_00.mpg;Shinzo ABE.jpg;24353;24509;38481;1218;1226;8
/net/per610a/home/mvp/mvp_db/news7-lv/2014/2014_10_21_19_00/2014_10_21_19_00.mpg;Shinzo ABE.jpg;2217;2233;36085;110;111;1
/net/per610a/home/mvp/mvp_db/news7-lv/2014/2014_10_21_19_00/2014_10_21_19_00.mpg;Shinzo ABE.jpg;8069;8093;36085;403;405;2
/net/per610a/home/mvp/mvp_db/news7-lv/2014/2014_10_21_19_00/2014_10_21_19_00.mpg;Shinzo ABE.jpg;26849;27545;36085;1343;1378;35
/net/per610a/home/mvp/mvp_db/news7-lv/2014/2014_10_21_19_00/2014_10_21_19_00.mpg;Sadakazu TANIGAKI.jpg;3125;3213;36085;156;160;4
/net/per610a/home/mvp/mvp_db/news7-lv/2014/2014_10_21_19_00/2014_10_21_19_00.mpg;Sadakazu TANIGAKI.jpg;3329;3889;36085;166;194;28
/net/per610a/home/mvp/mvp_db/news7-lv/2014/2014_10_21_19_00/2014_10_21_19_00.mpg;Taro ASO.jpg;9921;10333;36085;496;517;21
/net/per610a/home/mvp/mvp_db/news7-lv/2014/2014_10_22_19_00/2014_10_22_19_00.mpg;Shinzo ABE.jpg;1229;1769;36081;61;88;27
/net/per610a/home/mvp/mvp_db/news7-lv/2014/2014_10_22_19_00/2014_10_22_19_00.mpg;Shinzo ABE.jpg;1897;2533;36081;94;126;32
/net/per610a/home/mvp/mvp_db/news7-lv/2014/2014_10_22_19_00/2014_10_22_19_00.mpg;Shinzo ABE.jpg;5273;5605;36081;263;280;17
/net/per610a/home/mvp/mvp_db/news7-lv/2014/2014_10_22_19_00/2014_10_22_19_00.mpg;Shinzo ABE.jpg;30613;30889;36081;1531;1545;14
/net/per610a/home/mvp/mvp_db/news7-lv/2014/2014_10_22_19_00/2014_10_22_19_00.mpg;Shinzo ABE.jpg;30973;31469;36081;1549;1574;25
/net/per610a/home/mvp/mvp_db/news7-lv/2014/2014_10_22_19_00/2014_10_22_19_00.mpg;Shinzo ABE.jpg;32617;33137;36081;1631;1657;26
/net/per610a/home/mvp/mvp_db/news7-lv/2014/2014_10_26_19_00/2014_10_26_19_00.mpg;Shinzo ABE.jpg;9941;10425;36085;497;521;24
/net/per610a/home/mvp/mvp_db/news7-lv/2014/2014_10_26_19_00/2014_10_26_19_00.mpg;Shinzo ABE.jpg;10693;10777;36085;535;539;4
/net/per610a/home/mvp/mvp_db/news7-lv/2014/2014_10_26_19_00/2014_10_26_19_00.mpg;Shinzo ABE.jpg;10861;11529;36085;543;577;34
/net/per610a/home/mvp/mvp_db/news7-lv/2014/2014_10_26_19_00/2014_10_26_19_00.mpg;Shinzo ABE.jpg;18729;18997;36085;937;950;13
/net/per610a/home/mvp/mvp_db/news7-lv/2014/2014_10_26_19_00/2014_10_26_19_00.mpg;Yukio EDANO.jpg;31809;32561;36085;1591;1629;38
/net/per610a/home/mvp/mvp_db/news7-lv/2014/2014_10_28_19_00/2014_10_28_19_00.mpg;Shinzo ABE.jpg;20117;20669;36081;1006;1033;27
/net/per610a/home/mvp/mvp_db/news7-lv/2014/2014_10_28_19_00/2014_10_28_19_00.mpg;Shinzo ABE.jpg;20881;20985;36081;1044;1049;5
/net/per610a/home/mvp/mvp_db/news7-lv/2014/2014_10_28_19_00/2014_10_28_19_00.mpg;Shinzo ABE.jpg;23357;23829;36081;1168;1192;24
/net/per610a/home/mvp/mvp_db/news7-lv/2014/2014_10_30_19_00/2014_10_30_19_00.mpg;Sadakazu TANIGAKI.jpg;10477;11621;36073;524;581;57
/net/per610a/home/mvp/mvp_db/news7-lv/2014/2014_10_30_19_00/2014_10_30_19_00.mpg;Shinzo ABE.jpg;13521;13549;36073;676;677;1
/net/per610a/home/mvp/mvp_db/news7-lv/2014/2014_10_30_19_00/2014_10_30_19_00.mpg;Shinzo ABE.jpg;16425;16997;36073;821;850;29
/net/per610a/home/mvp/mvp_db/news7-lv/2014/2014_11_02_19_00/2014_11_02_19_00.mpg;Shinzo ABE.jpg;9713;9845;36081;485;492;7
/net/per610a/home/mvp/mvp_db/news7-lv/2014/2014_11_02_19_00/2014_11_02_19_00.mpg;Shinzo ABE.jpg;11673;11873;36081;583;593;10
/net/per610a/home/mvp/mvp_db/news7-lv/2014/2014_11_04_19_00/2014_11_04_19_00.mpg;Taro ASO.jpg;15037;15389;36077;752;769;17
/net/per610a/home/mvp/mvp_db/news7-lv/2014/2014_11_04_19_00/2014_11_04_19_00.mpg;Taro ASO.jpg;27245;27341;36077;1363;1367;4
/net/per610a/home/mvp/mvp_db/news7-lv/2014/2014_11_04_19_00/2014_11_04_19_00.mpg;Shinzo ABE.jpg;18097;18257;36077;905;913;8
/net/per610a/home/mvp/mvp_db/news7-lv/2014/2014_11_04_19_00/2014_11_04_19_00.mpg;Shinzo ABE.jpg;19497;20313;36077;975;1016;41
/net/per610a/home/mvp/mvp_db/news7-lv/2014/2014_11_04_19_00/2014_11_04_19_00.mpg;Shinzo ABE.jpg;24941;24989;36077;1247;1250;3
/net/per610a/home/mvp/mvp_db/news7-lv/2014/2014_11_04_19_00/2014_11_04_19_00.mpg;Shinzo ABE.jpg;25137;25481;36077;1257;1274;17
/net/per610a/home/mvp/mvp_db/news7-lv/2014/2014_11_04_19_00/2014_11_04_19_00.mpg;Shinzo ABE.jpg;25701;26533;36077;1285;1327;42
/net/per610a/home/mvp/mvp_db/news7-lv/2014/2014_11_04_19_00/2014_11_04_19_00.mpg;Shinzo ABE.jpg;26617;27113;36077;1331;1356;25
/net/per610a/home/mvp/mvp_db/news7-lv/2014/2014_11_05_19_00/2014_11_05_19_00.mpg;Ichiro OZAWA.jpg;16977;17181;36085;849;859;10
/net/per610a/home/mvp/mvp_db/news7-lv/2014/2014_11_06_19_00/2014_11_06_19_00.mpg;Natsuo YAMAGUCHI.jpg;1957;2321;36081;97;116;19
/net/per610a/home/mvp/mvp_db/news7-lv/2014/2014_11_07_19_00/2014_11_07_19_00.mpg;Shinzo ABE.jpg;173;633;38481;8;31;23
/net/per610a/home/mvp/mvp_db/news7-lv/2014/2014_11_07_19_00/2014_11_07_19_00.mpg;Shinzo ABE.jpg;821;909;38481;41;45;4
/net/per610a/home/mvp/mvp_db/news7-lv/2014/2014_11_07_19_00/2014_11_07_19_00.mpg;Shinzo ABE.jpg;3469;3593;38481;173;179;6
/net/per610a/home/mvp/mvp_db/news7-lv/2014/2014_11_07_19_00/2014_11_07_19_00.mpg;Shinzo ABE.jpg;3669;3821;38481;183;191;8
/net/per610a/home/mvp/mvp_db/news7-lv/2014/2014_11_08_19_00/2014_11_08_19_00.mpg;Shinzo ABE.jpg;2853;3321;36081;142;166;24
/net/per610a/home/mvp/mvp_db/news7-lv/2014/2014_11_09_19_00/2014_11_09_19_00.mpg;Shinzo ABE.jpg;185;405;36085;9;20;11
/net/per610a/home/mvp/mvp_db/news7-lv/2014/2014_11_09_19_00/2014_11_09_19_00.mpg;Shinzo ABE.jpg;1157;1685;36085;57;84;27
/net/per610a/home/mvp/mvp_db/news7-lv/2014/2014_11_09_19_00/2014_11_09_19_00.mpg;Shinzo ABE.jpg;2917;3509;36085;145;175;30
/net/per610a/home/mvp/mvp_db/news7-lv/2014/2014_11_09_19_00/2014_11_09_19_00.mpg;Shinzo ABE.jpg;3589;4277;36085;179;214;35
/net/per610a/home/mvp/mvp_db/news7-lv/2014/2014_11_09_19_00/2014_11_09_19_00.mpg;Shinzo ABE.jpg;4513;4613;36085;225;230;5
/net/per610a/home/mvp/mvp_db/news7-lv/2014/2014_11_09_19_00/2014_11_09_19_00.mpg;Shinzo ABE.jpg;4885;5433;36085;244;271;27
/net/per610a/home/mvp/mvp_db/news7-lv/2014/2014_11_09_19_00/2014_11_09_19_00.mpg;Shinzo ABE.jpg;5925;6305;36085;296;315;19
/net/per610a/home/mvp/mvp_db/news7-lv/2014/2014_11_09_19_00/2014_11_09_19_00.mpg;Shinzo ABE.jpg;7089;7365;36085;354;368;14
/net/per610a/home/mvp/mvp_db/news7-lv/2014/2014_11_09_19_00/2014_11_09_19_00.mpg;Shinzo ABE.jpg;7613;7661;36085;381;383;2
/net/per610a/home/mvp/mvp_db/news7-lv/2014/2014_11_09_19_00/2014_11_09_19_00.mpg;Shinzo ABE.jpg;15173;16445;36085;759;823;64
/net/per610a/home/mvp/mvp_db/news7-lv/2014/2014_11_09_19_00/2014_11_09_19_00.mpg;Yasuo FUKUDA.jpg;6669;7073;36085;333;353;20
/net/per610a/home/mvp/mvp_db/news7-lv/2014/2014_11_10_19_00/2014_11_10_19_00.mpg;Shinzo ABE.jpg;721;781;36085;36;39;3
/net/per610a/home/mvp/mvp_db/news7-lv/2014/2014_11_10_19_00/2014_11_10_19_00.mpg;Shinzo ABE.jpg;1825;1937;36085;91;96;5
/net/per610a/home/mvp/mvp_db/news7-lv/2014/2014_11_10_19_00/2014_11_10_19_00.mpg;Shinzo ABE.jpg;10541;10929;36085;527;546;19
/net/per610a/home/mvp/mvp_db/news7-lv/2014/2014_11_10_19_00/2014_11_10_19_00.mpg;Shinzo ABE.jpg;17921;18237;36085;896;912;16
/net/per610a/home/mvp/mvp_db/news7-lv/2014/2014_11_10_19_00/2014_11_10_19_00.mpg;Shinzo ABE.jpg;19021;19181;36085;951;959;8
/net/per610a/home/mvp/mvp_db/news7-lv/2014/2014_11_10_19_00/2014_11_10_19_00.mpg;Shinzo ABE.jpg;19517;19605;36085;976;981;5
/net/per610a/home/mvp/mvp_db/news7-lv/2014/2014_11_10_19_00/2014_11_10_19_00.mpg;Takeo Hiranuma.jpeg;8725;9241;36085;436;462;26
/net/per610a/home/mvp/mvp_db/news7-lv/2014/2014_11_10_19_00/2014_11_10_19_00.mpg;Natsuo YAMAGUCHI.jpg;16729;17265;36085;837;864;27
/net/per610a/home/mvp/mvp_db/news7-lv/2014/2014_11_11_19_00/2014_11_11_19_00.mpg;Shinzo ABE.jpg;1341;1781;36085;67;89;22
/net/per610a/home/mvp/mvp_db/news7-lv/2014/2014_11_11_19_00/2014_11_11_19_00.mpg;Shinzo ABE.jpg;4293;4577;36085;214;229;15
/net/per610a/home/mvp/mvp_db/news7-lv/2014/2014_11_11_19_00/2014_11_11_19_00.mpg;Shinzo ABE.jpg;12245;14189;36085;612;710;98
/net/per610a/home/mvp/mvp_db/news7-lv/2014/2014_11_11_19_00/2014_11_11_19_00.mpg;Shinzo ABE.jpg;14609;14713;36085;731;736;5
/net/per610a/home/mvp/mvp_db/news7-lv/2014/2014_11_11_19_00/2014_11_11_19_00.mpg;Katsuya OKADA.jpg;6017;6093;36085;301;304;3
/net/per610a/home/mvp/mvp_db/news7-lv/2014/2014_11_11_19_00/2014_11_11_19_00.mpg;Yukio EDANO.jpg;6185;6201;36085;309;310;1
/net/per610a/home/mvp/mvp_db/news7-lv/2014/2014_11_11_19_00/2014_11_11_19_00.mpg;Yukio EDANO.jpg;6277;6729;36085;314;336;22
/net/per610a/home/mvp/mvp_db/news7-lv/2014/2014_11_11_19_00/2014_11_11_19_00.mpg;Kenji Eda.jpg;6853;7437;36085;342;372;30
/net/per610a/home/mvp/mvp_db/news7-lv/2014/2014_11_11_19_00/2014_11_11_19_00.mpg;Shinzo ABE.jpg;9897;10909;36085;495;545;50
/net/per610a/home/mvp/mvp_db/news7-lv/2014/2014_11_11_19_00/2014_11_11_19_00.mpg;Shinzo ABE.jpg;11401;11405;36085;570;570;0
/net/per610a/home/mvp/mvp_db/news7-lv/2014/2014_11_11_19_00/2014_11_11_19_00.mpg;Shinzo ABE.jpg;14433;14521;36085;722;726;4
/net/per610a/home/mvp/mvp_db/news7-lv/2014/2014_11_12_19_00/2014_11_12_19_00.mpg;Shinzo ABE.jpg;957;1289;36085;47;64;17
/net/per610a/home/mvp/mvp_db/news7-lv/2014/2014_11_12_19_00/2014_11_12_19_00.mpg;Shinzo ABE.jpg;1489;1801;36085;74;90;16
/net/per610a/home/mvp/mvp_db/news7-lv/2014/2014_11_12_19_00/2014_11_12_19_00.mpg;Toranosuke Katayama.jpg;5621;5949;36085;281;297;16
/net/per610a/home/mvp/mvp_db/news7-lv/2014/2014_11_12_19_00/2014_11_12_19_00.mpg;Toru Hashimoto.jpg;6061;6337;36085;303;317;14
/net/per610a/home/mvp/mvp_db/news7-lv/2014/2014_11_12_19_00/2014_11_12_19_00.mpg;Kazuo SHII.jpg;7317;7769;36085;366;388;22
/net/per610a/home/mvp/mvp_db/news7-lv/2014/2014_11_12_19_00/2014_11_12_19_00.mpg;Shinzo ABE.jpg;24973;25089;36085;1249;1255;6
/net/per610a/home/mvp/mvp_db/news7-lv/2014/2014_11_12_19_00/2014_11_12_19_00.mpg;Shinzo ABE.jpg;25269;25293;36085;1264;1265;1
/net/per610a/home/mvp/mvp_db/news7-lv/2014/2014_11_13_19_00/2014_11_13_19_00.mpg;Shinzo ABE.jpg;8689;9453;36085;434;473;39
/net/per610a/home/mvp/mvp_db/news7-lv/2014/2014_11_13_19_00/2014_11_13_19_00.mpg;Shinzo ABE.jpg;9697;9753;36085;485;488;3
/net/per610a/home/mvp/mvp_db/news7-lv/2014/2014_11_13_19_00/2014_11_13_19_00.mpg;Sadakazu TANIGAKI.jpg;10677;10689;36085;534;534;0
/net/per610a/home/mvp/mvp_db/news7-lv/2014/2014_11_13_19_00/2014_11_13_19_00.mpg;Sadakazu TANIGAKI.jpg;10809;11209;36085;540;560;20
/net/per610a/home/mvp/mvp_db/news7-lv/2014/2014_11_13_19_00/2014_11_13_19_00.mpg;Bairi Kaieda.jpg;13513;13589;36085;676;680;4
/net/per610a/home/mvp/mvp_db/news7-lv/2014/2014_11_13_19_00/2014_11_13_19_00.mpg;Bairi Kaieda.jpg;13877;14353;36085;694;718;24
/net/per610a/home/mvp/mvp_db/news7-lv/2014/2014_11_13_19_00/2014_11_13_19_00.mpg;Toru Hashimoto.jpg;14429;14873;36085;722;744;22
/net/per610a/home/mvp/mvp_db/news7-lv/2014/2014_11_14_19_00/2014_11_14_19_00.mpg;Shinzo ABE.jpg;637;1293;36081;31;64;33
/net/per610a/home/mvp/mvp_db/news7-lv/2014/2014_11_14_19_00/2014_11_14_19_00.mpg;Shinzo ABE.jpg;2189;3301;36081;109;165;56
/net/per610a/home/mvp/mvp_db/news7-lv/2014/2014_11_14_19_00/2014_11_14_19_00.mpg;Shinzo ABE.jpg;3445;3817;36081;172;190;18
/net/per610a/home/mvp/mvp_db/news7-lv/2014/2014_11_14_19_00/2014_11_14_19_00.mpg;Shinzo ABE.jpg;8545;9833;36081;427;491;64
/net/per610a/home/mvp/mvp_db/news7-lv/2014/2014_11_14_19_00/2014_11_14_19_00.mpg;Shinzo ABE.jpg;12585;13517;36081;629;676;47
/net/per610a/home/mvp/mvp_db/news7-lv/2014/2014_11_14_19_00/2014_11_14_19_00.mpg;Shinzo ABE.jpg;25201;25341;36081;1260;1267;7
/net/per610a/home/mvp/mvp_db/news7-lv/2014/2014_11_14_19_00/2014_11_14_19_00.mpg;Yoshihiko Noda.jpg;4949;4965;36081;247;248;1
/net/per610a/home/mvp/mvp_db/news7-lv/2014/2014_11_14_19_00/2014_11_14_19_00.mpg;Yoshihiko Noda.jpg;6369;7229;36081;318;361;43
/net/per610a/home/mvp/mvp_db/news7-lv/2014/2014_11_14_19_00/2014_11_14_19_00.mpg;Yorihisa Matsuno.png;7353;8517;36081;367;426;59
/net/per610a/home/mvp/mvp_db/news7-lv/2014/2014_11_14_19_00/2014_11_14_19_00.mpg;Taro ASO.jpg;11221;12265;36081;561;613;52
/net/per610a/home/mvp/mvp_db/news7-lv/2014/2014_11_15_19_00/2014_11_15_19_00.mpg;Taro ASO.jpg;4917;5501;36085;246;275;29
/net/per610a/home/mvp/mvp_db/news7-lv/2014/2014_11_15_19_00/2014_11_15_19_00.mpg;Ichiro OZAWA.jpg;11533;12837;36085;577;642;65
/net/per610a/home/mvp/mvp_db/news7-lv/2014/2014_11_15_19_00/2014_11_15_19_00.mpg;Yukio EDANO.jpg;13297;14201;36085;665;710;45
/net/per610a/home/mvp/mvp_db/news7-lv/2014/2014_11_15_19_00/2014_11_15_19_00.mpg;Kenji Eda.jpg;14269;15745;36085;714;788;74
/net/per610a/home/mvp/mvp_db/news7-lv/2014/2014_11_16_19_00/2014_11_16_19_00.mpg;Shinzo ABE.jpg;901;1533;36085;45;76;31
/net/per610a/home/mvp/mvp_db/news7-lv/2014/2014_11_16_19_00/2014_11_16_19_00.mpg;Shinzo ABE.jpg;22297;22301;36085;1115;1116;1
/net/per610a/home/mvp/mvp_db/news7-lv/2014/2014_11_16_19_00/2014_11_16_19_00.mpg;Shinzo ABE.jpg;1849;1889;36085;92;94;2
/net/per610a/home/mvp/mvp_db/news7-lv/2014/2014_11_16_19_00/2014_11_16_19_00.mpg;Shinzo ABE.jpg;19941;20013;36085;998;1001;3
/net/per610a/home/mvp/mvp_db/news7-lv/2014/2014_11_16_19_00/2014_11_16_19_00.mpg;Shinzo ABE.jpg;8937;9885;36085;447;494;47
/net/per610a/home/mvp/mvp_db/news7-lv/2014/2014_11_16_19_00/2014_11_16_19_00.mpg;Shinzo ABE.jpg;22921;22977;36085;1147;1149;2
/net/per610a/home/mvp/mvp_db/news7-lv/2014/2014_11_16_19_00/2014_11_16_19_00.mpg;Natsuo YAMAGUCHI.jpg;10293;10529;36085;515;526;11
/net/per610a/home/mvp/mvp_db/news7-lv/2014/2014_11_17_19_00/2014_11_17_19_00.mpg;Shinzo ABE.jpg;861;1457;36085;43;72;29
/net/per610a/home/mvp/mvp_db/news7-lv/2014/2014_11_17_19_00/2014_11_17_19_00.mpg;Shinzo ABE.jpg;12573;13021;36085;629;651;22
/net/per610a/home/mvp/mvp_db/news7-lv/2014/2014_11_17_19_00/2014_11_17_19_00.mpg;Shinzo ABE.jpg;13229;13257;36085;662;663;1
/net/per610a/home/mvp/mvp_db/news7-lv/2014/2014_11_17_19_00/2014_11_17_19_00.mpg;Shinzo ABE.jpg;13553;14049;36085;678;703;25
/net/per610a/home/mvp/mvp_db/news7-lv/2014/2014_11_17_19_00/2014_11_17_19_00.mpg;Natsuo YAMAGUCHI.jpg;12573;13021;36085;629;651;22
/net/per610a/home/mvp/mvp_db/news7-lv/2014/2014_11_17_19_00/2014_11_17_19_00.mpg;Natsuo YAMAGUCHI.jpg;13477;13989;36085;674;700;26
/net/per610a/home/mvp/mvp_db/news7-lv/2014/2014_11_17_19_00/2014_11_17_19_00.mpg;Shinzo ABE.jpg;15457;15665;36085;773;784;11
/net/per610a/home/mvp/mvp_db/news7-lv/2014/2014_11_17_19_00/2014_11_17_19_00.mpg;Sadakazu TANIGAKI.jpg;16085;16181;36085;805;809;4
/net/per610a/home/mvp/mvp_db/news7-lv/2014/2014_11_17_19_00/2014_11_17_19_00.mpg;Bairi Kaieda.jpg;16545;16929;36085;828;847;19
/net/per610a/home/mvp/mvp_db/news7-lv/2014/2014_11_17_19_00/2014_11_17_19_00.mpg;Bairi Kaieda.jpg;17013;17081;36085;851;854;3
/net/per610a/home/mvp/mvp_db/news7-lv/2014/2014_11_17_19_00/2014_11_17_19_00.mpg;Bairi Kaieda.jpg;17565;17637;36085;879;882;3
/net/per610a/home/mvp/mvp_db/news7-lv/2014/2014_11_17_19_00/2014_11_17_19_00.mpg;Yukio EDANO.jpg;17089;17185;36085;855;860;5
/net/per610a/home/mvp/mvp_db/news7-lv/2014/2014_11_17_19_00/2014_11_17_19_00.mpg;Ichiro OZAWA.jpg;20021;20157;36085;1002;1008;6
/net/per610a/home/mvp/mvp_db/news7-lv/2014/2014_11_18_19_00/2014_11_18_19_00.mpg;Shinzo ABE.jpg;2885;3261;72049;144;163;19
/net/per610a/home/mvp/mvp_db/news7-lv/2014/2014_11_18_19_00/2014_11_18_19_00.mpg;Shinzo ABE.jpg;3697;4621;72049;185;231;46
/net/per610a/home/mvp/mvp_db/news7-lv/2014/2014_11_18_19_00/2014_11_18_19_00.mpg;Shinzo ABE.jpg;4685;4829;72049;234;241;7
/net/per610a/home/mvp/mvp_db/news7-lv/2014/2014_11_18_19_00/2014_11_18_19_00.mpg;Shinzo ABE.jpg;11153;11229;72049;558;562;4
/net/per610a/home/mvp/mvp_db/news7-lv/2014/2014_11_18_19_00/2014_11_18_19_00.mpg;Shinzo ABE.jpg;12749;12797;72049;638;640;2
/net/per610a/home/mvp/mvp_db/news7-lv/2014/2014_11_18_19_00/2014_11_18_19_00.mpg;Shinzo ABE.jpg;12933;13109;72049;647;656;9
/net/per610a/home/mvp/mvp_db/news7-lv/2014/2014_11_18_19_00/2014_11_18_19_00.mpg;Shinzo ABE.jpg;13621;25221;72049;681;1262;581
/net/per610a/home/mvp/mvp_db/news7-lv/2014/2014_11_18_19_00/2014_11_18_19_00.mpg;Shinzo ABE.jpg;25345;28297;72049;1268;1416;148
/net/per610a/home/mvp/mvp_db/news7-lv/2014/2014_11_18_19_00/2014_11_18_19_00.mpg;Shinzo ABE.jpg;28453;31357;72049;1424;1569;145
/net/per610a/home/mvp/mvp_db/news7-lv/2014/2014_11_18_19_00/2014_11_18_19_00.mpg;Shinzo ABE.jpg;31777;31977;72049;1590;1600;10
/net/per610a/home/mvp/mvp_db/news7-lv/2014/2014_11_18_19_00/2014_11_18_19_00.mpg;Shinzo ABE.jpg;32045;34993;72049;1603;1751;148
/net/per610a/home/mvp/mvp_db/news7-lv/2014/2014_11_18_19_00/2014_11_18_19_00.mpg;Shinzo ABE.jpg;35133;35213;72049;1758;1762;4
/net/per610a/home/mvp/mvp_db/news7-lv/2014/2014_11_18_19_00/2014_11_18_19_00.mpg;Shinzo ABE.jpg;35289;39549;72049;1766;1979;213
/net/per610a/home/mvp/mvp_db/news7-lv/2014/2014_11_18_19_00/2014_11_18_19_00.mpg;Shinzo ABE.jpg;39809;40745;72049;1992;2039;47
/net/per610a/home/mvp/mvp_db/news7-lv/2014/2014_11_18_19_00/2014_11_18_19_00.mpg;Shinzo ABE.jpg;41065;44097;72049;2055;2207;152
/net/per610a/home/mvp/mvp_db/news7-lv/2014/2014_11_18_19_00/2014_11_18_19_00.mpg;Shinzo ABE.jpg;46845;47333;72049;2344;2368;24
/net/per610a/home/mvp/mvp_db/news7-lv/2014/2014_11_18_19_00/2014_11_18_19_00.mpg;Shinzo ABE.jpg;52713;52877;72049;2638;2646;8
/net/per610a/home/mvp/mvp_db/news7-lv/2014/2014_11_18_19_00/2014_11_18_19_00.mpg;Yasuo FUKUDA.jpg;6385;7241;72049;319;362;43
/net/per610a/home/mvp/mvp_db/news7-lv/2014/2014_11_18_19_00/2014_11_18_19_00.mpg;Bairi Kaieda.jpg;53821;55109;72049;2693;2758;65
/net/per610a/home/mvp/mvp_db/news7-lv/2014/2014_11_19_19_00/2014_11_19_19_00.mpg;Shinzo ABE.jpg;1261;1809;36085;63;90;27
/net/per610a/home/mvp/mvp_db/news7-lv/2014/2014_11_19_19_00/2014_11_19_19_00.mpg;Shinzo ABE.jpg;1897;1997;36085;94;99;5
/net/per610a/home/mvp/mvp_db/news7-lv/2014/2014_11_20_19_00/2014_11_20_19_00.mpg;Bairi Kaieda.jpg;8001;8089;36085;400;404;4
/net/per610a/home/mvp/mvp_db/news7-lv/2014/2014_11_21_19_00/2014_11_21_19_00.mpg;Kenji Eda.jpg;2633;3029;72057;131;151;20
/net/per610a/home/mvp/mvp_db/news7-lv/2014/2014_11_21_19_00/2014_11_21_19_00.mpg;Kenji Eda.jpg;38717;41717;72057;1937;2087;150
/net/per610a/home/mvp/mvp_db/news7-lv/2014/2014_11_21_19_00/2014_11_21_19_00.mpg;Shinzo ABE.jpg;3825;3885;72057;191;194;3
/net/per610a/home/mvp/mvp_db/news7-lv/2014/2014_11_21_19_00/2014_11_21_19_00.mpg;Shinzo ABE.jpg;18741;18797;72057;937;940;3
/net/per610a/home/mvp/mvp_db/news7-lv/2014/2014_11_21_19_00/2014_11_21_19_00.mpg;Shinzo ABE.jpg;29037;32769;72057;1453;1639;186
/net/per610a/home/mvp/mvp_db/news7-lv/2014/2014_11_21_19_00/2014_11_21_19_00.mpg;Shinzo ABE.jpg;70753;70881;72057;3540;3547;7
/net/per610a/home/mvp/mvp_db/news7-lv/2014/2014_11_21_19_00/2014_11_21_19_00.mpg;Natsuo YAMAGUCHI.jpg;10885;11077;72057;544;554;10
/net/per610a/home/mvp/mvp_db/news7-lv/2014/2014_11_21_19_00/2014_11_21_19_00.mpg;Natsuo YAMAGUCHI.jpg;11185;11265;72057;559;563;4
/net/per610a/home/mvp/mvp_db/news7-lv/2014/2014_11_21_19_00/2014_11_21_19_00.mpg;Natsuo YAMAGUCHI.jpg;32773;35641;72057;1640;1783;143
/net/per610a/home/mvp/mvp_db/news7-lv/2014/2014_11_21_19_00/2014_11_21_19_00.mpg;Bairi Kaieda.jpg;11505;11769;72057;575;588;13
/net/per610a/home/mvp/mvp_db/news7-lv/2014/2014_11_21_19_00/2014_11_21_19_00.mpg;Bairi Kaieda.jpg;35645;38713;72057;1783;1937;154
/net/per610a/home/mvp/mvp_db/news7-lv/2014/2014_11_21_19_00/2014_11_21_19_00.mpg;Kenji Eda.jpg;12077;12485;72057;604;624;20
/net/per610a/home/mvp/mvp_db/news7-lv/2014/2014_11_21_19_00/2014_11_21_19_00.mpg;Kazuo SHII.jpg;13265;13497;72057;663;675;12
/net/per610a/home/mvp/mvp_db/news7-lv/2014/2014_11_21_19_00/2014_11_21_19_00.mpg;Kazuo SHII.jpg;43865;45737;72057;2195;2288;93
/net/per610a/home/mvp/mvp_db/news7-lv/2014/2014_11_21_19_00/2014_11_21_19_00.mpg;Ichiro OZAWA.jpg;13609;13609;72057;681;681;0
/net/per610a/home/mvp/mvp_db/news7-lv/2014/2014_11_21_19_00/2014_11_21_19_00.mpg;Ichiro OZAWA.jpg;45821;47613;72057;2293;2382;89
/net/per610a/home/mvp/mvp_db/news7-lv/2014/2014_11_21_19_00/2014_11_21_19_00.mpg;Taro ASO.jpg;41721;43861;72057;2087;2194;107
/net/per610a/home/mvp/mvp_db/news7-lv/2014/2014_11_21_19_00/2014_11_21_19_00.mpg;Tadatomo Yoshida.jpg;47617;49489;72057;2382;2476;94
/net/per610a/home/mvp/mvp_db/news7-lv/2014/2014_11_22_19_00/2014_11_22_19_00.mpg;Sadakazu TANIGAKI.jpg;653;2177;36093;32;108;76
/net/per610a/home/mvp/mvp_db/news7-lv/2014/2014_11_22_19_00/2014_11_22_19_00.mpg;Kazuo SHII.jpg;5009;5265;36093;250;263;13
/net/per610a/home/mvp/mvp_db/news7-lv/2014/2014_11_22_19_00/2014_11_22_19_00.mpg;Toranosuke Katayama.jpg;5773;6417;36093;288;321;33
/net/per610a/home/mvp/mvp_db/news7-lv/2014/2014_11_22_19_00/2014_11_22_19_00.mpg;Shinzo ABE.jpg;7461;7773;36093;373;388;15
/net/per610a/home/mvp/mvp_db/news7-lv/2014/2014_11_23_19_00/2014_11_23_19_00.mpg;Natsuo YAMAGUCHI.jpg;22265;22365;36085;1114;1119;5
/net/per610a/home/mvp/mvp_db/news7-lv/2014/2014_11_23_19_00/2014_11_23_19_00.mpg;Toru Hashimoto.jpg;25109;25529;36085;1256;1277;21
/net/per610a/home/mvp/mvp_db/news7-lv/2014/2014_11_23_19_00/2014_11_23_19_00.mpg;Toru Hashimoto.jpg;25949;27029;36085;1298;1352;54
/net/per610a/home/mvp/mvp_db/news7-lv/2014/2014_11_24_19_00/2014_11_24_19_00.mpg;Shinzo ABE.jpg;4585;4929;36085;229;246;17
/net/per610a/home/mvp/mvp_db/news7-lv/2014/2014_11_24_19_00/2014_11_24_19_00.mpg;Bairi Kaieda.jpg;13233;13509;36085;662;676;14
/net/per610a/home/mvp/mvp_db/news7-lv/2014/2014_11_24_19_00/2014_11_24_19_00.mpg;Bairi Kaieda.jpg;13577;14061;36085;679;703;24
/net/per610a/home/mvp/mvp_db/news7-lv/2014/2014_11_24_19_00/2014_11_24_19_00.mpg;Bairi Kaieda.jpg;16057;16173;36085;803;809;6
/net/per610a/home/mvp/mvp_db/news7-lv/2014/2014_11_24_19_00/2014_11_24_19_00.mpg;Bairi Kaieda.jpg;16573;17073;36085;829;854;25
/net/per610a/home/mvp/mvp_db/news7-lv/2014/2014_11_24_19_00/2014_11_24_19_00.mpg;Bairi Kaieda.jpg;18437;18565;36085;922;929;7
/net/per610a/home/mvp/mvp_db/news7-lv/2014/2014_11_25_19_00/2014_11_25_19_00.mpg;Shinzo ABE.jpg;7877;8369;36081;394;418;24
/net/per610a/home/mvp/mvp_db/news7-lv/2014/2014_11_25_19_00/2014_11_25_19_00.mpg;Shinzo ABE.jpg;15313;15465;36081;766;773;7
/net/per610a/home/mvp/mvp_db/news7-lv/2014/2014_11_25_19_00/2014_11_25_19_00.mpg;Shinzo ABE.jpg;15757;16677;36081;788;834;46
/net/per610a/home/mvp/mvp_db/news7-lv/2014/2014_11_25_19_00/2014_11_25_19_00.mpg;Shinzo ABE.jpg;16781;17537;36081;839;877;38
/net/per610a/home/mvp/mvp_db/news7-lv/2014/2014_11_25_19_00/2014_11_25_19_00.mpg;Shinzo ABE.jpg;18265;18769;36081;913;938;25
/net/per610a/home/mvp/mvp_db/news7-lv/2014/2014_11_25_19_00/2014_11_25_19_00.mpg;Shinzo ABE.jpg;24697;25009;36081;1235;1251;16
/net/per610a/home/mvp/mvp_db/news7-lv/2014/2014_11_25_19_00/2014_11_25_19_00.mpg;Shinzo ABE.jpg;25113;25433;36081;1256;1272;16
/net/per610a/home/mvp/mvp_db/news7-lv/2014/2014_11_26_19_00/2014_11_26_19_00.mpg;Ichiro OZAWA.jpg;21205;21517;36085;1061;1076;15
/net/per610a/home/mvp/mvp_db/news7-lv/2014/2014_11_27_19_00/2014_11_27_19_00.mpg;Bairi Kaieda.jpg;7361;9517;36089;368;476;108
/net/per610a/home/mvp/mvp_db/news7-lv/2014/2014_11_27_19_00/2014_11_27_19_00.mpg;Natsuo YAMAGUCHI.jpg;9521;10557;36089;476;528;52
/net/per610a/home/mvp/mvp_db/news7-lv/2014/2014_11_27_19_00/2014_11_27_19_00.mpg;Natsuo YAMAGUCHI.jpg;12457;13117;36089;623;656;33
/net/per610a/home/mvp/mvp_db/news7-lv/2014/2014_11_27_19_00/2014_11_27_19_00.mpg;Tadatomo Yoshida.jpg;13853;14413;36089;693;721;28
/net/per610a/home/mvp/mvp_db/news7-lv/2014/2014_11_27_19_00/2014_11_27_19_00.mpg;Tadatomo Yoshida.jpg;15133;15813;36089;757;791;34
/net/per610a/home/mvp/mvp_db/news7-lv/2014/2014_11_28_19_00/2014_11_28_19_00.mpg;Shinzo ABE.jpg;8829;10137;36073;441;507;66
/net/per610a/home/mvp/mvp_db/news7-lv/2014/2014_11_29_19_00/2014_11_29_19_00.mpg;Sadakazu TANIGAKI.jpg;13581;13685;36085;679;684;5
/net/per610a/home/mvp/mvp_db/news7-lv/2014/2014_11_30_19_00/2014_11_30_19_00.mpg;Shinzo ABE.jpg;21185;22017;36085;1060;1101;41
/net/per610a/home/mvp/mvp_db/news7-lv/2014/2014_11_30_19_00/2014_11_30_19_00.mpg;Bairi Kaieda.jpg;22977;24617;36085;1149;1232;83
/net/per610a/home/mvp/mvp_db/news7-lv/2014/2014_11_30_19_00/2014_11_30_19_00.mpg;Tadatomo Yoshida.jpg;25473;25965;36085;1274;1299;25
/net/per610a/home/mvp/mvp_db/news7-lv/2014/2014_12_01_19_00/2014_12_01_19_00.mpg;Shinzo ABE.jpg;4597;8409;36085;230;420;190
/net/per610a/home/mvp/mvp_db/news7-lv/2014/2014_12_01_19_00/2014_12_01_19_00.mpg;Shinzo ABE.jpg;8585;9501;36085;429;475;46
/net/per610a/home/mvp/mvp_db/news7-lv/2014/2014_12_01_19_00/2014_12_01_19_00.mpg;Shinzo ABE.jpg;9613;10585;36085;481;529;48
/net/per610a/home/mvp/mvp_db/news7-lv/2014/2014_12_01_19_00/2014_12_01_19_00.mpg;Shinzo ABE.jpg;10749;11829;36085;537;592;55
/net/per610a/home/mvp/mvp_db/news7-lv/2014/2014_12_01_19_00/2014_12_01_19_00.mpg;Shinzo ABE.jpg;11965;12681;36085;598;634;36
/net/per610a/home/mvp/mvp_db/news7-lv/2014/2014_12_01_19_00/2014_12_01_19_00.mpg;Shinzo ABE.jpg;17249;17617;36085;863;881;18
/net/per610a/home/mvp/mvp_db/news7-lv/2014/2014_12_02_19_00/2014_12_02_19_00.mpg;Bairi Kaieda.jpg;2609;3577;125993;130;179;49
/net/per610a/home/mvp/mvp_db/news7-lv/2014/2014_12_02_19_00/2014_12_02_19_00.mpg;Bairi Kaieda.jpg;50205;61909;125993;2512;3098;586
/net/per610a/home/mvp/mvp_db/news7-lv/2014/2014_12_02_19_00/2014_12_02_19_00.mpg;Kenji Eda.jpg;3741;4741;125993;187;237;50
/net/per610a/home/mvp/mvp_db/news7-lv/2014/2014_12_02_19_00/2014_12_02_19_00.mpg;Kenji Eda.jpg;62209;67821;125993;3113;3394;281
/net/per610a/home/mvp/mvp_db/news7-lv/2014/2014_12_02_19_00/2014_12_02_19_00.mpg;Natsuo YAMAGUCHI.jpg;5049;5877;125993;252;294;42
/net/per610a/home/mvp/mvp_db/news7-lv/2014/2014_12_02_19_00/2014_12_02_19_00.mpg;Natsuo YAMAGUCHI.jpg;71665;81549;125993;3586;4081;495
/net/per610a/home/mvp/mvp_db/news7-lv/2014/2014_12_02_19_00/2014_12_02_19_00.mpg;Takeo Hiranuma.jpeg;5917;6665;125993;296;333;37
/net/per610a/home/mvp/mvp_db/news7-lv/2014/2014_12_02_19_00/2014_12_02_19_00.mpg;Takeo Hiranuma.jpeg;81837;89025;125993;4095;4455;360
/net/per610a/home/mvp/mvp_db/news7-lv/2014/2014_12_02_19_00/2014_12_02_19_00.mpg;Kazuo SHII.jpg;6757;7429;125993;338;371;33
/net/per610a/home/mvp/mvp_db/news7-lv/2014/2014_12_02_19_00/2014_12_02_19_00.mpg;Kazuo SHII.jpg;89277;96445;125993;4468;4827;359
/net/per610a/home/mvp/mvp_db/news7-lv/2014/2014_12_02_19_00/2014_12_02_19_00.mpg;Ichiro OZAWA.jpg;7713;8133;125993;386;407;21
/net/per610a/home/mvp/mvp_db/news7-lv/2014/2014_12_02_19_00/2014_12_02_19_00.mpg;Ichiro OZAWA.jpg;96721;101989;125993;4840;5104;264
/net/per610a/home/mvp/mvp_db/news7-lv/2014/2014_12_02_19_00/2014_12_02_19_00.mpg;Shinzo ABE.jpg;23933;49917;125993;1197;2498;1301
/net/per610a/home/mvp/mvp_db/news7-lv/2014/2014_12_03_19_00/2014_12_03_19_00.mpg;Shinzo ABE.jpg;21209;22401;36077;1061;1120;59
/net/per610a/home/mvp/mvp_db/news7-lv/2014/2014_12_03_19_00/2014_12_03_19_00.mpg;Natsuo YAMAGUCHI.jpg;23121;24545;36077;1156;1228;72
/net/per610a/home/mvp/mvp_db/news7-lv/2014/2014_12_03_19_00/2014_12_03_19_00.mpg;Kyoko Nakayama.jpg;26265;26301;36077;1314;1315;1
/net/per610a/home/mvp/mvp_db/news7-lv/2014/2014_12_03_19_00/2014_12_03_19_00.mpg;Kyoko Nakayama.jpg;27325;27381;36077;1367;1369;2
/net/per610a/home/mvp/mvp_db/news7-lv/2014/2014_12_03_19_00/2014_12_03_19_00.mpg;Kyoko Nakayama.jpg;27881;28053;36077;1394;1403;9
/net/per610a/home/mvp/mvp_db/news7-lv/2014/2014_12_03_19_00/2014_12_03_19_00.mpg;Kyoko Nakayama.jpg;28177;28253;36077;1409;1413;4
/net/per610a/home/mvp/mvp_db/news7-lv/2014/2014_12_06_19_00/2014_12_06_19_00.mpg;Kenji Eda.jpg;24773;25217;36085;1239;1262;23
/net/per610a/home/mvp/mvp_db/news7-lv/2014/2014_12_07_19_00/2014_12_07_19_00.mpg;Shinzo ABE.jpg;21973;23201;36077;1099;1160;61
/net/per610a/home/mvp/mvp_db/news7-lv/2014/2014_12_08_19_00/2014_12_08_19_00.mpg;Toru Hashimoto.jpg;21841;21933;36085;1093;1097;4
/net/per610a/home/mvp/mvp_db/news7-lv/2014/2014_12_08_19_00/2014_12_08_19_00.mpg;Toru Hashimoto.jpg;21997;22273;36085;1100;1114;14
/net/per610a/home/mvp/mvp_db/news7-lv/2014/2014_12_08_19_00/2014_12_08_19_00.mpg;Shinzo ABE.jpg;27581;27925;36085;1380;1397;17
/net/per610a/home/mvp/mvp_db/news7-lv/2014/2014_12_09_19_00/2014_12_09_19_00.mpg;Taro Yamamoto.jpg;26613;26773;36085;1331;1339;8
/net/per610a/home/mvp/mvp_db/news7-lv/2014/2014_12_09_19_00/2014_12_09_19_00.mpg;Shinzo ABE.jpg;30985;31353;36085;1550;1569;19
/net/per610a/home/mvp/mvp_db/news7-lv/2014/2014_12_10_19_00/2014_12_10_19_00.mpg;Shinzo ABE.jpg;11017;11053;36081;551;552;1
/net/per610a/home/mvp/mvp_db/news7-lv/2014/2014_12_10_19_00/2014_12_10_19_00.mpg;Shinzo ABE.jpg;11153;11337;36081;557;567;10
/net/per610a/home/mvp/mvp_db/news7-lv/2014/2014_12_12_19_00/2014_12_12_19_00.mpg;Shinzo ABE.jpg;22773;23861;36085;1139;1194;55
/net/per610a/home/mvp/mvp_db/news7-lv/2014/2014_12_13_19_00/2014_12_13_19_00.mpg;Shinzo ABE.jpg;8425;8925;36085;421;446;25
/net/per610a/home/mvp/mvp_db/news7-lv/2014/2014_12_15_19_00/2014_12_15_19_00.mpg;Shinzo ABE.jpg;281;437;36081;14;21;7
/net/per610a/home/mvp/mvp_db/news7-lv/2014/2014_12_15_19_00/2014_12_15_19_00.mpg;Shinzo ABE.jpg;1221;1709;36081;61;85;24
/net/per610a/home/mvp/mvp_db/news7-lv/2014/2014_12_15_19_00/2014_12_15_19_00.mpg;Shinzo ABE.jpg;1781;2069;36081;89;103;14
/net/per610a/home/mvp/mvp_db/news7-lv/2014/2014_12_15_19_00/2014_12_15_19_00.mpg;Shinzo ABE.jpg;4705;5861;36081;235;293;58
/net/per610a/home/mvp/mvp_db/news7-lv/2014/2014_12_15_19_00/2014_12_15_19_00.mpg;Shinzo ABE.jpg;5929;6309;36081;296;315;19
/net/per610a/home/mvp/mvp_db/news7-lv/2014/2014_12_15_19_00/2014_12_15_19_00.mpg;Shinzo ABE.jpg;7733;7973;36081;387;399;12
/net/per610a/home/mvp/mvp_db/news7-lv/2014/2014_12_15_19_00/2014_12_15_19_00.mpg;Shinzo ABE.jpg;469;529;36081;23;26;3
/net/per610a/home/mvp/mvp_db/news7-lv/2014/2014_12_15_19_00/2014_12_15_19_00.mpg;Shinzo ABE.jpg;3441;3469;36081;172;173;1
/net/per610a/home/mvp/mvp_db/news7-lv/2014/2014_12_15_19_00/2014_12_15_19_00.mpg;Shinzo ABE.jpg;3569;3741;36081;178;187;9
/net/per610a/home/mvp/mvp_db/news7-lv/2014/2014_12_15_19_00/2014_12_15_19_00.mpg;Shinzo ABE.jpg;3877;4009;36081;194;200;6
/net/per610a/home/mvp/mvp_db/news7-lv/2014/2014_12_15_19_00/2014_12_15_19_00.mpg;Shinzo ABE.jpg;4185;4317;36081;209;216;7
/net/per610a/home/mvp/mvp_db/news7-lv/2014/2014_12_15_19_00/2014_12_15_19_00.mpg;Shinzo ABE.jpg;4593;4629;36081;229;231;2
/net/per610a/home/mvp/mvp_db/news7-lv/2014/2014_12_15_19_00/2014_12_15_19_00.mpg;Shinzo ABE.jpg;12725;12737;36081;636;637;1
/net/per610a/home/mvp/mvp_db/news7-lv/2014/2014_12_15_19_00/2014_12_15_19_00.mpg;Shinzo ABE.jpg;13109;13149;36081;656;658;2
/net/per610a/home/mvp/mvp_db/news7-lv/2014/2014_12_15_19_00/2014_12_15_19_00.mpg;Bairi Kaieda.jpg;629;869;36081;31;43;12
/net/per610a/home/mvp/mvp_db/news7-lv/2014/2014_12_15_19_00/2014_12_15_19_00.mpg;Bairi Kaieda.jpg;14273;14825;36081;714;742;28
/net/per610a/home/mvp/mvp_db/news7-lv/2014/2014_12_15_19_00/2014_12_15_19_00.mpg;Kazuo SHII.jpg;2889;2997;36081;144;150;6
/net/per610a/home/mvp/mvp_db/news7-lv/2014/2014_12_15_19_00/2014_12_15_19_00.mpg;Kazuo SHII.jpg;15581;16989;36081;779;850;71
/net/per610a/home/mvp/mvp_db/news7-lv/2014/2014_12_15_19_00/2014_12_15_19_00.mpg;Natsuo YAMAGUCHI.jpg;3965;4009;36081;198;200;2
/net/per610a/home/mvp/mvp_db/news7-lv/2014/2014_12_15_19_00/2014_12_15_19_00.mpg;Natsuo YAMAGUCHI.jpg;4321;4565;36081;216;228;12
/net/per610a/home/mvp/mvp_db/news7-lv/2014/2014_12_15_19_00/2014_12_15_19_00.mpg;Yukio EDANO.jpg;15297;15521;36081;765;776;11
/net/per610a/home/mvp/mvp_db/news7-lv/2014/2014_12_16_19_00/2014_12_16_19_00.mpg;Shinzo ABE.jpg;14125;14921;36077;706;746;40
/net/per610a/home/mvp/mvp_db/news7-lv/2014/2014_12_16_19_00/2014_12_16_19_00.mpg;Bairi Kaieda.jpg;15901;16057;36077;795;803;8
/net/per610a/home/mvp/mvp_db/news7-lv/2014/2014_12_17_19_00/2014_12_17_19_00.mpg;Katsuya OKADA.jpg;15145;15309;38481;758;766;8
/net/per610a/home/mvp/mvp_db/news7-lv/2014/2014_12_18_19_00/2014_12_18_19_00.mpg;Yukio EDANO.jpg;32209;32425;36085;1612;1622;10
/net/per610a/home/mvp/mvp_db/news7-lv/2014/2014_12_23_19_00/2014_12_23_19_00.mpg;Toru Hashimoto.jpg;27293;27825;36085;1365;1392;27
/net/per610a/home/mvp/mvp_db/news7-lv/2014/2014_12_23_19_00/2014_12_23_19_00.mpg;Toru Hashimoto.jpg;29373;29433;36085;1470;1473;3
/net/per610a/home/mvp/mvp_db/news7-lv/2014/2014_12_23_19_00/2014_12_23_19_00.mpg;Toru Hashimoto.jpg;29529;30025;36085;1477;1502;25
/net/per610a/home/mvp/mvp_db/news7-lv/2014/2014_12_23_19_00/2014_12_23_19_00.mpg;Kenji Eda.jpg;27841;27901;36085;1393;1396;3
/net/per610a/home/mvp/mvp_db/news7-lv/2014/2014_12_23_19_00/2014_12_23_19_00.mpg;Kenji Eda.jpg;28285;28685;36085;1415;1435;20
/net/per610a/home/mvp/mvp_db/news7-lv/2014/2014_12_23_19_00/2014_12_23_19_00.mpg;Kenji Eda.jpg;29529;29965;36085;1477;1499;22
/net/per610a/home/mvp/mvp_db/news7-lv/2014/2014_12_24_19_00/2014_12_24_19_00.mpg;Shinzo ABE.jpg;15833;16073;36085;792;804;12
/net/per610a/home/mvp/mvp_db/news7-lv/2014/2014_12_24_19_00/2014_12_24_19_00.mpg;Shinzo ABE.jpg;17317;17593;36085;866;880;14
/net/per610a/home/mvp/mvp_db/news7-lv/2014/2014_12_24_19_00/2014_12_24_19_00.mpg;Shinzo ABE.jpg;17989;18417;36085;900;921;21
/net/per610a/home/mvp/mvp_db/news7-lv/2014/2014_12_24_19_00/2014_12_24_19_00.mpg;Shinzo ABE.jpg;18777;19937;36085;939;997;58
/net/per610a/home/mvp/mvp_db/news7-lv/2014/2014_12_24_19_00/2014_12_24_19_00.mpg;Natsuo YAMAGUCHI.jpg;17989;18417;36085;900;921;21
/net/per610a/home/mvp/mvp_db/news7-lv/2014/2014_12_24_19_00/2014_12_24_19_00.mpg;Renho.jpg;21561;22061;36085;1079;1104;25
/net/per610a/home/mvp/mvp_db/news7-lv/2014/2014_12_25_19_00/2014_12_25_19_00.mpg;Seiji MAEHARA.jpg;11465;11941;36085;573;597;24
/net/per610a/home/mvp/mvp_db/news7-lv/2014/2014_12_25_19_00/2014_12_25_19_00.mpg;Seiji MAEHARA.jpg;13193;13469;36085;660;674;14
/net/per610a/home/mvp/mvp_db/news7-lv/2014/2014_12_26_19_00/2014_12_26_19_00.mpg;Shinzo ABE.jpg;11137;11653;36081;557;582;25
/net/per610a/home/mvp/mvp_db/news7-lv/2014/2014_12_26_19_00/2014_12_26_19_00.mpg;Katsuya OKADA.jpg;25209;25513;36081;1261;1276;15
/net/per610a/home/mvp/mvp_db/news7-lv/2014/2014_12_27_19_00/2014_12_27_19_00.mpg;Shinzo ABE.jpg;129;241;36085;6;12;6
/net/per610a/home/mvp/mvp_db/news7-lv/2014/2014_12_27_19_00/2014_12_27_19_00.mpg;Shinzo ABE.jpg;365;517;36085;18;25;7
/net/per610a/home/mvp/mvp_db/news7-lv/2014/2014_12_27_19_00/2014_12_27_19_00.mpg;Shinzo ABE.jpg;1657;1701;36085;82;85;3
/net/per610a/home/mvp/mvp_db/news7-lv/2014/2014_12_27_19_00/2014_12_27_19_00.mpg;Shinzo ABE.jpg;2025;2125;36085;101;106;5
/net/per610a/home/mvp/mvp_db/news7-lv/2014/2014_12_27_19_00/2014_12_27_19_00.mpg;Shinzo ABE.jpg;9233;9493;36085;462;475;13
/net/per610a/home/mvp/mvp_db/news7-lv/2014/2014_12_27_19_00/2014_12_27_19_00.mpg;Shinzo ABE.jpg;32637;32793;36085;1633;1641;8
/net/per610a/home/mvp/mvp_db/news7-lv/2014/2014_12_30_19_00/2014_12_30_19_00.mpg;Shinzo ABE.jpg;7113;7373;36081;355;368;13
/net/per610a/home/mvp/mvp_db/news7-lv/2015/2015_01_01_19_00/2015_01_01_19_00.mpg;Shinzo ABE.jpg;13293;13433;24093;665;672;7
/net/per610a/home/mvp/mvp_db/news7-lv/2015/2015_01_01_19_00/2015_01_01_19_00.mpg;Shinzo ABE.jpg;13613;13749;24093;681;688;7
/net/per610a/home/mvp/mvp_db/news7-lv/2015/2015_01_01_19_00/2015_01_01_19_00.mpg;Shinzo ABE.jpg;13849;14253;24093;693;713;20
/net/per610a/home/mvp/mvp_db/news7-lv/2015/2015_01_02_19_00/2015_01_02_19_00.mpg;Shinzo ABE.jpg;11049;11093;36077;552;555;3
/net/per610a/home/mvp/mvp_db/news7-lv/2015/2015_01_02_19_00/2015_01_02_19_00.mpg;Shinzo ABE.jpg;13209;13477;36077;660;674;14
/net/per610a/home/mvp/mvp_db/news7-lv/2015/2015_01_02_19_00/2015_01_02_19_00.mpg;Shinzo ABE.jpg;14377;15037;36077;719;752;33
/net/per610a/home/mvp/mvp_db/news7-lv/2015/2015_01_02_19_00/2015_01_02_19_00.mpg;Shinzo ABE.jpg;17633;17929;36077;882;897;15
/net/per610a/home/mvp/mvp_db/news7-lv/2015/2015_01_05_19_00/2015_01_05_19_00.mpg;Shinzo ABE.jpg;705;837;36085;35;41;6
/net/per610a/home/mvp/mvp_db/news7-lv/2015/2015_01_05_19_00/2015_01_05_19_00.mpg;Shinzo ABE.jpg;10185;10485;36085;509;524;15
/net/per610a/home/mvp/mvp_db/news7-lv/2015/2015_01_05_19_00/2015_01_05_19_00.mpg;Shinzo ABE.jpg;10661;12125;36085;533;606;73
/net/per610a/home/mvp/mvp_db/news7-lv/2015/2015_01_05_19_00/2015_01_05_19_00.mpg;Shinzo ABE.jpg;12229;13373;36085;612;669;57
/net/per610a/home/mvp/mvp_db/news7-lv/2015/2015_01_05_19_00/2015_01_05_19_00.mpg;Shinzo ABE.jpg;13537;14185;36085;677;709;32
/net/per610a/home/mvp/mvp_db/news7-lv/2015/2015_01_05_19_00/2015_01_05_19_00.mpg;Renho.jpg;15709;15905;36085;786;796;10
/net/per610a/home/mvp/mvp_db/news7-lv/2015/2015_01_06_19_00/2015_01_06_19_00.mpg;Shinzo ABE.jpg;8869;9089;36085;443;454;11
/net/per610a/home/mvp/mvp_db/news7-lv/2015/2015_01_09_19_00/2015_01_09_19_00.mpg;Shinzo ABE.jpg;18949;19273;36085;948;964;16
/net/per610a/home/mvp/mvp_db/news7-lv/2015/2015_01_09_19_00/2015_01_09_19_00.mpg;Shinzo ABE.jpg;19517;19569;36085;976;979;3
/net/per610a/home/mvp/mvp_db/news7-lv/2015/2015_01_12_19_00/2015_01_12_19_00.mpg;Shinzo ABE.jpg;10981;11569;36085;549;579;30
/net/per610a/home/mvp/mvp_db/news7-lv/2015/2015_01_12_19_00/2015_01_12_19_00.mpg;Shinzo ABE.jpg;12253;12333;36085;613;617;4
/net/per610a/home/mvp/mvp_db/news7-lv/2015/2015_01_12_19_00/2015_01_12_19_00.mpg;Shinzo ABE.jpg;12409;12701;36085;621;635;14
/net/per610a/home/mvp/mvp_db/news7-lv/2015/2015_01_12_19_00/2015_01_12_19_00.mpg;Shinzo ABE.jpg;18217;18221;36085;911;911;0
/net/per610a/home/mvp/mvp_db/news7-lv/2015/2015_01_12_19_00/2015_01_12_19_00.mpg;Shinzo ABE.jpg;19777;19781;36085;989;990;1
/net/per610a/home/mvp/mvp_db/news7-lv/2015/2015_01_13_19_00/2015_01_13_19_00.mpg;Shinzo ABE.jpg;25717;26217;36085;1287;1312;25
/net/per610a/home/mvp/mvp_db/news7-lv/2015/2015_01_14_19_00/2015_01_14_19_00.mpg;Yoshimi WATANABE.jpg;16161;17153;36077;808;858;50
/net/per610a/home/mvp/mvp_db/news7-lv/2015/2015_01_14_19_00/2015_01_14_19_00.mpg;Yoshimi WATANABE.jpg;17433;17665;36077;872;883;11
/net/per610a/home/mvp/mvp_db/news7-lv/2015/2015_01_17_19_00/2015_01_17_19_00.mpg;Katsuya OKADA.jpg;23513;23733;36085;1176;1187;11
/net/per610a/home/mvp/mvp_db/news7-lv/2015/2015_01_17_19_00/2015_01_17_19_00.mpg;Katsuya OKADA.jpg;23797;23833;36085;1191;1192;1
/net/per610a/home/mvp/mvp_db/news7-lv/2015/2015_01_17_19_00/2015_01_17_19_00.mpg;Katsuya OKADA.jpg;25937;26181;36085;1298;1310;12
/net/per610a/home/mvp/mvp_db/news7-lv/2015/2015_01_18_19_00/2015_01_18_19_00.mpg;Katsuya OKADA.jpg;1749;1789;36081;87;89;2
/net/per610a/home/mvp/mvp_db/news7-lv/2015/2015_01_18_19_00/2015_01_18_19_00.mpg;Katsuya OKADA.jpg;9269;9269;36081;463;463;0
/net/per610a/home/mvp/mvp_db/news7-lv/2015/2015_01_18_19_00/2015_01_18_19_00.mpg;Katsuya OKADA.jpg;9369;9473;36081;468;473;5
/net/per610a/home/mvp/mvp_db/news7-lv/2015/2015_01_18_19_00/2015_01_18_19_00.mpg;Katsuya OKADA.jpg;10189;10733;36081;509;536;27
/net/per610a/home/mvp/mvp_db/news7-lv/2015/2015_01_18_19_00/2015_01_18_19_00.mpg;Katsuya OKADA.jpg;3913;4261;36081;195;213;18
/net/per610a/home/mvp/mvp_db/news7-lv/2015/2015_01_18_19_00/2015_01_18_19_00.mpg;Katsuya OKADA.jpg;4325;4401;36081;216;220;4
/net/per610a/home/mvp/mvp_db/news7-lv/2015/2015_01_18_19_00/2015_01_18_19_00.mpg;Katsuya OKADA.jpg;9241;9261;36081;462;463;1
/net/per610a/home/mvp/mvp_db/news7-lv/2015/2015_01_18_19_00/2015_01_18_19_00.mpg;Katsuya OKADA.jpg;10041;10153;36081;502;507;5
/net/per610a/home/mvp/mvp_db/news7-lv/2015/2015_01_18_19_00/2015_01_18_19_00.mpg;Sadakazu TANIGAKI.jpg;6469;8365;36081;323;418;95
/net/per610a/home/mvp/mvp_db/news7-lv/2015/2015_01_18_19_00/2015_01_18_19_00.mpg;Katsuya OKADA.jpg;9717;9865;36081;486;493;7
/net/per610a/home/mvp/mvp_db/news7-lv/2015/2015_01_19_19_00/2015_01_19_19_00.mpg;Shinzo ABE.jpg;1193;1609;36085;59;80;21
/net/per610a/home/mvp/mvp_db/news7-lv/2015/2015_01_19_19_00/2015_01_19_19_00.mpg;Shinzo ABE.jpg;3445;3829;36085;172;191;19
/net/per610a/home/mvp/mvp_db/news7-lv/2015/2015_01_19_19_00/2015_01_19_19_00.mpg;Shinzo ABE.jpg;3897;4537;36085;195;227;32
/net/per610a/home/mvp/mvp_db/news7-lv/2015/2015_01_19_19_00/2015_01_19_19_00.mpg;Katsuya OKADA.jpg;4541;4773;36085;227;238;11
/net/per610a/home/mvp/mvp_db/news7-lv/2015/2015_01_19_19_00/2015_01_19_19_00.mpg;Katsuya OKADA.jpg;4857;4897;36085;243;245;2
/net/per610a/home/mvp/mvp_db/news7-lv/2015/2015_01_19_19_00/2015_01_19_19_00.mpg;Katsuya OKADA.jpg;5021;5469;36085;251;273;22
/net/per610a/home/mvp/mvp_db/news7-lv/2015/2015_01_19_19_00/2015_01_19_19_00.mpg;Katsuya OKADA.jpg;6817;7085;36085;341;354;13
/net/per610a/home/mvp/mvp_db/news7-lv/2015/2015_01_19_19_00/2015_01_19_19_00.mpg;Katsuya OKADA.jpg;7741;7825;36085;387;391;4
/net/per610a/home/mvp/mvp_db/news7-lv/2015/2015_01_19_19_00/2015_01_19_19_00.mpg;Katsuya OKADA.jpg;36065;36081;36085;1804;1805;1
/net/per610a/home/mvp/mvp_db/news7-lv/2015/2015_01_19_19_00/2015_01_19_19_00.mpg;Toru Hashimoto.jpg;8501;9009;36085;425;450;25
/net/per610a/home/mvp/mvp_db/news7-lv/2015/2015_01_20_19_00/2015_01_20_19_00.mpg;Shinzo ABE.jpg;2953;5673;38481;147;283;136
/net/per610a/home/mvp/mvp_db/news7-lv/2015/2015_01_20_19_00/2015_01_20_19_00.mpg;Shinzo ABE.jpg;6181;6181;38481;309;309;0
/net/per610a/home/mvp/mvp_db/news7-lv/2015/2015_01_20_19_00/2015_01_20_19_00.mpg;Shinzo ABE.jpg;6261;7445;38481;313;372;59
/net/per610a/home/mvp/mvp_db/news7-lv/2015/2015_01_20_19_00/2015_01_20_19_00.mpg;Shinzo ABE.jpg;27701;27701;38481;1386;1386;0
/net/per610a/home/mvp/mvp_db/news7-lv/2015/2015_01_20_19_00/2015_01_20_19_00.mpg;Shinzo ABE.jpg;27773;28089;38481;1390;1405;15
/net/per610a/home/mvp/mvp_db/news7-lv/2015/2015_01_20_19_00/2015_01_20_19_00.mpg;Shinzo ABE.jpg;37349;38469;38481;1869;1925;56
/net/per610a/home/mvp/mvp_db/news7-lv/2015/2015_01_21_19_00/2015_01_21_19_00.mpg;Shinzo ABE.jpg;6137;7049;36085;307;352;45
/net/per610a/home/mvp/mvp_db/news7-lv/2015/2015_01_21_19_00/2015_01_21_19_00.mpg;Shinzo ABE.jpg;21805;21857;36085;1091;1093;2
/net/per610a/home/mvp/mvp_db/news7-lv/2015/2015_01_23_19_00/2015_01_23_19_00.mpg;Shinzo ABE.jpg;3741;3897;36085;187;195;8
/net/per610a/home/mvp/mvp_db/news7-lv/2015/2015_01_23_19_00/2015_01_23_19_00.mpg;Shinzo ABE.jpg;35985;36069;36085;1800;1805;5
/net/per610a/home/mvp/mvp_db/news7-lv/2015/2015_01_23_19_00/2015_01_23_19_00.mpg;Shinzo ABE.jpg;8569;8737;36085;428;437;9
/net/per610a/home/mvp/mvp_db/news7-lv/2015/2015_01_24_19_00/2015_01_24_19_00.mpg;Shinzo ABE.jpg;25517;26153;36085;1277;1308;31
/net/per610a/home/mvp/mvp_db/news7-lv/2015/2015_01_25_19_00/2015_01_25_19_00.mpg;Shinzo ABE.jpg;457;513;36085;22;25;3
/net/per610a/home/mvp/mvp_db/news7-lv/2015/2015_01_25_19_00/2015_01_25_19_00.mpg;Shinzo ABE.jpg;3573;3777;36085;178;189;11
/net/per610a/home/mvp/mvp_db/news7-lv/2015/2015_01_25_19_00/2015_01_25_19_00.mpg;Shinzo ABE.jpg;6513;7429;36085;325;371;46
/net/per610a/home/mvp/mvp_db/news7-lv/2015/2015_01_25_19_00/2015_01_25_19_00.mpg;Shinzo ABE.jpg;8425;8785;36085;421;439;18
/net/per610a/home/mvp/mvp_db/news7-lv/2015/2015_01_25_19_00/2015_01_25_19_00.mpg;Shinzo ABE.jpg;35965;36029;36085;1799;1803;4
/net/per610a/home/mvp/mvp_db/news7-lv/2015/2015_01_26_19_00/2015_01_26_19_00.mpg;Shinzo ABE.jpg;9417;10097;36085;471;505;34
/net/per610a/home/mvp/mvp_db/news7-lv/2015/2015_01_26_19_00/2015_01_26_19_00.mpg;Shinzo ABE.jpg;29869;30293;36085;1494;1516;22
/net/per610a/home/mvp/mvp_db/news7-lv/2015/2015_01_27_19_00/2015_01_27_19_00.mpg;Shinzo ABE.jpg;9357;9497;36081;468;475;7
/net/per610a/home/mvp/mvp_db/news7-lv/2015/2015_01_27_19_00/2015_01_27_19_00.mpg;Shinzo ABE.jpg;14877;15277;36081;744;764;20
/net/per610a/home/mvp/mvp_db/news7-lv/2015/2015_01_27_19_00/2015_01_27_19_00.mpg;Shinzo ABE.jpg;25309;25449;36081;1266;1273;7
/net/per610a/home/mvp/mvp_db/news7-lv/2015/2015_01_28_19_00/2015_01_28_19_00.mpg;Shinzo ABE.jpg;27629;28093;36085;1382;1406;24
/net/per610a/home/mvp/mvp_db/news7-lv/2015/2015_01_31_19_00/2015_01_31_19_00.mpg;Shinzo ABE.jpg;2285;2469;36085;114;123;9
/net/per610a/home/mvp/mvp_db/news7-lv/2015/2015_01_31_19_00/2015_01_31_19_00.mpg;Katsuya OKADA.jpg;31505;32065;36085;1576;1604;28
/net/per610a/home/mvp/mvp_db/news7-lv/2015/2015_02_01_19_00/2015_02_01_19_00.mpg;Shinzo ABE.jpg;241;365;38481;12;18;6
/net/per610a/home/mvp/mvp_db/news7-lv/2015/2015_02_01_19_00/2015_02_01_19_00.mpg;Shinzo ABE.jpg;3101;3121;38481;155;156;1
/net/per610a/home/mvp/mvp_db/news7-lv/2015/2015_02_01_19_00/2015_02_01_19_00.mpg;Shinzo ABE.jpg;6349;6817;38481;317;341;24
/net/per610a/home/mvp/mvp_db/news7-lv/2015/2015_02_01_19_00/2015_02_01_19_00.mpg;Shinzo ABE.jpg;19057;19153;38481;953;958;5
/net/per610a/home/mvp/mvp_db/news7-lv/2015/2015_02_01_19_00/2015_02_01_19_00.mpg;Shinzo ABE.jpg;3233;3693;38481;161;184;23
/net/per610a/home/mvp/mvp_db/news7-lv/2015/2015_02_02_19_00/2015_02_02_19_00.mpg;Shinzo ABE.jpg;4093;4613;36081;204;230;26
/net/per610a/home/mvp/mvp_db/news7-lv/2015/2015_02_02_19_00/2015_02_02_19_00.mpg;Shinzo ABE.jpg;15225;15909;36081;762;796;34
/net/per610a/home/mvp/mvp_db/news7-lv/2015/2015_02_02_19_00/2015_02_02_19_00.mpg;Shinzo ABE.jpg;16329;17021;36081;817;851;34
/net/per610a/home/mvp/mvp_db/news7-lv/2015/2015_02_03_19_00/2015_02_03_19_00.mpg;Shinzo ABE.jpg;13037;13137;36085;652;657;5
/net/per610a/home/mvp/mvp_db/news7-lv/2015/2015_02_05_19_00/2015_02_05_19_00.mpg;Shinzo ABE.jpg;25241;26785;36085;1263;1340;77
/net/per610a/home/mvp/mvp_db/news7-lv/2015/2015_02_05_19_00/2015_02_05_19_00.mpg;Shinzo ABE.jpg;28581;28961;36085;1430;1449;19
/net/per610a/home/mvp/mvp_db/news7-lv/2015/2015_02_06_19_00/2015_02_06_19_00.mpg;Shinzo ABE.jpg;23281;23781;36077;1164;1189;25
/net/per610a/home/mvp/mvp_db/news7-lv/2015/2015_02_07_19_00/2015_02_07_19_00.mpg;Shinzo ABE.jpg;27045;27529;36085;1353;1377;24
/net/per610a/home/mvp/mvp_db/news7-lv/2015/2015_02_07_19_00/2015_02_07_19_00.mpg;Natsuo YAMAGUCHI.jpg;28917;29533;36085;1447;1478;31
/net/per610a/home/mvp/mvp_db/news7-lv/2015/2015_02_07_19_00/2015_02_07_19_00.mpg;Katsuya OKADA.jpg;29609;30385;36085;1481;1520;39
/net/per610a/home/mvp/mvp_db/news7-lv/2015/2015_02_09_19_00/2015_02_09_19_00.mpg;Sadakazu TANIGAKI.jpg;6557;6657;36073;328;333;5
/net/per610a/home/mvp/mvp_db/news7-lv/2015/2015_02_09_19_00/2015_02_09_19_00.mpg;Sadakazu TANIGAKI.jpg;6873;7161;36073;343;358;15
/net/per610a/home/mvp/mvp_db/news7-lv/2015/2015_02_09_19_00/2015_02_09_19_00.mpg;Sadakazu TANIGAKI.jpg;7253;7749;36073;362;387;25
/net/per610a/home/mvp/mvp_db/news7-lv/2015/2015_02_09_19_00/2015_02_09_19_00.mpg;Shinzo ABE.jpg;8885;9141;36073;444;457;13
/net/per610a/home/mvp/mvp_db/news7-lv/2015/2015_02_09_19_00/2015_02_09_19_00.mpg;Shinzo ABE.jpg;9301;10457;36073;465;523;58
/net/per610a/home/mvp/mvp_db/news7-lv/2015/2015_02_09_19_00/2015_02_09_19_00.mpg;Shinzo ABE.jpg;14633;15029;36073;732;752;20
/net/per610a/home/mvp/mvp_db/news7-lv/2015/2015_02_09_19_00/2015_02_09_19_00.mpg;Shinzo ABE.jpg;16353;16397;36073;818;820;2
/net/per610a/home/mvp/mvp_db/news7-lv/2015/2015_02_09_19_00/2015_02_09_19_00.mpg;Shinzo ABE.jpg;16625;16685;36073;831;834;3
/net/per610a/home/mvp/mvp_db/news7-lv/2015/2015_02_09_19_00/2015_02_09_19_00.mpg;Shinzo ABE.jpg;17105;18057;36073;855;903;48
/net/per610a/home/mvp/mvp_db/news7-lv/2015/2015_02_10_19_00/2015_02_10_19_00.mpg;Shinzo ABE.jpg;28977;29017;36085;1450;1452;2
/net/per610a/home/mvp/mvp_db/news7-lv/2015/2015_02_10_19_00/2015_02_10_19_00.mpg;Shinzo ABE.jpg;30477;30617;36085;1525;1532;7
/net/per610a/home/mvp/mvp_db/news7-lv/2015/2015_02_11_19_00/2015_02_11_19_00.mpg;Natsuo YAMAGUCHI.jpg;10625;11201;36085;531;560;29
/net/per610a/home/mvp/mvp_db/news7-lv/2015/2015_02_11_19_00/2015_02_11_19_00.mpg;Katsuya OKADA.jpg;11225;12257;36085;561;613;52
/net/per610a/home/mvp/mvp_db/news7-lv/2015/2015_02_12_19_00/2015_02_12_19_00.mpg;Shinzo ABE.jpg;7421;7909;36085;371;395;24
/net/per610a/home/mvp/mvp_db/news7-lv/2015/2015_02_12_19_00/2015_02_12_19_00.mpg;Shinzo ABE.jpg;7997;8633;36085;400;432;32
/net/per610a/home/mvp/mvp_db/news7-lv/2015/2015_02_12_19_00/2015_02_12_19_00.mpg;Shinzo ABE.jpg;8709;9365;36085;435;468;33
/net/per610a/home/mvp/mvp_db/news7-lv/2015/2015_02_12_19_00/2015_02_12_19_00.mpg;Shinzo ABE.jpg;9953;13865;36085;498;693;195
/net/per610a/home/mvp/mvp_db/news7-lv/2015/2015_02_12_19_00/2015_02_12_19_00.mpg;Shinzo ABE.jpg;14141;14369;36085;707;719;12
/net/per610a/home/mvp/mvp_db/news7-lv/2015/2015_02_12_19_00/2015_02_12_19_00.mpg;Shinzo ABE.jpg;14693;15773;36085;735;789;54
/net/per610a/home/mvp/mvp_db/news7-lv/2015/2015_02_12_19_00/2015_02_12_19_00.mpg;Shinzo ABE.jpg;31485;32297;36085;1575;1616;41
/net/per610a/home/mvp/mvp_db/news7-lv/2015/2015_02_13_19_00/2015_02_13_19_00.mpg;Junichiro KOIZUMI.jpg;9653;9817;36085;483;491;8
/net/per610a/home/mvp/mvp_db/news7-lv/2015/2015_02_13_19_00/2015_02_13_19_00.mpg;Shinzo ABE.jpg;16949;17161;36085;848;858;10
/net/per610a/home/mvp/mvp_db/news7-lv/2015/2015_02_14_19_00/2015_02_14_19_00.mpg;Shinzo ABE.jpg;18725;19061;36081;937;954;17
/net/per610a/home/mvp/mvp_db/news7-lv/2015/2015_02_14_19_00/2015_02_14_19_00.mpg;Shinzo ABE.jpg;19761;19833;36081;989;992;3
/net/per610a/home/mvp/mvp_db/news7-lv/2015/2015_02_14_19_00/2015_02_14_19_00.mpg;Shinzo ABE.jpg;19953;19977;36081;998;999;1
/net/per610a/home/mvp/mvp_db/news7-lv/2015/2015_02_14_19_00/2015_02_14_19_00.mpg;Shinzo ABE.jpg;20589;20785;36081;1030;1040;10
/net/per610a/home/mvp/mvp_db/news7-lv/2015/2015_02_14_19_00/2015_02_14_19_00.mpg;Shinzo ABE.jpg;20889;22273;36081;1045;1114;69
/net/per610a/home/mvp/mvp_db/news7-lv/2015/2015_02_16_19_00/2015_02_16_19_00.mpg;Shinzo ABE.jpg;19217;19941;36085;961;998;37
/net/per610a/home/mvp/mvp_db/news7-lv/2015/2015_02_16_19_00/2015_02_16_19_00.mpg;Katsuya OKADA.jpg;25749;25961;36085;1288;1299;11
/net/per610a/home/mvp/mvp_db/news7-lv/2015/2015_02_17_19_00/2015_02_17_19_00.mpg;Shinzo ABE.jpg;23345;23913;36085;1168;1196;28
/net/per610a/home/mvp/mvp_db/news7-lv/2015/2015_02_18_19_00/2015_02_18_19_00.mpg;Shinzo ABE.jpg;22893;23317;36085;1145;1166;21
/net/per610a/home/mvp/mvp_db/news7-lv/2015/2015_02_18_19_00/2015_02_18_19_00.mpg;Kyoko Nakayama.jpg;27029;27421;36085;1352;1372;20
/net/per610a/home/mvp/mvp_db/news7-lv/2015/2015_02_19_19_00/2015_02_19_19_00.mpg;Shinzo ABE.jpg;1737;1913;36085;86;95;9
/net/per610a/home/mvp/mvp_db/news7-lv/2015/2015_02_21_19_00/2015_02_21_19_00.mpg;Katsuya OKADA.jpg;25493;26621;36085;1275;1332;57
/net/per610a/home/mvp/mvp_db/news7-lv/2015/2015_02_22_19_00/2015_02_22_19_00.mpg;Kenji Eda.jpg;19297;19937;36085;965;997;32
/net/per610a/home/mvp/mvp_db/news7-lv/2015/2015_02_22_19_00/2015_02_22_19_00.mpg;Kenji Eda.jpg;20021;21065;36085;1002;1054;52
/net/per610a/home/mvp/mvp_db/news7-lv/2015/2015_02_22_19_00/2015_02_22_19_00.mpg;Toru Hashimoto.jpg;21401;21549;36085;1071;1078;7
/net/per610a/home/mvp/mvp_db/news7-lv/2015/2015_02_23_19_00/2015_02_23_19_00.mpg;Shinzo ABE.jpg;25929;26465;36093;1297;1324;27
/net/per610a/home/mvp/mvp_db/news7-lv/2015/2015_02_24_19_00/2015_02_24_19_00.mpg;Sadakazu TANIGAKI.jpg;25449;25885;36085;1273;1295;22
/net/per610a/home/mvp/mvp_db/news7-lv/2015/2015_02_24_19_00/2015_02_24_19_00.mpg;Katsuya OKADA.jpg;25973;26213;36085;1299;1311;12
/net/per610a/home/mvp/mvp_db/news7-lv/2015/2015_02_25_19_00/2015_02_25_19_00.mpg;Shinzo ABE.jpg;105;221;36085;5;11;6
/net/per610a/home/mvp/mvp_db/news7-lv/2015/2015_02_25_19_00/2015_02_25_19_00.mpg;Shinzo ABE.jpg;11093;11637;36085;555;582;27
/net/per610a/home/mvp/mvp_db/news7-lv/2015/2015_02_25_19_00/2015_02_25_19_00.mpg;Shinzo ABE.jpg;13213;13445;36085;661;672;11
/net/per610a/home/mvp/mvp_db/news7-lv/2015/2015_02_25_19_00/2015_02_25_19_00.mpg;Shinzo ABE.jpg;17213;17485;36085;861;875;14
/net/per610a/home/mvp/mvp_db/news7-lv/2015/2015_02_25_19_00/2015_02_25_19_00.mpg;Shinzo ABE.jpg;22273;22429;36085;1114;1122;8
/net/per610a/home/mvp/mvp_db/news7-lv/2015/2015_02_25_19_00/2015_02_25_19_00.mpg;Shinzo ABE.jpg;22501;22521;36085;1126;1127;1
/net/per610a/home/mvp/mvp_db/news7-lv/2015/2015_02_25_19_00/2015_02_25_19_00.mpg;Sadakazu TANIGAKI.jpg;18581;20453;36085;929;1023;94
/net/per610a/home/mvp/mvp_db/news7-lv/2015/2015_02_26_19_00/2015_02_26_19_00.mpg;Seiji MAEHARA.jpg;29385;29501;36081;1470;1475;5
/net/per610a/home/mvp/mvp_db/news7-lv/2015/2015_03_01_19_00/2015_03_01_19_00.mpg;Shinzo ABE.jpg;15221;15493;36077;761;775;14
/net/per610a/home/mvp/mvp_db/news7-lv/2015/2015_03_01_19_00/2015_03_01_19_00.mpg;Shinzo ABE.jpg;17389;17841;36077;870;892;22
/net/per610a/home/mvp/mvp_db/news7-lv/2015/2015_03_01_19_00/2015_03_01_19_00.mpg;Renho.jpg;24689;24769;36077;1235;1239;4
/net/per610a/home/mvp/mvp_db/news7-lv/2015/2015_03_02_19_00/2015_03_02_19_00.mpg;Shinzo ABE.jpg;1189;1649;36085;59;82;23
/net/per610a/home/mvp/mvp_db/news7-lv/2015/2015_03_02_19_00/2015_03_02_19_00.mpg;Shinzo ABE.jpg;2533;2721;36085;126;136;10
/net/per610a/home/mvp/mvp_db/news7-lv/2015/2015_03_02_19_00/2015_03_02_19_00.mpg;Natsuo YAMAGUCHI.jpg;27869;28305;36085;1394;1416;22
/net/per610a/home/mvp/mvp_db/news7-lv/2015/2015_03_03_19_00/2015_03_03_19_00.mpg;Katsuya OKADA.jpg;7129;7129;36085;356;356;0
/net/per610a/home/mvp/mvp_db/news7-lv/2015/2015_03_03_19_00/2015_03_03_19_00.mpg;Katsuya OKADA.jpg;7325;7541;36085;366;377;11
/net/per610a/home/mvp/mvp_db/news7-lv/2015/2015_03_03_19_00/2015_03_03_19_00.mpg;Katsuya OKADA.jpg;7689;7725;36085;384;386;2
/net/per610a/home/mvp/mvp_db/news7-lv/2015/2015_03_03_19_00/2015_03_03_19_00.mpg;Katsuya OKADA.jpg;7797;7989;36085;390;399;9
/net/per610a/home/mvp/mvp_db/news7-lv/2015/2015_03_03_19_00/2015_03_03_19_00.mpg;Katsuya OKADA.jpg;8445;8521;36085;422;426;4
/net/per610a/home/mvp/mvp_db/news7-lv/2015/2015_03_03_19_00/2015_03_03_19_00.mpg;Shinzo ABE.jpg;7997;8061;36085;400;403;3
/net/per610a/home/mvp/mvp_db/news7-lv/2015/2015_03_03_19_00/2015_03_03_19_00.mpg;Shinzo ABE.jpg;19865;19937;36085;994;997;3
/net/per610a/home/mvp/mvp_db/news7-lv/2015/2015_03_03_19_00/2015_03_03_19_00.mpg;Shinzo ABE.jpg;9481;9909;36085;474;495;21
/net/per610a/home/mvp/mvp_db/news7-lv/2015/2015_03_03_19_00/2015_03_03_19_00.mpg;Shinzo ABE.jpg;19609;19637;36085;981;982;1
/net/per610a/home/mvp/mvp_db/news7-lv/2015/2015_03_04_19_00/2015_03_04_19_00.mpg;Shinzo ABE.jpg;6401;6777;36085;320;339;19
/net/per610a/home/mvp/mvp_db/news7-lv/2015/2015_03_04_19_00/2015_03_04_19_00.mpg;Shinzo ABE.jpg;7189;7801;36085;359;390;31
/net/per610a/home/mvp/mvp_db/news7-lv/2015/2015_03_04_19_00/2015_03_04_19_00.mpg;Shinzo ABE.jpg;21157;21241;36085;1058;1063;5
/net/per610a/home/mvp/mvp_db/news7-lv/2015/2015_03_04_19_00/2015_03_04_19_00.mpg;Sadakazu TANIGAKI.jpg;7189;8121;36085;359;406;47
/net/per610a/home/mvp/mvp_db/news7-lv/2015/2015_03_05_19_00/2015_03_05_19_00.mpg;Shinzo ABE.jpg;993;1165;36085;49;58;9
/net/per610a/home/mvp/mvp_db/news7-lv/2015/2015_03_07_19_00/2015_03_07_19_00.mpg;Shinzo ABE.jpg;19181;19981;36073;959;999;40
/net/per610a/home/mvp/mvp_db/news7-lv/2015/2015_03_07_19_00/2015_03_07_19_00.mpg;Shinzo ABE.jpg;20745;21433;36073;1038;1072;34
/net/per610a/home/mvp/mvp_db/news7-lv/2015/2015_03_08_19_00/2015_03_08_19_00.mpg;Sadakazu TANIGAKI.jpg;12005;12221;36085;600;611;11
/net/per610a/home/mvp/mvp_db/news7-lv/2015/2015_03_09_19_00/2015_03_09_19_00.mpg;Shinzo ABE.jpg;13865;15425;36085;693;771;78
/net/per610a/home/mvp/mvp_db/news7-lv/2015/2015_03_09_19_00/2015_03_09_19_00.mpg;Shinzo ABE.jpg;23821;24121;36085;1192;1207;15
/net/per610a/home/mvp/mvp_db/news7-lv/2015/2015_03_09_19_00/2015_03_09_19_00.mpg;Shinzo ABE.jpg;24785;24957;36085;1240;1249;9
/net/per610a/home/mvp/mvp_db/news7-lv/2015/2015_03_09_19_00/2015_03_09_19_00.mpg;Shinzo ABE.jpg;25649;25669;36085;1283;1284;1
/net/per610a/home/mvp/mvp_db/news7-lv/2015/2015_03_12_19_00/2015_03_12_19_00.mpg;Shinzo ABE.jpg;6045;6845;36089;302;342;40
/net/per610a/home/mvp/mvp_db/news7-lv/2015/2015_03_13_19_00/2015_03_13_19_00.mpg;Shinzo ABE.jpg;18649;18669;36077;933;934;1
/net/per610a/home/mvp/mvp_db/news7-lv/2015/2015_03_13_19_00/2015_03_13_19_00.mpg;Shinzo ABE.jpg;18773;19005;36077;939;950;11
/net/per610a/home/mvp/mvp_db/news7-lv/2015/2015_03_13_19_00/2015_03_13_19_00.mpg;Shinzo ABE.jpg;23793;23957;36077;1190;1198;8
/net/per610a/home/mvp/mvp_db/news7-lv/2015/2015_03_13_19_00/2015_03_13_19_00.mpg;Shinzo ABE.jpg;20369;20489;36077;1019;1025;6
/net/per610a/home/mvp/mvp_db/news7-lv/2015/2015_03_13_19_00/2015_03_13_19_00.mpg;Shinzo ABE.jpg;24889;24901;36077;1245;1245;0
/net/per610a/home/mvp/mvp_db/news7-lv/2015/2015_03_14_19_00/2015_03_14_19_00.mpg;Shinzo ABE.jpg;15137;15137;36085;757;757;0
/net/per610a/home/mvp/mvp_db/news7-lv/2015/2015_03_14_19_00/2015_03_14_19_00.mpg;Shinzo ABE.jpg;15245;15989;36085;762;800;38
/net/per610a/home/mvp/mvp_db/news7-lv/2015/2015_03_17_19_00/2015_03_17_19_00.mpg;Toru Hashimoto.jpg;6865;7301;36085;343;365;22
/net/per610a/home/mvp/mvp_db/news7-lv/2015/2015_03_17_19_00/2015_03_17_19_00.mpg;Shinzo ABE.jpg;21609;21833;36085;1081;1092;11
/net/per610a/home/mvp/mvp_db/news7-lv/2015/2015_03_17_19_00/2015_03_17_19_00.mpg;Shinzo ABE.jpg;23177;23597;36085;1159;1180;21
/net/per610a/home/mvp/mvp_db/news7-lv/2015/2015_03_17_19_00/2015_03_17_19_00.mpg;Shinzo ABE.jpg;23845;24401;36085;1193;1221;28
/net/per610a/home/mvp/mvp_db/news7-lv/2015/2015_03_18_19_00/2015_03_18_19_00.mpg;Shinzo ABE.jpg;17781;17793;36081;890;890;0
/net/per610a/home/mvp/mvp_db/news7-lv/2015/2015_03_18_19_00/2015_03_18_19_00.mpg;Shinzo ABE.jpg;18105;18377;36081;906;919;13
/net/per610a/home/mvp/mvp_db/news7-lv/2015/2015_03_18_19_00/2015_03_18_19_00.mpg;Shinzo ABE.jpg;17909;18041;36081;896;903;7
/net/per610a/home/mvp/mvp_db/news7-lv/2015/2015_03_18_19_00/2015_03_18_19_00.mpg;Shinzo ABE.jpg;24397;24613;36081;1221;1231;10
/net/per610a/home/mvp/mvp_db/news7-lv/2015/2015_03_19_19_00/2015_03_19_19_00.mpg;Shinzo ABE.jpg;2973;3361;36077;148;168;20
/net/per610a/home/mvp/mvp_db/news7-lv/2015/2015_03_20_19_00/2015_03_20_19_00.mpg;Shinzo ABE.jpg;19681;19817;36085;985;991;6
/net/per610a/home/mvp/mvp_db/news7-lv/2015/2015_03_20_19_00/2015_03_20_19_00.mpg;Shinzo ABE.jpg;29625;30149;36085;1482;1508;26
/net/per610a/home/mvp/mvp_db/news7-lv/2015/2015_03_20_19_00/2015_03_20_19_00.mpg;Shinzo ABE.jpg;30377;30505;36085;1520;1526;6
/net/per610a/home/mvp/mvp_db/news7-lv/2015/2015_03_20_19_00/2015_03_20_19_00.mpg;Shinzo ABE.jpg;31093;31221;36085;1556;1562;6
/net/per610a/home/mvp/mvp_db/news7-lv/2015/2015_03_20_19_00/2015_03_20_19_00.mpg;Taro ASO.jpg;28197;29065;36085;1411;1454;43
/net/per610a/home/mvp/mvp_db/news7-lv/2015/2015_03_21_19_00/2015_03_21_19_00.mpg;Shinzo ABE.jpg;3289;3549;36085;164;177;13
/net/per610a/home/mvp/mvp_db/news7-lv/2015/2015_03_22_19_00/2015_03_22_19_00.mpg;Shinzo ABE.jpg;25689;26013;36085;1285;1301;16
/net/per610a/home/mvp/mvp_db/news7-lv/2015/2015_03_23_19_00/2015_03_23_19_00.mpg;Shinzo ABE.jpg;12261;12629;36085;613;632;19
/net/per610a/home/mvp/mvp_db/news7-lv/2015/2015_03_23_19_00/2015_03_23_19_00.mpg;Shinzo ABE.jpg;13017;13121;36085;651;656;5
/net/per610a/home/mvp/mvp_db/news7-lv/2015/2015_03_23_19_00/2015_03_23_19_00.mpg;Shinzo ABE.jpg;18221;18297;36085;911;915;4
/net/per610a/home/mvp/mvp_db/news7-lv/2015/2015_03_23_19_00/2015_03_23_19_00.mpg;Shinzo ABE.jpg;18645;19049;36085;933;953;20
/net/per610a/home/mvp/mvp_db/news7-lv/2015/2015_03_23_19_00/2015_03_23_19_00.mpg;Sadakazu TANIGAKI.jpg;16157;16157;36085;808;808;0
/net/per610a/home/mvp/mvp_db/news7-lv/2015/2015_03_23_19_00/2015_03_23_19_00.mpg;Sadakazu TANIGAKI.jpg;17101;17341;36085;855;867;12
/net/per610a/home/mvp/mvp_db/news7-lv/2015/2015_03_23_19_00/2015_03_23_19_00.mpg;Shinzo ABE.jpg;24273;24305;36085;1214;1216;2
/net/per610a/home/mvp/mvp_db/news7-lv/2015/2015_03_23_19_00/2015_03_23_19_00.mpg;Shinzo ABE.jpg;32001;32417;36085;1601;1622;21
/net/per610a/home/mvp/mvp_db/news7-lv/2015/2015_03_24_19_00/2015_03_24_19_00.mpg;Natsuo YAMAGUCHI.jpg;6065;6573;36085;303;328;25
/net/per610a/home/mvp/mvp_db/news7-lv/2015/2015_03_24_19_00/2015_03_24_19_00.mpg;Shinzo ABE.jpg;26409;26709;36085;1321;1336;15
/net/per610a/home/mvp/mvp_db/news7-lv/2015/2015_03_24_19_00/2015_03_24_19_00.mpg;Shinzo ABE.jpg;27685;27721;36085;1385;1387;2
/net/per610a/home/mvp/mvp_db/news7-lv/2015/2015_03_25_19_00/2015_03_25_19_00.mpg;Sadakazu TANIGAKI.jpg;17101;19193;36085;855;960;105
/net/per610a/home/mvp/mvp_db/news7-lv/2015/2015_03_30_19_00/2015_03_30_19_00.mpg;Shinzo ABE.jpg;6825;7109;36085;341;355;14
/net/per610a/home/mvp/mvp_db/news7-lv/2015/2015_03_30_19_00/2015_03_30_19_00.mpg;Shinzo ABE.jpg;7449;8397;36085;372;420;48
/net/per610a/home/mvp/mvp_db/news7-lv/2015/2015_03_30_19_00/2015_03_30_19_00.mpg;Shinzo ABE.jpg;33361;33445;36085;1669;1673;4
/net/per610a/home/mvp/mvp_db/news7-lv/2015/2015_04_01_19_00/2015_04_01_19_00.mpg;Shinzo ABE.jpg;26229;26345;36077;1312;1318;6
/net/per610a/home/mvp/mvp_db/news7-lv/2015/2015_04_01_19_00/2015_04_01_19_00.mpg;Shinzo ABE.jpg;27153;27409;36077;1358;1371;13
/net/per610a/home/mvp/mvp_db/news7-lv/2015/2015_04_01_19_00/2015_04_01_19_00.mpg;Shinzo ABE.jpg;27969;28049;36077;1399;1403;4
/net/per610a/home/mvp/mvp_db/news7-lv/2015/2015_04_02_19_00/2015_04_02_19_00.mpg;Shinzo ABE.jpg;23765;24441;36085;1189;1223;34
/net/per610a/home/mvp/mvp_db/news7-lv/2015/2015_04_02_19_00/2015_04_02_19_00.mpg;Shinzo ABE.jpg;26205;26405;36085;1311;1321;10
/net/per610a/home/mvp/mvp_db/news7-lv/2015/2015_04_02_19_00/2015_04_02_19_00.mpg;Shinzo ABE.jpg;26833;27117;36085;1342;1357;15
/net/per610a/home/mvp/mvp_db/news7-lv/2015/2015_04_02_19_00/2015_04_02_19_00.mpg;Shinzo ABE.jpg;27249;27337;36085;1363;1368;5
/net/per610a/home/mvp/mvp_db/news7-lv/2015/2015_04_03_19_00/2015_04_03_19_00.mpg;Shinzo ABE.jpg;7481;7961;36085;374;398;24
/net/per610a/home/mvp/mvp_db/news7-lv/2015/2015_04_03_19_00/2015_04_03_19_00.mpg;Shinzo ABE.jpg;10293;10493;36085;515;525;10
/net/per610a/home/mvp/mvp_db/news7-lv/2015/2015_04_08_19_00/2015_04_08_19_00.mpg;Shinzo ABE.jpg;1409;1837;36081;70;91;21
/net/per610a/home/mvp/mvp_db/news7-lv/2015/2015_04_08_19_00/2015_04_08_19_00.mpg;Shinzo ABE.jpg;24529;24929;36081;1227;1247;20
/net/per610a/home/mvp/mvp_db/news7-lv/2015/2015_04_08_19_00/2015_04_08_19_00.mpg;Shinzo ABE.jpg;25217;25625;36081;1261;1281;20
/net/per610a/home/mvp/mvp_db/news7-lv/2015/2015_04_08_19_00/2015_04_08_19_00.mpg;Shinzo ABE.jpg;26613;26777;36081;1331;1339;8
/net/per610a/home/mvp/mvp_db/news7-lv/2015/2015_04_08_19_00/2015_04_08_19_00.mpg;Shinzo ABE.jpg;14305;14653;36081;715;733;18
/net/per610a/home/mvp/mvp_db/news7-lv/2015/2015_06_02_19_00/2015_06_02_19_00.mpg;Ichiro OZAWA.jpg;9845;10581;36085;492;529;37
/net/per610a/home/mvp/mvp_db/news7-lv/2015/2015_06_02_19_00/2015_06_02_19_00.mpg;Shinzo ABE.jpg;21061;21157;36085;1054;1058;4
/net/per610a/home/mvp/mvp_db/news7-lv/2015/2015_06_02_19_00/2015_06_02_19_00.mpg;Shinzo ABE.jpg;21577;22461;36085;1079;1124;45
/net/per610a/home/mvp/mvp_db/news7-lv/2015/2015_06_02_19_00/2015_06_02_19_00.mpg;Shinzo ABE.jpg;22909;23045;36085;1146;1153;7
/net/per610a/home/mvp/mvp_db/news7-lv/2015/2015_06_02_19_00/2015_06_02_19_00.mpg;Shinzo ABE.jpg;23705;23893;36085;1186;1195;9
/net/per610a/home/mvp/mvp_db/news7-lv/2015/2015_06_02_19_00/2015_06_02_19_00.mpg;Shinzo ABE.jpg;29425;29833;36085;1472;1493;21
/net/per610a/home/mvp/mvp_db/news7-lv/2015/2015_04_09_19_00/2015_04_09_19_00.mpg;Shinzo ABE.jpg;10233;10609;38481;511;530;19
/net/per610a/home/mvp/mvp_db/news7-lv/2015/2015_04_09_19_00/2015_04_09_19_00.mpg;Shinzo ABE.jpg;12089;12665;38481;604;633;29
/net/per610a/home/mvp/mvp_db/news7-lv/2015/2015_04_09_19_00/2015_04_09_19_00.mpg;Shinzo ABE.jpg;13865;13993;38481;693;699;6
/net/per610a/home/mvp/mvp_db/news7-lv/2015/2015_04_09_19_00/2015_04_09_19_00.mpg;Shinzo ABE.jpg;14173;14249;38481;708;712;4
/net/per610a/home/mvp/mvp_db/news7-lv/2015/2015_04_09_19_00/2015_04_09_19_00.mpg;Shinzo ABE.jpg;19109;19465;38481;955;973;18
/net/per610a/home/mvp/mvp_db/news7-lv/2015/2015_04_09_19_00/2015_04_09_19_00.mpg;Shinzo ABE.jpg;10901;10913;38481;545;545;0
/net/per610a/home/mvp/mvp_db/news7-lv/2015/2015_04_09_19_00/2015_04_09_19_00.mpg;Shinzo ABE.jpg;11037;11077;38481;552;554;2
/net/per610a/home/mvp/mvp_db/news7-lv/2015/2015_04_09_19_00/2015_04_09_19_00.mpg;Shinzo ABE.jpg;11809;11829;38481;590;591;1
/net/per610a/home/mvp/mvp_db/news7-lv/2015/2015_04_09_19_00/2015_04_09_19_00.mpg;Shinzo ABE.jpg;15425;15837;38481;771;792;21
/net/per610a/home/mvp/mvp_db/news7-lv/2015/2015_04_11_19_00/2015_04_11_19_00.mpg;Sadakazu TANIGAKI.jpg;4981;5977;36081;249;299;50
/net/per610a/home/mvp/mvp_db/news7-lv/2015/2015_04_13_19_00/2015_04_13_19_00.mpg;Shinzo ABE.jpg;15609;15901;36085;781;795;14
/net/per610a/home/mvp/mvp_db/news7-lv/2015/2015_04_13_19_00/2015_04_13_19_00.mpg;Yukio EDANO.jpg;17089;17129;36085;855;857;2
/net/per610a/home/mvp/mvp_db/news7-lv/2015/2015_04_13_19_00/2015_04_13_19_00.mpg;Yukio EDANO.jpg;17445;17617;36085;873;881;8
/net/per610a/home/mvp/mvp_db/news7-lv/2015/2015_04_13_19_00/2015_04_13_19_00.mpg;Yorihisa Matsuno.png;17709;18197;36085;886;910;24
/net/per610a/home/mvp/mvp_db/news7-lv/2015/2015_04_13_19_00/2015_04_13_19_00.mpg;Kazuo SHII.jpg;18321;18881;36085;916;944;28
/net/per610a/home/mvp/mvp_db/news7-lv/2015/2015_04_14_19_00/2015_04_14_19_00.mpg;Shinzo ABE.jpg;15801;16273;36085;790;814;24
/net/per610a/home/mvp/mvp_db/news7-lv/2015/2015_04_14_19_00/2015_04_14_19_00.mpg;Shinzo ABE.jpg;21401;21533;36085;1071;1077;6
/net/per610a/home/mvp/mvp_db/news7-lv/2015/2015_04_15_19_00/2015_04_15_19_00.mpg;Shinzo ABE.jpg;4477;4937;36081;223;246;23
/net/per610a/home/mvp/mvp_db/news7-lv/2015/2015_04_15_19_00/2015_04_15_19_00.mpg;Shinzo ABE.jpg;6009;6313;36081;300;315;15
/net/per610a/home/mvp/mvp_db/news7-lv/2015/2015_04_15_19_00/2015_04_15_19_00.mpg;Shinzo ABE.jpg;7985;8045;36081;399;402;3
/net/per610a/home/mvp/mvp_db/news7-lv/2015/2015_04_15_19_00/2015_04_15_19_00.mpg;Shinzo ABE.jpg;10109;10325;36081;505;516;11
/net/per610a/home/mvp/mvp_db/news7-lv/2015/2015_04_15_19_00/2015_04_15_19_00.mpg;Shinzo ABE.jpg;10897;11057;36081;545;553;8
/net/per610a/home/mvp/mvp_db/news7-lv/2015/2015_04_16_19_00/2015_04_16_19_00.mpg;Shinzo ABE.jpg;7881;8705;36085;394;435;41
/net/per610a/home/mvp/mvp_db/news7-lv/2015/2015_04_16_19_00/2015_04_16_19_00.mpg;Shinzo ABE.jpg;9525;9821;36085;476;491;15
/net/per610a/home/mvp/mvp_db/news7-lv/2015/2015_04_16_19_00/2015_04_16_19_00.mpg;Shinzo ABE.jpg;27981;29085;36085;1400;1455;55
/net/per610a/home/mvp/mvp_db/news7-lv/2015/2015_04_17_19_00/2015_04_17_19_00.mpg;Shinzo ABE.jpg;1729;2813;36085;86;140;54
/net/per610a/home/mvp/mvp_db/news7-lv/2015/2015_04_17_19_00/2015_04_17_19_00.mpg;Shinzo ABE.jpg;4449;4493;36085;222;224;2
/net/per610a/home/mvp/mvp_db/news7-lv/2015/2015_04_17_19_00/2015_04_17_19_00.mpg;Shinzo ABE.jpg;7625;7801;36085;381;390;9
/net/per610a/home/mvp/mvp_db/news7-lv/2015/2015_04_17_19_00/2015_04_17_19_00.mpg;Shinzo ABE.jpg;8125;8181;36085;406;409;3
/net/per610a/home/mvp/mvp_db/news7-lv/2015/2015_04_22_19_00/2015_04_22_19_00.mpg;Shinzo ABE.jpg;14093;14161;36085;705;708;3
/net/per610a/home/mvp/mvp_db/news7-lv/2015/2015_04_22_19_00/2015_04_22_19_00.mpg;Shinzo ABE.jpg;16069;17109;36085;804;856;52
/net/per610a/home/mvp/mvp_db/news7-lv/2015/2015_04_22_19_00/2015_04_22_19_00.mpg;Shinzo ABE.jpg;19317;19769;36085;966;989;23
/net/per610a/home/mvp/mvp_db/news7-lv/2015/2015_04_22_19_00/2015_04_22_19_00.mpg;Shinzo ABE.jpg;26213;26261;36085;1311;1314;3
/net/per610a/home/mvp/mvp_db/news7-lv/2015/2015_04_22_19_00/2015_04_22_19_00.mpg;Shinzo ABE.jpg;26437;26669;36085;1323;1334;11
/net/per610a/home/mvp/mvp_db/news7-lv/2015/2015_04_24_19_00/2015_04_24_19_00.mpg;Ichiro OZAWA.jpg;7001;7129;36085;350;356;6
/net/per610a/home/mvp/mvp_db/news7-lv/2015/2015_04_24_19_00/2015_04_24_19_00.mpg;Yuichiro Tamaki.png;29177;29209;36085;1460;1461;1
/net/per610a/home/mvp/mvp_db/news7-lv/2015/2015_04_24_19_00/2015_04_24_19_00.mpg;Yuichiro Tamaki.png;29437;29661;36085;1473;1484;11
/net/per610a/home/mvp/mvp_db/news7-lv/2015/2015_04_25_19_00/2015_04_25_19_00.mpg;Shinzo ABE.jpg;23169;23333;36085;1159;1167;8
/net/per610a/home/mvp/mvp_db/news7-lv/2015/2015_04_25_19_00/2015_04_25_19_00.mpg;Shinzo ABE.jpg;24649;24681;36085;1233;1235;2
/net/per610a/home/mvp/mvp_db/news7-lv/2015/2015_04_25_19_00/2015_04_25_19_00.mpg;Shinzo ABE.jpg;25801;25941;36085;1291;1298;7
/net/per610a/home/mvp/mvp_db/news7-lv/2015/2015_04_28_19_00/2015_04_28_19_00.mpg;Shinzo ABE.jpg;5405;5449;36093;270;272;2
/net/per610a/home/mvp/mvp_db/news7-lv/2015/2015_04_28_19_00/2015_04_28_19_00.mpg;Shinzo ABE.jpg;7589;7777;36093;379;389;10
/net/per610a/home/mvp/mvp_db/news7-lv/2015/2015_04_30_19_00/2015_04_30_19_00.mpg;Shinzo ABE.jpg;2077;2513;36081;103;125;22
/net/per610a/home/mvp/mvp_db/news7-lv/2015/2015_05_01_19_00/2015_05_01_19_00.mpg;Shinzo ABE.jpg;6393;6413;36085;319;320;1
/net/per610a/home/mvp/mvp_db/news7-lv/2015/2015_05_01_19_00/2015_05_01_19_00.mpg;Shinzo ABE.jpg;7185;7273;36085;359;364;5
/net/per610a/home/mvp/mvp_db/news7-lv/2015/2015_05_01_19_00/2015_05_01_19_00.mpg;Shinzo ABE.jpg;7521;7969;36085;376;398;22
/net/per610a/home/mvp/mvp_db/news7-lv/2015/2015_05_01_19_00/2015_05_01_19_00.mpg;Shinzo ABE.jpg;9477;9521;36085;474;476;2
/net/per610a/home/mvp/mvp_db/news7-lv/2015/2015_05_01_19_00/2015_05_01_19_00.mpg;Shinzo ABE.jpg;9601;9749;36085;480;487;7
/net/per610a/home/mvp/mvp_db/news7-lv/2015/2015_05_02_19_00/2015_05_02_19_00.mpg;Shinzo ABE.jpg;18225;18769;36085;912;939;27
/net/per610a/home/mvp/mvp_db/news7-lv/2015/2015_05_02_19_00/2015_05_02_19_00.mpg;Shinzo ABE.jpg;18973;19257;36085;949;963;14
/net/per610a/home/mvp/mvp_db/news7-lv/2015/2015_05_02_19_00/2015_05_02_19_00.mpg;Shinzo ABE.jpg;20277;20337;36085;1014;1017;3
/net/per610a/home/mvp/mvp_db/news7-lv/2015/2015_05_02_19_00/2015_05_02_19_00.mpg;Shinzo ABE.jpg;20989;21237;36085;1050;1062;12
/net/per610a/home/mvp/mvp_db/news7-lv/2015/2015_05_02_19_00/2015_05_02_19_00.mpg;Shinzo ABE.jpg;21361;21821;36085;1069;1092;23
/net/per610a/home/mvp/mvp_db/news7-lv/2015/2015_05_10_19_00/2015_05_10_19_00.mpg;Toru Hashimoto.jpg;13897;13897;36085;695;695;0
/net/per610a/home/mvp/mvp_db/news7-lv/2015/2015_05_10_19_00/2015_05_10_19_00.mpg;Toru Hashimoto.jpg;13969;13989;36085;699;700;1
/net/per610a/home/mvp/mvp_db/news7-lv/2015/2015_05_10_19_00/2015_05_10_19_00.mpg;Toru Hashimoto.jpg;14141;14221;36085;707;711;4
/net/per610a/home/mvp/mvp_db/news7-lv/2015/2015_05_11_19_00/2015_05_11_19_00.mpg;Shinzo ABE.jpg;14969;15381;36081;748;769;21
/net/per610a/home/mvp/mvp_db/news7-lv/2015/2015_05_11_19_00/2015_05_11_19_00.mpg;Shinzo ABE.jpg;26497;26657;36081;1325;1333;8
/net/per610a/home/mvp/mvp_db/news7-lv/2015/2015_05_11_19_00/2015_05_11_19_00.mpg;Shinzo ABE.jpg;27257;27293;36081;1363;1365;2
/net/per610a/home/mvp/mvp_db/news7-lv/2015/2015_05_11_19_00/2015_05_11_19_00.mpg;Shinzo ABE.jpg;27521;27613;36081;1376;1381;5
/net/per610a/home/mvp/mvp_db/news7-lv/2015/2015_05_11_19_00/2015_05_11_19_00.mpg;Shinzo ABE.jpg;25389;25449;36081;1270;1273;3
/net/per610a/home/mvp/mvp_db/news7-lv/2015/2015_05_11_19_00/2015_05_11_19_00.mpg;Shinzo ABE.jpg;26221;26377;36081;1311;1319;8
/net/per610a/home/mvp/mvp_db/news7-lv/2015/2015_05_12_19_00/2015_05_12_19_00.mpg;Shinzo ABE.jpg;22261;22773;36085;1114;1139;25
/net/per610a/home/mvp/mvp_db/news7-lv/2015/2015_05_12_19_00/2015_05_12_19_00.mpg;Shinzo ABE.jpg;23161;23737;36085;1159;1188;29
/net/per610a/home/mvp/mvp_db/news7-lv/2015/2015_05_12_19_00/2015_05_12_19_00.mpg;Shinzo ABE.jpg;29109;29113;36085;1456;1457;1
/net/per610a/home/mvp/mvp_db/news7-lv/2015/2015_05_14_19_00/2015_05_14_19_00.mpg;Shinzo ABE.jpg;821;1021;38485;41;51;10
/net/per610a/home/mvp/mvp_db/news7-lv/2015/2015_05_14_19_00/2015_05_14_19_00.mpg;Shinzo ABE.jpg;2121;2293;38485;106;114;8
/net/per610a/home/mvp/mvp_db/news7-lv/2015/2015_05_14_19_00/2015_05_14_19_00.mpg;Shinzo ABE.jpg;3605;3673;38485;180;183;3
/net/per610a/home/mvp/mvp_db/news7-lv/2015/2015_05_14_19_00/2015_05_14_19_00.mpg;Shinzo ABE.jpg;4405;7525;38485;220;376;156
/net/per610a/home/mvp/mvp_db/news7-lv/2015/2015_05_14_19_00/2015_05_14_19_00.mpg;Shinzo ABE.jpg;15761;15849;38485;788;793;5
/net/per610a/home/mvp/mvp_db/news7-lv/2015/2015_05_14_19_00/2015_05_14_19_00.mpg;Shinzo ABE.jpg;15989;16029;38485;800;802;2
/net/per610a/home/mvp/mvp_db/news7-lv/2015/2015_05_14_19_00/2015_05_14_19_00.mpg;Shinzo ABE.jpg;16129;16217;38485;807;811;4
/net/per610a/home/mvp/mvp_db/news7-lv/2015/2015_05_14_19_00/2015_05_14_19_00.mpg;Shinzo ABE.jpg;16221;16329;38485;811;817;6
/net/per610a/home/mvp/mvp_db/news7-lv/2015/2015_05_14_19_00/2015_05_14_19_00.mpg;Shinzo ABE.jpg;16905;17493;38485;846;875;29
/net/per610a/home/mvp/mvp_db/news7-lv/2015/2015_05_14_19_00/2015_05_14_19_00.mpg;Shinzo ABE.jpg;22445;22705;38485;1123;1136;13
/net/per610a/home/mvp/mvp_db/news7-lv/2015/2015_05_14_19_00/2015_05_14_19_00.mpg;Shinzo ABE.jpg;24033;24169;38485;1202;1209;7
/net/per610a/home/mvp/mvp_db/news7-lv/2015/2015_05_14_19_00/2015_05_14_19_00.mpg;Shinzo ABE.jpg;31745;31817;38485;1588;1592;4
/net/per610a/home/mvp/mvp_db/news7-lv/2015/2015_05_16_19_00/2015_05_16_19_00.mpg;Shinzo ABE.jpg;12593;13013;36077;630;651;21
/net/per610a/home/mvp/mvp_db/news7-lv/2015/2015_05_16_19_00/2015_05_16_19_00.mpg;Shinzo ABE.jpg;13649;14593;36077;682;730;48
/net/per610a/home/mvp/mvp_db/news7-lv/2015/2015_05_16_19_00/2015_05_16_19_00.mpg;Shinzo ABE.jpg;14929;14985;36077;746;749;3
/net/per610a/home/mvp/mvp_db/news7-lv/2015/2015_05_17_19_00/2015_05_17_19_00.mpg;Shinzo ABE.jpg;25497;25545;36077;1275;1278;3
/net/per610a/home/mvp/mvp_db/news7-lv/2015/2015_05_17_19_00/2015_05_17_19_00.mpg;Shinzo ABE.jpg;25633;25973;36077;1282;1299;17
/net/per610a/home/mvp/mvp_db/news7-lv/2015/2015_05_18_19_00/2015_05_18_19_00.mpg;Toru Hashimoto.jpg;193;197;36085;9;9;0
/net/per610a/home/mvp/mvp_db/news7-lv/2015/2015_05_18_19_00/2015_05_18_19_00.mpg;Toru Hashimoto.jpg;1553;1569;36085;77;78;1
/net/per610a/home/mvp/mvp_db/news7-lv/2015/2015_05_18_19_00/2015_05_18_19_00.mpg;Toru Hashimoto.jpg;1709;1777;36085;85;88;3
/net/per610a/home/mvp/mvp_db/news7-lv/2015/2015_05_18_19_00/2015_05_18_19_00.mpg;Toru Hashimoto.jpg;4425;4813;36085;221;240;19
/net/per610a/home/mvp/mvp_db/news7-lv/2015/2015_05_18_19_00/2015_05_18_19_00.mpg;Sadakazu TANIGAKI.jpg;5701;7313;36085;285;366;81
/net/per610a/home/mvp/mvp_db/news7-lv/2015/2015_05_19_19_00/2015_05_19_19_00.mpg;Yorihisa Matsuno.png;409;581;36085;20;29;9
/net/per610a/home/mvp/mvp_db/news7-lv/2015/2015_05_19_19_00/2015_05_19_19_00.mpg;Yorihisa Matsuno.png;1573;1685;36085;78;84;6
/net/per610a/home/mvp/mvp_db/news7-lv/2015/2015_05_19_19_00/2015_05_19_19_00.mpg;Yorihisa Matsuno.png;2029;2037;36085;101;101;0
/net/per610a/home/mvp/mvp_db/news7-lv/2015/2015_05_19_19_00/2015_05_19_19_00.mpg;Yorihisa Matsuno.png;7177;7305;36085;359;365;6
/net/per610a/home/mvp/mvp_db/news7-lv/2015/2015_05_19_19_00/2015_05_19_19_00.mpg;Yorihisa Matsuno.png;7693;8121;36085;385;406;21
/net/per610a/home/mvp/mvp_db/news7-lv/2015/2015_05_19_19_00/2015_05_19_19_00.mpg;Kenji Eda.jpg;2981;3241;36085;149;162;13
/net/per610a/home/mvp/mvp_db/news7-lv/2015/2015_05_19_19_00/2015_05_19_19_00.mpg;Kenji Eda.jpg;6957;7145;36085;348;357;9
/net/per610a/home/mvp/mvp_db/news7-lv/2015/2015_05_19_19_00/2015_05_19_19_00.mpg;Yorihisa Matsuno.png;3933;4221;36085;196;211;15
/net/per610a/home/mvp/mvp_db/news7-lv/2015/2015_05_19_19_00/2015_05_19_19_00.mpg;Sadakazu TANIGAKI.jpg;5105;5857;36085;255;293;38
/net/per610a/home/mvp/mvp_db/news7-lv/2015/2015_05_19_19_00/2015_05_19_19_00.mpg;Toru Hashimoto.jpg;6957;7145;36085;348;357;9
/net/per610a/home/mvp/mvp_db/news7-lv/2015/2015_05_19_19_00/2015_05_19_19_00.mpg;Masashi Nakano.jpg;27617;27961;36085;1382;1399;17
/net/per610a/home/mvp/mvp_db/news7-lv/2015/2015_05_19_19_00/2015_05_19_19_00.mpg;Masashi Nakano.jpg;29149;29645;36085;1458;1483;25
/net/per610a/home/mvp/mvp_db/news7-lv/2015/2015_05_20_19_00/2015_05_20_19_00.mpg;Shinzo ABE.jpg;1105;1805;36085;55;90;35
/net/per610a/home/mvp/mvp_db/news7-lv/2015/2015_05_20_19_00/2015_05_20_19_00.mpg;Shinzo ABE.jpg;3605;4869;36085;180;243;63
/net/per610a/home/mvp/mvp_db/news7-lv/2015/2015_05_20_19_00/2015_05_20_19_00.mpg;Shinzo ABE.jpg;6317;6721;36085;316;336;20
/net/per610a/home/mvp/mvp_db/news7-lv/2015/2015_05_20_19_00/2015_05_20_19_00.mpg;Shinzo ABE.jpg;29621;30089;36085;1482;1505;23
/net/per610a/home/mvp/mvp_db/news7-lv/2015/2015_05_20_19_00/2015_05_20_19_00.mpg;Shinzo ABE.jpg;30369;30781;36085;1519;1540;21
/net/per610a/home/mvp/mvp_db/news7-lv/2015/2015_05_22_19_00/2015_05_22_19_00.mpg;Shinzo ABE.jpg;15729;16225;36085;787;812;25
/net/per610a/home/mvp/mvp_db/news7-lv/2015/2015_05_22_19_00/2015_05_22_19_00.mpg;Shinzo ABE.jpg;17757;17861;36085;888;893;5
/net/per610a/home/mvp/mvp_db/news7-lv/2015/2015_05_22_19_00/2015_05_22_19_00.mpg;Shinzo ABE.jpg;18541;18617;36085;927;931;4
/net/per610a/home/mvp/mvp_db/news7-lv/2015/2015_05_22_19_00/2015_05_22_19_00.mpg;Shinzo ABE.jpg;18921;18945;36085;946;948;2
/net/per610a/home/mvp/mvp_db/news7-lv/2015/2015_05_23_19_00/2015_05_23_19_00.mpg;Shinzo ABE.jpg;1801;2229;36081;90;111;21
/net/per610a/home/mvp/mvp_db/news7-lv/2015/2015_05_23_19_00/2015_05_23_19_00.mpg;Shinzo ABE.jpg;2381;2849;36081;119;142;23
/net/per610a/home/mvp/mvp_db/news7-lv/2015/2015_05_23_19_00/2015_05_23_19_00.mpg;Shinzo ABE.jpg;3629;3725;36081;181;186;5
/net/per610a/home/mvp/mvp_db/news7-lv/2015/2015_05_23_19_00/2015_05_23_19_00.mpg;Shinzo ABE.jpg;4617;5505;36081;230;275;45
/net/per610a/home/mvp/mvp_db/news7-lv/2015/2015_05_23_19_00/2015_05_23_19_00.mpg;Shinzo ABE.jpg;5877;5957;36081;294;298;4
/net/per610a/home/mvp/mvp_db/news7-lv/2015/2015_05_24_19_00/2015_05_24_19_00.mpg;Shinzo ABE.jpg;9229;9409;36085;461;470;9
/net/per610a/home/mvp/mvp_db/news7-lv/2015/2015_05_25_19_00/2015_05_25_19_00.mpg;Sadakazu TANIGAKI.jpg;7409;7921;36081;370;396;26
/net/per610a/home/mvp/mvp_db/news7-lv/2015/2015_05_26_19_00/2015_05_26_19_00.mpg;Shinzo ABE.jpg;661;889;36081;33;44;11
/net/per610a/home/mvp/mvp_db/news7-lv/2015/2015_05_26_19_00/2015_05_26_19_00.mpg;Shinzo ABE.jpg;6961;8577;36081;348;429;81
/net/per610a/home/mvp/mvp_db/news7-lv/2015/2015_05_26_19_00/2015_05_26_19_00.mpg;Shinzo ABE.jpg;28049;28509;36081;1403;1426;23
/net/per610a/home/mvp/mvp_db/news7-lv/2015/2015_05_26_19_00/2015_05_26_19_00.mpg;Shinzo ABE.jpg;1193;1757;36081;59;87;28
/net/per610a/home/mvp/mvp_db/news7-lv/2015/2015_05_26_19_00/2015_05_26_19_00.mpg;Shinzo ABE.jpg;2125;2457;36081;106;122;16
/net/per610a/home/mvp/mvp_db/news7-lv/2015/2015_05_27_19_00/2015_05_27_19_00.mpg;Shinzo ABE.jpg;929;1525;36085;46;76;30
/net/per610a/home/mvp/mvp_db/news7-lv/2015/2015_05_27_19_00/2015_05_27_19_00.mpg;Shinzo ABE.jpg;2817;3513;36085;140;175;35
/net/per610a/home/mvp/mvp_db/news7-lv/2015/2015_05_27_19_00/2015_05_27_19_00.mpg;Shinzo ABE.jpg;5289;5613;36085;264;280;16
/net/per610a/home/mvp/mvp_db/news7-lv/2015/2015_05_27_19_00/2015_05_27_19_00.mpg;Shinzo ABE.jpg;9329;9353;36085;466;468;2
/net/per610a/home/mvp/mvp_db/news7-lv/2015/2015_05_27_19_00/2015_05_27_19_00.mpg;Shinzo ABE.jpg;10253;10257;36085;513;513;0
/net/per610a/home/mvp/mvp_db/news7-lv/2015/2015_05_27_19_00/2015_05_27_19_00.mpg;Shinzo ABE.jpg;24165;24817;36085;1209;1242;33
/net/per610a/home/mvp/mvp_db/news7-lv/2015/2015_05_27_19_00/2015_05_27_19_00.mpg;Shinzo ABE.jpg;23045;23465;36085;1153;1174;21
/net/per610a/home/mvp/mvp_db/news7-lv/2015/2015_05_28_19_00/2015_05_28_19_00.mpg;Shinzo ABE.jpg;1053;1145;36077;52;57;5
/net/per610a/home/mvp/mvp_db/news7-lv/2015/2015_05_28_19_00/2015_05_28_19_00.mpg;Shinzo ABE.jpg;3565;3957;36077;178;197;19
/net/per610a/home/mvp/mvp_db/news7-lv/2015/2015_05_28_19_00/2015_05_28_19_00.mpg;Shinzo ABE.jpg;6321;6589;36077;316;329;13
/net/per610a/home/mvp/mvp_db/news7-lv/2015/2015_05_29_19_00/2015_05_29_19_00.mpg;Shinzo ABE.jpg;9717;9885;38485;486;494;8
/net/per610a/home/mvp/mvp_db/news7-lv/2015/2015_05_29_19_00/2015_05_29_19_00.mpg;Shinzo ABE.jpg;26721;27365;38485;1337;1369;32
/net/per610a/home/mvp/mvp_db/news7-lv/2015/2015_05_29_19_00/2015_05_29_19_00.mpg;Shinzo ABE.jpg;27461;27637;38485;1374;1383;9
/net/per610a/home/mvp/mvp_db/news7-lv/2015/2015_05_29_19_00/2015_05_29_19_00.mpg;Shinzo ABE.jpg;30165;30325;38485;1509;1517;8
/net/per610a/home/mvp/mvp_db/news7-lv/2015/2015_05_31_19_00/2015_05_31_19_00.mpg;Shintaro ISHIHARA.jpg;15241;15525;36085;762;777;15
/net/per610a/home/mvp/mvp_db/news7-lv/2015/2015_06_05_19_00/2015_06_05_19_00.mpg;Shinzo ABE.jpg;725;1157;38481;36;57;21
/net/per610a/home/mvp/mvp_db/news7-lv/2015/2015_06_05_19_00/2015_06_05_19_00.mpg;Shinzo ABE.jpg;5985;6349;38481;299;317;18
/net/per610a/home/mvp/mvp_db/news7-lv/2015/2015_06_05_19_00/2015_06_05_19_00.mpg;Shinzo ABE.jpg;1185;2309;38481;59;115;56
/net/per610a/home/mvp/mvp_db/news7-lv/2015/2015_06_05_19_00/2015_06_05_19_00.mpg;Shinzo ABE.jpg;7005;7117;38481;350;356;6
/net/per610a/home/mvp/mvp_db/news7-lv/2015/2015_06_06_19_00/2015_06_06_19_00.mpg;Shinzo ABE.jpg;16581;16657;36085;829;833;4
/net/per610a/home/mvp/mvp_db/news7-lv/2015/2015_06_06_19_00/2015_06_06_19_00.mpg;Shinzo ABE.jpg;16957;16957;36085;848;848;0
/net/per610a/home/mvp/mvp_db/news7-lv/2015/2015_06_06_19_00/2015_06_06_19_00.mpg;Shinzo ABE.jpg;17513;19277;36085;876;964;88
/net/per610a/home/mvp/mvp_db/news7-lv/2015/2015_06_06_19_00/2015_06_06_19_00.mpg;Shinzo ABE.jpg;19429;19489;36085;972;975;3
/net/per610a/home/mvp/mvp_db/news7-lv/2015/2015_06_07_19_00/2015_06_07_19_00.mpg;Shinzo ABE.jpg;4597;5157;36085;230;258;28
/net/per610a/home/mvp/mvp_db/news7-lv/2015/2015_06_07_19_00/2015_06_07_19_00.mpg;Shinzo ABE.jpg;7049;7853;36085;352;393;41
/net/per610a/home/mvp/mvp_db/news7-lv/2015/2015_06_07_19_00/2015_06_07_19_00.mpg;Shinzo ABE.jpg;8377;9201;36085;419;460;41
/net/per610a/home/mvp/mvp_db/news7-lv/2015/2015_06_07_19_00/2015_06_07_19_00.mpg;Shinzo ABE.jpg;11193;11269;36085;560;563;3
/net/per610a/home/mvp/mvp_db/news7-lv/2015/2015_06_09_19_00/2015_06_09_19_00.mpg;Shinzo ABE.jpg;15125;15485;36085;756;775;19
/net/per610a/home/mvp/mvp_db/news7-lv/2015/2015_06_10_19_00/2015_06_10_19_00.mpg;Shinzo ABE.jpg;16021;16377;36077;801;819;18
/net/per610a/home/mvp/mvp_db/news7-lv/2015/2015_06_10_19_00/2015_06_10_19_00.mpg;Shinzo ABE.jpg;19621;20213;36077;981;1011;30
/net/per610a/home/mvp/mvp_db/news7-lv/2015/2015_06_10_19_00/2015_06_10_19_00.mpg;Shinzo ABE.jpg;21001;21105;36077;1050;1055;5
/net/per610a/home/mvp/mvp_db/news7-lv/2015/2015_06_10_19_00/2015_06_10_19_00.mpg;Shinzo ABE.jpg;25629;25853;36077;1282;1293;11
/net/per610a/home/mvp/mvp_db/news7-lv/2015/2015_06_11_19_00/2015_06_11_19_00.mpg;Shinzo ABE.jpg;32897;33117;36085;1646;1657;11
/net/per610a/home/mvp/mvp_db/news7-lv/2015/2015_06_12_19_00/2015_06_12_19_00.mpg;Shinzo ABE.jpg;16029;16089;36081;802;805;3
/net/per610a/home/mvp/mvp_db/news7-lv/2015/2015_06_12_19_00/2015_06_12_19_00.mpg;Shinzo ABE.jpg;19313;19437;36081;966;972;6
/net/per610a/home/mvp/mvp_db/news7-lv/2015/2015_06_14_19_00/2015_06_14_19_00.mpg;Toru Hashimoto.jpg;14561;15021;36085;728;751;23
/net/per610a/home/mvp/mvp_db/news7-lv/2015/2015_06_14_19_00/2015_06_14_19_00.mpg;Toru Hashimoto.jpg;15465;16173;36085;774;809;35
/net/per610a/home/mvp/mvp_db/news7-lv/2015/2015_06_14_19_00/2015_06_14_19_00.mpg;Shinzo ABE.jpg;14561;15021;36085;728;751;23
/net/per610a/home/mvp/mvp_db/news7-lv/2015/2015_06_14_19_00/2015_06_14_19_00.mpg;Shinzo ABE.jpg;15465;16173;36085;774;809;35
/net/per610a/home/mvp/mvp_db/news7-lv/2015/2015_06_16_19_00/2015_06_16_19_00.mpg;Shinzo ABE.jpg;20901;21197;36085;1046;1060;14
/net/per610a/home/mvp/mvp_db/news7-lv/2015/2015_06_16_19_00/2015_06_16_19_00.mpg;Shinzo ABE.jpg;29057;29081;36085;1454;1455;1
/net/per610a/home/mvp/mvp_db/news7-lv/2015/2015_06_16_19_00/2015_06_16_19_00.mpg;Shinzo ABE.jpg;30733;31033;36085;1538;1553;15
/net/per610a/home/mvp/mvp_db/news7-lv/2015/2015_06_16_19_00/2015_06_16_19_00.mpg;Takeo Hiranuma.jpeg;31489;31845;36085;1575;1593;18
/net/per610a/home/mvp/mvp_db/news7-lv/2015/2015_06_17_19_00/2015_06_17_19_00.mpg;Shinzo ABE.jpg;25797;25953;36077;1290;1298;8
/net/per610a/home/mvp/mvp_db/news7-lv/2015/2015_06_17_19_00/2015_06_17_19_00.mpg;Shinzo ABE.jpg;26773;26829;36077;1339;1342;3
/net/per610a/home/mvp/mvp_db/news7-lv/2015/2015_06_18_19_00/2015_06_18_19_00.mpg;Shinzo ABE.jpg;28349;28473;36085;1418;1425;7
/net/per610a/home/mvp/mvp_db/news7-lv/2015/2015_06_18_19_00/2015_06_18_19_00.mpg;Shinzo ABE.jpg;28981;29481;36085;1450;1475;25
/net/per610a/home/mvp/mvp_db/news7-lv/2015/2015_06_19_19_00/2015_06_19_19_00.mpg;Shinzo ABE.jpg;31145;31461;36085;1558;1574;16
/net/per610a/home/mvp/mvp_db/news7-lv/2015/2015_06_20_19_00/2015_06_20_19_00.mpg;Shintaro ISHIHARA.jpg;15573;16005;36085;779;801;22
/net/per610a/home/mvp/mvp_db/news7-lv/2015/2015_06_20_19_00/2015_06_20_19_00.mpg;Toru Hashimoto.jpg;20125;20489;36085;1007;1025;18
/net/per610a/home/mvp/mvp_db/news7-lv/2015/2015_06_21_19_00/2015_06_21_19_00.mpg;Shinzo ABE.jpg;6297;6417;36081;315;321;6
/net/per610a/home/mvp/mvp_db/news7-lv/2015/2015_06_22_19_00/2015_06_22_19_00.mpg;Natsuo YAMAGUCHI.jpg;2101;2153;36085;105;107;2
/net/per610a/home/mvp/mvp_db/news7-lv/2015/2015_06_22_19_00/2015_06_22_19_00.mpg;Natsuo YAMAGUCHI.jpg;2409;2525;36085;120;126;6
/net/per610a/home/mvp/mvp_db/news7-lv/2015/2015_06_22_19_00/2015_06_22_19_00.mpg;Natsuo YAMAGUCHI.jpg;5685;5737;36085;284;287;3
/net/per610a/home/mvp/mvp_db/news7-lv/2015/2015_06_22_19_00/2015_06_22_19_00.mpg;Sadakazu TANIGAKI.jpg;2609;2813;36085;130;140;10
/net/per610a/home/mvp/mvp_db/news7-lv/2015/2015_06_22_19_00/2015_06_22_19_00.mpg;Sadakazu TANIGAKI.jpg;2929;2953;36085;146;147;1
/net/per610a/home/mvp/mvp_db/news7-lv/2015/2015_06_23_19_00/2015_06_23_19_00.mpg;Shinzo ABE.jpg;10121;10581;36085;506;529;23
/net/per610a/home/mvp/mvp_db/news7-lv/2015/2015_06_23_19_00/2015_06_23_19_00.mpg;Shinzo ABE.jpg;11985;12297;36085;599;615;16
/net/per610a/home/mvp/mvp_db/news7-lv/2015/2015_06_23_19_00/2015_06_23_19_00.mpg;Natsuo YAMAGUCHI.jpg;24529;24861;36085;1227;1244;17
/net/per610a/home/mvp/mvp_db/news7-lv/2015/2015_06_24_19_00/2015_06_24_19_00.mpg;Shinzo ABE.jpg;31209;32249;36081;1561;1613;52
/net/per610a/home/mvp/mvp_db/news7-lv/2015/2015_06_25_19_00/2015_06_25_19_00.mpg;Shinzo ABE.jpg;8129;8453;36085;406;423;17
/net/per610a/home/mvp/mvp_db/news7-lv/2015/2015_06_25_19_00/2015_06_25_19_00.mpg;Shinzo ABE.jpg;28797;28905;36085;1441;1446;5
/net/per610a/home/mvp/mvp_db/news7-lv/2015/2015_06_26_19_00/2015_06_26_19_00.mpg;Shinzo ABE.jpg;5713;6109;36085;285;305;20
/net/per610a/home/mvp/mvp_db/news7-lv/2015/2015_06_26_19_00/2015_06_26_19_00.mpg;Shinzo ABE.jpg;27893;28101;36085;1396;1406;10
/net/per610a/home/mvp/mvp_db/news7-lv/2015/2015_06_29_19_00/2015_06_29_19_00.mpg;Masashi Nakano.jpg;8961;9517;36077;448;476;28
/net/per610a/home/mvp/mvp_db/news7-lv/2015/2015_06_29_19_00/2015_06_29_19_00.mpg;Shinzo ABE.jpg;13057;13629;36077;653;681;28
/net/per610a/home/mvp/mvp_db/news7-lv/2015/2015_06_30_19_00/2015_06_30_19_00.mpg;Shinzo ABE.jpg;23193;23249;38481;1160;1163;3
/net/per610a/home/mvp/mvp_db/news7-lv/2015/2015_06_30_19_00/2015_06_30_19_00.mpg;Shinzo ABE.jpg;27401;27513;38481;1370;1376;6
/net/per610a/home/mvp/mvp_db/news7-lv/2015/2015_07_02_19_00/2015_07_02_19_00.mpg;Toru Hashimoto.jpg;23685;23933;36077;1185;1197;12
/net/per610a/home/mvp/mvp_db/news7-lv/2015/2015_07_02_19_00/2015_07_02_19_00.mpg;Toru Hashimoto.jpg;31389;31729;36077;1570;1587;17
/net/per610a/home/mvp/mvp_db/news7-lv/2015/2015_07_03_19_00/2015_07_03_19_00.mpg;Shinzo ABE.jpg;13089;13137;36089;655;657;2
/net/per610a/home/mvp/mvp_db/news7-lv/2015/2015_07_03_19_00/2015_07_03_19_00.mpg;Shinzo ABE.jpg;16317;16361;36089;816;818;2
/net/per610a/home/mvp/mvp_db/news7-lv/2015/2015_07_03_19_00/2015_07_03_19_00.mpg;Shinzo ABE.jpg;23737;23809;36089;1187;1191;4
/net/per610a/home/mvp/mvp_db/news7-lv/2015/2015_07_03_19_00/2015_07_03_19_00.mpg;Shinzo ABE.jpg;24573;25073;36089;1229;1254;25
/net/per610a/home/mvp/mvp_db/news7-lv/2015/2015_07_03_19_00/2015_07_03_19_00.mpg;Shinzo ABE.jpg;26433;26701;36089;1322;1336;14
/net/per610a/home/mvp/mvp_db/news7-lv/2015/2015_07_06_19_00/2015_07_06_19_00.mpg;Shinzo ABE.jpg;23873;24177;36085;1194;1210;16
/net/per610a/home/mvp/mvp_db/news7-lv/2015/2015_07_06_19_00/2015_07_06_19_00.mpg;Sadakazu TANIGAKI.jpg;24477;24981;36085;1225;1250;25
/net/per610a/home/mvp/mvp_db/news7-lv/2015/2015_07_08_19_00/2015_07_08_19_00.mpg;Yorihisa Matsuno.png;21249;21545;36085;1063;1078;15
/net/per610a/home/mvp/mvp_db/news7-lv/2015/2015_07_08_19_00/2015_07_08_19_00.mpg;Yorihisa Matsuno.png;23001;23013;36085;1151;1151;0
/net/per610a/home/mvp/mvp_db/news7-lv/2015/2015_07_08_19_00/2015_07_08_19_00.mpg;Yorihisa Matsuno.png;23641;23645;36085;1183;1183;0
/net/per610a/home/mvp/mvp_db/news7-lv/2015/2015_07_08_19_00/2015_07_08_19_00.mpg;Yorihisa Matsuno.png;26057;26141;36085;1304;1308;4
/net/per610a/home/mvp/mvp_db/news7-lv/2015/2015_07_08_19_00/2015_07_08_19_00.mpg;Yorihisa Matsuno.png;26213;26457;36085;1311;1324;13
/net/per610a/home/mvp/mvp_db/news7-lv/2015/2015_07_09_19_00/2015_07_09_19_00.mpg;Kenji Eda.jpg;30313;30441;36081;1516;1522;6
/net/per610a/home/mvp/mvp_db/news7-lv/2015/2015_07_09_19_00/2015_07_09_19_00.mpg;Toranosuke Katayama.jpg;33149;33197;36081;1658;1660;2
/net/per610a/home/mvp/mvp_db/news7-lv/2015/2015_07_09_19_00/2015_07_09_19_00.mpg;Toranosuke Katayama.jpg;33497;33545;36081;1675;1678;3
/net/per610a/home/mvp/mvp_db/news7-lv/2015/2015_07_11_19_00/2015_07_11_19_00.mpg;Shinzo ABE.jpg;14641;14677;36085;732;734;2
/net/per610a/home/mvp/mvp_db/news7-lv/2015/2015_07_11_19_00/2015_07_11_19_00.mpg;Shinzo ABE.jpg;14877;15313;36085;744;766;22
/net/per610a/home/mvp/mvp_db/news7-lv/2015/2015_07_11_19_00/2015_07_11_19_00.mpg;Shinzo ABE.jpg;26153;26529;36085;1308;1327;19
/net/per610a/home/mvp/mvp_db/news7-lv/2015/2015_07_11_19_00/2015_07_11_19_00.mpg;Shinzo ABE.jpg;27017;27773;36085;1352;1389;37
/net/per610a/home/mvp/mvp_db/news7-lv/2015/2015_07_11_19_00/2015_07_11_19_00.mpg;Yukio EDANO.jpg;14989;15313;36085;750;766;16
/net/per610a/home/mvp/mvp_db/news7-lv/2015/2015_07_11_19_00/2015_07_11_19_00.mpg;Yukio EDANO.jpg;27017;27773;36085;1352;1389;37
/net/per610a/home/mvp/mvp_db/news7-lv/2015/2015_07_12_19_00/2015_07_12_19_00.mpg;Shinzo ABE.jpg;18065;18285;36085;904;915;11
/net/per610a/home/mvp/mvp_db/news7-lv/2015/2015_07_12_19_00/2015_07_12_19_00.mpg;Shinzo ABE.jpg;22697;22705;36085;1135;1136;1
/net/per610a/home/mvp/mvp_db/news7-lv/2015/2015_07_12_19_00/2015_07_12_19_00.mpg;Shinzo ABE.jpg;22757;22893;36085;1138;1145;7
/net/per610a/home/mvp/mvp_db/news7-lv/2015/2015_07_13_19_00/2015_07_13_19_00.mpg;Shinzo ABE.jpg;7661;7749;36081;383;387;4
/net/per610a/home/mvp/mvp_db/news7-lv/2015/2015_07_13_19_00/2015_07_13_19_00.mpg;Shinzo ABE.jpg;7905;7937;36081;395;397;2
/net/per610a/home/mvp/mvp_db/news7-lv/2015/2015_07_13_19_00/2015_07_13_19_00.mpg;Shinzo ABE.jpg;22713;23133;36081;1136;1157;21
/net/per610a/home/mvp/mvp_db/news7-lv/2015/2015_07_13_19_00/2015_07_13_19_00.mpg;Shinzo ABE.jpg;24025;24189;36081;1201;1210;9
/net/per610a/home/mvp/mvp_db/news7-lv/2015/2015_07_13_19_00/2015_07_13_19_00.mpg;Shinzo ABE.jpg;24429;24529;36081;1222;1227;5
/net/per610a/home/mvp/mvp_db/news7-lv/2015/2015_07_13_19_00/2015_07_13_19_00.mpg;Shinzo ABE.jpg;25421;25557;36081;1271;1278;7
/net/per610a/home/mvp/mvp_db/news7-lv/2015/2015_07_13_19_00/2015_07_13_19_00.mpg;Shinzo ABE.jpg;25625;25737;36081;1281;1287;6
/net/per610a/home/mvp/mvp_db/news7-lv/2015/2015_07_13_19_00/2015_07_13_19_00.mpg;Shinzo ABE.jpg;26385;26645;36081;1319;1332;13
/net/per610a/home/mvp/mvp_db/news7-lv/2015/2015_07_13_19_00/2015_07_13_19_00.mpg;Sadakazu TANIGAKI.jpg;7761;7865;36081;388;393;5
/net/per610a/home/mvp/mvp_db/news7-lv/2015/2015_07_13_19_00/2015_07_13_19_00.mpg;Sadakazu TANIGAKI.jpg;10677;11249;36081;534;562;28
/net/per610a/home/mvp/mvp_db/news7-lv/2015/2015_07_14_19_00/2015_07_14_19_00.mpg;Sadakazu TANIGAKI.jpg;9733;9985;36085;487;499;12
/net/per610a/home/mvp/mvp_db/news7-lv/2015/2015_07_14_19_00/2015_07_14_19_00.mpg;Katsuya OKADA.jpg;10241;10509;36085;512;525;13
/net/per610a/home/mvp/mvp_db/news7-lv/2015/2015_07_14_19_00/2015_07_14_19_00.mpg;Katsuya OKADA.jpg;13565;13981;36085;678;699;21
/net/per610a/home/mvp/mvp_db/news7-lv/2015/2015_07_14_19_00/2015_07_14_19_00.mpg;Yorihisa Matsuno.png;10861;10881;36085;543;544;1
/net/per610a/home/mvp/mvp_db/news7-lv/2015/2015_07_14_19_00/2015_07_14_19_00.mpg;Yorihisa Matsuno.png;13973;14665;36085;699;733;34
/net/per610a/home/mvp/mvp_db/news7-lv/2015/2015_07_14_19_00/2015_07_14_19_00.mpg;Shinzo ABE.jpg;13141;13505;36085;657;675;18
/net/per610a/home/mvp/mvp_db/news7-lv/2015/2015_07_14_19_00/2015_07_14_19_00.mpg;Shinzo ABE.jpg;16293;16637;36085;815;832;17
/net/per610a/home/mvp/mvp_db/news7-lv/2015/2015_07_14_19_00/2015_07_14_19_00.mpg;Kazuo SHII.jpg;13565;13969;36085;678;699;21
/net/per610a/home/mvp/mvp_db/news7-lv/2015/2015_07_15_19_00/2015_07_15_19_00.mpg;Natsuo YAMAGUCHI.jpg;9657;9769;36077;483;488;5
/net/per610a/home/mvp/mvp_db/news7-lv/2015/2015_07_15_19_00/2015_07_15_19_00.mpg;Natsuo YAMAGUCHI.jpg;11389;11397;36077;569;570;1
/net/per610a/home/mvp/mvp_db/news7-lv/2015/2015_07_15_19_00/2015_07_15_19_00.mpg;Yorihisa Matsuno.png;11257;11389;36077;563;569;6
/net/per610a/home/mvp/mvp_db/news7-lv/2015/2015_07_15_19_00/2015_07_15_19_00.mpg;Kazuo SHII.jpg;11257;11401;36077;563;570;7
/net/per610a/home/mvp/mvp_db/news7-lv/2015/2015_07_15_19_00/2015_07_15_19_00.mpg;Kazuo SHII.jpg;12221;12233;36077;611;612;1
/net/per610a/home/mvp/mvp_db/news7-lv/2015/2015_07_16_19_00/2015_07_16_19_00.mpg;Shinzo ABE.jpg;19717;19809;36089;986;991;5
/net/per610a/home/mvp/mvp_db/news7-lv/2015/2015_07_16_19_00/2015_07_16_19_00.mpg;Shinzo ABE.jpg;21445;21621;36089;1073;1081;8
/net/per610a/home/mvp/mvp_db/news7-lv/2015/2015_07_16_19_00/2015_07_16_19_00.mpg;Shinzo ABE.jpg;28745;28917;36089;1438;1447;9
/net/per610a/home/mvp/mvp_db/news7-lv/2015/2015_07_16_19_00/2015_07_16_19_00.mpg;Shinzo ABE.jpg;21733;22093;36089;1087;1105;18
/net/per610a/home/mvp/mvp_db/news7-lv/2015/2015_07_16_19_00/2015_07_16_19_00.mpg;Shinzo ABE.jpg;26889;27009;36089;1345;1351;6
/net/per610a/home/mvp/mvp_db/news7-lv/2015/2015_07_16_19_00/2015_07_16_19_00.mpg;Shinzo ABE.jpg;29781;30177;36089;1490;1510;20
/net/per610a/home/mvp/mvp_db/news7-lv/2015/2015_07_16_19_00/2015_07_16_19_00.mpg;Natsuo YAMAGUCHI.jpg;26889;27025;36089;1345;1352;7
/net/per610a/home/mvp/mvp_db/news7-lv/2015/2015_07_16_19_00/2015_07_16_19_00.mpg;Kazuo SHII.jpg;27025;27157;36089;1352;1359;7
/net/per610a/home/mvp/mvp_db/news7-lv/2015/2015_07_17_19_00/2015_07_17_19_00.mpg;Shinzo ABE.jpg;2209;2885;38485;110;144;34
/net/per610a/home/mvp/mvp_db/news7-lv/2015/2015_07_18_19_00/2015_07_18_19_00.mpg;Shinzo ABE.jpg;14969;15181;36085;749;759;10
/net/per610a/home/mvp/mvp_db/news7-lv/2015/2015_07_20_19_00/2015_07_20_19_00.mpg;Shinzo ABE.jpg;25133;25577;36081;1257;1279;22
/net/per610a/home/mvp/mvp_db/news7-lv/2015/2015_07_20_19_00/2015_07_20_19_00.mpg;Shinzo ABE.jpg;25837;26433;36081;1292;1322;30
/net/per610a/home/mvp/mvp_db/news7-lv/2015/2015_07_20_19_00/2015_07_20_19_00.mpg;Shinzo ABE.jpg;26513;26641;36081;1326;1332;6
/net/per610a/home/mvp/mvp_db/news7-lv/2015/2015_07_21_19_00/2015_07_21_19_00.mpg;Taro ASO.jpg;3457;3677;36077;172;183;11
/net/per610a/home/mvp/mvp_db/news7-lv/2015/2015_07_21_19_00/2015_07_21_19_00.mpg;Shinzo ABE.jpg;11273;11673;36077;564;584;20
/net/per610a/home/mvp/mvp_db/news7-lv/2015/2015_07_21_19_00/2015_07_21_19_00.mpg;Shinzo ABE.jpg;11989;13081;36077;599;654;55
/net/per610a/home/mvp/mvp_db/news7-lv/2015/2015_07_22_19_00/2015_07_22_19_00.mpg;Shinzo ABE.jpg;27361;27553;36085;1369;1378;9
/net/per610a/home/mvp/mvp_db/news7-lv/2015/2015_07_22_19_00/2015_07_22_19_00.mpg;Shinzo ABE.jpg;27897;28193;36085;1396;1411;15
/net/per610a/home/mvp/mvp_db/news7-lv/2015/2015_07_23_19_00/2015_07_23_19_00.mpg;Ichiro OZAWA.jpg;11973;11997;36085;599;600;1
/net/per610a/home/mvp/mvp_db/news7-lv/2015/2015_07_23_19_00/2015_07_23_19_00.mpg;Ichiro OZAWA.jpg;12101;12541;36085;605;627;22
/net/per610a/home/mvp/mvp_db/news7-lv/2015/2015_07_23_19_00/2015_07_23_19_00.mpg;Taro ASO.jpg;24293;25241;36085;1215;1263;48
/net/per610a/home/mvp/mvp_db/news7-lv/2015/2015_07_23_19_00/2015_07_23_19_00.mpg;Toru Hashimoto.jpg;27405;27957;36085;1371;1399;28
/net/per610a/home/mvp/mvp_db/news7-lv/2015/2015_07_28_19_00/2015_07_28_19_00.mpg;Shinzo ABE.jpg;22957;22989;36089;1148;1150;2
/net/per610a/home/mvp/mvp_db/news7-lv/2015/2015_07_28_19_00/2015_07_28_19_00.mpg;Shinzo ABE.jpg;24441;24525;36089;1223;1227;4
/net/per610a/home/mvp/mvp_db/news7-lv/2015/2015_07_28_19_00/2015_07_28_19_00.mpg;Shinzo ABE.jpg;25953;26373;36089;1298;1319;21
/net/per610a/home/mvp/mvp_db/news7-lv/2015/2015_07_28_19_00/2015_07_28_19_00.mpg;Shinzo ABE.jpg;26637;27313;36089;1332;1366;34
/net/per610a/home/mvp/mvp_db/news7-lv/2015/2015_07_29_19_00/2015_07_29_19_00.mpg;Shinzo ABE.jpg;3301;3505;36081;165;175;10
/net/per610a/home/mvp/mvp_db/news7-lv/2015/2015_07_29_19_00/2015_07_29_19_00.mpg;Shinzo ABE.jpg;20413;20553;36081;1021;1028;7
/net/per610a/home/mvp/mvp_db/news7-lv/2015/2015_07_29_19_00/2015_07_29_19_00.mpg;Shinzo ABE.jpg;22545;22561;36081;1127;1128;1
/net/per610a/home/mvp/mvp_db/news7-lv/2015/2015_07_29_19_00/2015_07_29_19_00.mpg;Shinzo ABE.jpg;23021;23045;36081;1151;1152;1
/net/per610a/home/mvp/mvp_db/news7-lv/2015/2015_07_29_19_00/2015_07_29_19_00.mpg;Shinzo ABE.jpg;24053;24449;36081;1203;1223;20
/net/per610a/home/mvp/mvp_db/news7-lv/2015/2015_07_29_19_00/2015_07_29_19_00.mpg;Shinzo ABE.jpg;24757;25173;36081;1238;1259;21
/net/per610a/home/mvp/mvp_db/news7-lv/2015/2015_07_30_19_00/2015_07_30_19_00.mpg;Shinzo ABE.jpg;13809;13997;36081;690;700;10
/net/per610a/home/mvp/mvp_db/news7-lv/2015/2015_07_30_19_00/2015_07_30_19_00.mpg;Shinzo ABE.jpg;14281;14505;36081;714;725;11
/net/per610a/home/mvp/mvp_db/news7-lv/2015/2015_07_30_19_00/2015_07_30_19_00.mpg;Shinzo ABE.jpg;15837;16281;36081;792;814;22
/net/per610a/home/mvp/mvp_db/news7-lv/2015/2015_07_31_19_00/2015_07_31_19_00.mpg;Sadakazu TANIGAKI.jpg;26713;27073;38489;1336;1354;18
/net/per610a/home/mvp/mvp_db/news7-lv/2015/2015_08_03_19_00/2015_08_03_19_00.mpg;Yukio EDANO.jpg;13889;15029;36085;695;752;57
/net/per610a/home/mvp/mvp_db/news7-lv/2015/2015_08_04_19_00/2015_08_04_19_00.mpg;Shinzo ABE.jpg;25757;26125;36085;1289;1307;18
/net/per610a/home/mvp/mvp_db/news7-lv/2015/2015_08_04_19_00/2015_08_04_19_00.mpg;Shinzo ABE.jpg;26249;26261;36085;1313;1314;1
/net/per610a/home/mvp/mvp_db/news7-lv/2015/2015_08_04_19_00/2015_08_04_19_00.mpg;Shinzo ABE.jpg;26381;26833;36085;1320;1342;22
/net/per610a/home/mvp/mvp_db/news7-lv/2015/2015_08_04_19_00/2015_08_04_19_00.mpg;Shinzo ABE.jpg;27713;28097;36085;1386;1406;20
/net/per610a/home/mvp/mvp_db/news7-lv/2015/2015_08_04_19_00/2015_08_04_19_00.mpg;Shinzo ABE.jpg;28369;28429;36085;1419;1422;3
/net/per610a/home/mvp/mvp_db/news7-lv/2015/2015_08_04_19_00/2015_08_04_19_00.mpg;Shinzo ABE.jpg;28589;28837;36085;1430;1443;13
/net/per610a/home/mvp/mvp_db/news7-lv/2015/2015_08_04_19_00/2015_08_04_19_00.mpg;Shinzo ABE.jpg;29037;29121;36085;1453;1457;4
/net/per610a/home/mvp/mvp_db/news7-lv/2015/2015_08_06_19_00/2015_08_06_19_00.mpg;Shinzo ABE.jpg;18397;18869;36089;920;944;24
/net/per610a/home/mvp/mvp_db/news7-lv/2015/2015_08_06_19_00/2015_08_06_19_00.mpg;Shinzo ABE.jpg;23073;23213;36089;1154;1161;7
/net/per610a/home/mvp/mvp_db/news7-lv/2015/2015_08_07_19_00/2015_08_07_19_00.mpg;Shinzo ABE.jpg;11813;12261;36085;591;613;22
/net/per610a/home/mvp/mvp_db/news7-lv/2015/2015_08_07_19_00/2015_08_07_19_00.mpg;Shinzo ABE.jpg;27589;27669;36085;1380;1384;4
/net/per610a/home/mvp/mvp_db/news7-lv/2015/2015_08_09_19_00/2015_08_09_19_00.mpg;Shinzo ABE.jpg;5253;5385;36081;262;269;7
/net/per610a/home/mvp/mvp_db/news7-lv/2015/2015_08_09_19_00/2015_08_09_19_00.mpg;Shinzo ABE.jpg;5501;5789;36081;275;289;14
/net/per610a/home/mvp/mvp_db/news7-lv/2015/2015_08_09_19_00/2015_08_09_19_00.mpg;Shinzo ABE.jpg;7309;7641;36081;365;382;17
/net/per610a/home/mvp/mvp_db/news7-lv/2015/2015_08_10_19_00/2015_08_10_19_00.mpg;Shinzo ABE.jpg;11313;11321;36085;566;566;0
/net/per610a/home/mvp/mvp_db/news7-lv/2015/2015_08_10_19_00/2015_08_10_19_00.mpg;Shinzo ABE.jpg;11417;11561;36085;571;578;7
/net/per610a/home/mvp/mvp_db/news7-lv/2015/2015_08_10_19_00/2015_08_10_19_00.mpg;Shinzo ABE.jpg;27517;28197;36085;1377;1411;34
/net/per610a/home/mvp/mvp_db/news7-lv/2015/2015_08_14_19_00/2015_08_14_19_00.mpg;Shinzo ABE.jpg;977;2349;36085;48;117;69
/net/per610a/home/mvp/mvp_db/news7-lv/2015/2015_08_14_19_00/2015_08_14_19_00.mpg;Shinzo ABE.jpg;8781;9029;36085;439;451;12
/net/per610a/home/mvp/mvp_db/news7-lv/2015/2015_08_14_19_00/2015_08_14_19_00.mpg;Shinzo ABE.jpg;10501;11321;36085;525;566;41
/net/per610a/home/mvp/mvp_db/news7-lv/2015/2015_08_14_19_00/2015_08_14_19_00.mpg;Shinzo ABE.jpg;16269;16481;36085;814;824;10
/net/per610a/home/mvp/mvp_db/news7-lv/2015/2015_08_14_19_00/2015_08_14_19_00.mpg;Shinzo ABE.jpg;16725;17141;36085;837;857;20
/net/per610a/home/mvp/mvp_db/news7-lv/2015/2015_08_14_19_00/2015_08_14_19_00.mpg;Shinzo ABE.jpg;17337;17709;36085;867;886;19
/net/per610a/home/mvp/mvp_db/news7-lv/2015/2015_08_14_19_00/2015_08_14_19_00.mpg;Shinzo ABE.jpg;18077;18225;36085;904;912;8
/net/per610a/home/mvp/mvp_db/news7-lv/2015/2015_08_14_19_00/2015_08_14_19_00.mpg;Shinzo ABE.jpg;24689;24729;36085;1235;1237;2
/net/per610a/home/mvp/mvp_db/news7-lv/2015/2015_08_15_19_00/2015_08_15_19_00.mpg;Shinzo ABE.jpg;4005;4353;36085;200;217;17
/net/per610a/home/mvp/mvp_db/news7-lv/2015/2015_08_15_19_00/2015_08_15_19_00.mpg;Shinzo ABE.jpg;10625;10841;36085;531;542;11
/net/per610a/home/mvp/mvp_db/news7-lv/2015/2015_08_20_19_00/2015_08_20_19_00.mpg;Ichiro Matsui.jpeg;27057;27209;36085;1354;1361;7
/net/per610a/home/mvp/mvp_db/news7-lv/2015/2015_08_20_19_00/2015_08_20_19_00.mpg;Ichiro Matsui.jpeg;27325;27325;36085;1367;1367;0
/net/per610a/home/mvp/mvp_db/news7-lv/2015/2015_08_20_19_00/2015_08_20_19_00.mpg;Ichiro Matsui.jpeg;27409;27409;36085;1371;1371;0
/net/per610a/home/mvp/mvp_db/news7-lv/2015/2015_08_20_19_00/2015_08_20_19_00.mpg;Ichiro Matsui.jpeg;27489;27489;36085;1375;1375;0
/net/per610a/home/mvp/mvp_db/news7-lv/2015/2015_08_20_19_00/2015_08_20_19_00.mpg;Ichiro Matsui.jpeg;28341;28733;36085;1418;1438;20
/net/per610a/home/mvp/mvp_db/news7-lv/2015/2015_08_27_19_00/2015_08_27_19_00.mpg;Toru Hashimoto.jpg;157;169;36081;7;8;1
/net/per610a/home/mvp/mvp_db/news7-lv/2015/2015_08_27_19_00/2015_08_27_19_00.mpg;Toru Hashimoto.jpg;6957;7285;36081;348;364;16
/net/per610a/home/mvp/mvp_db/news7-lv/2015/2015_08_27_19_00/2015_08_27_19_00.mpg;Toru Hashimoto.jpg;9329;9649;36081;466;482;16
/net/per610a/home/mvp/mvp_db/news7-lv/2015/2015_08_27_19_00/2015_08_27_19_00.mpg;Toru Hashimoto.jpg;10177;10713;36081;509;535;26
/net/per610a/home/mvp/mvp_db/news7-lv/2015/2015_08_27_19_00/2015_08_27_19_00.mpg;Toru Hashimoto.jpg;10817;11329;36081;541;566;25
/net/per610a/home/mvp/mvp_db/news7-lv/2015/2015_08_27_19_00/2015_08_27_19_00.mpg;Toranosuke Katayama.jpg;12389;12493;36081;619;624;5
/net/per610a/home/mvp/mvp_db/news7-lv/2015/2015_08_27_19_00/2015_08_27_19_00.mpg;Sadakazu TANIGAKI.jpg;15493;16069;36081;775;803;28
/net/per610a/home/mvp/mvp_db/news7-lv/2015/2015_08_28_19_00/2015_08_28_19_00.mpg;Shinzo ABE.jpg;10517;10705;36081;526;535;9
/net/per610a/home/mvp/mvp_db/news7-lv/2015/2015_08_29_19_00/2015_08_29_19_00.mpg;Toru Hashimoto.jpg;7233;7457;36085;362;373;11
/net/per610a/home/mvp/mvp_db/news7-lv/2015/2015_08_30_19_00/2015_08_30_19_00.mpg;Shintaro ISHIHARA.jpg;12249;12445;36089;612;622;10
/net/per610a/home/mvp/mvp_db/news7-lv/2015/2015_08_30_19_00/2015_08_30_19_00.mpg;Sadakazu TANIGAKI.jpg;15969;16277;36089;799;814;15
/net/per610a/home/mvp/mvp_db/news7-lv/2015/2015_08_30_19_00/2015_08_30_19_00.mpg;Yorihisa Matsuno.png;19785;20433;36089;990;1022;32
/net/per610a/home/mvp/mvp_db/news7-lv/2015/2015_08_30_19_00/2015_08_30_19_00.mpg;Yorihisa Matsuno.png;20817;22133;36089;1041;1107;66
/net/per610a/home/mvp/mvp_db/news7-lv/2015/2015_08_30_19_00/2015_08_30_19_00.mpg;Toru Hashimoto.jpg;19785;20169;36089;990;1009;19
/net/per610a/home/mvp/mvp_db/news7-lv/2015/2015_08_31_19_00/2015_08_31_19_00.mpg;Yorihisa Matsuno.png;17449;17569;36085;873;879;6
/net/per610a/home/mvp/mvp_db/news7-lv/2015/2015_08_31_19_00/2015_08_31_19_00.mpg;Yorihisa Matsuno.png;17805;17885;36085;891;895;4
/net/per610a/home/mvp/mvp_db/news7-lv/2015/2015_08_31_19_00/2015_08_31_19_00.mpg;Yorihisa Matsuno.png;18837;19213;36085;942;961;19
/net/per610a/home/mvp/mvp_db/news7-lv/2015/2015_09_01_19_00/2015_09_01_19_00.mpg;Shinzo ABE.jpg;14241;14525;38485;712;726;14
/net/per610a/home/mvp/mvp_db/news7-lv/2015/2015_09_01_19_00/2015_09_01_19_00.mpg;Shinzo ABE.jpg;29901;30169;38485;1496;1509;13
/net/per610a/home/mvp/mvp_db/news7-lv/2015/2015_09_02_19_00/2015_09_02_19_00.mpg;Shinzo ABE.jpg;11865;12845;36085;593;642;49
/net/per610a/home/mvp/mvp_db/news7-lv/2015/2015_09_02_19_00/2015_09_02_19_00.mpg;Shinzo ABE.jpg;13157;13621;36085;658;681;23
/net/per610a/home/mvp/mvp_db/news7-lv/2015/2015_09_04_19_00/2015_09_04_19_00.mpg;Yorihisa Matsuno.png;21445;21485;36089;1073;1075;2
/net/per610a/home/mvp/mvp_db/news7-lv/2015/2015_09_04_19_00/2015_09_04_19_00.mpg;Yorihisa Matsuno.png;23069;23121;36089;1154;1157;3
/net/per610a/home/mvp/mvp_db/news7-lv/2015/2015_09_04_19_00/2015_09_04_19_00.mpg;Yorihisa Matsuno.png;24101;24745;36089;1206;1238;32
/net/per610a/home/mvp/mvp_db/news7-lv/2015/2015_09_05_19_00/2015_09_05_19_00.mpg;Taro ASO.jpg;1;105;36085;0;5;5
/net/per610a/home/mvp/mvp_db/news7-lv/2015/2015_09_05_19_00/2015_09_05_19_00.mpg;Taro ASO.jpg;1541;1925;36085;77;96;19
/net/per610a/home/mvp/mvp_db/news7-lv/2015/2015_09_05_19_00/2015_09_05_19_00.mpg;Taro ASO.jpg;3269;3321;36085;163;166;3
/net/per610a/home/mvp/mvp_db/news7-lv/2015/2015_09_07_19_00/2015_09_07_19_00.mpg;Shinzo ABE.jpg;17253;17601;36085;863;880;17
/net/per610a/home/mvp/mvp_db/news7-lv/2015/2015_09_08_19_00/2015_09_08_19_00.mpg;Natsuo YAMAGUCHI.jpg;19981;20981;36081;999;1049;50
/net/per610a/home/mvp/mvp_db/news7-lv/2015/2015_09_08_19_00/2015_09_08_19_00.mpg;Shinzo ABE.jpg;24045;24149;36081;1202;1208;6
/net/per610a/home/mvp/mvp_db/news7-lv/2015/2015_09_09_19_00/2015_09_09_19_00.mpg;Shinzo ABE.jpg;25361;26013;36081;1268;1301;33
/net/per610a/home/mvp/mvp_db/news7-lv/2015/2015_09_09_19_00/2015_09_09_19_00.mpg;Sadakazu TANIGAKI.jpg;25881;26013;36081;1294;1301;7
/net/per610a/home/mvp/mvp_db/news7-lv/2015/2015_09_10_19_00/2015_09_10_19_00.mpg;Shinzo ABE.jpg;22829;22993;72053;1142;1150;8
/net/per610a/home/mvp/mvp_db/news7-lv/2015/2015_09_11_19_00/2015_09_11_19_00.mpg;Shinzo ABE.jpg;21297;21421;36077;1065;1071;6
/net/per610a/home/mvp/mvp_db/news7-lv/2015/2015_09_11_19_00/2015_09_11_19_00.mpg;Shinzo ABE.jpg;27733;28121;36077;1387;1406;19
/net/per610a/home/mvp/mvp_db/news7-lv/2015/2015_09_11_19_00/2015_09_11_19_00.mpg;Sadakazu TANIGAKI.jpg;31081;31361;36077;1555;1569;14
/net/per610a/home/mvp/mvp_db/news7-lv/2015/2015_09_13_19_00/2015_09_13_19_00.mpg;Shinzo ABE.jpg;24001;24505;36085;1201;1226;25
/net/per610a/home/mvp/mvp_db/news7-lv/2015/2015_09_14_19_00/2015_09_14_19_00.mpg;Shinzo ABE.jpg;21385;21461;38489;1070;1073;3
/net/per610a/home/mvp/mvp_db/news7-lv/2015/2015_09_14_19_00/2015_09_14_19_00.mpg;Shinzo ABE.jpg;27865;28209;38489;1394;1411;17
/net/per610a/home/mvp/mvp_db/news7-lv/2015/2015_09_14_19_00/2015_09_14_19_00.mpg;Shinzo ABE.jpg;28937;29137;38489;1448;1458;10
/net/per610a/home/mvp/mvp_db/news7-lv/2015/2015_09_14_19_00/2015_09_14_19_00.mpg;Shinzo ABE.jpg;31525;31681;38489;1577;1585;8
/net/per610a/home/mvp/mvp_db/news7-lv/2015/2015_09_16_19_00/2015_09_16_19_00.mpg;Shinzo ABE.jpg;2025;2341;44413;101;117;16
/net/per610a/home/mvp/mvp_db/news7-lv/2015/2015_09_16_19_00/2015_09_16_19_00.mpg;Shinzo ABE.jpg;6637;6673;44413;332;333;1
/net/per610a/home/mvp/mvp_db/news7-lv/2015/2015_09_16_19_00/2015_09_16_19_00.mpg;Shinzo ABE.jpg;7053;7181;44413;352;359;7
/net/per610a/home/mvp/mvp_db/news7-lv/2015/2015_09_16_19_00/2015_09_16_19_00.mpg;Shinzo ABE.jpg;38385;38497;44413;1920;1926;6
/net/per610a/home/mvp/mvp_db/news7-lv/2015/2015_09_16_19_00/2015_09_16_19_00.mpg;Shinzo ABE.jpg;38665;38713;44413;1934;1936;2
/net/per610a/home/mvp/mvp_db/news7-lv/2015/2015_09_16_19_00/2015_09_16_19_00.mpg;Shinzo ABE.jpg;39089;39405;44413;1955;1971;16
/net/per610a/home/mvp/mvp_db/news7-lv/2015/2015_09_16_19_00/2015_09_16_19_00.mpg;Shinzo ABE.jpg;42189;42285;44413;2110;2115;5
/net/per610a/home/mvp/mvp_db/news7-lv/2015/2015_09_17_19_00/2015_09_17_19_00.mpg;Shinzo ABE.jpg;6877;6901;38477;344;345;1
/net/per610a/home/mvp/mvp_db/news7-lv/2015/2015_09_17_19_00/2015_09_17_19_00.mpg;Shinzo ABE.jpg;12409;12413;38477;620;621;1
/net/per610a/home/mvp/mvp_db/news7-lv/2015/2015_09_17_19_00/2015_09_17_19_00.mpg;Shinzo ABE.jpg;13457;13605;38477;673;680;7
/net/per610a/home/mvp/mvp_db/news7-lv/2015/2015_09_17_19_00/2015_09_17_19_00.mpg;Shinzo ABE.jpg;14425;14509;38477;721;725;4
/net/per610a/home/mvp/mvp_db/news7-lv/2015/2015_09_17_19_00/2015_09_17_19_00.mpg;Shinzo ABE.jpg;14729;14845;38477;736;742;6
/net/per610a/home/mvp/mvp_db/news7-lv/2015/2015_09_18_19_00/2015_09_18_19_00.mpg;Taro ASO.jpg;25345;25557;36089;1268;1278;10
/net/per610a/home/mvp/mvp_db/news7-lv/2015/2015_09_19_19_00/2015_09_19_19_00.mpg;Shinzo ABE.jpg;5605;5701;36085;280;285;5
/net/per610a/home/mvp/mvp_db/news7-lv/2015/2015_09_19_19_00/2015_09_19_19_00.mpg;Shinzo ABE.jpg;10173;10501;36085;509;525;16
/net/per610a/home/mvp/mvp_db/news7-lv/2015/2015_09_19_19_00/2015_09_19_19_00.mpg;Kazuo SHII.jpg;14025;14977;36085;701;749;48
/net/per610a/home/mvp/mvp_db/news7-lv/2015/2015_09_23_19_00/2015_09_23_19_00.mpg;Ichiro OZAWA.jpg;27737;27977;36077;1387;1399;12
/net/per610a/home/mvp/mvp_db/news7-lv/2015/2015_09_24_19_00/2015_09_24_19_00.mpg;Shinzo ABE.jpg;7141;7625;36085;357;381;24
/net/per610a/home/mvp/mvp_db/news7-lv/2015/2015_09_24_19_00/2015_09_24_19_00.mpg;Shinzo ABE.jpg;7717;7841;36085;386;392;6
/net/per610a/home/mvp/mvp_db/news7-lv/2015/2015_09_24_19_00/2015_09_24_19_00.mpg;Shinzo ABE.jpg;7909;8133;36085;395;407;12
/net/per610a/home/mvp/mvp_db/news7-lv/2015/2015_09_24_19_00/2015_09_24_19_00.mpg;Shinzo ABE.jpg;8565;8825;36085;428;441;13
/net/per610a/home/mvp/mvp_db/news7-lv/2015/2015_09_24_19_00/2015_09_24_19_00.mpg;Shinzo ABE.jpg;8893;9061;36085;445;453;8
/net/per610a/home/mvp/mvp_db/news7-lv/2015/2015_09_24_19_00/2015_09_24_19_00.mpg;Shinzo ABE.jpg;9337;9649;36085;467;482;15
/net/per610a/home/mvp/mvp_db/news7-lv/2015/2015_09_24_19_00/2015_09_24_19_00.mpg;Shinzo ABE.jpg;9769;10053;36085;488;503;15
/net/per610a/home/mvp/mvp_db/news7-lv/2015/2015_09_24_19_00/2015_09_24_19_00.mpg;Shinzo ABE.jpg;10977;11717;36085;549;586;37
/net/per610a/home/mvp/mvp_db/news7-lv/2015/2015_09_25_19_00/2015_09_25_19_00.mpg;Taro ASO.jpg;5169;5645;36085;258;282;24
/net/per610a/home/mvp/mvp_db/news7-lv/2015/2015_09_25_19_00/2015_09_25_19_00.mpg;Shinzo ABE.jpg;14301;14685;36085;715;734;19
/net/per610a/home/mvp/mvp_db/news7-lv/2015/2015_09_25_19_00/2015_09_25_19_00.mpg;Shinzo ABE.jpg;14857;14889;36085;743;745;2
/net/per610a/home/mvp/mvp_db/news7-lv/2015/2015_09_25_19_00/2015_09_25_19_00.mpg;Shinzo ABE.jpg;15241;15269;36085;762;764;2
/net/per610a/home/mvp/mvp_db/news7-lv/2015/2015_09_25_19_00/2015_09_25_19_00.mpg;Shinzo ABE.jpg;15433;15505;36085;772;776;4
/net/per610a/home/mvp/mvp_db/news7-lv/2015/2015_09_25_19_00/2015_09_25_19_00.mpg;Shinzo ABE.jpg;19121;19173;36085;956;959;3
/net/per610a/home/mvp/mvp_db/news7-lv/2015/2015_09_25_19_00/2015_09_25_19_00.mpg;Shinzo ABE.jpg;19241;20429;36085;962;1022;60
/net/per610a/home/mvp/mvp_db/news7-lv/2015/2015_09_25_19_00/2015_09_25_19_00.mpg;Shinzo ABE.jpg;21333;22225;36085;1067;1112;45
/net/per610a/home/mvp/mvp_db/news7-lv/2015/2015_09_25_19_00/2015_09_25_19_00.mpg;Sadakazu TANIGAKI.jpg;16405;17169;36085;821;859;38
/net/per610a/home/mvp/mvp_db/news7-lv/2015/2015_09_25_19_00/2015_09_25_19_00.mpg;Kazuo SHII.jpg;17753;17789;36085;888;890;2
/net/per610a/home/mvp/mvp_db/news7-lv/2015/2015_09_25_19_00/2015_09_25_19_00.mpg;Kazuo SHII.jpg;18073;18149;36085;904;908;4
/net/per610a/home/mvp/mvp_db/news7-lv/2015/2015_09_25_19_00/2015_09_25_19_00.mpg;Kazuo SHII.jpg;18225;18481;36085;912;924;12
/net/per610a/home/mvp/mvp_db/news7-lv/2015/2015_09_29_19_00/2015_09_29_19_00.mpg;Shinzo ABE.jpg;32193;32709;36081;1610;1636;26
/net/per610a/home/mvp/mvp_db/news7-lv/2015/2015_09_30_19_00/2015_09_30_19_00.mpg;Shinzo ABE.jpg;23933;24245;36085;1197;1213;16
/net/per610a/home/mvp/mvp_db/news7-lv/2015/2015_10_02_19_00/2015_10_02_19_00.mpg;Kyoko Nakayama.jpg;26409;27021;36081;1321;1351;30
/net/per610a/home/mvp/mvp_db/news7-lv/2015/2015_10_07_19_00/2015_10_07_19_00.mpg;Shinzo ABE.jpg;1253;1325;36081;62;66;4
/net/per610a/home/mvp/mvp_db/news7-lv/2015/2015_10_07_19_00/2015_10_07_19_00.mpg;Shinzo ABE.jpg;12801;12905;36081;640;645;5
/net/per610a/home/mvp/mvp_db/news7-lv/2015/2015_10_07_19_00/2015_10_07_19_00.mpg;Shinzo ABE.jpg;5117;6085;36081;256;304;48
/net/per610a/home/mvp/mvp_db/news7-lv/2015/2015_10_07_19_00/2015_10_07_19_00.mpg;Shinzo ABE.jpg;6245;6701;36081;312;335;23
/net/per610a/home/mvp/mvp_db/news7-lv/2015/2015_10_07_19_00/2015_10_07_19_00.mpg;Shinzo ABE.jpg;7161;7501;36081;358;375;17
/net/per610a/home/mvp/mvp_db/news7-lv/2015/2015_10_07_19_00/2015_10_07_19_00.mpg;Shinzo ABE.jpg;12573;12613;36081;629;631;2
/net/per610a/home/mvp/mvp_db/news7-lv/2015/2015_10_07_19_00/2015_10_07_19_00.mpg;Shinzo ABE.jpg;12725;12769;36081;636;639;3
/net/per610a/home/mvp/mvp_db/news7-lv/2015/2015_10_07_19_00/2015_10_07_19_00.mpg;Shinzo ABE.jpg;12913;12961;36081;646;648;2
/net/per610a/home/mvp/mvp_db/news7-lv/2015/2015_10_11_19_00/2015_10_11_19_00.mpg;Natsuo YAMAGUCHI.jpg;13557;15161;36085;678;758;80
/net/per610a/home/mvp/mvp_db/news7-lv/2015/2015_10_13_19_00/2015_10_13_19_00.mpg;Shinzo ABE.jpg;16589;16933;36081;829;847;18
/net/per610a/home/mvp/mvp_db/news7-lv/2015/2015_10_13_19_00/2015_10_13_19_00.mpg;Shinzo ABE.jpg;17545;17545;36081;877;877;0
/net/per610a/home/mvp/mvp_db/news7-lv/2015/2015_10_13_19_00/2015_10_13_19_00.mpg;Shinzo ABE.jpg;17681;17793;36081;884;890;6
/net/per610a/home/mvp/mvp_db/news7-lv/2015/2015_10_13_19_00/2015_10_13_19_00.mpg;Shinzo ABE.jpg;19625;19745;36081;981;987;6
/net/per610a/home/mvp/mvp_db/news7-lv/2015/2015_10_14_19_00/2015_10_14_19_00.mpg;Natsuo YAMAGUCHI.jpg;6989;7265;36081;349;363;14
/net/per610a/home/mvp/mvp_db/news7-lv/2015/2015_10_14_19_00/2015_10_14_19_00.mpg;Shinzo ABE.jpg;24813;24893;36081;1241;1245;4
/net/per610a/home/mvp/mvp_db/news7-lv/2015/2015_10_14_19_00/2015_10_14_19_00.mpg;Shinzo ABE.jpg;25045;25105;36081;1252;1255;3
/net/per610a/home/mvp/mvp_db/news7-lv/2015/2015_10_14_19_00/2015_10_14_19_00.mpg;Shinzo ABE.jpg;29629;29661;36081;1482;1483;1
/net/per610a/home/mvp/mvp_db/news7-lv/2015/2015_10_14_19_00/2015_10_14_19_00.mpg;Shinzo ABE.jpg;29729;30101;36081;1487;1505;18
/net/per610a/home/mvp/mvp_db/news7-lv/2015/2015_10_15_19_00/2015_10_15_19_00.mpg;Toranosuke Katayama.jpg;22249;22441;36089;1113;1123;10
/net/per610a/home/mvp/mvp_db/news7-lv/2015/2015_10_15_19_00/2015_10_15_19_00.mpg;Shinzo ABE.jpg;29673;30197;36089;1484;1511;27
/net/per610a/home/mvp/mvp_db/news7-lv/2015/2015_10_16_19_00/2015_10_16_19_00.mpg;Shinzo ABE.jpg;19373;19509;36085;969;976;7
/net/per610a/home/mvp/mvp_db/news7-lv/2015/2015_10_16_19_00/2015_10_16_19_00.mpg;Shinzo ABE.jpg;19717;19985;36085;986;1000;14
/net/per610a/home/mvp/mvp_db/news7-lv/2015/2015_10_16_19_00/2015_10_16_19_00.mpg;Shinzo ABE.jpg;26617;27017;36085;1332;1352;20
/net/per610a/home/mvp/mvp_db/news7-lv/2015/2015_10_17_19_00/2015_10_17_19_00.mpg;Shinzo ABE.jpg;17893;18085;36089;895;905;10
/net/per610a/home/mvp/mvp_db/news7-lv/2015/2015_10_18_19_00/2015_10_18_19_00.mpg;Shinzo ABE.jpg;9113;9209;36089;456;460;4
/net/per610a/home/mvp/mvp_db/news7-lv/2015/2015_10_18_19_00/2015_10_18_19_00.mpg;Shinzo ABE.jpg;9705;10125;36089;485;506;21
/net/per610a/home/mvp/mvp_db/news7-lv/2015/2015_10_19_19_00/2015_10_19_19_00.mpg;Toru Hashimoto.jpg;21317;21801;36081;1066;1090;24
/net/per610a/home/mvp/mvp_db/news7-lv/2015/2015_10_19_19_00/2015_10_19_19_00.mpg;Toru Hashimoto.jpg;22265;23353;36081;1113;1168;55
/net/per610a/home/mvp/mvp_db/news7-lv/2015/2015_10_21_19_00/2015_10_21_19_00.mpg;Sadakazu TANIGAKI.jpg;18389;18873;36085;920;944;24
/net/per610a/home/mvp/mvp_db/news7-lv/2015/2015_10_22_19_00/2015_10_22_19_00.mpg;Shinzo ABE.jpg;8905;8973;36081;445;448;3
/net/per610a/home/mvp/mvp_db/news7-lv/2015/2015_10_22_19_00/2015_10_22_19_00.mpg;Shinzo ABE.jpg;9797;9917;36081;490;496;6
/net/per610a/home/mvp/mvp_db/news7-lv/2015/2015_10_22_19_00/2015_10_22_19_00.mpg;Shinzo ABE.jpg;11757;11905;36081;588;595;7
/net/per610a/home/mvp/mvp_db/news7-lv/2015/2015_10_22_19_00/2015_10_22_19_00.mpg;Yorihisa Matsuno.png;27193;27701;36081;1360;1385;25
/net/per610a/home/mvp/mvp_db/news7-lv/2015/2015_10_22_19_00/2015_10_22_19_00.mpg;Yorihisa Matsuno.png;28925;29121;36081;1447;1456;9
/net/per610a/home/mvp/mvp_db/news7-lv/2015/2015_10_22_19_00/2015_10_22_19_00.mpg;Yorihisa Matsuno.png;29381;29849;36081;1469;1493;24
/net/per610a/home/mvp/mvp_db/news7-lv/2015/2015_10_22_19_00/2015_10_22_19_00.mpg;Yorihisa Matsuno.png;30633;30665;36081;1532;1534;2
/net/per610a/home/mvp/mvp_db/news7-lv/2015/2015_10_22_19_00/2015_10_22_19_00.mpg;Toru Hashimoto.jpg;27193;27701;36081;1360;1385;25
/net/per610a/home/mvp/mvp_db/news7-lv/2015/2015_10_22_19_00/2015_10_22_19_00.mpg;Toru Hashimoto.jpg;28569;29121;36081;1429;1456;27
/net/per610a/home/mvp/mvp_db/news7-lv/2015/2015_10_22_19_00/2015_10_22_19_00.mpg;Toru Hashimoto.jpg;29597;29849;36081;1480;1493;13
/net/per610a/home/mvp/mvp_db/news7-lv/2015/2015_10_24_19_00/2015_10_24_19_00.mpg;Yorihisa Matsuno.png;11177;11253;36085;559;563;4
/net/per610a/home/mvp/mvp_db/news7-lv/2015/2015_10_24_19_00/2015_10_24_19_00.mpg;Yorihisa Matsuno.png;13861;14469;36085;693;724;31
/net/per610a/home/mvp/mvp_db/news7-lv/2015/2015_10_24_19_00/2015_10_24_19_00.mpg;Toranosuke Katayama.jpg;11309;11465;36085;565;573;8
/net/per610a/home/mvp/mvp_db/news7-lv/2015/2015_10_26_19_00/2015_10_26_19_00.mpg;Shinzo ABE.jpg;26273;26661;36081;1314;1333;19
/net/per610a/home/mvp/mvp_db/news7-lv/2015/2015_10_26_19_00/2015_10_26_19_00.mpg;Shinzo ABE.jpg;26785;27117;36081;1339;1356;17
/net/per610a/home/mvp/mvp_db/news7-lv/2015/2015_10_28_19_00/2015_10_28_19_00.mpg;Shinzo ABE.jpg;28561;28885;36077;1428;1445;17
/net/per610a/home/mvp/mvp_db/news7-lv/2015/2015_10_31_19_00/2015_10_31_19_00.mpg;Toru Hashimoto.jpg;6361;6997;36081;318;350;32
/net/per610a/home/mvp/mvp_db/news7-lv/2015/2015_10_31_19_00/2015_10_31_19_00.mpg;Toru Hashimoto.jpg;7169;7221;36081;358;361;3
/net/per610a/home/mvp/mvp_db/news7-lv/2015/2015_10_31_19_00/2015_10_31_19_00.mpg;Toru Hashimoto.jpg;7441;7713;36081;372;385;13
/net/per610a/home/mvp/mvp_db/news7-lv/2015/2015_10_31_19_00/2015_10_31_19_00.mpg;Toru Hashimoto.jpg;9361;9397;36081;468;470;2
/net/per610a/home/mvp/mvp_db/news7-lv/2015/2015_10_31_19_00/2015_10_31_19_00.mpg;Toru Hashimoto.jpg;12377;13061;36081;619;653;34
/net/per610a/home/mvp/mvp_db/news7-lv/2015/2015_10_31_19_00/2015_10_31_19_00.mpg;Toru Hashimoto.jpg;8861;8977;36081;443;449;6
/net/per610a/home/mvp/mvp_db/news7-lv/2015/2015_10_31_19_00/2015_10_31_19_00.mpg;Toranosuke Katayama.jpg;10237;10461;36081;512;523;11
/net/per610a/home/mvp/mvp_db/news7-lv/2015/2015_10_31_19_00/2015_10_31_19_00.mpg;Yorihisa Matsuno.png;11049;11373;36081;552;568;16
/net/per610a/home/mvp/mvp_db/news7-lv/2015/2015_10_31_19_00/2015_10_31_19_00.mpg;Shinzo ABE.jpg;13865;13893;36081;693;695;2
/net/per610a/home/mvp/mvp_db/news7-lv/2015/2015_10_31_19_00/2015_10_31_19_00.mpg;Shinzo ABE.jpg;16573;17157;36081;829;858;29
/net/per610a/home/mvp/mvp_db/news7-lv/2015/2015_10_31_19_00/2015_10_31_19_00.mpg;Shinzo ABE.jpg;17817;17825;36081;891;891;0
/net/per610a/home/mvp/mvp_db/news7-lv/2015/2015_10_31_19_00/2015_10_31_19_00.mpg;Shinzo ABE.jpg;18073;18653;36081;904;933;29
/net/per610a/home/mvp/mvp_db/news7-lv/2015/2015_11_01_19_00/2015_11_01_19_00.mpg;Shinzo ABE.jpg;673;765;36085;33;38;5
/net/per610a/home/mvp/mvp_db/news7-lv/2015/2015_11_01_19_00/2015_11_01_19_00.mpg;Shinzo ABE.jpg;1533;2501;36085;76;125;49
/net/per610a/home/mvp/mvp_db/news7-lv/2015/2015_11_01_19_00/2015_11_01_19_00.mpg;Shinzo ABE.jpg;3237;3749;36085;162;187;25
/net/per610a/home/mvp/mvp_db/news7-lv/2015/2015_11_01_19_00/2015_11_01_19_00.mpg;Shinzo ABE.jpg;3921;4277;36085;196;214;18
/net/per610a/home/mvp/mvp_db/news7-lv/2015/2015_11_01_19_00/2015_11_01_19_00.mpg;Shinzo ABE.jpg;5525;5657;36085;276;283;7
/net/per610a/home/mvp/mvp_db/news7-lv/2015/2015_11_01_19_00/2015_11_01_19_00.mpg;Shinzo ABE.jpg;5885;6005;36085;294;300;6
/net/per610a/home/mvp/mvp_db/news7-lv/2015/2015_11_01_19_00/2015_11_01_19_00.mpg;Shinzo ABE.jpg;10929;11309;36085;546;565;19
/net/per610a/home/mvp/mvp_db/news7-lv/2015/2015_11_01_19_00/2015_11_01_19_00.mpg;Shinzo ABE.jpg;2829;2857;36085;141;142;1
/net/per610a/home/mvp/mvp_db/news7-lv/2015/2015_11_01_19_00/2015_11_01_19_00.mpg;Shinzo ABE.jpg;5701;5869;36085;285;293;8
/net/per610a/home/mvp/mvp_db/news7-lv/2015/2015_11_01_19_00/2015_11_01_19_00.mpg;Shinzo ABE.jpg;5961;5965;36085;298;298;0
/net/per610a/home/mvp/mvp_db/news7-lv/2015/2015_11_01_19_00/2015_11_01_19_00.mpg;Shinzo ABE.jpg;12965;13237;36085;648;662;14
/net/per610a/home/mvp/mvp_db/news7-lv/2015/2015_11_01_19_00/2015_11_01_19_00.mpg;Shinzo ABE.jpg;13473;13577;36085;674;679;5
/net/per610a/home/mvp/mvp_db/news7-lv/2015/2015_11_02_19_00/2015_11_02_19_00.mpg;Shinzo ABE.jpg;4109;4549;36089;205;227;22
/net/per610a/home/mvp/mvp_db/news7-lv/2015/2015_11_02_19_00/2015_11_02_19_00.mpg;Shinzo ABE.jpg;6677;7233;36089;334;361;27
/net/per610a/home/mvp/mvp_db/news7-lv/2015/2015_11_02_19_00/2015_11_02_19_00.mpg;Shinzo ABE.jpg;10257;10461;36089;513;523;10
/net/per610a/home/mvp/mvp_db/news7-lv/2015/2015_11_05_19_00/2015_11_05_19_00.mpg;Shinzo ABE.jpg;20681;20857;36089;1034;1043;9
/net/per610a/home/mvp/mvp_db/news7-lv/2015/2015_11_05_19_00/2015_11_05_19_00.mpg;Shinzo ABE.jpg;21001;21121;36089;1050;1056;6
/net/per610a/home/mvp/mvp_db/news7-lv/2015/2015_11_05_19_00/2015_11_05_19_00.mpg;Shinzo ABE.jpg;21753;22037;36089;1088;1102;14
/net/per610a/home/mvp/mvp_db/news7-lv/2015/2015_11_08_19_00/2015_11_08_19_00.mpg;Shinzo ABE.jpg;13501;13817;36085;675;691;16
/net/per610a/home/mvp/mvp_db/news7-lv/2015/2015_11_10_19_00/2015_11_10_19_00.mpg;Shinzo ABE.jpg;13669;14097;36085;684;705;21
/net/per610a/home/mvp/mvp_db/news7-lv/2015/2015_11_10_19_00/2015_11_10_19_00.mpg;Shinzo ABE.jpg;15457;15601;36085;773;780;7
/net/per610a/home/mvp/mvp_db/news7-lv/2015/2015_11_10_19_00/2015_11_10_19_00.mpg;Shinzo ABE.jpg;16485;17149;36085;825;858;33
/net/per610a/home/mvp/mvp_db/news7-lv/2015/2015_11_12_19_00/2015_11_12_19_00.mpg;Shinzo ABE.jpg;18877;19413;36081;944;971;27
/net/per610a/home/mvp/mvp_db/news7-lv/2015/2015_11_12_19_00/2015_11_12_19_00.mpg;Shinzo ABE.jpg;19593;19821;36081;980;991;11
/net/per610a/home/mvp/mvp_db/news7-lv/2015/2015_11_12_19_00/2015_11_12_19_00.mpg;Sadakazu TANIGAKI.jpg;19593;19821;36081;980;991;11
/net/per610a/home/mvp/mvp_db/news7-lv/2015/2015_11_14_19_00/2015_11_14_19_00.mpg;Shinzo ABE.jpg;20085;20449;38473;1004;1023;19
/net/per610a/home/mvp/mvp_db/news7-lv/2015/2015_11_14_19_00/2015_11_14_19_00.mpg;Shinzo ABE.jpg;25881;25953;38473;1294;1298;4
/net/per610a/home/mvp/mvp_db/news7-lv/2015/2015_11_16_19_00/2015_11_16_19_00.mpg;Shinzo ABE.jpg;10033;10065;36081;501;503;2
/net/per610a/home/mvp/mvp_db/news7-lv/2015/2015_11_16_19_00/2015_11_16_19_00.mpg;Shinzo ABE.jpg;26065;26121;36081;1303;1306;3
/net/per610a/home/mvp/mvp_db/news7-lv/2015/2015_11_16_19_00/2015_11_16_19_00.mpg;Shinzo ABE.jpg;29949;30013;36081;1498;1501;3
/net/per610a/home/mvp/mvp_db/news7-lv/2015/2015_11_16_19_00/2015_11_16_19_00.mpg;Toru Hashimoto.jpg;17665;17829;36081;883;891;8
/net/per610a/home/mvp/mvp_db/news7-lv/2015/2015_11_16_19_00/2015_11_16_19_00.mpg;Toru Hashimoto.jpg;19281;19545;36081;964;977;13
/net/per610a/home/mvp/mvp_db/news7-lv/2015/2015_11_18_19_00/2015_11_18_19_00.mpg;Shinzo ABE.jpg;20329;20497;36089;1017;1025;8
/net/per610a/home/mvp/mvp_db/news7-lv/2015/2015_11_18_19_00/2015_11_18_19_00.mpg;Shinzo ABE.jpg;20653;20681;36089;1033;1034;1
/net/per610a/home/mvp/mvp_db/news7-lv/2015/2015_11_18_19_00/2015_11_18_19_00.mpg;Shinzo ABE.jpg;20749;20829;36089;1038;1042;4
/net/per610a/home/mvp/mvp_db/news7-lv/2015/2015_11_19_19_00/2015_11_19_19_00.mpg;Shinzo ABE.jpg;22149;22189;36089;1108;1110;2
/net/per610a/home/mvp/mvp_db/news7-lv/2015/2015_11_19_19_00/2015_11_19_19_00.mpg;Shinzo ABE.jpg;22937;22981;36089;1147;1150;3
/net/per610a/home/mvp/mvp_db/news7-lv/2015/2015_11_19_19_00/2015_11_19_19_00.mpg;Shinzo ABE.jpg;26777;26813;36089;1340;1341;1
/net/per610a/home/mvp/mvp_db/news7-lv/2015/2015_11_19_19_00/2015_11_19_19_00.mpg;Shinzo ABE.jpg;27101;27417;36089;1356;1372;16
/net/per610a/home/mvp/mvp_db/news7-lv/2015/2015_11_19_19_00/2015_11_19_19_00.mpg;Shinzo ABE.jpg;27929;28133;36089;1397;1407;10
/net/per610a/home/mvp/mvp_db/news7-lv/2015/2015_11_19_19_00/2015_11_19_19_00.mpg;Shinzo ABE.jpg;23117;23333;36089;1156;1167;11
/net/per610a/home/mvp/mvp_db/news7-lv/2015/2015_11_19_19_00/2015_11_19_19_00.mpg;Shinzo ABE.jpg;25849;25877;36089;1293;1294;1
/net/per610a/home/mvp/mvp_db/news7-lv/2015/2015_11_19_19_00/2015_11_19_19_00.mpg;Shinzo ABE.jpg;26125;26125;36089;1307;1307;0
/net/per610a/home/mvp/mvp_db/news7-lv/2015/2015_11_19_19_00/2015_11_19_19_00.mpg;Shinzo ABE.jpg;26825;26833;36089;1342;1342;0
/net/per610a/home/mvp/mvp_db/news7-lv/2015/2015_11_19_19_00/2015_11_19_19_00.mpg;Shinzo ABE.jpg;28145;28241;36089;1408;1413;5
/net/per610a/home/mvp/mvp_db/news7-lv/2015/2015_11_19_19_00/2015_11_19_19_00.mpg;Shinzo ABE.jpg;28365;28617;36089;1419;1432;13
/net/per610a/home/mvp/mvp_db/news7-lv/2015/2015_11_19_19_00/2015_11_19_19_00.mpg;Shinzo ABE.jpg;29317;29613;36089;1467;1481;14
/net/per610a/home/mvp/mvp_db/news7-lv/2015/2015_11_20_19_00/2015_11_20_19_00.mpg;Shinzo ABE.jpg;15533;16233;36077;777;812;35
/net/per610a/home/mvp/mvp_db/news7-lv/2015/2015_11_21_19_00/2015_11_21_19_00.mpg;Shinzo ABE.jpg;18641;18961;36085;932;948;16
/net/per610a/home/mvp/mvp_db/news7-lv/2015/2015_11_21_19_00/2015_11_21_19_00.mpg;Shinzo ABE.jpg;19061;19453;36085;953;973;20
/net/per610a/home/mvp/mvp_db/news7-lv/2015/2015_11_22_19_00/2015_11_22_19_00.mpg;Shinzo ABE.jpg;3609;4209;36085;180;210;30
/net/per610a/home/mvp/mvp_db/news7-lv/2015/2015_11_22_19_00/2015_11_22_19_00.mpg;Shinzo ABE.jpg;4433;5413;36085;221;270;49
/net/per610a/home/mvp/mvp_db/news7-lv/2015/2015_11_22_19_00/2015_11_22_19_00.mpg;Shinzo ABE.jpg;7449;8377;36085;372;419;47
/net/per610a/home/mvp/mvp_db/news7-lv/2015/2015_11_22_19_00/2015_11_22_19_00.mpg;Shinzo ABE.jpg;4269;4269;36085;213;213;0
/net/per610a/home/mvp/mvp_db/news7-lv/2015/2015_11_22_19_00/2015_11_22_19_00.mpg;Shinzo ABE.jpg;7041;7057;36085;352;353;1
/net/per610a/home/mvp/mvp_db/news7-lv/2015/2015_11_22_19_00/2015_11_22_19_00.mpg;Shinzo ABE.jpg;8433;8501;36085;422;425;3
/net/per610a/home/mvp/mvp_db/news7-lv/2015/2015_11_22_19_00/2015_11_22_19_00.mpg;Ichiro Matsui.jpeg;13453;13605;36085;673;680;7
/net/per610a/home/mvp/mvp_db/news7-lv/2015/2015_11_24_19_00/2015_11_24_19_00.mpg;Shinzo ABE.jpg;24257;24309;36089;1213;1216;3
/net/per610a/home/mvp/mvp_db/news7-lv/2015/2015_11_24_19_00/2015_11_24_19_00.mpg;Shinzo ABE.jpg;28001;28681;36089;1401;1435;34
/net/per610a/home/mvp/mvp_db/news7-lv/2015/2015_11_25_19_00/2015_11_25_19_00.mpg;Shinzo ABE.jpg;22577;23097;36085;1129;1155;26
/net/per610a/home/mvp/mvp_db/news7-lv/2015/2015_11_25_19_00/2015_11_25_19_00.mpg;Shinzo ABE.jpg;27089;27305;36085;1355;1366;11
/net/per610a/home/mvp/mvp_db/news7-lv/2015/2015_11_26_19_00/2015_11_26_19_00.mpg;Shinzo ABE.jpg;22477;22573;36081;1124;1129;5
/net/per610a/home/mvp/mvp_db/news7-lv/2015/2015_11_26_19_00/2015_11_26_19_00.mpg;Shinzo ABE.jpg;22801;22989;36081;1140;1150;10
/net/per610a/home/mvp/mvp_db/news7-lv/2015/2015_11_26_19_00/2015_11_26_19_00.mpg;Shinzo ABE.jpg;26657;26717;36081;1333;1336;3
/net/per610a/home/mvp/mvp_db/news7-lv/2015/2015_11_27_19_00/2015_11_27_19_00.mpg;Shinzo ABE.jpg;28125;28217;36081;1406;1411;5
/net/per610a/home/mvp/mvp_db/news7-lv/2015/2015_11_27_19_00/2015_11_27_19_00.mpg;Shinzo ABE.jpg;29517;29853;36081;1476;1493;17
/net/per610a/home/mvp/mvp_db/news7-lv/2015/2015_11_29_19_00/2015_11_29_19_00.mpg;Natsuo YAMAGUCHI.jpg;13733;14265;36081;687;713;26
/net/per610a/home/mvp/mvp_db/news7-lv/2015/2015_11_29_19_00/2015_11_29_19_00.mpg;Shinzo ABE.jpg;14681;14857;36081;734;743;9
/net/per610a/home/mvp/mvp_db/news7-lv/2015/2015_12_05_19_00/2015_12_05_19_00.mpg;Shinzo ABE.jpg;17881;18133;36081;894;907;13
/net/per610a/home/mvp/mvp_db/news7-lv/2015/2015_12_05_19_00/2015_12_05_19_00.mpg;Shinzo ABE.jpg;27957;29085;36081;1398;1455;57
/net/per610a/home/mvp/mvp_db/news7-lv/2015/2015_12_07_19_00/2015_12_07_19_00.mpg;Shinzo ABE.jpg;5865;5925;36093;293;296;3
/net/per610a/home/mvp/mvp_db/news7-lv/2015/2015_12_07_19_00/2015_12_07_19_00.mpg;Shinzo ABE.jpg;26177;26393;36093;1309;1320;11
/net/per610a/home/mvp/mvp_db/news7-lv/2015/2015_12_07_19_00/2015_12_07_19_00.mpg;Yorihisa Matsuno.png;14153;14525;36093;708;726;18
/net/per610a/home/mvp/mvp_db/news7-lv/2015/2015_12_07_19_00/2015_12_07_19_00.mpg;Yorihisa Matsuno.png;15121;15333;36093;756;767;11
/net/per610a/home/mvp/mvp_db/news7-lv/2015/2015_12_07_19_00/2015_12_07_19_00.mpg;Kazuo SHII.jpg;18513;18737;36093;926;937;11
/net/per610a/home/mvp/mvp_db/news7-lv/2015/2015_12_08_19_00/2015_12_08_19_00.mpg;Shinzo ABE.jpg;3953;4081;36085;197;204;7
/net/per610a/home/mvp/mvp_db/news7-lv/2015/2015_12_08_19_00/2015_12_08_19_00.mpg;Shinzo ABE.jpg;17613;17813;36085;881;891;10
/net/per610a/home/mvp/mvp_db/news7-lv/2015/2015_12_08_19_00/2015_12_08_19_00.mpg;Toranosuke Katayama.jpg;24569;24753;36085;1229;1238;9
/net/per610a/home/mvp/mvp_db/news7-lv/2015/2015_12_08_19_00/2015_12_08_19_00.mpg;Toranosuke Katayama.jpg;25189;25325;36085;1260;1267;7
/net/per610a/home/mvp/mvp_db/news7-lv/2015/2015_12_08_19_00/2015_12_08_19_00.mpg;Toranosuke Katayama.jpg;25921;26233;36085;1297;1312;15
/net/per610a/home/mvp/mvp_db/news7-lv/2015/2015_12_08_19_00/2015_12_08_19_00.mpg;Toru Hashimoto.jpg;24905;25049;36085;1246;1253;7
/net/per610a/home/mvp/mvp_db/news7-lv/2015/2015_12_08_19_00/2015_12_08_19_00.mpg;Sadakazu TANIGAKI.jpg;27897;28029;36085;1396;1402;6
/net/per610a/home/mvp/mvp_db/news7-lv/2015/2015_12_09_19_00/2015_12_09_19_00.mpg;Masashi Nakano.jpg;6045;6629;36081;302;331;29
/net/per610a/home/mvp/mvp_db/news7-lv/2015/2015_12_06_19_00/2015_12_06_19_00.mpg;Yorihisa Matsuno.png;18733;19085;36085;937;955;18
/net/per610a/home/mvp/mvp_db/news7-lv/2015/2015_12_06_19_00/2015_12_06_19_00.mpg;Yorihisa Matsuno.png;19285;19969;36085;965;999;34
/net/per610a/home/mvp/mvp_db/news7-lv/2015/2015_12_06_19_00/2015_12_06_19_00.mpg;Yorihisa Matsuno.png;20157;20209;36085;1008;1011;3
/net/per610a/home/mvp/mvp_db/news7-lv/2015/2015_12_06_19_00/2015_12_06_19_00.mpg;Yorihisa Matsuno.png;21745;21837;36085;1088;1092;4
/net/per610a/home/mvp/mvp_db/news7-lv/2015/2015_12_06_19_00/2015_12_06_19_00.mpg;Yorihisa Matsuno.png;22097;22165;36085;1105;1109;4
/net/per610a/home/mvp/mvp_db/news7-lv/2015/2015_12_10_19_00/2015_12_10_19_00.mpg;Natsuo YAMAGUCHI.jpg;7561;7917;36085;378;396;18
/net/per610a/home/mvp/mvp_db/news7-lv/2015/2015_12_10_19_00/2015_12_10_19_00.mpg;Sadakazu TANIGAKI.jpg;18057;18329;36085;903;917;14
/net/per610a/home/mvp/mvp_db/news7-lv/2015/2015_12_11_19_00/2015_12_11_19_00.mpg;Sadakazu TANIGAKI.jpg;2317;2541;36081;115;127;12
/net/per610a/home/mvp/mvp_db/news7-lv/2015/2015_12_11_19_00/2015_12_11_19_00.mpg;Sadakazu TANIGAKI.jpg;33653;34005;36081;1683;1701;18
/net/per610a/home/mvp/mvp_db/news7-lv/2015/2015_12_12_19_00/2015_12_12_19_00.mpg;Sadakazu TANIGAKI.jpg;1985;1989;36085;99;99;0
/net/per610a/home/mvp/mvp_db/news7-lv/2015/2015_12_12_19_00/2015_12_12_19_00.mpg;Sadakazu TANIGAKI.jpg;2325;2457;36085;116;122;6
/net/per610a/home/mvp/mvp_db/news7-lv/2015/2015_12_12_19_00/2015_12_12_19_00.mpg;Sadakazu TANIGAKI.jpg;1997;2277;36085;99;113;14
/net/per610a/home/mvp/mvp_db/news7-lv/2015/2015_12_12_19_00/2015_12_12_19_00.mpg;Sadakazu TANIGAKI.jpg;3137;3177;36085;157;159;2
/net/per610a/home/mvp/mvp_db/news7-lv/2015/2015_12_12_19_00/2015_12_12_19_00.mpg;Shinzo ABE.jpg;9001;9521;36085;450;476;26
/net/per610a/home/mvp/mvp_db/news7-lv/2015/2015_12_12_19_00/2015_12_12_19_00.mpg;Shinzo ABE.jpg;13957;14309;36085;698;716;18
/net/per610a/home/mvp/mvp_db/news7-lv/2015/2015_12_12_19_00/2015_12_12_19_00.mpg;Shinzo ABE.jpg;14961;15009;36085;748;751;3
/net/per610a/home/mvp/mvp_db/news7-lv/2015/2015_12_12_19_00/2015_12_12_19_00.mpg;Shinzo ABE.jpg;15105;15121;36085;755;756;1
/net/per610a/home/mvp/mvp_db/news7-lv/2015/2015_12_12_19_00/2015_12_12_19_00.mpg;Shinzo ABE.jpg;15981;16617;36085;799;831;32
/net/per610a/home/mvp/mvp_db/news7-lv/2015/2015_12_13_19_00/2015_12_13_19_00.mpg;Shinzo ABE.jpg;1537;1573;36077;76;78;2
/net/per610a/home/mvp/mvp_db/news7-lv/2015/2015_12_13_19_00/2015_12_13_19_00.mpg;Shinzo ABE.jpg;4717;4885;36077;236;244;8
/net/per610a/home/mvp/mvp_db/news7-lv/2015/2015_12_13_19_00/2015_12_13_19_00.mpg;Shinzo ABE.jpg;6321;6333;36077;316;316;0
/net/per610a/home/mvp/mvp_db/news7-lv/2015/2015_12_13_19_00/2015_12_13_19_00.mpg;Shinzo ABE.jpg;6525;6641;36077;326;332;6
/net/per610a/home/mvp/mvp_db/news7-lv/2015/2015_12_13_19_00/2015_12_13_19_00.mpg;Shinzo ABE.jpg;6837;6965;36077;342;348;6
/net/per610a/home/mvp/mvp_db/news7-lv/2015/2015_12_13_19_00/2015_12_13_19_00.mpg;Sadakazu TANIGAKI.jpg;16657;16797;36077;833;840;7
/net/per610a/home/mvp/mvp_db/news7-lv/2015/2015_12_14_19_00/2015_12_14_19_00.mpg;Shinzo ABE.jpg;23013;23129;36081;1151;1157;6
/net/per610a/home/mvp/mvp_db/news7-lv/2015/2015_12_14_19_00/2015_12_14_19_00.mpg;Shinzo ABE.jpg;23877;24145;36081;1194;1207;13
/net/per610a/home/mvp/mvp_db/news7-lv/2015/2015_12_15_19_00/2015_12_15_19_00.mpg;Shinzo ABE.jpg;8857;9029;36085;443;451;8
/net/per610a/home/mvp/mvp_db/news7-lv/2015/2015_12_15_19_00/2015_12_15_19_00.mpg;Yukio HATOYAMA.jpg;26585;26817;36085;1330;1342;12
/net/per610a/home/mvp/mvp_db/news7-lv/2015/2015_12_15_19_00/2015_12_15_19_00.mpg;Shinzo ABE.jpg;27825;27937;36085;1392;1398;6
/net/per610a/home/mvp/mvp_db/news7-lv/2015/2015_12_15_19_00/2015_12_15_19_00.mpg;Shinzo ABE.jpg;28533;28885;36085;1428;1445;17
/net/per610a/home/mvp/mvp_db/news7-lv/2015/2015_12_16_19_00/2015_12_16_19_00.mpg;Renho.jpg;8453;8749;36085;423;437;14
/net/per610a/home/mvp/mvp_db/news7-lv/2015/2015_12_17_19_00/2015_12_17_19_00.mpg;Ichiro OZAWA.jpg;25333;25593;36085;1267;1280;13
/net/per610a/home/mvp/mvp_db/news7-lv/2015/2015_12_18_19_00/2015_12_18_19_00.mpg;Toru Hashimoto.jpg;261;273;36085;13;13;0
/net/per610a/home/mvp/mvp_db/news7-lv/2015/2015_12_18_19_00/2015_12_18_19_00.mpg;Toru Hashimoto.jpg;349;481;36085;17;24;7
/net/per610a/home/mvp/mvp_db/news7-lv/2015/2015_12_18_19_00/2015_12_18_19_00.mpg;Toru Hashimoto.jpg;7709;7837;36085;385;392;7
/net/per610a/home/mvp/mvp_db/news7-lv/2015/2015_12_18_19_00/2015_12_18_19_00.mpg;Toru Hashimoto.jpg;8625;8745;36085;431;437;6
/net/per610a/home/mvp/mvp_db/news7-lv/2015/2015_12_18_19_00/2015_12_18_19_00.mpg;Toru Hashimoto.jpg;9713;9717;36085;486;486;0
/net/per610a/home/mvp/mvp_db/news7-lv/2015/2015_12_18_19_00/2015_12_18_19_00.mpg;Toru Hashimoto.jpg;10385;10469;36085;519;523;4
/net/per610a/home/mvp/mvp_db/news7-lv/2015/2015_12_18_19_00/2015_12_18_19_00.mpg;Toru Hashimoto.jpg;11257;11641;36085;563;582;19
/net/per610a/home/mvp/mvp_db/news7-lv/2015/2015_12_18_19_00/2015_12_18_19_00.mpg;Toru Hashimoto.jpg;12461;12789;36085;623;640;17
/net/per610a/home/mvp/mvp_db/news7-lv/2015/2015_12_18_19_00/2015_12_18_19_00.mpg;Toru Hashimoto.jpg;13185;13201;36085;659;660;1
/net/per610a/home/mvp/mvp_db/news7-lv/2015/2015_12_18_19_00/2015_12_18_19_00.mpg;Shinzo ABE.jpg;19641;19685;36085;983;985;2
/net/per610a/home/mvp/mvp_db/news7-lv/2015/2015_12_18_19_00/2015_12_18_19_00.mpg;Shinzo ABE.jpg;21009;21125;36085;1051;1057;6
/net/per610a/home/mvp/mvp_db/news7-lv/2015/2015_12_19_19_00/2015_12_19_19_00.mpg;Shinzo ABE.jpg;5897;5977;36085;295;299;4
/net/per610a/home/mvp/mvp_db/news7-lv/2015/2015_12_19_19_00/2015_12_19_19_00.mpg;Shinzo ABE.jpg;20973;21221;36085;1049;1062;13
/net/per610a/home/mvp/mvp_db/news7-lv/2015/2015_12_19_19_00/2015_12_19_19_00.mpg;Shinzo ABE.jpg;21865;22401;36085;1094;1121;27
/net/per610a/home/mvp/mvp_db/news7-lv/2015/2015_12_19_19_00/2015_12_19_19_00.mpg;Toru Hashimoto.jpg;20569;20917;36085;1029;1046;17
/net/per610a/home/mvp/mvp_db/news7-lv/2015/2015_12_19_19_00/2015_12_19_19_00.mpg;Toru Hashimoto.jpg;21865;22361;36085;1094;1119;25
/net/per610a/home/mvp/mvp_db/news7-lv/2015/2015_12_21_19_00/2015_12_21_19_00.mpg;Taro ASO.jpg;20513;20601;36085;1026;1031;5
/net/per610a/home/mvp/mvp_db/news7-lv/2015/2015_12_21_19_00/2015_12_21_19_00.mpg;Taro ASO.jpg;22441;22533;36085;1123;1127;4
/net/per610a/home/mvp/mvp_db/news7-lv/2015/2015_12_23_19_00/2015_12_23_19_00.mpg;Sadakazu TANIGAKI.jpg;20885;21297;36085;1045;1065;20
/net/per610a/home/mvp/mvp_db/news7-lv/2015/2015_12_24_19_00/2015_12_24_19_00.mpg;Shinzo ABE.jpg;309;633;36085;15;31;16
/net/per610a/home/mvp/mvp_db/news7-lv/2015/2015_12_24_19_00/2015_12_24_19_00.mpg;Shinzo ABE.jpg;1865;2981;36085;93;149;56
/net/per610a/home/mvp/mvp_db/news7-lv/2015/2015_12_24_19_00/2015_12_24_19_00.mpg;Shinzo ABE.jpg;3605;4093;36085;180;204;24
/net/per610a/home/mvp/mvp_db/news7-lv/2015/2015_12_24_19_00/2015_12_24_19_00.mpg;Shinzo ABE.jpg;4437;4813;36085;222;240;18
/net/per610a/home/mvp/mvp_db/news7-lv/2015/2015_12_24_19_00/2015_12_24_19_00.mpg;Shinzo ABE.jpg;5501;5885;36085;275;294;19
/net/per610a/home/mvp/mvp_db/news7-lv/2015/2015_12_24_19_00/2015_12_24_19_00.mpg;Shinzo ABE.jpg;8489;8901;36085;424;445;21
/net/per610a/home/mvp/mvp_db/news7-lv/2015/2015_12_24_19_00/2015_12_24_19_00.mpg;Shinzo ABE.jpg;653;721;36085;32;36;4
/net/per610a/home/mvp/mvp_db/news7-lv/2015/2015_12_24_19_00/2015_12_24_19_00.mpg;Shinzo ABE.jpg;20349;20473;36085;1018;1024;6
/net/per610a/home/mvp/mvp_db/news7-lv/2015/2015_12_28_19_00/2015_12_28_19_00.mpg;Shinzo ABE.jpg;10117;10649;36085;506;532;26
/net/per610a/home/mvp/mvp_db/news7-lv/2016/2016_04_21_19_00/2016_04_21_19_00.mpg;Toru Hashimoto.jpg;23657;23829;38481;1183;1192;9
/net/per610a/home/mvp/mvp_db/news7-lv/2016/2016_01_01_19_00/2016_01_01_19_00.mpg;Shinzo ABE.jpg;13689;14069;24097;685;704;19
/net/per610a/home/mvp/mvp_db/news7-lv/2016/2016_01_01_19_00/2016_01_01_19_00.mpg;Shinzo ABE.jpg;14269;14365;24097;714;718;4
/net/per610a/home/mvp/mvp_db/news7-lv/2016/2016_01_01_19_00/2016_01_01_19_00.mpg;Shinzo ABE.jpg;15853;16157;24097;793;808;15
/net/per610a/home/mvp/mvp_db/news7-lv/2016/2016_01_01_19_00/2016_01_01_19_00.mpg;Shinzo ABE.jpg;16413;16413;24097;821;821;0
/net/per610a/home/mvp/mvp_db/news7-lv/2016/2016_01_01_19_00/2016_01_01_19_00.mpg;Shinzo ABE.jpg;16517;16589;24097;826;830;4
/net/per610a/home/mvp/mvp_db/news7-lv/2016/2016_01_04_19_00/2016_01_04_19_00.mpg;Shinzo ABE.jpg;1601;2097;36085;80;104;24
/net/per610a/home/mvp/mvp_db/news7-lv/2016/2016_01_04_19_00/2016_01_04_19_00.mpg;Shinzo ABE.jpg;3505;3541;36085;175;177;2
/net/per610a/home/mvp/mvp_db/news7-lv/2016/2016_01_04_19_00/2016_01_04_19_00.mpg;Natsuo YAMAGUCHI.jpg;2173;2573;36085;108;128;20
/net/per610a/home/mvp/mvp_db/news7-lv/2016/2016_01_04_19_00/2016_01_04_19_00.mpg;Kazuo SHII.jpg;3881;3937;36085;194;197;3
/net/per610a/home/mvp/mvp_db/news7-lv/2016/2016_01_04_19_00/2016_01_04_19_00.mpg;Kazuo SHII.jpg;6601;7101;36085;330;355;25
/net/per610a/home/mvp/mvp_db/news7-lv/2016/2016_01_04_19_00/2016_01_04_19_00.mpg;Shinzo ABE.jpg;5165;5745;36085;258;287;29
/net/per610a/home/mvp/mvp_db/news7-lv/2016/2016_01_04_19_00/2016_01_04_19_00.mpg;Shinzo ABE.jpg;8101;8169;36085;405;408;3
/net/per610a/home/mvp/mvp_db/news7-lv/2016/2016_01_04_19_00/2016_01_04_19_00.mpg;Yorihisa Matsuno.png;6257;6297;36085;313;315;2
/net/per610a/home/mvp/mvp_db/news7-lv/2016/2016_01_04_19_00/2016_01_04_19_00.mpg;Yorihisa Matsuno.png;8485;8557;36085;424;428;4
/net/per610a/home/mvp/mvp_db/news7-lv/2016/2016_01_04_19_00/2016_01_04_19_00.mpg;Toranosuke Katayama.jpg;7293;7845;36085;365;392;27
/net/per610a/home/mvp/mvp_db/news7-lv/2016/2016_01_07_19_00/2016_01_07_19_00.mpg;Shinzo ABE.jpg;8389;8749;36085;419;437;18
/net/per610a/home/mvp/mvp_db/news7-lv/2016/2016_01_07_19_00/2016_01_07_19_00.mpg;Shinzo ABE.jpg;9025;9449;36085;451;472;21
/net/per610a/home/mvp/mvp_db/news7-lv/2016/2016_01_07_19_00/2016_01_07_19_00.mpg;Shinzo ABE.jpg;28353;28445;36085;1419;1423;4
/net/per610a/home/mvp/mvp_db/news7-lv/2016/2016_01_10_19_00/2016_01_10_19_00.mpg;Shinzo ABE.jpg;4589;5377;36085;229;269;40
/net/per610a/home/mvp/mvp_db/news7-lv/2016/2016_01_10_19_00/2016_01_10_19_00.mpg;Shinzo ABE.jpg;26113;26889;36085;1306;1345;39
/net/per610a/home/mvp/mvp_db/news7-lv/2016/2016_01_12_19_00/2016_01_12_19_00.mpg;Taro ASO.jpg;8113;8385;36073;405;419;14
/net/per610a/home/mvp/mvp_db/news7-lv/2016/2016_01_12_19_00/2016_01_12_19_00.mpg;Shinzo ABE.jpg;16341;16817;36073;817;841;24
/net/per610a/home/mvp/mvp_db/news7-lv/2016/2016_01_12_19_00/2016_01_12_19_00.mpg;Shinzo ABE.jpg;17113;17497;36073;856;875;19
/net/per610a/home/mvp/mvp_db/news7-lv/2016/2016_01_12_19_00/2016_01_12_19_00.mpg;Shinzo ABE.jpg;18841;19401;36073;942;970;28
/net/per610a/home/mvp/mvp_db/news7-lv/2016/2016_01_12_19_00/2016_01_12_19_00.mpg;Shinzo ABE.jpg;20033;20885;36073;1002;1045;43
/net/per610a/home/mvp/mvp_db/news7-lv/2016/2016_01_12_19_00/2016_01_12_19_00.mpg;Shinzo ABE.jpg;21569;21617;36073;1079;1081;2
/net/per610a/home/mvp/mvp_db/news7-lv/2016/2016_01_12_19_00/2016_01_12_19_00.mpg;Shinzo ABE.jpg;21689;21757;36073;1085;1088;3
/net/per610a/home/mvp/mvp_db/news7-lv/2016/2016_01_13_19_00/2016_01_13_19_00.mpg;Shinzo ABE.jpg;23245;23393;36081;1162;1170;8
/net/per610a/home/mvp/mvp_db/news7-lv/2016/2016_01_14_19_00/2016_01_14_19_00.mpg;Sadakazu TANIGAKI.jpg;23357;25233;36077;1168;1262;94
/net/per610a/home/mvp/mvp_db/news7-lv/2016/2016_01_18_19_00/2016_01_18_19_00.mpg;Shinzo ABE.jpg;23941;24249;36081;1197;1213;16
/net/per610a/home/mvp/mvp_db/news7-lv/2016/2016_01_18_19_00/2016_01_18_19_00.mpg;Shinzo ABE.jpg;25585;25929;36081;1279;1297;18
/net/per610a/home/mvp/mvp_db/news7-lv/2016/2016_01_18_19_00/2016_01_18_19_00.mpg;Shinzo ABE.jpg;27377;27421;36081;1369;1371;2
/net/per610a/home/mvp/mvp_db/news7-lv/2016/2016_01_18_19_00/2016_01_18_19_00.mpg;Shinzo ABE.jpg;27525;27545;36081;1376;1377;1
/net/per610a/home/mvp/mvp_db/news7-lv/2016/2016_01_19_19_00/2016_01_19_19_00.mpg;Shinzo ABE.jpg;21365;21433;36077;1068;1072;4
/net/per610a/home/mvp/mvp_db/news7-lv/2016/2016_01_19_19_00/2016_01_19_19_00.mpg;Shinzo ABE.jpg;21597;21865;36077;1080;1093;13
/net/per610a/home/mvp/mvp_db/news7-lv/2016/2016_01_19_19_00/2016_01_19_19_00.mpg;Shinzo ABE.jpg;22505;22545;36077;1125;1127;2
/net/per610a/home/mvp/mvp_db/news7-lv/2016/2016_01_19_19_00/2016_01_19_19_00.mpg;Shinzo ABE.jpg;22789;22817;36077;1140;1141;1
/net/per610a/home/mvp/mvp_db/news7-lv/2016/2016_01_19_19_00/2016_01_19_19_00.mpg;Shinzo ABE.jpg;25797;25869;36077;1290;1294;4
/net/per610a/home/mvp/mvp_db/news7-lv/2016/2016_01_22_19_00/2016_01_22_19_00.mpg;Shinzo ABE.jpg;13553;13589;36081;678;680;2
/net/per610a/home/mvp/mvp_db/news7-lv/2016/2016_01_22_19_00/2016_01_22_19_00.mpg;Shinzo ABE.jpg;13701;13933;36081;685;697;12
/net/per610a/home/mvp/mvp_db/news7-lv/2016/2016_01_22_19_00/2016_01_22_19_00.mpg;Shinzo ABE.jpg;15341;15609;36081;767;781;14
/net/per610a/home/mvp/mvp_db/news7-lv/2016/2016_01_22_19_00/2016_01_22_19_00.mpg;Shinzo ABE.jpg;16493;16549;36081;825;828;3
/net/per610a/home/mvp/mvp_db/news7-lv/2016/2016_01_22_19_00/2016_01_22_19_00.mpg;Shinzo ABE.jpg;19049;19101;36081;953;956;3
/net/per610a/home/mvp/mvp_db/news7-lv/2016/2016_05_11_19_00/2016_05_11_19_00.mpg;Shinzo ABE.jpg;10949;11433;36081;547;571;24
/net/per610a/home/mvp/mvp_db/news7-lv/2016/2016_05_11_19_00/2016_05_11_19_00.mpg;Toru Hashimoto.jpg;25205;25397;36081;1260;1270;10
/net/per610a/home/mvp/mvp_db/news7-lv/2016/2016_01_26_19_00/2016_01_26_19_00.mpg;Shinzo ABE.jpg;11077;11737;36089;554;587;33
/net/per610a/home/mvp/mvp_db/news7-lv/2016/2016_01_26_19_00/2016_01_26_19_00.mpg;Sadakazu TANIGAKI.jpg;12957;13973;36089;648;699;51
/net/per610a/home/mvp/mvp_db/news7-lv/2016/2016_01_27_19_00/2016_01_27_19_00.mpg;Kazuo SHII.jpg;29821;30633;36085;1492;1533;41
/net/per610a/home/mvp/mvp_db/news7-lv/2016/2016_01_28_19_00/2016_01_28_19_00.mpg;Shinzo ABE.jpg;133;5061;39721;6;253;247
/net/per610a/home/mvp/mvp_db/news7-lv/2016/2016_01_28_19_00/2016_01_28_19_00.mpg;Shinzo ABE.jpg;15085;15137;39721;754;757;3
/net/per610a/home/mvp/mvp_db/news7-lv/2016/2016_01_28_19_00/2016_01_28_19_00.mpg;Shinzo ABE.jpg;32213;32697;39721;1612;1636;24
/net/per610a/home/mvp/mvp_db/news7-lv/2016/2016_01_28_19_00/2016_01_28_19_00.mpg;Shinzo ABE.jpg;37517;38105;39721;1877;1907;30
/net/per610a/home/mvp/mvp_db/news7-lv/2016/2016_02_01_19_00/2016_02_01_19_00.mpg;Sadakazu TANIGAKI.jpg;21313;21313;36085;1066;1066;0
/net/per610a/home/mvp/mvp_db/news7-lv/2016/2016_02_01_19_00/2016_02_01_19_00.mpg;Sadakazu TANIGAKI.jpg;22117;22641;36085;1106;1133;27
/net/per610a/home/mvp/mvp_db/news7-lv/2016/2016_02_03_19_00/2016_02_03_19_00.mpg;Shinzo ABE.jpg;7045;7337;36085;352;367;15
/net/per610a/home/mvp/mvp_db/news7-lv/2016/2016_02_03_19_00/2016_02_03_19_00.mpg;Shinzo ABE.jpg;21825;22105;36085;1092;1106;14
/net/per610a/home/mvp/mvp_db/news7-lv/2016/2016_02_03_19_00/2016_02_03_19_00.mpg;Shinzo ABE.jpg;23337;23361;36085;1167;1169;2
/net/per610a/home/mvp/mvp_db/news7-lv/2016/2016_02_03_19_00/2016_02_03_19_00.mpg;Shinzo ABE.jpg;23429;23453;36085;1172;1173;1
/net/per610a/home/mvp/mvp_db/news7-lv/2016/2016_02_03_19_00/2016_02_03_19_00.mpg;Shinzo ABE.jpg;20301;20741;36085;1016;1038;22
/net/per610a/home/mvp/mvp_db/news7-lv/2016/2016_02_03_19_00/2016_02_03_19_00.mpg;Shinzo ABE.jpg;21257;21617;36085;1063;1081;18
/net/per610a/home/mvp/mvp_db/news7-lv/2016/2016_02_05_19_00/2016_02_05_19_00.mpg;Shinzo ABE.jpg;31453;31829;40881;1574;1592;18
/net/per610a/home/mvp/mvp_db/news7-lv/2016/2016_02_07_19_00/2016_02_07_19_00.mpg;Shinzo ABE.jpg;3449;3809;36093;172;190;18
/net/per610a/home/mvp/mvp_db/news7-lv/2016/2016_02_08_19_00/2016_02_08_19_00.mpg;Shinzo ABE.jpg;22393;22741;36081;1120;1137;17
/net/per610a/home/mvp/mvp_db/news7-lv/2016/2016_02_08_19_00/2016_02_08_19_00.mpg;Shinzo ABE.jpg;23445;23705;36081;1172;1185;13
/net/per610a/home/mvp/mvp_db/news7-lv/2016/2016_02_08_19_00/2016_02_08_19_00.mpg;Shinzo ABE.jpg;25073;25473;36081;1254;1274;20
/net/per610a/home/mvp/mvp_db/news7-lv/2016/2016_02_09_19_00/2016_02_09_19_00.mpg;Shinzo ABE.jpg;9817;10869;36073;491;543;52
/net/per610a/home/mvp/mvp_db/news7-lv/2016/2016_02_09_19_00/2016_02_09_19_00.mpg;Shinzo ABE.jpg;11349;11729;36073;567;586;19
/net/per610a/home/mvp/mvp_db/news7-lv/2016/2016_02_11_19_00/2016_02_11_19_00.mpg;Sadakazu TANIGAKI.jpg;8125;8349;36081;406;417;11
/net/per610a/home/mvp/mvp_db/news7-lv/2016/2016_02_11_19_00/2016_02_11_19_00.mpg;Sadakazu TANIGAKI.jpg;8433;8881;36081;421;444;23
/net/per610a/home/mvp/mvp_db/news7-lv/2016/2016_02_12_19_00/2016_02_12_19_00.mpg;Sadakazu TANIGAKI.jpg;12197;13033;36081;610;651;41
/net/per610a/home/mvp/mvp_db/news7-lv/2016/2016_02_14_19_00/2016_02_14_19_00.mpg;Shintaro ISHIHARA.jpg;14665;14989;36085;733;750;17
/net/per610a/home/mvp/mvp_db/news7-lv/2016/2016_02_19_19_00/2016_02_19_19_00.mpg;Shinzo ABE.jpg;10233;10481;36085;512;524;12
/net/per610a/home/mvp/mvp_db/news7-lv/2016/2016_02_19_19_00/2016_02_19_19_00.mpg;Shinzo ABE.jpg;31733;32093;36085;1588;1606;18
/net/per610a/home/mvp/mvp_db/news7-lv/2016/2016_02_21_19_00/2016_02_21_19_00.mpg;Shinzo ABE.jpg;19821;20057;36085;992;1003;11
/net/per610a/home/mvp/mvp_db/news7-lv/2016/2016_02_21_19_00/2016_02_21_19_00.mpg;Shinzo ABE.jpg;20241;20609;36085;1013;1031;18
/net/per610a/home/mvp/mvp_db/news7-lv/2016/2016_02_22_19_00/2016_02_22_19_00.mpg;Kazuo SHII.jpg;14005;14505;36081;701;726;25
/net/per610a/home/mvp/mvp_db/news7-lv/2016/2016_02_22_19_00/2016_02_22_19_00.mpg;Kazuo SHII.jpg;14581;14637;36081;729;732;3
/net/per610a/home/mvp/mvp_db/news7-lv/2016/2016_02_22_19_00/2016_02_22_19_00.mpg;Kazuo SHII.jpg;14757;14821;36081;738;741;3
/net/per610a/home/mvp/mvp_db/news7-lv/2016/2016_02_22_19_00/2016_02_22_19_00.mpg;Kazuo SHII.jpg;15397;15877;36081;770;794;24
/net/per610a/home/mvp/mvp_db/news7-lv/2016/2016_02_22_19_00/2016_02_22_19_00.mpg;Yorihisa Matsuno.png;14645;14737;36081;733;737;4
/net/per610a/home/mvp/mvp_db/news7-lv/2016/2016_02_23_19_00/2016_02_23_19_00.mpg;Sadakazu TANIGAKI.jpg;11501;12221;36085;575;611;36
/net/per610a/home/mvp/mvp_db/news7-lv/2016/2016_02_26_19_00/2016_02_26_19_00.mpg;Taro ASO.jpg;28845;29249;36081;1443;1463;20
/net/per610a/home/mvp/mvp_db/news7-lv/2016/2016_03_01_19_00/2016_03_01_19_00.mpg;Shinzo ABE.jpg;23145;23597;36081;1157;1180;23
/net/per610a/home/mvp/mvp_db/news7-lv/2016/2016_03_02_19_00/2016_03_02_19_00.mpg;Shinzo ABE.jpg;11713;12565;36085;586;628;42
/net/per610a/home/mvp/mvp_db/news7-lv/2016/2016_03_02_19_00/2016_03_02_19_00.mpg;Shinzo ABE.jpg;13125;13637;36085;656;682;26
/net/per610a/home/mvp/mvp_db/news7-lv/2016/2016_03_03_19_00/2016_03_03_19_00.mpg;Shinzo ABE.jpg;9181;9669;36089;459;483;24
/net/per610a/home/mvp/mvp_db/news7-lv/2016/2016_03_03_19_00/2016_03_03_19_00.mpg;Shinzo ABE.jpg;27209;27545;36089;1361;1378;17
/net/per610a/home/mvp/mvp_db/news7-lv/2016/2016_03_03_19_00/2016_03_03_19_00.mpg;Shinzo ABE.jpg;27989;28469;36089;1400;1424;24
/net/per610a/home/mvp/mvp_db/news7-lv/2016/2016_03_03_19_00/2016_03_03_19_00.mpg;Shinzo ABE.jpg;28817;29241;36089;1442;1463;21
/net/per610a/home/mvp/mvp_db/news7-lv/2016/2016_03_03_19_00/2016_03_03_19_00.mpg;Shinzo ABE.jpg;29637;29637;36089;1483;1483;0
/net/per610a/home/mvp/mvp_db/news7-lv/2016/2016_03_03_19_00/2016_03_03_19_00.mpg;Shinzo ABE.jpg;29865;29917;36089;1494;1497;3
/net/per610a/home/mvp/mvp_db/news7-lv/2016/2016_03_03_19_00/2016_03_03_19_00.mpg;Shinzo ABE.jpg;30249;30297;36089;1513;1516;3
/net/per610a/home/mvp/mvp_db/news7-lv/2016/2016_03_04_19_00/2016_03_04_19_00.mpg;Shinzo ABE.jpg;293;305;36085;14;15;1
/net/per610a/home/mvp/mvp_db/news7-lv/2016/2016_03_04_19_00/2016_03_04_19_00.mpg;Shinzo ABE.jpg;893;1385;36085;44;69;25
/net/per610a/home/mvp/mvp_db/news7-lv/2016/2016_03_04_19_00/2016_03_04_19_00.mpg;Shinzo ABE.jpg;2109;2229;36085;105;111;6
/net/per610a/home/mvp/mvp_db/news7-lv/2016/2016_03_04_19_00/2016_03_04_19_00.mpg;Shinzo ABE.jpg;2337;2429;36085;116;121;5
/net/per610a/home/mvp/mvp_db/news7-lv/2016/2016_03_04_19_00/2016_03_04_19_00.mpg;Shinzo ABE.jpg;3761;4605;36085;188;230;42
/net/per610a/home/mvp/mvp_db/news7-lv/2016/2016_03_04_19_00/2016_03_04_19_00.mpg;Shinzo ABE.jpg;6637;7193;36085;332;359;27
/net/per610a/home/mvp/mvp_db/news7-lv/2016/2016_03_04_19_00/2016_03_04_19_00.mpg;Shinzo ABE.jpg;10949;11493;36085;547;575;28
/net/per610a/home/mvp/mvp_db/news7-lv/2016/2016_03_05_19_00/2016_03_05_19_00.mpg;Taro ASO.jpg;5561;5949;36085;278;297;19
/net/per610a/home/mvp/mvp_db/news7-lv/2016/2016_03_05_19_00/2016_03_05_19_00.mpg;Shinzo ABE.jpg;13965;14113;36085;698;706;8
/net/per610a/home/mvp/mvp_db/news7-lv/2016/2016_03_07_19_00/2016_03_07_19_00.mpg;Shinzo ABE.jpg;21349;21777;36081;1068;1089;21
/net/per610a/home/mvp/mvp_db/news7-lv/2016/2016_03_07_19_00/2016_03_07_19_00.mpg;Shinzo ABE.jpg;22137;22817;36081;1107;1141;34
/net/per610a/home/mvp/mvp_db/news7-lv/2016/2016_03_08_19_00/2016_03_08_19_00.mpg;Shinzo ABE.jpg;26753;26861;36089;1338;1344;6
/net/per610a/home/mvp/mvp_db/news7-lv/2016/2016_03_09_19_00/2016_03_09_19_00.mpg;Kazuo SHII.jpg;22917;23145;36085;1146;1158;12
/net/per610a/home/mvp/mvp_db/news7-lv/2016/2016_03_10_19_00/2016_03_10_19_00.mpg;Shinzo ABE.jpg;8501;8781;36093;425;439;14
/net/per610a/home/mvp/mvp_db/news7-lv/2016/2016_03_10_19_00/2016_03_10_19_00.mpg;Shinzo ABE.jpg;11281;12113;36093;564;606;42
/net/per610a/home/mvp/mvp_db/news7-lv/2016/2016_03_10_19_00/2016_03_10_19_00.mpg;Shinzo ABE.jpg;26229;26245;36093;1312;1313;1
/net/per610a/home/mvp/mvp_db/news7-lv/2016/2016_03_10_19_00/2016_03_10_19_00.mpg;Shinzo ABE.jpg;26309;27193;36093;1316;1360;44
/net/per610a/home/mvp/mvp_db/news7-lv/2016/2016_03_11_19_00/2016_03_11_19_00.mpg;Takenori KANZAKI.jpg;60557;60889;72049;3030;3047;17
/net/per610a/home/mvp/mvp_db/news7-lv/2016/2016_03_13_19_00/2016_03_13_19_00.mpg;Shinzo ABE.jpg;23193;23965;36081;1160;1199;39
/net/per610a/home/mvp/mvp_db/news7-lv/2016/2016_03_13_19_00/2016_03_13_19_00.mpg;Shinzo ABE.jpg;25109;25409;36081;1256;1271;15
/net/per610a/home/mvp/mvp_db/news7-lv/2016/2016_03_13_19_00/2016_03_13_19_00.mpg;Natsuo YAMAGUCHI.jpg;24121;24589;36081;1207;1230;23
/net/per610a/home/mvp/mvp_db/news7-lv/2016/2016_03_14_19_00/2016_03_14_19_00.mpg;Shinzo ABE.jpg;16309;16341;36081;815;817;2
/net/per610a/home/mvp/mvp_db/news7-lv/2016/2016_03_14_19_00/2016_03_14_19_00.mpg;Shinzo ABE.jpg;18877;18877;36081;944;944;0
/net/per610a/home/mvp/mvp_db/news7-lv/2016/2016_03_14_19_00/2016_03_14_19_00.mpg;Shinzo ABE.jpg;19705;19905;36081;985;995;10
/net/per610a/home/mvp/mvp_db/news7-lv/2016/2016_03_17_19_00/2016_03_17_19_00.mpg;Sadakazu TANIGAKI.jpg;27193;27589;36081;1360;1380;20
/net/per610a/home/mvp/mvp_db/news7-lv/2016/2016_03_21_19_00/2016_03_21_19_00.mpg;Shinzo ABE.jpg;15285;15793;36081;764;790;26
/net/per610a/home/mvp/mvp_db/news7-lv/2016/2016_03_23_19_00/2016_03_23_19_00.mpg;Shinzo ABE.jpg;27961;28077;36085;1399;1405;6
/net/per610a/home/mvp/mvp_db/news7-lv/2016/2016_03_25_19_00/2016_03_25_19_00.mpg;Shinzo ABE.jpg;24861;25281;36085;1244;1265;21
/net/per610a/home/mvp/mvp_db/news7-lv/2016/2016_03_27_19_00/2016_03_27_19_00.mpg;Kenji Eda.jpg;17017;17657;36085;851;883;32
/net/per610a/home/mvp/mvp_db/news7-lv/2016/2016_03_28_19_00/2016_03_28_19_00.mpg;Shinzo ABE.jpg;13689;13889;36085;685;695;10
/net/per610a/home/mvp/mvp_db/news7-lv/2016/2016_03_28_19_00/2016_03_28_19_00.mpg;Kenji Eda.jpg;14181;15221;36085;709;761;52
/net/per610a/home/mvp/mvp_db/news7-lv/2016/2016_03_29_19_00/2016_03_29_19_00.mpg;Shinzo ABE.jpg;889;1337;36085;44;66;22
/net/per610a/home/mvp/mvp_db/news7-lv/2016/2016_03_29_19_00/2016_03_29_19_00.mpg;Shinzo ABE.jpg;1677;1693;36085;83;84;1
/net/per610a/home/mvp/mvp_db/news7-lv/2016/2016_03_29_19_00/2016_03_29_19_00.mpg;Shinzo ABE.jpg;2485;2545;36085;124;127;3
/net/per610a/home/mvp/mvp_db/news7-lv/2016/2016_03_29_19_00/2016_03_29_19_00.mpg;Shinzo ABE.jpg;3777;4397;36085;189;220;31
/net/per610a/home/mvp/mvp_db/news7-lv/2016/2016_03_29_19_00/2016_03_29_19_00.mpg;Shinzo ABE.jpg;5529;5709;36085;276;285;9
/net/per610a/home/mvp/mvp_db/news7-lv/2016/2016_03_29_19_00/2016_03_29_19_00.mpg;Shinzo ABE.jpg;10245;10901;36085;512;545;33
/net/per610a/home/mvp/mvp_db/news7-lv/2016/2016_03_30_19_00/2016_03_30_19_00.mpg;Shinzo ABE.jpg;21985;22169;36089;1100;1109;9
/net/per610a/home/mvp/mvp_db/news7-lv/2016/2016_03_30_19_00/2016_03_30_19_00.mpg;Shinzo ABE.jpg;22625;22789;36089;1132;1140;8
/net/per610a/home/mvp/mvp_db/news7-lv/2016/2016_03_30_19_00/2016_03_30_19_00.mpg;Shinzo ABE.jpg;24229;24437;36089;1212;1222;10
/net/per610a/home/mvp/mvp_db/news7-lv/2016/2016_03_30_19_00/2016_03_30_19_00.mpg;Shinzo ABE.jpg;27357;28145;36089;1369;1408;39
/net/per610a/home/mvp/mvp_db/news7-lv/2016/2016_03_30_19_00/2016_03_30_19_00.mpg;Natsuo YAMAGUCHI.jpg;27357;28149;36089;1369;1408;39
/net/per610a/home/mvp/mvp_db/news7-lv/2016/2016_03_31_19_00/2016_03_31_19_00.mpg;Shinzo ABE.jpg;8517;8993;36085;426;450;24
/net/per610a/home/mvp/mvp_db/news7-lv/2016/2016_03_31_19_00/2016_03_31_19_00.mpg;Shinzo ABE.jpg;10041;10261;36085;502;513;11
/net/per610a/home/mvp/mvp_db/news7-lv/2016/2016_03_31_19_00/2016_03_31_19_00.mpg;Shinzo ABE.jpg;13241;13625;36085;662;681;19
/net/per610a/home/mvp/mvp_db/news7-lv/2016/2016_04_01_19_00/2016_04_01_19_00.mpg;Shinzo ABE.jpg;2209;2857;36085;110;142;32
/net/per610a/home/mvp/mvp_db/news7-lv/2016/2016_04_01_19_00/2016_04_01_19_00.mpg;Shinzo ABE.jpg;5421;5721;36085;271;286;15
/net/per610a/home/mvp/mvp_db/news7-lv/2016/2016_04_02_19_00/2016_04_02_19_00.mpg;Shinzo ABE.jpg;13493;13569;36081;675;678;3
/net/per610a/home/mvp/mvp_db/news7-lv/2016/2016_04_02_19_00/2016_04_02_19_00.mpg;Shinzo ABE.jpg;13673;13901;36081;684;695;11
/net/per610a/home/mvp/mvp_db/news7-lv/2016/2016_04_04_19_00/2016_04_04_19_00.mpg;Shinzo ABE.jpg;30989;31269;36089;1550;1564;14
/net/per610a/home/mvp/mvp_db/news7-lv/2016/2016_04_04_19_00/2016_04_04_19_00.mpg;Shinzo ABE.jpg;31345;31521;36089;1568;1577;9
/net/per610a/home/mvp/mvp_db/news7-lv/2016/2016_04_05_19_00/2016_04_05_19_00.mpg;Shinzo ABE.jpg;6885;7333;36081;344;366;22
/net/per610a/home/mvp/mvp_db/news7-lv/2016/2016_04_05_19_00/2016_04_05_19_00.mpg;Shinzo ABE.jpg;8601;9217;36081;430;461;31
/net/per610a/home/mvp/mvp_db/news7-lv/2016/2016_04_06_19_00/2016_04_06_19_00.mpg;Sadakazu TANIGAKI.jpg;27321;27537;36085;1367;1378;11
/net/per610a/home/mvp/mvp_db/news7-lv/2016/2016_04_06_19_00/2016_04_06_19_00.mpg;Yukio EDANO.jpg;27585;27849;36085;1380;1393;13
/net/per610a/home/mvp/mvp_db/news7-lv/2016/2016_04_07_19_00/2016_04_07_19_00.mpg;Yukio EDANO.jpg;23525;23817;36085;1177;1192;15
/net/per610a/home/mvp/mvp_db/news7-lv/2016/2016_04_07_19_00/2016_04_07_19_00.mpg;Shinzo ABE.jpg;27861;28113;36085;1394;1407;13
/net/per610a/home/mvp/mvp_db/news7-lv/2016/2016_04_07_19_00/2016_04_07_19_00.mpg;Shinzo ABE.jpg;28213;28261;36085;1412;1414;2
/net/per610a/home/mvp/mvp_db/news7-lv/2016/2016_04_11_19_00/2016_04_11_19_00.mpg;Shinzo ABE.jpg;12161;12509;36085;608;626;18
/net/per610a/home/mvp/mvp_db/news7-lv/2016/2016_04_11_19_00/2016_04_11_19_00.mpg;Shinzo ABE.jpg;26101;26129;36085;1306;1307;1
/net/per610a/home/mvp/mvp_db/news7-lv/2016/2016_04_11_19_00/2016_04_11_19_00.mpg;Shinzo ABE.jpg;26345;26425;36085;1318;1322;4
/net/per610a/home/mvp/mvp_db/news7-lv/2016/2016_04_12_19_00/2016_04_12_19_00.mpg;Taro ASO.jpg;10853;11357;36081;542;568;26
/net/per610a/home/mvp/mvp_db/news7-lv/2016/2016_04_15_19_00/2016_04_15_19_00.mpg;Shinzo ABE.jpg;24541;24705;72049;1228;1236;8
/net/per610a/home/mvp/mvp_db/news7-lv/2016/2016_04_15_19_00/2016_04_15_19_00.mpg;Shinzo ABE.jpg;63937;64149;72049;3200;3210;10
/net/per610a/home/mvp/mvp_db/news7-lv/2016/2016_04_16_19_00/2016_04_16_19_00.mpg;Taro ASO.jpg;61929;61965;72053;3099;3101;2
/net/per610a/home/mvp/mvp_db/news7-lv/2016/2016_04_16_19_00/2016_04_16_19_00.mpg;Taro ASO.jpg;63317;63345;72053;3168;3170;2
/net/per610a/home/mvp/mvp_db/news7-lv/2016/2016_04_16_19_00/2016_04_16_19_00.mpg;Taro ASO.jpg;63577;63909;72053;3181;3198;17
/net/per610a/home/mvp/mvp_db/news7-lv/2016/2016_04_17_19_00/2016_04_17_19_00.mpg;Shinzo ABE.jpg;27969;28585;72049;1399;1430;31
/net/per610a/home/mvp/mvp_db/news7-lv/2016/2016_04_17_19_00/2016_04_17_19_00.mpg;Shinzo ABE.jpg;29077;29369;72049;1455;1469;14
/net/per610a/home/mvp/mvp_db/news7-lv/2016/2016_04_25_19_00/2016_04_25_19_00.mpg;Shinzo ABE.jpg;8117;8545;36081;406;427;21
/net/per610a/home/mvp/mvp_db/news7-lv/2016/2016_04_25_19_00/2016_04_25_19_00.mpg;Shinzo ABE.jpg;23585;23681;36081;1179;1184;5
/net/per610a/home/mvp/mvp_db/news7-lv/2016/2016_04_25_19_00/2016_04_25_19_00.mpg;Shinzo ABE.jpg;26117;26265;36081;1306;1313;7
/net/per610a/home/mvp/mvp_db/news7-lv/2016/2016_04_25_19_00/2016_04_25_19_00.mpg;Shinzo ABE.jpg;26373;26413;36081;1319;1321;2
/net/per610a/home/mvp/mvp_db/news7-lv/2016/2016_04_25_19_00/2016_04_25_19_00.mpg;Sadakazu TANIGAKI.jpg;23777;24477;36081;1189;1224;35
/net/per610a/home/mvp/mvp_db/news7-lv/2016/2016_04_26_19_00/2016_04_26_19_00.mpg;Shinzo ABE.jpg;26837;26889;36081;1342;1345;3
/net/per610a/home/mvp/mvp_db/news7-lv/2016/2016_04_26_19_00/2016_04_26_19_00.mpg;Shinzo ABE.jpg;27113;27153;36081;1356;1358;2
/net/per610a/home/mvp/mvp_db/news7-lv/2016/2016_04_26_19_00/2016_04_26_19_00.mpg;Shinzo ABE.jpg;27321;27449;36081;1366;1373;7
/net/per610a/home/mvp/mvp_db/news7-lv/2016/2016_04_26_19_00/2016_04_26_19_00.mpg;Kazuo SHII.jpg;27317;27317;36081;1366;1366;0
/net/per610a/home/mvp/mvp_db/news7-lv/2016/2016_04_26_19_00/2016_04_26_19_00.mpg;Kazuo SHII.jpg;27385;27449;36081;1369;1373;4
/net/per610a/home/mvp/mvp_db/news7-lv/2016/2016_04_26_19_00/2016_04_26_19_00.mpg;Kazuo SHII.jpg;27993;28209;36081;1400;1411;11
/net/per610a/home/mvp/mvp_db/news7-lv/2016/2016_04_18_19_00/2016_04_18_19_00.mpg;Shinzo ABE.jpg;33317;33377;38485;1667;1670;3
/net/per610a/home/mvp/mvp_db/news7-lv/2016/2016_04_18_19_00/2016_04_18_19_00.mpg;Shinzo ABE.jpg;33669;33785;38485;1684;1690;6
/net/per610a/home/mvp/mvp_db/news7-lv/2016/2016_04_18_19_00/2016_04_18_19_00.mpg;Shinzo ABE.jpg;33985;34137;38485;1700;1708;8
/net/per610a/home/mvp/mvp_db/news7-lv/2016/2016_04_18_19_00/2016_04_18_19_00.mpg;Shinzo ABE.jpg;34345;34541;38485;1718;1728;10
/net/per610a/home/mvp/mvp_db/news7-lv/2016/2016_04_29_19_00/2016_04_29_19_00.mpg;Shinzo ABE.jpg;9717;10253;36085;486;513;27
/net/per610a/home/mvp/mvp_db/news7-lv/2016/2016_04_30_19_00/2016_04_30_19_00.mpg;Shinzo ABE.jpg;25153;25337;36085;1258;1268;10
/net/per610a/home/mvp/mvp_db/news7-lv/2016/2016_04_30_19_00/2016_04_30_19_00.mpg;Shinzo ABE.jpg;25545;25705;36085;1278;1286;8
/net/per610a/home/mvp/mvp_db/news7-lv/2016/2016_04_30_19_00/2016_04_30_19_00.mpg;Shinzo ABE.jpg;29177;29673;36085;1460;1485;25
/net/per610a/home/mvp/mvp_db/news7-lv/2016/2016_05_01_19_00/2016_05_01_19_00.mpg;Yukio HATOYAMA.jpg;26721;26981;36089;1337;1350;13
/net/per610a/home/mvp/mvp_db/news7-lv/2016/2016_05_02_19_00/2016_05_02_19_00.mpg;Shinzo ABE.jpg;29005;29805;36081;1451;1491;40
/net/per610a/home/mvp/mvp_db/news7-lv/2016/2016_05_03_19_00/2016_05_03_19_00.mpg;Shinzo ABE.jpg;18097;18717;36085;905;936;31
/net/per610a/home/mvp/mvp_db/news7-lv/2016/2016_05_03_19_00/2016_05_03_19_00.mpg;Shinzo ABE.jpg;30849;31385;36085;1543;1570;27
/net/per610a/home/mvp/mvp_db/news7-lv/2016/2016_05_09_19_00/2016_05_09_19_00.mpg;Shinzo ABE.jpg;14733;14969;36089;737;749;12
/net/per610a/home/mvp/mvp_db/news7-lv/2016/2016_11_13_19_00/2016_11_13_19_00.mpg;Yukiko Kada.jpg;177;221;36085;8;11;3
/net/per610a/home/mvp/mvp_db/news7-lv/2016/2016_11_13_19_00/2016_11_13_19_00.mpg;Yukiko Kada.jpg;321;533;36085;16;26;10
/net/per610a/home/mvp/mvp_db/news7-lv/2016/2016_11_13_19_00/2016_11_13_19_00.mpg;Yukiko Kada.jpg;1633;1793;36085;81;89;8
/net/per610a/home/mvp/mvp_db/news7-lv/2016/2016_11_13_19_00/2016_11_13_19_00.mpg;Yukiko Kada.jpg;3073;3165;36085;153;158;5
/net/per610a/home/mvp/mvp_db/news7-lv/2016/2016_11_13_19_00/2016_11_13_19_00.mpg;Yukiko Kada.jpg;6029;6365;36085;301;318;17
/net/per610a/home/mvp/mvp_db/news7-lv/2016/2016_05_16_19_00/2016_05_16_19_00.mpg;Shinzo ABE.jpg;9193;9293;36085;460;465;5
/net/per610a/home/mvp/mvp_db/news7-lv/2016/2016_05_16_19_00/2016_05_16_19_00.mpg;Shinzo ABE.jpg;9449;9481;36085;472;474;2
/net/per610a/home/mvp/mvp_db/news7-lv/2016/2016_05_17_19_00/2016_05_17_19_00.mpg;Shinzo ABE.jpg;16877;16877;36085;844;844;0
/net/per610a/home/mvp/mvp_db/news7-lv/2016/2016_05_17_19_00/2016_05_17_19_00.mpg;Shinzo ABE.jpg;17125;17457;36085;857;873;16
/net/per610a/home/mvp/mvp_db/news7-lv/2016/2016_05_17_19_00/2016_05_17_19_00.mpg;Shinzo ABE.jpg;17953;17961;36085;898;898;0
/net/per610a/home/mvp/mvp_db/news7-lv/2016/2016_05_17_19_00/2016_05_17_19_00.mpg;Shinzo ABE.jpg;18349;18833;36085;918;942;24
/net/per610a/home/mvp/mvp_db/news7-lv/2016/2016_05_18_19_00/2016_05_18_19_00.mpg;Shinzo ABE.jpg;10453;10973;36085;523;549;26
/net/per610a/home/mvp/mvp_db/news7-lv/2016/2016_05_18_19_00/2016_05_18_19_00.mpg;Shinzo ABE.jpg;11849;11925;36085;593;596;3
/net/per610a/home/mvp/mvp_db/news7-lv/2016/2016_05_18_19_00/2016_05_18_19_00.mpg;Shinzo ABE.jpg;11997;12233;36085;600;612;12
/net/per610a/home/mvp/mvp_db/news7-lv/2016/2016_05_18_19_00/2016_05_18_19_00.mpg;Shinzo ABE.jpg;13213;13333;36085;661;667;6
/net/per610a/home/mvp/mvp_db/news7-lv/2016/2016_05_19_19_00/2016_05_19_19_00.mpg;Shinzo ABE.jpg;21465;21469;36093;1074;1074;0
/net/per610a/home/mvp/mvp_db/news7-lv/2016/2016_05_19_19_00/2016_05_19_19_00.mpg;Shinzo ABE.jpg;22577;22721;36093;1129;1136;7
/net/per610a/home/mvp/mvp_db/news7-lv/2016/2016_05_20_19_00/2016_05_20_19_00.mpg;Shinzo ABE.jpg;8441;8737;36085;422;437;15
/net/per610a/home/mvp/mvp_db/news7-lv/2016/2016_05_21_19_00/2016_05_21_19_00.mpg;Taro ASO.jpg;7249;7469;36073;362;373;11
/net/per610a/home/mvp/mvp_db/news7-lv/2016/2016_05_21_19_00/2016_05_21_19_00.mpg;Taro ASO.jpg;7581;7721;36073;379;386;7
/net/per610a/home/mvp/mvp_db/news7-lv/2016/2016_05_21_19_00/2016_05_21_19_00.mpg;Taro ASO.jpg;9789;10021;36073;489;501;12
/net/per610a/home/mvp/mvp_db/news7-lv/2016/2016_05_21_19_00/2016_05_21_19_00.mpg;Taro ASO.jpg;11357;11509;36073;568;575;7
/net/per610a/home/mvp/mvp_db/news7-lv/2016/2016_05_23_19_00/2016_05_23_19_00.mpg;Shinzo ABE.jpg;1793;1813;36085;89;90;1
/net/per610a/home/mvp/mvp_db/news7-lv/2016/2016_05_23_19_00/2016_05_23_19_00.mpg;Shinzo ABE.jpg;4333;4777;36085;216;239;23
/net/per610a/home/mvp/mvp_db/news7-lv/2016/2016_05_23_19_00/2016_05_23_19_00.mpg;Shinzo ABE.jpg;6069;6077;36085;303;304;1
/net/per610a/home/mvp/mvp_db/news7-lv/2016/2016_05_23_19_00/2016_05_23_19_00.mpg;Renho.jpg;29977;30713;36085;1500;1537;37
/net/per610a/home/mvp/mvp_db/news7-lv/2016/2016_05_24_19_00/2016_05_24_19_00.mpg;Shinzo ABE.jpg;2369;2857;36077;118;142;24
/net/per610a/home/mvp/mvp_db/news7-lv/2016/2016_05_24_19_00/2016_05_24_19_00.mpg;Shinzo ABE.jpg;3577;3597;36077;178;179;1
/net/per610a/home/mvp/mvp_db/news7-lv/2016/2016_05_24_19_00/2016_05_24_19_00.mpg;Shinzo ABE.jpg;7445;8337;36077;372;417;45
/net/per610a/home/mvp/mvp_db/news7-lv/2016/2016_05_24_19_00/2016_05_24_19_00.mpg;Sadakazu TANIGAKI.jpg;7445;8033;36077;372;401;29
/net/per610a/home/mvp/mvp_db/news7-lv/2016/2016_05_25_19_00/2016_05_25_19_00.mpg;Shinzo ABE.jpg;6281;6633;36085;314;331;17
/net/per610a/home/mvp/mvp_db/news7-lv/2016/2016_05_25_19_00/2016_05_25_19_00.mpg;Shinzo ABE.jpg;7645;7817;36085;382;391;9
/net/per610a/home/mvp/mvp_db/news7-lv/2016/2016_05_25_19_00/2016_05_25_19_00.mpg;Shinzo ABE.jpg;8365;8981;36085;418;449;31
/net/per610a/home/mvp/mvp_db/news7-lv/2016/2016_05_25_19_00/2016_05_25_19_00.mpg;Shinzo ABE.jpg;10537;10857;36085;527;543;16
/net/per610a/home/mvp/mvp_db/news7-lv/2016/2016_05_25_19_00/2016_05_25_19_00.mpg;Sadakazu TANIGAKI.jpg;12305;12645;36085;615;632;17
/net/per610a/home/mvp/mvp_db/news7-lv/2016/2016_05_25_19_00/2016_05_25_19_00.mpg;Sadakazu TANIGAKI.jpg;24425;24609;36085;1222;1231;9
/net/per610a/home/mvp/mvp_db/news7-lv/2016/2016_05_25_19_00/2016_05_25_19_00.mpg;Kazuo SHII.jpg;26133;26197;36085;1307;1311;4
/net/per610a/home/mvp/mvp_db/news7-lv/2016/2016_05_25_19_00/2016_05_25_19_00.mpg;Kazuo SHII.jpg;26501;26749;36085;1326;1338;12
/net/per610a/home/mvp/mvp_db/news7-lv/2016/2016_05_25_19_00/2016_05_25_19_00.mpg;Ichiro OZAWA.jpg;26229;26257;36085;1312;1314;2
/net/per610a/home/mvp/mvp_db/news7-lv/2016/2016_05_25_19_00/2016_05_25_19_00.mpg;Ichiro OZAWA.jpg;26757;27029;36085;1339;1352;13
/net/per610a/home/mvp/mvp_db/news7-lv/2016/2016_05_26_19_00/2016_05_26_19_00.mpg;Shinzo ABE.jpg;3173;3173;36085;158;158;0
/net/per610a/home/mvp/mvp_db/news7-lv/2016/2016_05_26_19_00/2016_05_26_19_00.mpg;Shinzo ABE.jpg;4021;4273;36085;201;213;12
/net/per610a/home/mvp/mvp_db/news7-lv/2016/2016_05_26_19_00/2016_05_26_19_00.mpg;Shinzo ABE.jpg;4693;5381;36085;234;269;35
/net/per610a/home/mvp/mvp_db/news7-lv/2016/2016_05_26_19_00/2016_05_26_19_00.mpg;Shinzo ABE.jpg;7093;7761;36085;354;388;34
/net/per610a/home/mvp/mvp_db/news7-lv/2016/2016_05_26_19_00/2016_05_26_19_00.mpg;Shinzo ABE.jpg;8085;8149;36085;404;407;3
/net/per610a/home/mvp/mvp_db/news7-lv/2016/2016_05_26_19_00/2016_05_26_19_00.mpg;Shinzo ABE.jpg;11829;11881;36085;592;594;2
/net/per610a/home/mvp/mvp_db/news7-lv/2016/2016_05_26_19_00/2016_05_26_19_00.mpg;Shinzo ABE.jpg;11953;11969;36085;598;599;1
/net/per610a/home/mvp/mvp_db/news7-lv/2016/2016_05_27_19_00/2016_05_27_19_00.mpg;Shinzo ABE.jpg;8433;8493;72049;422;425;3
/net/per610a/home/mvp/mvp_db/news7-lv/2016/2016_05_27_19_00/2016_05_27_19_00.mpg;Shinzo ABE.jpg;15225;15401;72049;762;770;8
/net/per610a/home/mvp/mvp_db/news7-lv/2016/2016_05_27_19_00/2016_05_27_19_00.mpg;Shinzo ABE.jpg;15649;15661;72049;783;783;0
/net/per610a/home/mvp/mvp_db/news7-lv/2016/2016_05_27_19_00/2016_05_27_19_00.mpg;Shinzo ABE.jpg;16117;16237;72049;806;812;6
/net/per610a/home/mvp/mvp_db/news7-lv/2016/2016_05_27_19_00/2016_05_27_19_00.mpg;Shinzo ABE.jpg;31401;31753;72049;1571;1589;18
/net/per610a/home/mvp/mvp_db/news7-lv/2016/2016_05_27_19_00/2016_05_27_19_00.mpg;Shinzo ABE.jpg;35969;36185;72049;1800;1811;11
/net/per610a/home/mvp/mvp_db/news7-lv/2016/2016_05_27_19_00/2016_05_27_19_00.mpg;Shinzo ABE.jpg;39509;39605;72049;1977;1982;5
/net/per610a/home/mvp/mvp_db/news7-lv/2016/2016_05_27_19_00/2016_05_27_19_00.mpg;Shinzo ABE.jpg;42717;43805;72049;2137;2192;55
/net/per610a/home/mvp/mvp_db/news7-lv/2016/2016_05_27_19_00/2016_05_27_19_00.mpg;Shinzo ABE.jpg;43893;44533;72049;2196;2228;32
/net/per610a/home/mvp/mvp_db/news7-lv/2016/2016_05_27_19_00/2016_05_27_19_00.mpg;Shinzo ABE.jpg;44621;44881;72049;2233;2246;13
/net/per610a/home/mvp/mvp_db/news7-lv/2016/2016_05_27_19_00/2016_05_27_19_00.mpg;Shinzo ABE.jpg;48397;48469;72049;2422;2425;3
/net/per610a/home/mvp/mvp_db/news7-lv/2016/2016_05_27_19_00/2016_05_27_19_00.mpg;Shinzo ABE.jpg;49921;50549;72049;2498;2529;31
/net/per610a/home/mvp/mvp_db/news7-lv/2016/2016_05_27_19_00/2016_05_27_19_00.mpg;Shinzo ABE.jpg;52305;52473;72049;2617;2626;9
/net/per610a/home/mvp/mvp_db/news7-lv/2016/2016_05_27_19_00/2016_05_27_19_00.mpg;Shinzo ABE.jpg;54465;54897;72049;2725;2747;22
/net/per610a/home/mvp/mvp_db/news7-lv/2016/2016_05_27_19_00/2016_05_27_19_00.mpg;Shinzo ABE.jpg;55241;55293;72049;2764;2767;3
/net/per610a/home/mvp/mvp_db/news7-lv/2016/2016_05_28_19_00/2016_05_28_19_00.mpg;Katsuya OKADA.jpg;14709;15721;36077;735;786;51
/net/per610a/home/mvp/mvp_db/news7-lv/2016/2016_05_29_19_00/2016_05_29_19_00.mpg;Taro ASO.jpg;7669;7701;36085;383;385;2
/net/per610a/home/mvp/mvp_db/news7-lv/2016/2016_05_29_19_00/2016_05_29_19_00.mpg;Taro ASO.jpg;7785;8637;36085;389;432;43
/net/per610a/home/mvp/mvp_db/news7-lv/2016/2016_05_29_19_00/2016_05_29_19_00.mpg;Shinzo ABE.jpg;9717;10077;36085;486;504;18
/net/per610a/home/mvp/mvp_db/news7-lv/2016/2016_05_29_19_00/2016_05_29_19_00.mpg;Shinzo ABE.jpg;12945;13209;36085;647;661;14
/net/per610a/home/mvp/mvp_db/news7-lv/2016/2016_05_29_19_00/2016_05_29_19_00.mpg;Kazuo SHII.jpg;12145;12585;36085;607;629;22
/net/per610a/home/mvp/mvp_db/news7-lv/2016/2016_08_26_19_00/2016_08_26_19_00.mpg;Kenji Eda.jpg;25889;25969;36085;1295;1299;4
/net/per610a/home/mvp/mvp_db/news7-lv/2016/2016_08_26_19_00/2016_08_26_19_00.mpg;Kenji Eda.jpg;26309;26369;36085;1316;1319;3
/net/per610a/home/mvp/mvp_db/news7-lv/2016/2016_05_30_19_00/2016_05_30_19_00.mpg;Shinzo ABE.jpg;105;193;36085;5;9;4
/net/per610a/home/mvp/mvp_db/news7-lv/2016/2016_05_30_19_00/2016_05_30_19_00.mpg;Shinzo ABE.jpg;2193;2221;36085;109;111;2
/net/per610a/home/mvp/mvp_db/news7-lv/2016/2016_05_30_19_00/2016_05_30_19_00.mpg;Shinzo ABE.jpg;11941;12109;36085;597;606;9
/net/per610a/home/mvp/mvp_db/news7-lv/2016/2016_05_30_19_00/2016_05_30_19_00.mpg;Shinzo ABE.jpg;1801;2101;36085;90;105;15
/net/per610a/home/mvp/mvp_db/news7-lv/2016/2016_05_30_19_00/2016_05_30_19_00.mpg;Shinzo ABE.jpg;3169;3245;36085;158;162;4
/net/per610a/home/mvp/mvp_db/news7-lv/2016/2016_05_30_19_00/2016_05_30_19_00.mpg;Shinzo ABE.jpg;3397;3625;36085;170;181;11
/net/per610a/home/mvp/mvp_db/news7-lv/2016/2016_05_30_19_00/2016_05_30_19_00.mpg;Shinzo ABE.jpg;4653;4801;36085;232;240;8
/net/per610a/home/mvp/mvp_db/news7-lv/2016/2016_05_30_19_00/2016_05_30_19_00.mpg;Shinzo ABE.jpg;5777;6105;36085;289;305;16
/net/per610a/home/mvp/mvp_db/news7-lv/2016/2016_05_30_19_00/2016_05_30_19_00.mpg;Shinzo ABE.jpg;6265;6617;36085;313;331;18
/net/per610a/home/mvp/mvp_db/news7-lv/2016/2016_05_30_19_00/2016_05_30_19_00.mpg;Shinzo ABE.jpg;10317;10421;36085;516;521;5
/net/per610a/home/mvp/mvp_db/news7-lv/2016/2016_05_30_19_00/2016_05_30_19_00.mpg;Sadakazu TANIGAKI.jpg;5153;5485;36085;257;274;17
/net/per610a/home/mvp/mvp_db/news7-lv/2016/2016_05_30_19_00/2016_05_30_19_00.mpg;Taro ASO.jpg;5777;6105;36085;289;305;16
/net/per610a/home/mvp/mvp_db/news7-lv/2016/2016_05_31_19_00/2016_05_31_19_00.mpg;Shinzo ABE.jpg;1317;1381;36085;65;69;4
/net/per610a/home/mvp/mvp_db/news7-lv/2016/2016_05_31_19_00/2016_05_31_19_00.mpg;Shinzo ABE.jpg;2305;2545;36085;115;127;12
/net/per610a/home/mvp/mvp_db/news7-lv/2016/2016_05_31_19_00/2016_05_31_19_00.mpg;Taro ASO.jpg;1649;1989;36085;82;99;17
/net/per610a/home/mvp/mvp_db/news7-lv/2016/2016_05_31_19_00/2016_05_31_19_00.mpg;Taro ASO.jpg;2305;2545;36085;115;127;12
/net/per610a/home/mvp/mvp_db/news7-lv/2016/2016_05_31_19_00/2016_05_31_19_00.mpg;Sadakazu TANIGAKI.jpg;2917;2989;36085;145;149;4
/net/per610a/home/mvp/mvp_db/news7-lv/2016/2016_05_31_19_00/2016_05_31_19_00.mpg;Sadakazu TANIGAKI.jpg;3089;3421;36085;154;171;17
/net/per610a/home/mvp/mvp_db/news7-lv/2016/2016_05_31_19_00/2016_05_31_19_00.mpg;Natsuo YAMAGUCHI.jpg;3885;4049;36085;194;202;8
/net/per610a/home/mvp/mvp_db/news7-lv/2016/2016_05_31_19_00/2016_05_31_19_00.mpg;Natsuo YAMAGUCHI.jpg;4405;4669;36085;220;233;13
/net/per610a/home/mvp/mvp_db/news7-lv/2016/2016_06_01_19_00/2016_06_01_19_00.mpg;Shinzo ABE.jpg;13989;14085;36089;700;704;4
/net/per610a/home/mvp/mvp_db/news7-lv/2016/2016_06_01_19_00/2016_06_01_19_00.mpg;Shinzo ABE.jpg;14165;14269;36089;708;714;6
/net/per610a/home/mvp/mvp_db/news7-lv/2016/2016_06_01_19_00/2016_06_01_19_00.mpg;Shinzo ABE.jpg;14373;14797;36089;719;740;21
/net/per610a/home/mvp/mvp_db/news7-lv/2016/2016_06_02_19_00/2016_06_02_19_00.mpg;Shinzo ABE.jpg;157;237;36081;7;11;4
/net/per610a/home/mvp/mvp_db/news7-lv/2016/2016_06_02_19_00/2016_06_02_19_00.mpg;Shinzo ABE.jpg;2069;2605;36081;103;130;27
/net/per610a/home/mvp/mvp_db/news7-lv/2016/2016_06_02_19_00/2016_06_02_19_00.mpg;Shinzo ABE.jpg;8281;8589;36081;414;429;15
/net/per610a/home/mvp/mvp_db/news7-lv/2016/2016_06_02_19_00/2016_06_02_19_00.mpg;Shinzo ABE.jpg;8693;8825;36081;434;441;7
/net/per610a/home/mvp/mvp_db/news7-lv/2016/2016_06_02_19_00/2016_06_02_19_00.mpg;Shinzo ABE.jpg;8917;9029;36081;446;451;5
/net/per610a/home/mvp/mvp_db/news7-lv/2016/2016_06_02_19_00/2016_06_02_19_00.mpg;Natsuo YAMAGUCHI.jpg;3277;4069;36081;163;203;40
/net/per610a/home/mvp/mvp_db/news7-lv/2016/2016_06_02_19_00/2016_06_02_19_00.mpg;Katsuya OKADA.jpg;4181;4313;36081;209;215;6
/net/per610a/home/mvp/mvp_db/news7-lv/2016/2016_06_02_19_00/2016_06_02_19_00.mpg;Katsuya OKADA.jpg;4505;5021;36081;225;251;26
/net/per610a/home/mvp/mvp_db/news7-lv/2016/2016_06_03_19_00/2016_06_03_19_00.mpg;Shinzo ABE.jpg;21437;21881;36085;1072;1095;23
/net/per610a/home/mvp/mvp_db/news7-lv/2016/2016_06_03_19_00/2016_06_03_19_00.mpg;Shinzo ABE.jpg;22789;22817;36085;1140;1141;1
/net/per610a/home/mvp/mvp_db/news7-lv/2016/2016_06_03_19_00/2016_06_03_19_00.mpg;Shinzo ABE.jpg;22937;23581;36085;1147;1180;33
/net/per610a/home/mvp/mvp_db/news7-lv/2016/2016_06_03_19_00/2016_06_03_19_00.mpg;Shinzo ABE.jpg;24905;25121;36085;1246;1257;11
/net/per610a/home/mvp/mvp_db/news7-lv/2016/2016_06_03_19_00/2016_06_03_19_00.mpg;Shinzo ABE.jpg;26097;26113;36085;1306;1306;0
/net/per610a/home/mvp/mvp_db/news7-lv/2016/2016_06_03_19_00/2016_06_03_19_00.mpg;Shinzo ABE.jpg;26233;26505;36085;1312;1326;14
/net/per610a/home/mvp/mvp_db/news7-lv/2016/2016_06_03_19_00/2016_06_03_19_00.mpg;Shinzo ABE.jpg;27097;27257;36085;1356;1364;8
/net/per610a/home/mvp/mvp_db/news7-lv/2016/2016_06_04_19_00/2016_06_04_19_00.mpg;Shinzo ABE.jpg;22401;22833;36085;1121;1142;21
/net/per610a/home/mvp/mvp_db/news7-lv/2016/2016_06_05_19_00/2016_06_05_19_00.mpg;Sadakazu TANIGAKI.jpg;23633;24561;36085;1182;1229;47
/net/per610a/home/mvp/mvp_db/news7-lv/2016/2016_06_05_19_00/2016_06_05_19_00.mpg;Natsuo YAMAGUCHI.jpg;24565;24645;36085;1229;1233;4
/net/per610a/home/mvp/mvp_db/news7-lv/2016/2016_06_06_19_00/2016_06_06_19_00.mpg;Yukiko Kada.jpg;9889;10265;36085;494;513;19
/net/per610a/home/mvp/mvp_db/news7-lv/2016/2016_06_08_19_00/2016_06_08_19_00.mpg;Shinzo ABE.jpg;24537;24769;36085;1228;1239;11
/net/per610a/home/mvp/mvp_db/news7-lv/2016/2016_06_08_19_00/2016_06_08_19_00.mpg;Shinzo ABE.jpg;25057;26129;36085;1254;1307;53
/net/per610a/home/mvp/mvp_db/news7-lv/2016/2016_06_08_19_00/2016_06_08_19_00.mpg;Masashi Nakano.jpg;27557;27861;36085;1379;1394;15
/net/per610a/home/mvp/mvp_db/news7-lv/2016/2016_06_09_19_00/2016_06_09_19_00.mpg;Shinzo ABE.jpg;8541;8717;36085;427;436;9
/net/per610a/home/mvp/mvp_db/news7-lv/2016/2016_06_09_19_00/2016_06_09_19_00.mpg;Shinzo ABE.jpg;19793;19841;36085;990;993;3
/net/per610a/home/mvp/mvp_db/news7-lv/2016/2016_06_09_19_00/2016_06_09_19_00.mpg;Natsuo YAMAGUCHI.jpg;24489;25885;36085;1225;1295;70
/net/per610a/home/mvp/mvp_db/news7-lv/2016/2016_06_09_19_00/2016_06_09_19_00.mpg;Kazuo SHII.jpg;27061;28177;36085;1354;1410;56
/net/per610a/home/mvp/mvp_db/news7-lv/2016/2016_06_10_19_00/2016_06_10_19_00.mpg;Takeo Hiranuma.jpeg;11429;11457;36085;572;573;1
/net/per610a/home/mvp/mvp_db/news7-lv/2016/2016_06_10_19_00/2016_06_10_19_00.mpg;Takeo Hiranuma.jpeg;11581;11873;36085;579;594;15
/net/per610a/home/mvp/mvp_db/news7-lv/2016/2016_06_10_19_00/2016_06_10_19_00.mpg;Takeo Hiranuma.jpeg;12197;12477;36085;610;624;14
/net/per610a/home/mvp/mvp_db/news7-lv/2016/2016_06_10_19_00/2016_06_10_19_00.mpg;Takeo Hiranuma.jpeg;13189;13405;36085;660;670;10
/net/per610a/home/mvp/mvp_db/news7-lv/2016/2016_06_10_19_00/2016_06_10_19_00.mpg;Takeo Hiranuma.jpeg;15573;16021;36085;779;801;22
/net/per610a/home/mvp/mvp_db/news7-lv/2016/2016_06_12_19_00/2016_06_12_19_00.mpg;Kazuo SHII.jpg;13397;13825;36085;670;691;21
/net/per610a/home/mvp/mvp_db/news7-lv/2016/2016_06_13_19_00/2016_06_13_19_00.mpg;Shinzo ABE.jpg;18129;18469;36089;907;924;17
/net/per610a/home/mvp/mvp_db/news7-lv/2016/2016_06_13_19_00/2016_06_13_19_00.mpg;Shinzo ABE.jpg;21297;21953;36089;1065;1098;33
/net/per610a/home/mvp/mvp_db/news7-lv/2016/2016_06_14_19_00/2016_06_14_19_00.mpg;Natsuo YAMAGUCHI.jpg;3345;3873;36081;167;193;26
/net/per610a/home/mvp/mvp_db/news7-lv/2016/2016_06_15_19_00/2016_06_15_19_00.mpg;Sadakazu TANIGAKI.jpg;17473;19001;38481;874;951;77
/net/per610a/home/mvp/mvp_db/news7-lv/2016/2016_06_17_19_00/2016_06_17_19_00.mpg;Sadakazu TANIGAKI.jpg;17509;17753;36085;876;888;12
/net/per610a/home/mvp/mvp_db/news7-lv/2016/2016_06_17_19_00/2016_06_17_19_00.mpg;Yukio EDANO.jpg;19005;19633;36085;951;982;31
/net/per610a/home/mvp/mvp_db/news7-lv/2016/2016_06_17_19_00/2016_06_17_19_00.mpg;Ichiro OZAWA.jpg;22429;23185;36085;1122;1160;38
/net/per610a/home/mvp/mvp_db/news7-lv/2016/2016_06_17_19_00/2016_06_17_19_00.mpg;Naoto KAN.jpg;28089;28661;36085;1405;1434;29
/net/per610a/home/mvp/mvp_db/news7-lv/2016/2016_06_18_19_00/2016_06_18_19_00.mpg;Renho.jpg;21101;21453;36085;1056;1073;17
/net/per610a/home/mvp/mvp_db/news7-lv/2016/2016_06_18_19_00/2016_06_18_19_00.mpg;Renho.jpg;21993;22189;36085;1100;1110;10
/net/per610a/home/mvp/mvp_db/news7-lv/2016/2016_06_18_19_00/2016_06_18_19_00.mpg;Yukio EDANO.jpg;21993;22189;36085;1100;1110;10
/net/per610a/home/mvp/mvp_db/news7-lv/2016/2016_06_18_19_00/2016_06_18_19_00.mpg;Yukio EDANO.jpg;22977;23833;36085;1149;1192;43
/net/per610a/home/mvp/mvp_db/news7-lv/2016/2016_06_19_19_00/2016_06_19_19_00.mpg;Shinzo ABE.jpg;23185;23585;36073;1160;1180;20
/net/per610a/home/mvp/mvp_db/news7-lv/2016/2016_06_19_19_00/2016_06_19_19_00.mpg;Natsuo YAMAGUCHI.jpg;23985;24673;36073;1200;1234;34
/net/per610a/home/mvp/mvp_db/news7-lv/2016/2016_06_20_19_00/2016_06_20_19_00.mpg;Kazuo SHII.jpg;17605;17781;36085;881;889;8
/net/per610a/home/mvp/mvp_db/news7-lv/2016/2016_06_20_19_00/2016_06_20_19_00.mpg;Sadakazu TANIGAKI.jpg;19673;21553;36085;984;1078;94
/net/per610a/home/mvp/mvp_db/news7-lv/2016/2016_06_21_19_00/2016_06_21_19_00.mpg;Shinzo ABE.jpg;19365;21785;36081;969;1090;121
/net/per610a/home/mvp/mvp_db/news7-lv/2016/2016_06_21_19_00/2016_06_21_19_00.mpg;Shinzo ABE.jpg;23165;24737;36081;1159;1238;79
/net/per610a/home/mvp/mvp_db/news7-lv/2016/2016_06_21_19_00/2016_06_21_19_00.mpg;Toranosuke Katayama.jpg;21793;23161;36081;1090;1159;69
/net/per610a/home/mvp/mvp_db/news7-lv/2016/2016_06_22_19_00/2016_06_22_19_00.mpg;Shinzo ABE.jpg;901;2177;125993;45;108;63
/net/per610a/home/mvp/mvp_db/news7-lv/2016/2016_06_22_19_00/2016_06_22_19_00.mpg;Shinzo ABE.jpg;23649;49773;125993;1183;2490;1307
/net/per610a/home/mvp/mvp_db/news7-lv/2016/2016_06_22_19_00/2016_06_22_19_00.mpg;Natsuo YAMAGUCHI.jpg;3265;4113;125993;163;205;42
/net/per610a/home/mvp/mvp_db/news7-lv/2016/2016_06_22_19_00/2016_06_22_19_00.mpg;Kazuo SHII.jpg;4125;4877;125993;206;244;38
/net/per610a/home/mvp/mvp_db/news7-lv/2016/2016_06_22_19_00/2016_06_22_19_00.mpg;Kazuo SHII.jpg;74221;89689;125993;3714;4488;774
/net/per610a/home/mvp/mvp_db/news7-lv/2016/2016_06_22_19_00/2016_06_22_19_00.mpg;Tadatomo Yoshida.jpg;5553;6037;125993;277;302;25
/net/per610a/home/mvp/mvp_db/news7-lv/2016/2016_06_22_19_00/2016_06_22_19_00.mpg;Tadatomo Yoshida.jpg;89929;92897;125993;4500;4648;148
/net/per610a/home/mvp/mvp_db/news7-lv/2016/2016_06_22_19_00/2016_06_22_19_00.mpg;Tadatomo Yoshida.jpg;93053;94841;125993;4656;4746;90
/net/per610a/home/mvp/mvp_db/news7-lv/2016/2016_06_22_19_00/2016_06_22_19_00.mpg;Ichiro OZAWA.jpg;6053;6389;125993;302;319;17
/net/per610a/home/mvp/mvp_db/news7-lv/2016/2016_06_22_19_00/2016_06_22_19_00.mpg;Ichiro OZAWA.jpg;95069;99409;125993;4757;4974;217
/net/per610a/home/mvp/mvp_db/news7-lv/2016/2016_06_22_19_00/2016_06_22_19_00.mpg;Natsuo YAMAGUCHI.jpg;64601;73957;125993;3232;3700;468
/net/per610a/home/mvp/mvp_db/news7-lv/2016/2016_06_22_19_00/2016_06_22_19_00.mpg;Kyoko Nakayama.jpg;99681;104401;125993;4988;5224;236
/net/per610a/home/mvp/mvp_db/news7-lv/2016/2016_06_23_19_00/2016_06_23_19_00.mpg;Shinzo ABE.jpg;23693;24045;36085;1185;1203;18
/net/per610a/home/mvp/mvp_db/news7-lv/2016/2016_06_23_19_00/2016_06_23_19_00.mpg;Shinzo ABE.jpg;24929;25333;36085;1247;1267;20
/net/per610a/home/mvp/mvp_db/news7-lv/2016/2016_06_24_19_00/2016_06_24_19_00.mpg;Ichiro OZAWA.jpg;12917;13177;36089;646;659;13
/net/per610a/home/mvp/mvp_db/news7-lv/2016/2016_06_24_19_00/2016_06_24_19_00.mpg;Shinzo ABE.jpg;22221;23013;36089;1112;1151;39
/net/per610a/home/mvp/mvp_db/news7-lv/2016/2016_06_25_19_00/2016_06_25_19_00.mpg;Taro ASO.jpg;10185;10397;36081;509;520;11
/net/per610a/home/mvp/mvp_db/news7-lv/2016/2016_06_25_19_00/2016_06_25_19_00.mpg;Ichiro Matsui.jpeg;26317;27837;36081;1316;1392;76
/net/per610a/home/mvp/mvp_db/news7-lv/2016/2016_06_26_19_00/2016_06_26_19_00.mpg;Shinzo ABE.jpg;21237;22309;36081;1062;1116;54
/net/per610a/home/mvp/mvp_db/news7-lv/2016/2016_06_26_19_00/2016_06_26_19_00.mpg;Natsuo YAMAGUCHI.jpg;22845;24049;36081;1142;1203;61
/net/per610a/home/mvp/mvp_db/news7-lv/2016/2016_06_26_19_00/2016_06_26_19_00.mpg;Kyoko Nakayama.jpg;24909;25277;36081;1246;1264;18
/net/per610a/home/mvp/mvp_db/news7-lv/2016/2016_06_27_19_00/2016_06_27_19_00.mpg;Tadatomo Yoshida.jpg;25897;26101;36085;1296;1306;10
/net/per610a/home/mvp/mvp_db/news7-lv/2016/2016_06_29_19_00/2016_06_29_19_00.mpg;YUriko Koike.jpg;13389;14829;36085;670;742;72
/net/per610a/home/mvp/mvp_db/news7-lv/2016/2016_06_29_19_00/2016_06_29_19_00.mpg;Seiji Mataichi.jpg;26221;26369;36085;1312;1319;7
/net/per610a/home/mvp/mvp_db/news7-lv/2016/2016_07_02_19_00/2016_07_02_19_00.mpg;Shinzo ABE.jpg;9393;9693;38481;470;485;15
/net/per610a/home/mvp/mvp_db/news7-lv/2016/2016_07_02_19_00/2016_07_02_19_00.mpg;Shinzo ABE.jpg;16653;17129;38481;833;857;24
/net/per610a/home/mvp/mvp_db/news7-lv/2016/2016_07_03_19_00/2016_07_03_19_00.mpg;Shinzo ABE.jpg;24893;25069;36085;1245;1254;9
/net/per610a/home/mvp/mvp_db/news7-lv/2016/2016_07_04_19_00/2016_07_04_19_00.mpg;Shinzo ABE.jpg;24529;24913;36085;1227;1246;19
/net/per610a/home/mvp/mvp_db/news7-lv/2016/2016_07_04_19_00/2016_07_04_19_00.mpg;Shinzo ABE.jpg;27705;27889;36085;1386;1395;9
/net/per610a/home/mvp/mvp_db/news7-lv/2016/2016_07_04_19_00/2016_07_04_19_00.mpg;Katsuya OKADA.jpg;28297;28421;36085;1416;1422;6
/net/per610a/home/mvp/mvp_db/news7-lv/2016/2016_07_04_19_00/2016_07_04_19_00.mpg;Tadatomo Yoshida.jpg;28361;28525;36085;1419;1427;8
/net/per610a/home/mvp/mvp_db/news7-lv/2016/2016_07_05_19_00/2016_07_05_19_00.mpg;YUriko Koike.jpg;8493;8837;36081;425;442;17
/net/per610a/home/mvp/mvp_db/news7-lv/2016/2016_07_05_19_00/2016_07_05_19_00.mpg;YUriko Koike.jpg;9157;9417;36081;458;471;13
/net/per610a/home/mvp/mvp_db/news7-lv/2016/2016_07_06_19_00/2016_07_06_19_00.mpg;YUriko Koike.jpg;4777;4885;36085;239;244;5
/net/per610a/home/mvp/mvp_db/news7-lv/2016/2016_07_06_19_00/2016_07_06_19_00.mpg;YUriko Koike.jpg;5505;5957;36085;275;298;23
/net/per610a/home/mvp/mvp_db/news7-lv/2016/2016_07_06_19_00/2016_07_06_19_00.mpg;YUriko Koike.jpg;6189;6769;36085;309;338;29
/net/per610a/home/mvp/mvp_db/news7-lv/2016/2016_07_09_19_00/2016_07_09_19_00.mpg;Shinzo ABE.jpg;8173;8737;36081;408;437;29
/net/per610a/home/mvp/mvp_db/news7-lv/2016/2016_07_11_19_00/2016_07_11_19_00.mpg;Natsuo YAMAGUCHI.jpg;141;197;36081;7;9;2
/net/per610a/home/mvp/mvp_db/news7-lv/2016/2016_07_11_19_00/2016_07_11_19_00.mpg;Natsuo YAMAGUCHI.jpg;3145;3145;36081;157;157;0
/net/per610a/home/mvp/mvp_db/news7-lv/2016/2016_07_11_19_00/2016_07_11_19_00.mpg;Natsuo YAMAGUCHI.jpg;3249;3345;36081;162;167;5
/net/per610a/home/mvp/mvp_db/news7-lv/2016/2016_07_11_19_00/2016_07_11_19_00.mpg;Shinzo ABE.jpg;329;429;36081;16;21;5
/net/per610a/home/mvp/mvp_db/news7-lv/2016/2016_07_11_19_00/2016_07_11_19_00.mpg;Shinzo ABE.jpg;10225;10737;36081;511;537;26
/net/per610a/home/mvp/mvp_db/news7-lv/2016/2016_07_11_19_00/2016_07_11_19_00.mpg;Shinzo ABE.jpg;11005;11609;36081;550;580;30
/net/per610a/home/mvp/mvp_db/news7-lv/2016/2016_07_11_19_00/2016_07_11_19_00.mpg;Shinzo ABE.jpg;12293;12905;36081;614;645;31
/net/per610a/home/mvp/mvp_db/news7-lv/2016/2016_07_11_19_00/2016_07_11_19_00.mpg;Shinzo ABE.jpg;14333;16081;36081;717;804;87
/net/per610a/home/mvp/mvp_db/news7-lv/2016/2016_07_11_19_00/2016_07_11_19_00.mpg;Shinzo ABE.jpg;16921;18157;36081;846;908;62
/net/per610a/home/mvp/mvp_db/news7-lv/2016/2016_07_11_19_00/2016_07_11_19_00.mpg;Shinzo ABE.jpg;469;621;36081;23;31;8
/net/per610a/home/mvp/mvp_db/news7-lv/2016/2016_07_11_19_00/2016_07_11_19_00.mpg;Shinzo ABE.jpg;3321;3373;36081;166;168;2
/net/per610a/home/mvp/mvp_db/news7-lv/2016/2016_07_11_19_00/2016_07_11_19_00.mpg;Shinzo ABE.jpg;3481;3649;36081;174;182;8
/net/per610a/home/mvp/mvp_db/news7-lv/2016/2016_07_11_19_00/2016_07_11_19_00.mpg;Taro ASO.jpg;3713;4073;36081;185;203;18
/net/per610a/home/mvp/mvp_db/news7-lv/2016/2016_07_12_19_00/2016_07_12_19_00.mpg;Yukio EDANO.jpg;13045;13089;38485;652;655;3
/net/per610a/home/mvp/mvp_db/news7-lv/2016/2016_07_12_19_00/2016_07_12_19_00.mpg;Yukio EDANO.jpg;13273;13625;38485;664;681;17
/net/per610a/home/mvp/mvp_db/news7-lv/2016/2016_07_12_19_00/2016_07_12_19_00.mpg;Shinzo ABE.jpg;27533;28121;38485;1377;1407;30
/net/per610a/home/mvp/mvp_db/news7-lv/2016/2016_07_14_19_00/2016_07_14_19_00.mpg;Shinzo ABE.jpg;2885;3277;36085;144;164;20
/net/per610a/home/mvp/mvp_db/news7-lv/2016/2016_07_14_19_00/2016_07_14_19_00.mpg;Shintaro ISHIHARA.jpg;15705;16137;36085;786;807;21
/net/per610a/home/mvp/mvp_db/news7-lv/2016/2016_07_14_19_00/2016_07_14_19_00.mpg;Shintaro ISHIHARA.jpg;16925;16981;36085;847;849;2
/net/per610a/home/mvp/mvp_db/news7-lv/2016/2016_07_15_19_00/2016_07_15_19_00.mpg;Shinzo ABE.jpg;11061;11893;36089;553;595;42
/net/per610a/home/mvp/mvp_db/news7-lv/2016/2016_07_15_19_00/2016_07_15_19_00.mpg;Shinzo ABE.jpg;19849;19921;36089;993;996;3
/net/per610a/home/mvp/mvp_db/news7-lv/2016/2016_07_15_19_00/2016_07_15_19_00.mpg;Shinzo ABE.jpg;21789;22237;36089;1090;1112;22
/net/per610a/home/mvp/mvp_db/news7-lv/2016/2016_07_19_19_00/2016_07_19_19_00.mpg;Shinzo ABE.jpg;16845;16853;36073;842;843;1
/net/per610a/home/mvp/mvp_db/news7-lv/2016/2016_07_19_19_00/2016_07_19_19_00.mpg;Shinzo ABE.jpg;18113;18221;36073;906;911;5
/net/per610a/home/mvp/mvp_db/news7-lv/2016/2016_07_19_19_00/2016_07_19_19_00.mpg;Shinzo ABE.jpg;16969;17081;36073;849;854;5
/net/per610a/home/mvp/mvp_db/news7-lv/2016/2016_07_19_19_00/2016_07_19_19_00.mpg;Kazuo SHII.jpg;18845;18941;36073;942;947;5
/net/per610a/home/mvp/mvp_db/news7-lv/2016/2016_07_25_19_00/2016_07_25_19_00.mpg;Shinzo ABE.jpg;21241;21465;36085;1063;1074;11
/net/per610a/home/mvp/mvp_db/news7-lv/2016/2016_07_27_19_00/2016_07_27_19_00.mpg;Shinzo ABE.jpg;12545;15281;36077;627;764;137
/net/per610a/home/mvp/mvp_db/news7-lv/2016/2016_07_30_19_00/2016_07_30_19_00.mpg;Seiji MAEHARA.jpg;10501;11121;36085;525;556;31
/net/per610a/home/mvp/mvp_db/news7-lv/2016/2016_07_30_19_00/2016_07_30_19_00.mpg;Renho.jpg;10501;10857;36085;525;543;18
/net/per610a/home/mvp/mvp_db/news7-lv/2016/2016_08_01_19_00/2016_08_01_19_00.mpg;YUriko Koike.jpg;5541;5589;36085;277;279;2
/net/per610a/home/mvp/mvp_db/news7-lv/2016/2016_08_01_19_00/2016_08_01_19_00.mpg;YUriko Koike.jpg;5713;5729;36085;285;286;1
/net/per610a/home/mvp/mvp_db/news7-lv/2016/2016_08_01_19_00/2016_08_01_19_00.mpg;YUriko Koike.jpg;5869;5989;36085;293;299;6
/net/per610a/home/mvp/mvp_db/news7-lv/2016/2016_08_01_19_00/2016_08_01_19_00.mpg;YUriko Koike.jpg;8021;8197;36085;401;410;9
/net/per610a/home/mvp/mvp_db/news7-lv/2016/2016_08_01_19_00/2016_08_01_19_00.mpg;YUriko Koike.jpg;8573;8969;36085;429;448;19
/net/per610a/home/mvp/mvp_db/news7-lv/2016/2016_08_01_19_00/2016_08_01_19_00.mpg;YUriko Koike.jpg;10669;10693;36085;533;535;2
/net/per610a/home/mvp/mvp_db/news7-lv/2016/2016_08_01_19_00/2016_08_01_19_00.mpg;YUriko Koike.jpg;12765;12973;36085;638;649;11
/net/per610a/home/mvp/mvp_db/news7-lv/2016/2016_08_01_19_00/2016_08_01_19_00.mpg;YUriko Koike.jpg;17161;17921;36085;858;896;38
/net/per610a/home/mvp/mvp_db/news7-lv/2016/2016_08_01_19_00/2016_08_01_19_00.mpg;YUriko Koike.jpg;7817;8017;36085;391;401;10
/net/per610a/home/mvp/mvp_db/news7-lv/2016/2016_08_01_19_00/2016_08_01_19_00.mpg;YUriko Koike.jpg;10769;11021;36085;538;551;13
/net/per610a/home/mvp/mvp_db/news7-lv/2016/2016_08_01_19_00/2016_08_01_19_00.mpg;Shinzo ABE.jpg;24257;24501;36085;1214;1226;12
/net/per610a/home/mvp/mvp_db/news7-lv/2016/2016_08_01_19_00/2016_08_01_19_00.mpg;Sadakazu TANIGAKI.jpg;24257;24501;36085;1214;1226;12
/net/per610a/home/mvp/mvp_db/news7-lv/2016/2016_08_01_19_00/2016_08_01_19_00.mpg;Taro ASO.jpg;26485;26645;36085;1325;1333;8
/net/per610a/home/mvp/mvp_db/news7-lv/2016/2016_08_02_19_00/2016_08_02_19_00.mpg;YUriko Koike.jpg;5469;5481;36077;273;274;1
/net/per610a/home/mvp/mvp_db/news7-lv/2016/2016_08_02_19_00/2016_08_02_19_00.mpg;YUriko Koike.jpg;7233;7501;36077;361;375;14
/net/per610a/home/mvp/mvp_db/news7-lv/2016/2016_08_02_19_00/2016_08_02_19_00.mpg;YUriko Koike.jpg;7569;7569;36077;378;378;0
/net/per610a/home/mvp/mvp_db/news7-lv/2016/2016_08_02_19_00/2016_08_02_19_00.mpg;YUriko Koike.jpg;7925;8001;36077;396;400;4
/net/per610a/home/mvp/mvp_db/news7-lv/2016/2016_08_02_19_00/2016_08_02_19_00.mpg;YUriko Koike.jpg;8233;8429;36077;411;421;10
/net/per610a/home/mvp/mvp_db/news7-lv/2016/2016_08_02_19_00/2016_08_02_19_00.mpg;YUriko Koike.jpg;8669;8957;36077;433;448;15
/net/per610a/home/mvp/mvp_db/news7-lv/2016/2016_08_02_19_00/2016_08_02_19_00.mpg;YUriko Koike.jpg;9993;10457;36077;499;523;24
/net/per610a/home/mvp/mvp_db/news7-lv/2016/2016_08_02_19_00/2016_08_02_19_00.mpg;Shinzo ABE.jpg;11053;11089;36077;553;554;1
/net/per610a/home/mvp/mvp_db/news7-lv/2016/2016_08_02_19_00/2016_08_02_19_00.mpg;Shinzo ABE.jpg;11233;11281;36077;562;564;2
/net/per610a/home/mvp/mvp_db/news7-lv/2016/2016_08_02_19_00/2016_08_02_19_00.mpg;Shinzo ABE.jpg;21285;21381;36077;1064;1069;5
/net/per610a/home/mvp/mvp_db/news7-lv/2016/2016_08_02_19_00/2016_08_02_19_00.mpg;Shinzo ABE.jpg;21453;21945;36077;1073;1097;24
/net/per610a/home/mvp/mvp_db/news7-lv/2016/2016_08_03_19_00/2016_08_03_19_00.mpg;Shinzo ABE.jpg;7473;7533;36081;373;376;3
/net/per610a/home/mvp/mvp_db/news7-lv/2016/2016_08_03_19_00/2016_08_03_19_00.mpg;Shinzo ABE.jpg;7641;7725;36081;382;386;4
/net/per610a/home/mvp/mvp_db/news7-lv/2016/2016_08_03_19_00/2016_08_03_19_00.mpg;Shinzo ABE.jpg;9685;10993;36081;484;549;65
/net/per610a/home/mvp/mvp_db/news7-lv/2016/2016_08_03_19_00/2016_08_03_19_00.mpg;Shinzo ABE.jpg;11101;11405;36081;555;570;15
/net/per610a/home/mvp/mvp_db/news7-lv/2016/2016_08_03_19_00/2016_08_03_19_00.mpg;Shinzo ABE.jpg;16157;16305;36081;808;815;7
/net/per610a/home/mvp/mvp_db/news7-lv/2016/2016_08_03_19_00/2016_08_03_19_00.mpg;Shinzo ABE.jpg;16453;16477;36081;823;824;1
/net/per610a/home/mvp/mvp_db/news7-lv/2016/2016_08_03_19_00/2016_08_03_19_00.mpg;Shinzo ABE.jpg;16605;16641;36081;830;832;2
/net/per610a/home/mvp/mvp_db/news7-lv/2016/2016_08_03_19_00/2016_08_03_19_00.mpg;Shinzo ABE.jpg;16869;16993;36081;843;850;7
/net/per610a/home/mvp/mvp_db/news7-lv/2016/2016_08_03_19_00/2016_08_03_19_00.mpg;Shinzo ABE.jpg;18185;18293;36081;909;915;6
/net/per610a/home/mvp/mvp_db/news7-lv/2016/2016_08_03_19_00/2016_08_03_19_00.mpg;Shinzo ABE.jpg;21101;21433;36081;1055;1072;17
/net/per610a/home/mvp/mvp_db/news7-lv/2016/2016_08_03_19_00/2016_08_03_19_00.mpg;Ichiro OZAWA.jpg;7833;7833;36081;391;391;0
/net/per610a/home/mvp/mvp_db/news7-lv/2016/2016_08_03_19_00/2016_08_03_19_00.mpg;Ichiro OZAWA.jpg;13909;15717;36081;695;786;91
/net/per610a/home/mvp/mvp_db/news7-lv/2016/2016_08_03_19_00/2016_08_03_19_00.mpg;Shinzo ABE.jpg;9549;9605;36081;477;480;3
/net/per610a/home/mvp/mvp_db/news7-lv/2016/2016_08_03_19_00/2016_08_03_19_00.mpg;Shinzo ABE.jpg;17613;18181;36081;881;909;28
/net/per610a/home/mvp/mvp_db/news7-lv/2016/2016_08_04_19_00/2016_08_04_19_00.mpg;Shinzo ABE.jpg;21521;21569;36085;1077;1079;2
/net/per610a/home/mvp/mvp_db/news7-lv/2016/2016_08_04_19_00/2016_08_04_19_00.mpg;Shinzo ABE.jpg;21973;22009;36085;1099;1101;2
/net/per610a/home/mvp/mvp_db/news7-lv/2016/2016_08_05_19_00/2016_08_05_19_00.mpg;YUriko Koike.jpg;20337;20497;36077;1017;1025;8
/net/per610a/home/mvp/mvp_db/news7-lv/2016/2016_08_05_19_00/2016_08_05_19_00.mpg;YUriko Koike.jpg;20813;21153;36077;1041;1058;17
/net/per610a/home/mvp/mvp_db/news7-lv/2016/2016_08_05_19_00/2016_08_05_19_00.mpg;YUriko Koike.jpg;21717;22617;36077;1086;1131;45
/net/per610a/home/mvp/mvp_db/news7-lv/2016/2016_08_05_19_00/2016_08_05_19_00.mpg;YUriko Koike.jpg;23441;23545;36077;1172;1178;6
/net/per610a/home/mvp/mvp_db/news7-lv/2016/2016_08_05_19_00/2016_08_05_19_00.mpg;YUriko Koike.jpg;20525;20733;36077;1026;1037;11
/net/per610a/home/mvp/mvp_db/news7-lv/2016/2016_08_05_19_00/2016_08_05_19_00.mpg;Kenji Eda.jpg;25985;26093;36077;1300;1305;5
/net/per610a/home/mvp/mvp_db/news7-lv/2016/2016_08_08_19_00/2016_08_08_19_00.mpg;Shinzo ABE.jpg;63685;64025;72049;3187;3204;17
/net/per610a/home/mvp/mvp_db/news7-lv/2016/2016_08_09_19_00/2016_08_09_19_00.mpg;Shinzo ABE.jpg;13965;14665;36085;698;733;35
/net/per610a/home/mvp/mvp_db/news7-lv/2016/2016_08_09_19_00/2016_08_09_19_00.mpg;Shinzo ABE.jpg;16597;17205;36085;830;861;31
/net/per610a/home/mvp/mvp_db/news7-lv/2016/2016_08_09_19_00/2016_08_09_19_00.mpg;Shinzo ABE.jpg;19025;19245;36085;952;963;11
/net/per610a/home/mvp/mvp_db/news7-lv/2016/2016_08_13_19_00/2016_08_13_19_00.mpg;Shinzo ABE.jpg;26417;26809;36085;1322;1341;19
/net/per610a/home/mvp/mvp_db/news7-lv/2016/2016_08_13_19_00/2016_08_13_19_00.mpg;Shinzo ABE.jpg;27189;27521;36085;1360;1377;17
/net/per610a/home/mvp/mvp_db/news7-lv/2016/2016_08_13_19_00/2016_08_13_19_00.mpg;Shinzo ABE.jpg;27621;27701;36085;1382;1386;4
/net/per610a/home/mvp/mvp_db/news7-lv/2016/2016_08_13_19_00/2016_08_13_19_00.mpg;Shinzo ABE.jpg;27917;27993;36085;1397;1401;4
/net/per610a/home/mvp/mvp_db/news7-lv/2016/2016_08_15_19_00/2016_08_15_19_00.mpg;Shinzo ABE.jpg;2449;2805;36081;122;140;18
/net/per610a/home/mvp/mvp_db/news7-lv/2016/2016_08_18_19_00/2016_08_18_19_00.mpg;YUriko Koike.jpg;30393;30661;36085;1521;1534;13
/net/per610a/home/mvp/mvp_db/news7-lv/2016/2016_08_20_19_00/2016_08_20_19_00.mpg;Shinzo ABE.jpg;19345;19897;36085;968;995;27
/net/per610a/home/mvp/mvp_db/news7-lv/2016/2016_08_20_19_00/2016_08_20_19_00.mpg;YUriko Koike.jpg;20601;20677;36085;1031;1034;3
/net/per610a/home/mvp/mvp_db/news7-lv/2016/2016_08_20_19_00/2016_08_20_19_00.mpg;YUriko Koike.jpg;20793;21249;36085;1040;1063;23
/net/per610a/home/mvp/mvp_db/news7-lv/2016/2016_08_23_19_00/2016_08_23_19_00.mpg;Renho.jpg;20365;20945;36085;1019;1048;29
/net/per610a/home/mvp/mvp_db/news7-lv/2016/2016_08_23_19_00/2016_08_23_19_00.mpg;Renho.jpg;22133;22701;36085;1107;1136;29
/net/per610a/home/mvp/mvp_db/news7-lv/2016/2016_08_23_19_00/2016_08_23_19_00.mpg;Seiji MAEHARA.jpg;23789;24161;36085;1190;1209;19
/net/per610a/home/mvp/mvp_db/news7-lv/2016/2016_08_23_19_00/2016_08_23_19_00.mpg;Yuichiro Tamaki.png;23797;24161;36085;1191;1209;18
/net/per610a/home/mvp/mvp_db/news7-lv/2016/2016_08_23_19_00/2016_08_23_19_00.mpg;Ichiro Matsui.jpeg;25965;26221;36085;1299;1312;13
/net/per610a/home/mvp/mvp_db/news7-lv/2016/2016_08_24_19_00/2016_08_24_19_00.mpg;Seiji MAEHARA.jpg;26905;27357;36085;1346;1369;23
/net/per610a/home/mvp/mvp_db/news7-lv/2016/2016_11_14_19_00/2016_11_14_19_00.mpg;Shinzo ABE.jpg;8989;9793;36089;449;490;41
/net/per610a/home/mvp/mvp_db/news7-lv/2016/2016_11_14_19_00/2016_11_14_19_00.mpg;Shinzo ABE.jpg;10857;11069;36089;543;553;10
/net/per610a/home/mvp/mvp_db/news7-lv/2016/2016_11_14_19_00/2016_11_14_19_00.mpg;Shinzo ABE.jpg;11561;11609;36089;578;580;2
/net/per610a/home/mvp/mvp_db/news7-lv/2016/2016_11_14_19_00/2016_11_14_19_00.mpg;Shinzo ABE.jpg;15673;15865;36089;784;793;9
/net/per610a/home/mvp/mvp_db/news7-lv/2016/2016_11_14_19_00/2016_11_14_19_00.mpg;Shinzo ABE.jpg;18377;18609;36089;919;931;12
/net/per610a/home/mvp/mvp_db/news7-lv/2016/2016_08_27_19_00/2016_08_27_19_00.mpg;Shinzo ABE.jpg;21481;21977;36081;1075;1100;25
/net/per610a/home/mvp/mvp_db/news7-lv/2016/2016_08_28_19_00/2016_08_28_19_00.mpg;Shinzo ABE.jpg;12973;13021;36073;649;651;2
/net/per610a/home/mvp/mvp_db/news7-lv/2016/2016_08_28_19_00/2016_08_28_19_00.mpg;Shinzo ABE.jpg;13193;13265;36073;660;663;3
/net/per610a/home/mvp/mvp_db/news7-lv/2016/2016_08_28_19_00/2016_08_28_19_00.mpg;Shinzo ABE.jpg;15941;16021;36073;797;801;4
/net/per610a/home/mvp/mvp_db/news7-lv/2016/2016_08_28_19_00/2016_08_28_19_00.mpg;Shinzo ABE.jpg;19157;19445;36073;958;972;14
/net/per610a/home/mvp/mvp_db/news7-lv/2016/2016_08_31_19_00/2016_08_31_19_00.mpg;YUriko Koike.jpg;50037;50273;84025;2504;2515;11
/net/per610a/home/mvp/mvp_db/news7-lv/2016/2016_08_31_19_00/2016_08_31_19_00.mpg;YUriko Koike.jpg;50361;50401;84025;2520;2522;2
/net/per610a/home/mvp/mvp_db/news7-lv/2016/2016_08_31_19_00/2016_08_31_19_00.mpg;YUriko Koike.jpg;53869;54149;84025;2695;2709;14
/net/per610a/home/mvp/mvp_db/news7-lv/2016/2016_08_31_19_00/2016_08_31_19_00.mpg;YUriko Koike.jpg;54889;55085;84025;2746;2756;10
/net/per610a/home/mvp/mvp_db/news7-lv/2016/2016_08_31_19_00/2016_08_31_19_00.mpg;Shintaro ISHIHARA.jpg;52689;53053;84025;2636;2655;19
/net/per610a/home/mvp/mvp_db/news7-lv/2016/2016_09_01_19_00/2016_09_01_19_00.mpg;Shinzo ABE.jpg;24069;24181;36081;1204;1210;6
/net/per610a/home/mvp/mvp_db/news7-lv/2016/2016_09_01_19_00/2016_09_01_19_00.mpg;Seiji MAEHARA.jpg;24809;25205;36081;1241;1261;20
/net/per610a/home/mvp/mvp_db/news7-lv/2016/2016_09_01_19_00/2016_09_01_19_00.mpg;Seiji MAEHARA.jpg;25333;25837;36081;1268;1293;25
/net/per610a/home/mvp/mvp_db/news7-lv/2016/2016_09_01_19_00/2016_09_01_19_00.mpg;Renho.jpg;26393;26465;36081;1321;1324;3
/net/per610a/home/mvp/mvp_db/news7-lv/2016/2016_09_01_19_00/2016_09_01_19_00.mpg;Renho.jpg;26697;26729;36081;1336;1337;1
/net/per610a/home/mvp/mvp_db/news7-lv/2016/2016_09_02_19_00/2016_09_02_19_00.mpg;Shinzo ABE.jpg;477;517;36085;23;25;2
/net/per610a/home/mvp/mvp_db/news7-lv/2016/2016_09_02_19_00/2016_09_02_19_00.mpg;Shinzo ABE.jpg;689;781;36085;34;39;5
/net/per610a/home/mvp/mvp_db/news7-lv/2016/2016_09_02_19_00/2016_09_02_19_00.mpg;Shinzo ABE.jpg;15245;15285;36085;762;764;2
/net/per610a/home/mvp/mvp_db/news7-lv/2016/2016_09_02_19_00/2016_09_02_19_00.mpg;Shinzo ABE.jpg;15369;15945;36085;769;798;29
/net/per610a/home/mvp/mvp_db/news7-lv/2016/2016_09_02_19_00/2016_09_02_19_00.mpg;Shinzo ABE.jpg;17365;17873;36085;869;894;25
/net/per610a/home/mvp/mvp_db/news7-lv/2016/2016_09_02_19_00/2016_09_02_19_00.mpg;Shinzo ABE.jpg;18349;18473;36085;918;924;6
/net/per610a/home/mvp/mvp_db/news7-lv/2016/2016_09_02_19_00/2016_09_02_19_00.mpg;Shinzo ABE.jpg;16185;16457;36085;810;823;13
/net/per610a/home/mvp/mvp_db/news7-lv/2016/2016_09_02_19_00/2016_09_02_19_00.mpg;Yuichiro Tamaki.png;21805;21813;36085;1091;1091;0
/net/per610a/home/mvp/mvp_db/news7-lv/2016/2016_09_02_19_00/2016_09_02_19_00.mpg;Yuichiro Tamaki.png;25637;25713;36085;1283;1286;3
/net/per610a/home/mvp/mvp_db/news7-lv/2016/2016_09_02_19_00/2016_09_02_19_00.mpg;Renho.jpg;22437;24665;36085;1122;1234;112
/net/per610a/home/mvp/mvp_db/news7-lv/2016/2016_09_02_19_00/2016_09_02_19_00.mpg;Renho.jpg;25545;25597;36085;1278;1281;3
/net/per610a/home/mvp/mvp_db/news7-lv/2016/2016_09_03_19_00/2016_09_03_19_00.mpg;Shinzo ABE.jpg;21669;22293;36085;1084;1115;31
/net/per610a/home/mvp/mvp_db/news7-lv/2016/2016_09_03_19_00/2016_09_03_19_00.mpg;Shinzo ABE.jpg;22469;22609;36085;1124;1131;7
/net/per610a/home/mvp/mvp_db/news7-lv/2016/2016_09_03_19_00/2016_09_03_19_00.mpg;Shinzo ABE.jpg;22697;22805;36085;1135;1141;6
/net/per610a/home/mvp/mvp_db/news7-lv/2016/2016_09_03_19_00/2016_09_03_19_00.mpg;Shinzo ABE.jpg;23605;23621;36085;1181;1182;1
/net/per610a/home/mvp/mvp_db/news7-lv/2016/2016_09_04_19_00/2016_09_04_19_00.mpg;Shinzo ABE.jpg;673;681;36081;33;34;1
/net/per610a/home/mvp/mvp_db/news7-lv/2016/2016_09_04_19_00/2016_09_04_19_00.mpg;Shinzo ABE.jpg;19181;19185;36081;959;959;0
/net/per610a/home/mvp/mvp_db/news7-lv/2016/2016_09_04_19_00/2016_09_04_19_00.mpg;Shinzo ABE.jpg;23137;23205;36081;1157;1160;3
/net/per610a/home/mvp/mvp_db/news7-lv/2016/2016_09_04_19_00/2016_09_04_19_00.mpg;Shinzo ABE.jpg;18237;18237;36081;912;912;0
/net/per610a/home/mvp/mvp_db/news7-lv/2016/2016_09_04_19_00/2016_09_04_19_00.mpg;Shinzo ABE.jpg;21725;21725;36081;1086;1086;0
/net/per610a/home/mvp/mvp_db/news7-lv/2016/2016_09_04_19_00/2016_09_04_19_00.mpg;Shinzo ABE.jpg;22357;22361;36081;1118;1118;0
/net/per610a/home/mvp/mvp_db/news7-lv/2016/2016_09_04_19_00/2016_09_04_19_00.mpg;Shinzo ABE.jpg;23285;23457;36081;1164;1173;9
/net/per610a/home/mvp/mvp_db/news7-lv/2016/2016_09_04_19_00/2016_09_04_19_00.mpg;Shinzo ABE.jpg;24605;24953;36081;1230;1248;18
/net/per610a/home/mvp/mvp_db/news7-lv/2016/2016_09_05_19_00/2016_09_05_19_00.mpg;Shinzo ABE.jpg;5749;5973;36085;287;298;11
/net/per610a/home/mvp/mvp_db/news7-lv/2016/2016_09_05_19_00/2016_09_05_19_00.mpg;Shinzo ABE.jpg;14965;14969;36085;748;749;1
/net/per610a/home/mvp/mvp_db/news7-lv/2016/2016_09_05_19_00/2016_09_05_19_00.mpg;Shinzo ABE.jpg;16141;16233;36085;807;812;5
/net/per610a/home/mvp/mvp_db/news7-lv/2016/2016_09_05_19_00/2016_09_05_19_00.mpg;Shinzo ABE.jpg;17537;17645;36085;877;883;6
/net/per610a/home/mvp/mvp_db/news7-lv/2016/2016_09_05_19_00/2016_09_05_19_00.mpg;Shinzo ABE.jpg;17689;18337;36085;885;917;32
/net/per610a/home/mvp/mvp_db/news7-lv/2016/2016_09_05_19_00/2016_09_05_19_00.mpg;Shinzo ABE.jpg;18513;18605;36085;926;931;5
/net/per610a/home/mvp/mvp_db/news7-lv/2016/2016_09_07_19_00/2016_09_07_19_00.mpg;Shinzo ABE.jpg;14589;14645;36085;730;732;2
/net/per610a/home/mvp/mvp_db/news7-lv/2016/2016_09_07_19_00/2016_09_07_19_00.mpg;Shinzo ABE.jpg;14829;14961;36085;742;748;6
/net/per610a/home/mvp/mvp_db/news7-lv/2016/2016_09_07_19_00/2016_09_07_19_00.mpg;Shinzo ABE.jpg;15113;15389;36085;756;770;14
/net/per610a/home/mvp/mvp_db/news7-lv/2016/2016_09_07_19_00/2016_09_07_19_00.mpg;Shinzo ABE.jpg;17729;18005;36085;887;901;14
/net/per610a/home/mvp/mvp_db/news7-lv/2016/2016_09_07_19_00/2016_09_07_19_00.mpg;Shinzo ABE.jpg;20213;20753;36085;1011;1038;27
/net/per610a/home/mvp/mvp_db/news7-lv/2016/2016_09_09_19_00/2016_09_09_19_00.mpg;Shinzo ABE.jpg;17269;17653;38481;864;883;19
/net/per610a/home/mvp/mvp_db/news7-lv/2016/2016_09_12_19_00/2016_09_12_19_00.mpg;YUriko Koike.jpg;225;301;36081;11;15;4
/net/per610a/home/mvp/mvp_db/news7-lv/2016/2016_09_12_19_00/2016_09_12_19_00.mpg;YUriko Koike.jpg;465;613;36081;23;30;7
/net/per610a/home/mvp/mvp_db/news7-lv/2016/2016_09_12_19_00/2016_09_12_19_00.mpg;YUriko Koike.jpg;7165;7333;36081;358;366;8
/net/per610a/home/mvp/mvp_db/news7-lv/2016/2016_09_12_19_00/2016_09_12_19_00.mpg;YUriko Koike.jpg;8613;8633;36081;430;431;1
/net/per610a/home/mvp/mvp_db/news7-lv/2016/2016_09_12_19_00/2016_09_12_19_00.mpg;YUriko Koike.jpg;8789;9045;36081;439;452;13
/net/per610a/home/mvp/mvp_db/news7-lv/2016/2016_09_12_19_00/2016_09_12_19_00.mpg;Shinzo ABE.jpg;5269;5293;36081;263;264;1
/net/per610a/home/mvp/mvp_db/news7-lv/2016/2016_09_12_19_00/2016_09_12_19_00.mpg;Shinzo ABE.jpg;5429;5833;36081;271;291;20
/net/per610a/home/mvp/mvp_db/news7-lv/2016/2016_09_12_19_00/2016_09_12_19_00.mpg;Shinzo ABE.jpg;23057;23085;36081;1153;1154;1
/net/per610a/home/mvp/mvp_db/news7-lv/2016/2016_09_12_19_00/2016_09_12_19_00.mpg;Shinzo ABE.jpg;23181;23273;36081;1159;1164;5
/net/per610a/home/mvp/mvp_db/news7-lv/2016/2016_09_12_19_00/2016_09_12_19_00.mpg;Shinzo ABE.jpg;23853;23945;36081;1193;1197;4
/net/per610a/home/mvp/mvp_db/news7-lv/2016/2016_09_12_19_00/2016_09_12_19_00.mpg;Shinzo ABE.jpg;24677;24697;36081;1234;1235;1
/net/per610a/home/mvp/mvp_db/news7-lv/2016/2016_09_12_19_00/2016_09_12_19_00.mpg;Shinzo ABE.jpg;24793;25025;36081;1240;1251;11
/net/per610a/home/mvp/mvp_db/news7-lv/2016/2016_09_12_19_00/2016_09_12_19_00.mpg;Shinzo ABE.jpg;25353;25633;36081;1268;1282;14
/net/per610a/home/mvp/mvp_db/news7-lv/2016/2016_09_12_19_00/2016_09_12_19_00.mpg;Shinzo ABE.jpg;22981;22989;36081;1149;1150;1
/net/per610a/home/mvp/mvp_db/news7-lv/2016/2016_09_12_19_00/2016_09_12_19_00.mpg;Shinzo ABE.jpg;25137;25341;36081;1257;1267;10
/net/per610a/home/mvp/mvp_db/news7-lv/2016/2016_09_13_19_00/2016_09_13_19_00.mpg;YUriko Koike.jpg;5633;5689;36081;281;284;3
/net/per610a/home/mvp/mvp_db/news7-lv/2016/2016_09_13_19_00/2016_09_13_19_00.mpg;YUriko Koike.jpg;5761;6125;36081;288;306;18
/net/per610a/home/mvp/mvp_db/news7-lv/2016/2016_09_13_19_00/2016_09_13_19_00.mpg;YUriko Koike.jpg;6585;6725;36081;329;336;7
/net/per610a/home/mvp/mvp_db/news7-lv/2016/2016_09_13_19_00/2016_09_13_19_00.mpg;Taro ASO.jpg;16249;16465;36081;812;823;11
/net/per610a/home/mvp/mvp_db/news7-lv/2016/2016_09_14_19_00/2016_09_14_19_00.mpg;YUriko Koike.jpg;425;553;36085;21;27;6
/net/per610a/home/mvp/mvp_db/news7-lv/2016/2016_09_14_19_00/2016_09_14_19_00.mpg;YUriko Koike.jpg;6409;6857;36085;320;343;23
/net/per610a/home/mvp/mvp_db/news7-lv/2016/2016_09_15_19_00/2016_09_15_19_00.mpg;Renho.jpg;10949;11717;36093;547;586;39
/net/per610a/home/mvp/mvp_db/news7-lv/2016/2016_09_15_19_00/2016_09_15_19_00.mpg;Renho.jpg;12161;12541;36093;608;627;19
/net/per610a/home/mvp/mvp_db/news7-lv/2016/2016_09_15_19_00/2016_09_15_19_00.mpg;Renho.jpg;15093;15633;36093;755;782;27
/net/per610a/home/mvp/mvp_db/news7-lv/2016/2016_09_15_19_00/2016_09_15_19_00.mpg;Renho.jpg;15821;15905;36093;791;795;4
/net/per610a/home/mvp/mvp_db/news7-lv/2016/2016_09_16_19_00/2016_09_16_19_00.mpg;Yoshihiko Noda.jpg;10753;10905;36085;538;545;7
/net/per610a/home/mvp/mvp_db/news7-lv/2016/2016_09_16_19_00/2016_09_16_19_00.mpg;Yoshihiko Noda.jpg;11525;11721;36085;576;586;10
/net/per610a/home/mvp/mvp_db/news7-lv/2016/2016_09_16_19_00/2016_09_16_19_00.mpg;Yoshihiko Noda.jpg;12853;12861;36085;643;643;0
/net/per610a/home/mvp/mvp_db/news7-lv/2016/2016_09_16_19_00/2016_09_16_19_00.mpg;Yoshihiko Noda.jpg;11729;11785;36085;587;589;2
/net/per610a/home/mvp/mvp_db/news7-lv/2016/2016_09_16_19_00/2016_09_16_19_00.mpg;Yoshihiko Noda.jpg;11889;12105;36085;595;605;10
/net/per610a/home/mvp/mvp_db/news7-lv/2016/2016_09_17_19_00/2016_09_17_19_00.mpg;Shinzo ABE.jpg;13965;13973;36085;698;699;1
/net/per610a/home/mvp/mvp_db/news7-lv/2016/2016_09_17_19_00/2016_09_17_19_00.mpg;Shinzo ABE.jpg;14437;14621;36085;722;731;9
/net/per610a/home/mvp/mvp_db/news7-lv/2016/2016_09_17_19_00/2016_09_17_19_00.mpg;Shinzo ABE.jpg;16281;16725;36085;814;837;23
/net/per610a/home/mvp/mvp_db/news7-lv/2016/2016_09_17_19_00/2016_09_17_19_00.mpg;Shinzo ABE.jpg;22901;23317;36085;1146;1166;20
/net/per610a/home/mvp/mvp_db/news7-lv/2016/2016_09_17_19_00/2016_09_17_19_00.mpg;Shinzo ABE.jpg;23393;23433;36085;1170;1172;2
/net/per610a/home/mvp/mvp_db/news7-lv/2016/2016_09_18_19_00/2016_09_18_19_00.mpg;Shinzo ABE.jpg;8153;8369;36073;407;418;11
/net/per610a/home/mvp/mvp_db/news7-lv/2016/2016_09_23_19_00/2016_09_23_19_00.mpg;YUriko Koike.jpg;3117;3581;36077;155;179;24
/net/per610a/home/mvp/mvp_db/news7-lv/2016/2016_09_23_19_00/2016_09_23_19_00.mpg;YUriko Koike.jpg;4933;5129;36077;246;256;10
/net/per610a/home/mvp/mvp_db/news7-lv/2016/2016_09_26_19_00/2016_09_26_19_00.mpg;Shinzo ABE.jpg;541;645;36093;27;32;5
/net/per610a/home/mvp/mvp_db/news7-lv/2016/2016_09_26_19_00/2016_09_26_19_00.mpg;Shinzo ABE.jpg;14745;14921;36093;737;746;9
/net/per610a/home/mvp/mvp_db/news7-lv/2016/2016_09_26_19_00/2016_09_26_19_00.mpg;Shinzo ABE.jpg;15669;15773;36093;784;789;5
/net/per610a/home/mvp/mvp_db/news7-lv/2016/2016_09_26_19_00/2016_09_26_19_00.mpg;Yoshihiko Noda.jpg;15221;15373;36093;761;769;8
/net/per610a/home/mvp/mvp_db/news7-lv/2016/2016_09_27_19_00/2016_09_27_19_00.mpg;YUriko Koike.jpg;749;901;36081;37;45;8
/net/per610a/home/mvp/mvp_db/news7-lv/2016/2016_09_27_19_00/2016_09_27_19_00.mpg;YUriko Koike.jpg;9789;10065;36081;489;503;14
/net/per610a/home/mvp/mvp_db/news7-lv/2016/2016_09_27_19_00/2016_09_27_19_00.mpg;Yoshihiko Noda.jpg;18573;20573;36081;929;1029;100
/net/per610a/home/mvp/mvp_db/news7-lv/2016/2016_09_27_19_00/2016_09_27_19_00.mpg;Yoshihiko Noda.jpg;21569;21945;36081;1079;1097;18
/net/per610a/home/mvp/mvp_db/news7-lv/2016/2016_09_28_19_00/2016_09_28_19_00.mpg;YUriko Koike.jpg;5;65;36089;0;3;3
/net/per610a/home/mvp/mvp_db/news7-lv/2016/2016_09_28_19_00/2016_09_28_19_00.mpg;YUriko Koike.jpg;225;309;36089;11;15;4
/net/per610a/home/mvp/mvp_db/news7-lv/2016/2016_09_28_19_00/2016_09_28_19_00.mpg;YUriko Koike.jpg;2385;3017;36089;119;150;31
/net/per610a/home/mvp/mvp_db/news7-lv/2016/2016_09_28_19_00/2016_09_28_19_00.mpg;YUriko Koike.jpg;3125;3165;36089;156;158;2
/net/per610a/home/mvp/mvp_db/news7-lv/2016/2016_09_28_19_00/2016_09_28_19_00.mpg;YUriko Koike.jpg;3277;3793;36089;163;189;26
/net/per610a/home/mvp/mvp_db/news7-lv/2016/2016_09_28_19_00/2016_09_28_19_00.mpg;YUriko Koike.jpg;5261;6293;36089;263;314;51
/net/per610a/home/mvp/mvp_db/news7-lv/2016/2016_09_28_19_00/2016_09_28_19_00.mpg;YUriko Koike.jpg;1113;1289;36089;55;64;9
/net/per610a/home/mvp/mvp_db/news7-lv/2016/2016_09_28_19_00/2016_09_28_19_00.mpg;YUriko Koike.jpg;2165;2185;36089;108;109;1
/net/per610a/home/mvp/mvp_db/news7-lv/2016/2016_09_28_19_00/2016_09_28_19_00.mpg;Renho.jpg;15197;15417;36089;760;771;11
/net/per610a/home/mvp/mvp_db/news7-lv/2016/2016_09_29_19_00/2016_09_29_19_00.mpg;YUriko Koike.jpg;153;237;36081;7;11;4
/net/per610a/home/mvp/mvp_db/news7-lv/2016/2016_09_29_19_00/2016_09_29_19_00.mpg;YUriko Koike.jpg;1173;1549;36081;58;77;19
/net/per610a/home/mvp/mvp_db/news7-lv/2016/2016_09_29_19_00/2016_09_29_19_00.mpg;YUriko Koike.jpg;1781;1877;36081;89;93;4
/net/per610a/home/mvp/mvp_db/news7-lv/2016/2016_09_29_19_00/2016_09_29_19_00.mpg;YUriko Koike.jpg;8273;8481;36081;413;424;11
/net/per610a/home/mvp/mvp_db/news7-lv/2016/2016_09_30_19_00/2016_09_30_19_00.mpg;YUriko Koike.jpg;245;485;36077;12;24;12
/net/per610a/home/mvp/mvp_db/news7-lv/2016/2016_09_30_19_00/2016_09_30_19_00.mpg;YUriko Koike.jpg;1737;2173;36077;86;108;22
/net/per610a/home/mvp/mvp_db/news7-lv/2016/2016_09_30_19_00/2016_09_30_19_00.mpg;YUriko Koike.jpg;3761;4553;36077;188;227;39
/net/per610a/home/mvp/mvp_db/news7-lv/2016/2016_09_30_19_00/2016_09_30_19_00.mpg;YUriko Koike.jpg;6461;7225;36077;323;361;38
/net/per610a/home/mvp/mvp_db/news7-lv/2016/2016_09_30_19_00/2016_09_30_19_00.mpg;Taro ASO.jpg;22053;22517;36077;1103;1126;23
/net/per610a/home/mvp/mvp_db/news7-lv/2016/2016_09_30_19_00/2016_09_30_19_00.mpg;Shinzo ABE.jpg;24665;24909;36077;1234;1246;12
/net/per610a/home/mvp/mvp_db/news7-lv/2016/2016_09_30_19_00/2016_09_30_19_00.mpg;Shinzo ABE.jpg;24993;25033;36077;1250;1252;2
/net/per610a/home/mvp/mvp_db/news7-lv/2016/2016_09_30_19_00/2016_09_30_19_00.mpg;Shinzo ABE.jpg;25641;25681;36077;1282;1284;2
/net/per610a/home/mvp/mvp_db/news7-lv/2016/2016_10_04_19_00/2016_10_04_19_00.mpg;YUriko Koike.jpg;609;701;36085;30;35;5
/net/per610a/home/mvp/mvp_db/news7-lv/2016/2016_10_05_19_00/2016_10_05_19_00.mpg;Shinzo ABE.jpg;20161;20457;36081;1008;1023;15
/net/per610a/home/mvp/mvp_db/news7-lv/2016/2016_10_05_19_00/2016_10_05_19_00.mpg;Shinzo ABE.jpg;23177;23285;36081;1159;1164;5
/net/per610a/home/mvp/mvp_db/news7-lv/2016/2016_10_06_19_00/2016_10_06_19_00.mpg;YUriko Koike.jpg;1149;1161;36085;57;58;1
/net/per610a/home/mvp/mvp_db/news7-lv/2016/2016_10_06_19_00/2016_10_06_19_00.mpg;YUriko Koike.jpg;1325;2261;36085;66;113;47
/net/per610a/home/mvp/mvp_db/news7-lv/2016/2016_10_08_19_00/2016_10_08_19_00.mpg;Shinzo ABE.jpg;26429;26493;36081;1322;1325;3
/net/per610a/home/mvp/mvp_db/news7-lv/2016/2016_10_08_19_00/2016_10_08_19_00.mpg;Shinzo ABE.jpg;27525;28145;36081;1376;1407;31
/net/per610a/home/mvp/mvp_db/news7-lv/2016/2016_10_10_19_00/2016_10_10_19_00.mpg;Yoshihiko Noda.jpg;11749;12397;36089;587;620;33
/net/per610a/home/mvp/mvp_db/news7-lv/2016/2016_10_11_19_00/2016_10_11_19_00.mpg;Renho.jpg;4153;4369;36081;207;218;11
/net/per610a/home/mvp/mvp_db/news7-lv/2016/2016_10_11_19_00/2016_10_11_19_00.mpg;Renho.jpg;23709;23813;36081;1186;1191;5
/net/per610a/home/mvp/mvp_db/news7-lv/2016/2016_10_11_19_00/2016_10_11_19_00.mpg;Kazuo SHII.jpg;4429;4673;36081;221;233;12
/net/per610a/home/mvp/mvp_db/news7-lv/2016/2016_10_11_19_00/2016_10_11_19_00.mpg;Shinzo ABE.jpg;18381;18473;36081;919;924;5
/net/per610a/home/mvp/mvp_db/news7-lv/2016/2016_10_11_19_00/2016_10_11_19_00.mpg;Shinzo ABE.jpg;18585;18657;36081;929;933;4
/net/per610a/home/mvp/mvp_db/news7-lv/2016/2016_10_11_19_00/2016_10_11_19_00.mpg;Shinzo ABE.jpg;18797;18797;36081;940;940;0
/net/per610a/home/mvp/mvp_db/news7-lv/2016/2016_10_11_19_00/2016_10_11_19_00.mpg;Shinzo ABE.jpg;18969;18969;36081;948;948;0
/net/per610a/home/mvp/mvp_db/news7-lv/2016/2016_10_11_19_00/2016_10_11_19_00.mpg;Shinzo ABE.jpg;19917;19969;36081;996;998;2
/net/per610a/home/mvp/mvp_db/news7-lv/2016/2016_10_11_19_00/2016_10_11_19_00.mpg;Shinzo ABE.jpg;20201;20201;36081;1010;1010;0
/net/per610a/home/mvp/mvp_db/news7-lv/2016/2016_10_11_19_00/2016_10_11_19_00.mpg;Shinzo ABE.jpg;21869;21881;36081;1094;1094;0
/net/per610a/home/mvp/mvp_db/news7-lv/2016/2016_10_11_19_00/2016_10_11_19_00.mpg;Shinzo ABE.jpg;20945;21289;36081;1047;1065;18
/net/per610a/home/mvp/mvp_db/news7-lv/2016/2016_10_11_19_00/2016_10_11_19_00.mpg;Shinzo ABE.jpg;21969;22165;36081;1099;1108;9
/net/per610a/home/mvp/mvp_db/news7-lv/2016/2016_10_11_19_00/2016_10_11_19_00.mpg;Renho.jpg;23917;24157;36081;1196;1208;12
/net/per610a/home/mvp/mvp_db/news7-lv/2016/2016_10_11_19_00/2016_10_11_19_00.mpg;Yoshihiko Noda.jpg;24221;24245;36081;1211;1212;1
/net/per610a/home/mvp/mvp_db/news7-lv/2016/2016_10_11_19_00/2016_10_11_19_00.mpg;Yoshihiko Noda.jpg;24385;24609;36081;1219;1231;12
/net/per610a/home/mvp/mvp_db/news7-lv/2016/2016_10_12_19_00/2016_10_12_19_00.mpg;YUriko Koike.jpg;10941;11049;36085;547;552;5
/net/per610a/home/mvp/mvp_db/news7-lv/2016/2016_10_12_19_00/2016_10_12_19_00.mpg;YUriko Koike.jpg;13017;13453;36085;651;673;22
/net/per610a/home/mvp/mvp_db/news7-lv/2016/2016_10_12_19_00/2016_10_12_19_00.mpg;YUriko Koike.jpg;19181;19441;36085;959;972;13
/net/per610a/home/mvp/mvp_db/news7-lv/2016/2016_10_12_19_00/2016_10_12_19_00.mpg;Shinzo ABE.jpg;25969;26333;36085;1299;1317;18
/net/per610a/home/mvp/mvp_db/news7-lv/2016/2016_10_12_19_00/2016_10_12_19_00.mpg;Shinzo ABE.jpg;26865;26869;36085;1344;1344;0
/net/per610a/home/mvp/mvp_db/news7-lv/2016/2016_10_12_19_00/2016_10_12_19_00.mpg;Shinzo ABE.jpg;27301;27313;36085;1366;1366;0
/net/per610a/home/mvp/mvp_db/news7-lv/2016/2016_10_13_19_00/2016_10_13_19_00.mpg;Yoshihiko Noda.jpg;13853;13941;36089;693;697;4
/net/per610a/home/mvp/mvp_db/news7-lv/2016/2016_10_13_19_00/2016_10_13_19_00.mpg;Yoshihiko Noda.jpg;14009;14753;36089;701;738;37
/net/per610a/home/mvp/mvp_db/news7-lv/2016/2016_10_13_19_00/2016_10_13_19_00.mpg;Yoshihiko Noda.jpg;16249;16793;36089;813;840;27
/net/per610a/home/mvp/mvp_db/news7-lv/2016/2016_10_14_19_00/2016_10_14_19_00.mpg;Shinzo ABE.jpg;5201;5393;36085;260;269;9
/net/per610a/home/mvp/mvp_db/news7-lv/2016/2016_10_15_19_00/2016_10_15_19_00.mpg;YUriko Koike.jpg;393;537;36085;19;26;7
/net/per610a/home/mvp/mvp_db/news7-lv/2016/2016_10_15_19_00/2016_10_15_19_00.mpg;YUriko Koike.jpg;3641;4269;36085;182;213;31
/net/per610a/home/mvp/mvp_db/news7-lv/2016/2016_10_15_19_00/2016_10_15_19_00.mpg;YUriko Koike.jpg;6097;6521;36085;305;326;21
/net/per610a/home/mvp/mvp_db/news7-lv/2016/2016_10_15_19_00/2016_10_15_19_00.mpg;YUriko Koike.jpg;8213;8489;36085;411;424;13
/net/per610a/home/mvp/mvp_db/news7-lv/2016/2016_10_16_19_00/2016_10_16_19_00.mpg;Shinzo ABE.jpg;24517;25301;36089;1226;1266;40
/net/per610a/home/mvp/mvp_db/news7-lv/2016/2016_10_17_19_00/2016_10_17_19_00.mpg;Ichiro OZAWA.jpg;15029;15173;36085;752;759;7
/net/per610a/home/mvp/mvp_db/news7-lv/2016/2016_10_17_19_00/2016_10_17_19_00.mpg;Shinzo ABE.jpg;28001;28209;36085;1401;1411;10
/net/per610a/home/mvp/mvp_db/news7-lv/2016/2016_10_17_19_00/2016_10_17_19_00.mpg;Shinzo ABE.jpg;31485;31557;36085;1575;1579;4
/net/per610a/home/mvp/mvp_db/news7-lv/2016/2016_10_18_19_00/2016_10_18_19_00.mpg;YUriko Koike.jpg;21;21;36085;1;1;0
/net/per610a/home/mvp/mvp_db/news7-lv/2016/2016_10_18_19_00/2016_10_18_19_00.mpg;YUriko Koike.jpg;2089;2117;36085;104;105;1
/net/per610a/home/mvp/mvp_db/news7-lv/2016/2016_10_18_19_00/2016_10_18_19_00.mpg;YUriko Koike.jpg;3817;3833;36085;191;191;0
/net/per610a/home/mvp/mvp_db/news7-lv/2016/2016_10_18_19_00/2016_10_18_19_00.mpg;YUriko Koike.jpg;4157;4785;36085;208;239;31
/net/per610a/home/mvp/mvp_db/news7-lv/2016/2016_10_18_19_00/2016_10_18_19_00.mpg;YUriko Koike.jpg;5525;5605;36085;276;280;4
/net/per610a/home/mvp/mvp_db/news7-lv/2016/2016_10_19_19_00/2016_10_19_19_00.mpg;Shinzo ABE.jpg;3489;3681;36085;174;184;10
/net/per610a/home/mvp/mvp_db/news7-lv/2016/2016_10_19_19_00/2016_10_19_19_00.mpg;Yukio HATOYAMA.jpg;11561;11933;36085;578;597;19
/net/per610a/home/mvp/mvp_db/news7-lv/2016/2016_10_19_19_00/2016_10_19_19_00.mpg;Yukio HATOYAMA.jpg;14557;14933;36085;728;747;19
/net/per610a/home/mvp/mvp_db/news7-lv/2016/2016_10_19_19_00/2016_10_19_19_00.mpg;Yukio HATOYAMA.jpg;15553;15837;36085;778;792;14
/net/per610a/home/mvp/mvp_db/news7-lv/2016/2016_10_20_19_00/2016_10_20_19_00.mpg;Renho.jpg;26265;26633;36093;1314;1332;18
/net/per610a/home/mvp/mvp_db/news7-lv/2016/2016_10_21_19_00/2016_10_21_19_00.mpg;YUriko Koike.jpg;24861;25133;38485;1244;1257;13
/net/per610a/home/mvp/mvp_db/news7-lv/2016/2016_10_24_19_00/2016_10_24_19_00.mpg;YUriko Koike.jpg;17429;17509;36081;871;875;4
/net/per610a/home/mvp/mvp_db/news7-lv/2016/2016_10_24_19_00/2016_10_24_19_00.mpg;Yoshihiko Noda.jpg;19417;20277;36081;971;1014;43
/net/per610a/home/mvp/mvp_db/news7-lv/2016/2016_10_25_19_00/2016_10_25_19_00.mpg;Ichiro OZAWA.jpg;23357;23785;36085;1168;1190;22
/net/per610a/home/mvp/mvp_db/news7-lv/2016/2016_10_26_19_00/2016_10_26_19_00.mpg;Shinzo ABE.jpg;22705;22877;38473;1136;1144;8
/net/per610a/home/mvp/mvp_db/news7-lv/2016/2016_10_27_19_00/2016_10_27_19_00.mpg;Shinzo ABE.jpg;11361;11377;36085;568;569;1
/net/per610a/home/mvp/mvp_db/news7-lv/2016/2016_10_27_19_00/2016_10_27_19_00.mpg;Shinzo ABE.jpg;13729;13765;36085;687;688;1
/net/per610a/home/mvp/mvp_db/news7-lv/2016/2016_10_27_19_00/2016_10_27_19_00.mpg;Shinzo ABE.jpg;14565;14629;36085;728;732;4
/net/per610a/home/mvp/mvp_db/news7-lv/2016/2016_10_27_19_00/2016_10_27_19_00.mpg;Shinzo ABE.jpg;20697;20733;36085;1035;1037;2
/net/per610a/home/mvp/mvp_db/news7-lv/2016/2016_10_27_19_00/2016_10_27_19_00.mpg;Shinzo ABE.jpg;22329;22505;36085;1117;1126;9
/net/per610a/home/mvp/mvp_db/news7-lv/2016/2016_10_27_19_00/2016_10_27_19_00.mpg;Shinzo ABE.jpg;13969;14257;36085;699;713;14
/net/per610a/home/mvp/mvp_db/news7-lv/2016/2016_10_28_19_00/2016_10_28_19_00.mpg;YUriko Koike.jpg;9101;10121;36077;455;506;51
/net/per610a/home/mvp/mvp_db/news7-lv/2016/2016_10_28_19_00/2016_10_28_19_00.mpg;Shinzo ABE.jpg;19449;19565;36077;973;978;5
/net/per610a/home/mvp/mvp_db/news7-lv/2016/2016_10_28_19_00/2016_10_28_19_00.mpg;Shinzo ABE.jpg;20905;21037;36077;1045;1052;7
/net/per610a/home/mvp/mvp_db/news7-lv/2016/2016_10_30_19_00/2016_10_30_19_00.mpg;Ichiro OZAWA.jpg;5341;6125;36089;267;306;39
/net/per610a/home/mvp/mvp_db/news7-lv/2016/2016_10_31_19_00/2016_10_31_19_00.mpg;YUriko Koike.jpg;19065;19481;36085;954;974;20
/net/per610a/home/mvp/mvp_db/news7-lv/2016/2016_10_31_19_00/2016_10_31_19_00.mpg;Shinzo ABE.jpg;21285;21297;36085;1065;1065;0
/net/per610a/home/mvp/mvp_db/news7-lv/2016/2016_10_31_19_00/2016_10_31_19_00.mpg;Shinzo ABE.jpg;21453;21453;36085;1073;1073;0
/net/per610a/home/mvp/mvp_db/news7-lv/2016/2016_10_31_19_00/2016_10_31_19_00.mpg;Shinzo ABE.jpg;22065;22077;36085;1104;1104;0
/net/per610a/home/mvp/mvp_db/news7-lv/2016/2016_10_31_19_00/2016_10_31_19_00.mpg;Shinzo ABE.jpg;22733;22833;36085;1137;1142;5
/net/per610a/home/mvp/mvp_db/news7-lv/2016/2016_10_31_19_00/2016_10_31_19_00.mpg;Shinzo ABE.jpg;22921;22953;36085;1147;1148;1
/net/per610a/home/mvp/mvp_db/news7-lv/2016/2016_11_01_19_00/2016_11_01_19_00.mpg;YUriko Koike.jpg;85;385;36081;4;19;15
/net/per610a/home/mvp/mvp_db/news7-lv/2016/2016_11_01_19_00/2016_11_01_19_00.mpg;YUriko Koike.jpg;1545;1681;36081;77;84;7
/net/per610a/home/mvp/mvp_db/news7-lv/2016/2016_11_01_19_00/2016_11_01_19_00.mpg;YUriko Koike.jpg;5577;6061;36081;278;303;25
/net/per610a/home/mvp/mvp_db/news7-lv/2016/2016_11_01_19_00/2016_11_01_19_00.mpg;Shinzo ABE.jpg;7633;7865;36081;381;393;12
/net/per610a/home/mvp/mvp_db/news7-lv/2016/2016_11_02_19_00/2016_11_02_19_00.mpg;YUriko Koike.jpg;4065;4325;36081;203;216;13
/net/per610a/home/mvp/mvp_db/news7-lv/2016/2016_11_02_19_00/2016_11_02_19_00.mpg;YUriko Koike.jpg;4713;4773;36081;235;238;3
/net/per610a/home/mvp/mvp_db/news7-lv/2016/2016_11_02_19_00/2016_11_02_19_00.mpg;YUriko Koike.jpg;29661;29849;36081;1483;1493;10
/net/per610a/home/mvp/mvp_db/news7-lv/2016/2016_11_02_19_00/2016_11_02_19_00.mpg;YUriko Koike.jpg;5197;5197;36081;259;259;0
/net/per610a/home/mvp/mvp_db/news7-lv/2016/2016_11_02_19_00/2016_11_02_19_00.mpg;YUriko Koike.jpg;5309;5573;36081;265;278;13
/net/per610a/home/mvp/mvp_db/news7-lv/2016/2016_11_04_19_00/2016_11_04_19_00.mpg;YUriko Koike.jpg;31129;31441;36081;1557;1572;15
/net/per610a/home/mvp/mvp_db/news7-lv/2016/2016_11_04_19_00/2016_11_04_19_00.mpg;YUriko Koike.jpg;31537;31657;36081;1577;1583;6
/net/per610a/home/mvp/mvp_db/news7-lv/2016/2016_11_07_19_00/2016_11_07_19_00.mpg;Ichiro OZAWA.jpg;24857;26145;36085;1244;1308;64
/net/per610a/home/mvp/mvp_db/news7-lv/2016/2016_11_08_19_00/2016_11_08_19_00.mpg;Shinzo ABE.jpg;25517;25937;36085;1277;1298;21
/net/per610a/home/mvp/mvp_db/news7-lv/2016/2016_11_09_19_00/2016_11_09_19_00.mpg;Shinzo ABE.jpg;25121;25937;72049;1257;1298;41
/net/per610a/home/mvp/mvp_db/news7-lv/2016/2016_11_09_19_00/2016_11_09_19_00.mpg;Shinzo ABE.jpg;31461;31609;72049;1574;1582;8
/net/per610a/home/mvp/mvp_db/news7-lv/2016/2016_11_09_19_00/2016_11_09_19_00.mpg;Shinzo ABE.jpg;33497;34053;72049;1676;1704;28
/net/per610a/home/mvp/mvp_db/news7-lv/2016/2016_11_09_19_00/2016_11_09_19_00.mpg;Shinzo ABE.jpg;71001;71329;72049;3553;3569;16
/net/per610a/home/mvp/mvp_db/news7-lv/2016/2016_11_09_19_00/2016_11_09_19_00.mpg;Yoshihiko Noda.jpg;54661;54777;72049;2735;2741;6
/net/per610a/home/mvp/mvp_db/news7-lv/2016/2016_11_09_19_00/2016_11_09_19_00.mpg;Yoshihiko Noda.jpg;54845;54917;72049;2744;2748;4
/net/per610a/home/mvp/mvp_db/news7-lv/2016/2016_11_09_19_00/2016_11_09_19_00.mpg;YUriko Koike.jpg;58565;58869;72049;2931;2946;15
/net/per610a/home/mvp/mvp_db/news7-lv/2016/2016_11_10_19_00/2016_11_10_19_00.mpg;Shinzo ABE.jpg;12581;12969;36085;629;649;20
/net/per610a/home/mvp/mvp_db/news7-lv/2016/2016_11_10_19_00/2016_11_10_19_00.mpg;Shinzo ABE.jpg;18889;19041;36085;945;952;7
/net/per610a/home/mvp/mvp_db/news7-lv/2016/2016_11_11_19_00/2016_11_11_19_00.mpg;Shinzo ABE.jpg;11377;12661;36085;569;633;64
/net/per610a/home/mvp/mvp_db/news7-lv/2016/2016_11_11_19_00/2016_11_11_19_00.mpg;Shinzo ABE.jpg;12809;12853;36085;641;643;2
/net/per610a/home/mvp/mvp_db/news7-lv/2016/2016_11_11_19_00/2016_11_11_19_00.mpg;Shinzo ABE.jpg;16389;16701;36085;820;835;15
/net/per610a/home/mvp/mvp_db/news7-lv/2016/2016_11_11_19_00/2016_11_11_19_00.mpg;Shinzo ABE.jpg;17505;17881;36085;876;894;18
/net/per610a/home/mvp/mvp_db/news7-lv/2016/2016_11_11_19_00/2016_11_11_19_00.mpg;Renho.jpg;13681;14093;36085;684;705;21
/net/per610a/home/mvp/mvp_db/news7-lv/2016/2016_11_11_19_00/2016_11_11_19_00.mpg;YUriko Koike.jpg;22657;22669;36085;1133;1134;1
/net/per610a/home/mvp/mvp_db/news7-lv/2016/2016_11_11_19_00/2016_11_11_19_00.mpg;YUriko Koike.jpg;23169;23409;36085;1159;1171;12
/net/per610a/home/mvp/mvp_db/news7-lv/2016/2016_11_11_19_00/2016_11_11_19_00.mpg;YUriko Koike.jpg;24869;25429;36085;1244;1272;28
/net/per610a/home/mvp/mvp_db/news7-lv/2016/2016_11_12_19_00/2016_11_12_19_00.mpg;Shinzo ABE.jpg;14049;14085;36085;703;704;1
/net/per610a/home/mvp/mvp_db/news7-lv/2016/2016_11_12_19_00/2016_11_12_19_00.mpg;Shinzo ABE.jpg;15197;15249;36085;760;763;3
/net/per610a/home/mvp/mvp_db/news7-lv/2016/2016_11_12_19_00/2016_11_12_19_00.mpg;Shinzo ABE.jpg;16293;16333;36085;815;817;2
/net/per610a/home/mvp/mvp_db/news7-lv/2016/2016_11_12_19_00/2016_11_12_19_00.mpg;Shinzo ABE.jpg;14473;14801;36085;724;740;16
/net/per610a/home/mvp/mvp_db/news7-lv/2016/2016_11_15_19_00/2016_11_15_19_00.mpg;Shinzo ABE.jpg;8929;9073;36085;446;454;8
/net/per610a/home/mvp/mvp_db/news7-lv/2016/2016_11_15_19_00/2016_11_15_19_00.mpg;Shinzo ABE.jpg;9765;10233;36085;488;512;24
/net/per610a/home/mvp/mvp_db/news7-lv/2016/2016_11_15_19_00/2016_11_15_19_00.mpg;Shinzo ABE.jpg;26113;26685;36085;1306;1335;29
/net/per610a/home/mvp/mvp_db/news7-lv/2016/2016_11_15_19_00/2016_11_15_19_00.mpg;Renho.jpg;16181;16549;36085;809;828;19
/net/per610a/home/mvp/mvp_db/news7-lv/2016/2016_11_17_19_00/2016_11_17_19_00.mpg;Shinzo ABE.jpg;1453;2333;36089;72;116;44
/net/per610a/home/mvp/mvp_db/news7-lv/2016/2016_11_17_19_00/2016_11_17_19_00.mpg;Shinzo ABE.jpg;3477;3709;36089;173;185;12
/net/per610a/home/mvp/mvp_db/news7-lv/2016/2016_11_17_19_00/2016_11_17_19_00.mpg;Shinzo ABE.jpg;4881;4969;36089;244;248;4
/net/per610a/home/mvp/mvp_db/news7-lv/2016/2016_11_17_19_00/2016_11_17_19_00.mpg;Shinzo ABE.jpg;5069;5181;36089;253;259;6
/net/per610a/home/mvp/mvp_db/news7-lv/2016/2016_11_18_19_00/2016_11_18_19_00.mpg;Shinzo ABE.jpg;3037;3161;36081;151;158;7
/net/per610a/home/mvp/mvp_db/news7-lv/2016/2016_11_18_19_00/2016_11_18_19_00.mpg;Shinzo ABE.jpg;3197;3649;36081;159;182;23
/net/per610a/home/mvp/mvp_db/news7-lv/2016/2016_11_18_19_00/2016_11_18_19_00.mpg;Shinzo ABE.jpg;11133;11493;36081;556;574;18
/net/per610a/home/mvp/mvp_db/news7-lv/2016/2016_11_18_19_00/2016_11_18_19_00.mpg;Shinzo ABE.jpg;26277;26449;36081;1314;1323;9
/net/per610a/home/mvp/mvp_db/news7-lv/2016/2016_11_18_19_00/2016_11_18_19_00.mpg;YUriko Koike.jpg;17585;18093;36081;879;905;26
/net/per610a/home/mvp/mvp_db/news7-lv/2016/2016_11_20_19_00/2016_11_20_19_00.mpg;Shinzo ABE.jpg;81;337;36089;4;16;12
/net/per610a/home/mvp/mvp_db/news7-lv/2016/2016_11_20_19_00/2016_11_20_19_00.mpg;Shinzo ABE.jpg;2969;3349;36089;148;167;19
/net/per610a/home/mvp/mvp_db/news7-lv/2016/2016_11_20_19_00/2016_11_20_19_00.mpg;Shinzo ABE.jpg;4197;4465;36089;210;223;13
/net/per610a/home/mvp/mvp_db/news7-lv/2016/2016_11_20_19_00/2016_11_20_19_00.mpg;Shinzo ABE.jpg;4933;4941;36089;246;247;1
/net/per610a/home/mvp/mvp_db/news7-lv/2016/2016_11_20_19_00/2016_11_20_19_00.mpg;Shinzo ABE.jpg;5117;5237;36089;256;262;6
/net/per610a/home/mvp/mvp_db/news7-lv/2016/2016_11_20_19_00/2016_11_20_19_00.mpg;Shinzo ABE.jpg;7061;7561;36089;353;378;25
/net/per610a/home/mvp/mvp_db/news7-lv/2016/2016_11_20_19_00/2016_11_20_19_00.mpg;Shinzo ABE.jpg;9609;9709;36089;480;485;5
/net/per610a/home/mvp/mvp_db/news7-lv/2016/2016_11_20_19_00/2016_11_20_19_00.mpg;Shinzo ABE.jpg;10141;10329;36089;507;516;9
/net/per610a/home/mvp/mvp_db/news7-lv/2016/2016_11_20_19_00/2016_11_20_19_00.mpg;Ichiro OZAWA.jpg;7737;8581;36089;387;429;42
/net/per610a/home/mvp/mvp_db/news7-lv/2016/2016_11_22_19_00/2016_11_22_19_00.mpg;Shinzo ABE.jpg;541;649;38481;27;32;5
/net/per610a/home/mvp/mvp_db/news7-lv/2016/2016_11_22_19_00/2016_11_22_19_00.mpg;Shinzo ABE.jpg;20889;21201;38481;1045;1061;16
/net/per610a/home/mvp/mvp_db/news7-lv/2016/2016_11_22_19_00/2016_11_22_19_00.mpg;Shinzo ABE.jpg;21273;21413;38481;1064;1071;7
/net/per610a/home/mvp/mvp_db/news7-lv/2016/2016_11_24_19_00/2016_11_24_19_00.mpg;Ichiro OZAWA.jpg;27777;27965;36073;1389;1399;10
/net/per610a/home/mvp/mvp_db/news7-lv/2016/2016_11_25_19_00/2016_11_25_19_00.mpg;Shinzo ABE.jpg;1585;1637;36081;79;81;2
/net/per610a/home/mvp/mvp_db/news7-lv/2016/2016_11_25_19_00/2016_11_25_19_00.mpg;Shinzo ABE.jpg;6649;6845;36081;332;342;10
/net/per610a/home/mvp/mvp_db/news7-lv/2016/2016_11_25_19_00/2016_11_25_19_00.mpg;Shinzo ABE.jpg;8929;9173;36081;446;459;13
/net/per610a/home/mvp/mvp_db/news7-lv/2016/2016_11_25_19_00/2016_11_25_19_00.mpg;Natsuo YAMAGUCHI.jpg;6649;6917;36081;332;346;14
/net/per610a/home/mvp/mvp_db/news7-lv/2016/2016_11_25_19_00/2016_11_25_19_00.mpg;YUriko Koike.jpg;10913;11145;36081;546;557;11
/net/per610a/home/mvp/mvp_db/news7-lv/2016/2016_11_27_19_00/2016_11_27_19_00.mpg;YUriko Koike.jpg;3757;4077;36081;187;203;16
/net/per610a/home/mvp/mvp_db/news7-lv/2016/2016_11_27_19_00/2016_11_27_19_00.mpg;Yoshihiko Noda.jpg;13785;14769;36081;689;738;49
/net/per610a/home/mvp/mvp_db/news7-lv/2016/2016_11_28_19_00/2016_11_28_19_00.mpg;YUriko Koike.jpg;11569;11981;36081;578;599;21
/net/per610a/home/mvp/mvp_db/news7-lv/2016/2016_11_28_19_00/2016_11_28_19_00.mpg;YUriko Koike.jpg;12385;12581;36081;619;629;10
/net/per610a/home/mvp/mvp_db/news7-lv/2016/2016_11_28_19_00/2016_11_28_19_00.mpg;YUriko Koike.jpg;15057;15529;36081;753;776;23
/net/per610a/home/mvp/mvp_db/news7-lv/2016/2016_11_28_19_00/2016_11_28_19_00.mpg;Shinzo ABE.jpg;15657;15705;36081;783;785;2
/net/per610a/home/mvp/mvp_db/news7-lv/2016/2016_11_28_19_00/2016_11_28_19_00.mpg;Shinzo ABE.jpg;16025;16117;36081;801;806;5
/net/per610a/home/mvp/mvp_db/news7-lv/2016/2016_11_28_19_00/2016_11_28_19_00.mpg;Natsuo YAMAGUCHI.jpg;16329;16597;36081;816;830;14
/net/per610a/home/mvp/mvp_db/news7-lv/2016/2016_11_29_19_00/2016_11_29_19_00.mpg;YUriko Koike.jpg;77;369;38481;3;18;15
/net/per610a/home/mvp/mvp_db/news7-lv/2016/2016_11_29_19_00/2016_11_29_19_00.mpg;YUriko Koike.jpg;453;565;38481;22;28;6
/net/per610a/home/mvp/mvp_db/news7-lv/2016/2016_11_29_19_00/2016_11_29_19_00.mpg;YUriko Koike.jpg;677;745;38481;33;37;4
/net/per610a/home/mvp/mvp_db/news7-lv/2016/2016_11_29_19_00/2016_11_29_19_00.mpg;YUriko Koike.jpg;11257;11305;38481;563;565;2
/net/per610a/home/mvp/mvp_db/news7-lv/2016/2016_11_29_19_00/2016_11_29_19_00.mpg;YUriko Koike.jpg;11449;11641;38481;573;582;9
/net/per610a/home/mvp/mvp_db/news7-lv/2016/2016_11_29_19_00/2016_11_29_19_00.mpg;YUriko Koike.jpg;11729;12069;38481;587;604;17
/net/per610a/home/mvp/mvp_db/news7-lv/2016/2016_11_29_19_00/2016_11_29_19_00.mpg;YUriko Koike.jpg;12173;12377;38481;609;619;10
/net/per610a/home/mvp/mvp_db/news7-lv/2016/2016_12_01_19_00/2016_12_01_19_00.mpg;YUriko Koike.jpg;1325;1689;36081;66;84;18
/net/per610a/home/mvp/mvp_db/news7-lv/2016/2016_12_01_19_00/2016_12_01_19_00.mpg;YUriko Koike.jpg;4953;5261;36081;247;263;16
/net/per610a/home/mvp/mvp_db/news7-lv/2016/2016_12_01_19_00/2016_12_01_19_00.mpg;Kazuo SHII.jpg;22581;22833;36081;1129;1142;13
/net/per610a/home/mvp/mvp_db/news7-lv/2016/2016_12_01_19_00/2016_12_01_19_00.mpg;Shinzo ABE.jpg;23881;24425;36081;1194;1221;27
/net/per610a/home/mvp/mvp_db/news7-lv/2016/2016_12_01_19_00/2016_12_01_19_00.mpg;Shinzo ABE.jpg;24753;25473;36081;1238;1274;36
/net/per610a/home/mvp/mvp_db/news7-lv/2016/2016_12_05_19_00/2016_12_05_19_00.mpg;Shinzo ABE.jpg;673;3413;36081;33;170;137
/net/per610a/home/mvp/mvp_db/news7-lv/2016/2016_12_05_19_00/2016_12_05_19_00.mpg;Shinzo ABE.jpg;4481;5057;36081;224;252;28
/net/per610a/home/mvp/mvp_db/news7-lv/2016/2016_12_05_19_00/2016_12_05_19_00.mpg;Shinzo ABE.jpg;6057;7129;36081;303;356;53
/net/per610a/home/mvp/mvp_db/news7-lv/2016/2016_12_05_19_00/2016_12_05_19_00.mpg;Shinzo ABE.jpg;27321;27889;36081;1366;1395;29
/net/per610a/home/mvp/mvp_db/news7-lv/2016/2016_12_05_19_00/2016_12_05_19_00.mpg;Shinzo ABE.jpg;28269;29029;36081;1414;1452;38
/net/per610a/home/mvp/mvp_db/news7-lv/2016/2016_12_05_19_00/2016_12_05_19_00.mpg;Shinzo ABE.jpg;31141;32617;36081;1557;1631;74
/net/per610a/home/mvp/mvp_db/news7-lv/2016/2016_12_05_19_00/2016_12_05_19_00.mpg;Shinzo ABE.jpg;33193;34021;36081;1660;1701;41
/net/per610a/home/mvp/mvp_db/news7-lv/2016/2016_12_07_19_00/2016_12_07_19_00.mpg;Shinzo ABE.jpg;6389;6573;36089;319;328;9
/net/per610a/home/mvp/mvp_db/news7-lv/2016/2016_12_09_19_00/2016_12_09_19_00.mpg;Renho.jpg;21005;21421;36081;1050;1071;21
/net/per610a/home/mvp/mvp_db/news7-lv/2016/2016_12_09_19_00/2016_12_09_19_00.mpg;Shinzo ABE.jpg;23193;23637;36081;1160;1182;22
/net/per610a/home/mvp/mvp_db/news7-lv/2016/2016_12_09_19_00/2016_12_09_19_00.mpg;YUriko Koike.jpg;24309;24673;36081;1216;1234;18
/net/per610a/home/mvp/mvp_db/news7-lv/2016/2016_12_09_19_00/2016_12_09_19_00.mpg;YUriko Koike.jpg;24997;25461;36081;1250;1273;23
/net/per610a/home/mvp/mvp_db/news7-lv/2016/2016_12_09_19_00/2016_12_09_19_00.mpg;YUriko Koike.jpg;26421;26909;36081;1321;1346;25
/net/per610a/home/mvp/mvp_db/news7-lv/2016/2016_12_10_19_00/2016_12_10_19_00.mpg;YUriko Koike.jpg;525;689;36081;26;34;8
/net/per610a/home/mvp/mvp_db/news7-lv/2016/2016_12_10_19_00/2016_12_10_19_00.mpg;YUriko Koike.jpg;817;889;36081;40;44;4
/net/per610a/home/mvp/mvp_db/news7-lv/2016/2016_12_10_19_00/2016_12_10_19_00.mpg;YUriko Koike.jpg;7469;7933;36081;373;396;23
/net/per610a/home/mvp/mvp_db/news7-lv/2016/2016_12_10_19_00/2016_12_10_19_00.mpg;YUriko Koike.jpg;8109;8329;36081;405;416;11
/net/per610a/home/mvp/mvp_db/news7-lv/2016/2016_12_11_19_00/2016_12_11_19_00.mpg;Shinzo ABE.jpg;13561;13761;36089;678;688;10
/net/per610a/home/mvp/mvp_db/news7-lv/2016/2016_12_11_19_00/2016_12_11_19_00.mpg;YUriko Koike.jpg;16089;16221;36089;805;811;6
/net/per610a/home/mvp/mvp_db/news7-lv/2016/2016_12_12_19_00/2016_12_12_19_00.mpg;Yoshihiko Noda.jpg;17789;17869;36081;889;893;4
/net/per610a/home/mvp/mvp_db/news7-lv/2016/2016_12_12_19_00/2016_12_12_19_00.mpg;Yoshihiko Noda.jpg;17957;18257;36081;898;913;15
/net/per610a/home/mvp/mvp_db/news7-lv/2016/2016_12_12_19_00/2016_12_12_19_00.mpg;Ichiro OZAWA.jpg;18349;19165;36081;917;958;41
/net/per610a/home/mvp/mvp_db/news7-lv/2016/2016_12_12_19_00/2016_12_12_19_00.mpg;Shinzo ABE.jpg;19029;19165;36081;951;958;7
/net/per610a/home/mvp/mvp_db/news7-lv/2016/2016_12_12_19_00/2016_12_12_19_00.mpg;Shinzo ABE.jpg;19337;19465;36081;967;973;6
/net/per610a/home/mvp/mvp_db/news7-lv/2016/2016_12_12_19_00/2016_12_12_19_00.mpg;Shinzo ABE.jpg;25229;25593;36081;1262;1280;18
/net/per610a/home/mvp/mvp_db/news7-lv/2016/2016_12_12_19_00/2016_12_12_19_00.mpg;Shinzo ABE.jpg;26553;26629;36081;1328;1332;4
/net/per610a/home/mvp/mvp_db/news7-lv/2016/2016_12_12_19_00/2016_12_12_19_00.mpg;Shinzo ABE.jpg;26389;26509;36081;1320;1326;6
/net/per610a/home/mvp/mvp_db/news7-lv/2016/2016_12_12_19_00/2016_12_12_19_00.mpg;Shinzo ABE.jpg;28857;28909;36081;1443;1446;3
/net/per610a/home/mvp/mvp_db/news7-lv/2016/2016_12_15_19_00/2016_12_15_19_00.mpg;Shinzo ABE.jpg;381;1945;36081;19;97;78
/net/per610a/home/mvp/mvp_db/news7-lv/2016/2016_12_15_19_00/2016_12_15_19_00.mpg;Shinzo ABE.jpg;9257;9293;36081;463;464;1
/net/per610a/home/mvp/mvp_db/news7-lv/2016/2016_12_15_19_00/2016_12_15_19_00.mpg;Shinzo ABE.jpg;17125;17785;36081;856;889;33
/net/per610a/home/mvp/mvp_db/news7-lv/2016/2016_12_15_19_00/2016_12_15_19_00.mpg;Yukio HATOYAMA.jpg;8665;8785;36081;433;439;6
/net/per610a/home/mvp/mvp_db/news7-lv/2016/2016_12_16_19_00/2016_12_16_19_00.mpg;Shinzo ABE.jpg;1;33;38481;0;1;1
/net/per610a/home/mvp/mvp_db/news7-lv/2016/2016_12_16_19_00/2016_12_16_19_00.mpg;Shinzo ABE.jpg;125;125;38481;6;6;0
/net/per610a/home/mvp/mvp_db/news7-lv/2016/2016_12_16_19_00/2016_12_16_19_00.mpg;Shinzo ABE.jpg;7113;7193;38481;355;359;4
/net/per610a/home/mvp/mvp_db/news7-lv/2016/2016_12_16_19_00/2016_12_16_19_00.mpg;Shinzo ABE.jpg;17821;17833;38481;891;892;1
/net/per610a/home/mvp/mvp_db/news7-lv/2016/2016_12_16_19_00/2016_12_16_19_00.mpg;Shinzo ABE.jpg;18917;19001;38481;946;950;4
/net/per610a/home/mvp/mvp_db/news7-lv/2016/2016_12_16_19_00/2016_12_16_19_00.mpg;Shinzo ABE.jpg;21509;21509;38481;1075;1075;0
/net/per610a/home/mvp/mvp_db/news7-lv/2016/2016_12_16_19_00/2016_12_16_19_00.mpg;Shinzo ABE.jpg;22749;22789;38481;1138;1140;2
/net/per610a/home/mvp/mvp_db/news7-lv/2016/2016_12_16_19_00/2016_12_16_19_00.mpg;Shinzo ABE.jpg;23465;23477;38481;1173;1174;1
/net/per610a/home/mvp/mvp_db/news7-lv/2016/2016_12_16_19_00/2016_12_16_19_00.mpg;Shinzo ABE.jpg;705;729;38481;35;36;1
/net/per610a/home/mvp/mvp_db/news7-lv/2016/2016_12_16_19_00/2016_12_16_19_00.mpg;Shinzo ABE.jpg;1009;1061;38481;50;53;3
/net/per610a/home/mvp/mvp_db/news7-lv/2016/2016_12_16_19_00/2016_12_16_19_00.mpg;Shinzo ABE.jpg;1813;1893;38481;90;94;4
/net/per610a/home/mvp/mvp_db/news7-lv/2016/2016_12_16_19_00/2016_12_16_19_00.mpg;Shinzo ABE.jpg;2797;3017;38481;139;150;11
/net/per610a/home/mvp/mvp_db/news7-lv/2016/2016_12_16_19_00/2016_12_16_19_00.mpg;Shinzo ABE.jpg;3081;3241;38481;154;162;8
/net/per610a/home/mvp/mvp_db/news7-lv/2016/2016_12_16_19_00/2016_12_16_19_00.mpg;Shinzo ABE.jpg;3357;3909;38481;167;195;28
/net/per610a/home/mvp/mvp_db/news7-lv/2016/2016_12_16_19_00/2016_12_16_19_00.mpg;Shinzo ABE.jpg;6781;7073;38481;339;353;14
/net/per610a/home/mvp/mvp_db/news7-lv/2016/2016_12_16_19_00/2016_12_16_19_00.mpg;YUriko Koike.jpg;24441;24553;38481;1222;1228;6
/net/per610a/home/mvp/mvp_db/news7-lv/2016/2016_12_16_19_00/2016_12_16_19_00.mpg;YUriko Koike.jpg;26473;26521;38481;1324;1326;2
/net/per610a/home/mvp/mvp_db/news7-lv/2016/2016_12_16_19_00/2016_12_16_19_00.mpg;YUriko Koike.jpg;27709;28209;38481;1386;1411;25
/net/per610a/home/mvp/mvp_db/news7-lv/2016/2016_12_16_19_00/2016_12_16_19_00.mpg;YUriko Koike.jpg;24633;24649;38481;1232;1233;1
/net/per610a/home/mvp/mvp_db/news7-lv/2016/2016_12_16_19_00/2016_12_16_19_00.mpg;YUriko Koike.jpg;25245;25497;38481;1262;1275;13
/net/per610a/home/mvp/mvp_db/news7-lv/2016/2016_12_16_19_00/2016_12_16_19_00.mpg;YUriko Koike.jpg;26985;27301;38481;1349;1365;16
/net/per610a/home/mvp/mvp_db/news7-lv/2016/2016_12_17_19_00/2016_12_17_19_00.mpg;YUriko Koike.jpg;8189;8281;36081;409;414;5
/net/per610a/home/mvp/mvp_db/news7-lv/2016/2016_12_17_19_00/2016_12_17_19_00.mpg;YUriko Koike.jpg;11329;11549;36081;566;577;11
/net/per610a/home/mvp/mvp_db/news7-lv/2016/2016_12_17_19_00/2016_12_17_19_00.mpg;YUriko Koike.jpg;10589;10925;36081;529;546;17
/net/per610a/home/mvp/mvp_db/news7-lv/2016/2016_12_20_19_00/2016_12_20_19_00.mpg;Shinzo ABE.jpg;18557;18669;36089;928;934;6
/net/per610a/home/mvp/mvp_db/news7-lv/2016/2016_12_21_19_00/2016_12_21_19_00.mpg;YUriko Koike.jpg;421;513;36089;21;25;4
/net/per610a/home/mvp/mvp_db/news7-lv/2016/2016_12_21_19_00/2016_12_21_19_00.mpg;YUriko Koike.jpg;593;833;36089;29;41;12
/net/per610a/home/mvp/mvp_db/news7-lv/2016/2016_12_21_19_00/2016_12_21_19_00.mpg;YUriko Koike.jpg;9413;9713;36089;471;486;15
/net/per610a/home/mvp/mvp_db/news7-lv/2016/2016_12_21_19_00/2016_12_21_19_00.mpg;Shinzo ABE.jpg;15029;15041;36089;752;752;0
/net/per610a/home/mvp/mvp_db/news7-lv/2016/2016_12_21_19_00/2016_12_21_19_00.mpg;Shinzo ABE.jpg;15841;16377;36089;792;819;27
/net/per610a/home/mvp/mvp_db/news7-lv/2016/2016_12_21_19_00/2016_12_21_19_00.mpg;Shinzo ABE.jpg;20837;21385;36089;1042;1070;28
/net/per610a/home/mvp/mvp_db/news7-lv/2016/2016_12_21_19_00/2016_12_21_19_00.mpg;Kazuo SHII.jpg;27505;27749;36089;1376;1388;12
/net/per610a/home/mvp/mvp_db/news7-lv/2016/2016_12_22_19_00/2016_12_22_19_00.mpg;YUriko Koike.jpg;29729;30113;38481;1487;1506;19
/net/per610a/home/mvp/mvp_db/news7-lv/2016/2016_12_24_19_00/2016_12_24_19_00.mpg;Toru Hashimoto.jpg;11233;11685;36089;562;584;22
/net/per610a/home/mvp/mvp_db/news7-lv/2016/2016_12_24_19_00/2016_12_24_19_00.mpg;Toru Hashimoto.jpg;12125;12841;36089;606;642;36
/net/per610a/home/mvp/mvp_db/news7-lv/2016/2016_12_24_19_00/2016_12_24_19_00.mpg;Shinzo ABE.jpg;11237;11685;36089;562;584;22
/net/per610a/home/mvp/mvp_db/news7-lv/2016/2016_12_24_19_00/2016_12_24_19_00.mpg;Shinzo ABE.jpg;12989;13037;36089;650;652;2
/net/per610a/home/mvp/mvp_db/news7-lv/2016/2016_12_24_19_00/2016_12_24_19_00.mpg;Shinzo ABE.jpg;12125;12917;36089;606;646;40
/net/per610a/home/mvp/mvp_db/news7-lv/2016/2016_12_25_19_00/2016_12_25_19_00.mpg;Toru Hashimoto.jpg;13881;13949;36089;694;698;4
/net/per610a/home/mvp/mvp_db/news7-lv/2016/2016_12_25_19_00/2016_12_25_19_00.mpg;Toru Hashimoto.jpg;14481;14593;36089;724;730;6
/net/per610a/home/mvp/mvp_db/news7-lv/2016/2016_12_25_19_00/2016_12_25_19_00.mpg;YUriko Koike.jpg;14729;15341;36089;737;767;30
/net/per610a/home/mvp/mvp_db/news7-lv/2016/2016_12_25_19_00/2016_12_25_19_00.mpg;YUriko Koike.jpg;15445;15725;36089;772;786;14
/net/per610a/home/mvp/mvp_db/news7-lv/2016/2016_12_27_19_00/2016_12_27_19_00.mpg;Shinzo ABE.jpg;237;365;36089;11;18;7
/net/per610a/home/mvp/mvp_db/news7-lv/2016/2016_12_27_19_00/2016_12_27_19_00.mpg;Shinzo ABE.jpg;1909;2009;36089;95;100;5
/net/per610a/home/mvp/mvp_db/news7-lv/2016/2016_12_27_19_00/2016_12_27_19_00.mpg;Shinzo ABE.jpg;3425;3853;36089;171;192;21
/net/per610a/home/mvp/mvp_db/news7-lv/2016/2016_12_27_19_00/2016_12_27_19_00.mpg;Shinzo ABE.jpg;10045;10321;36089;502;516;14
/net/per610a/home/mvp/mvp_db/news7-lv/2016/2016_12_27_19_00/2016_12_27_19_00.mpg;YUriko Koike.jpg;23129;23309;36089;1157;1166;9
/net/per610a/home/mvp/mvp_db/news7-lv/2016/2016_12_27_19_00/2016_12_27_19_00.mpg;YUriko Koike.jpg;23465;23589;36089;1174;1180;6
/net/per610a/home/mvp/mvp_db/news7-lv/2016/2016_12_27_19_00/2016_12_27_19_00.mpg;YUriko Koike.jpg;28441;29061;36089;1423;1454;31
/net/per610a/home/mvp/mvp_db/news7-lv/2016/2016_12_28_19_00/2016_12_28_19_00.mpg;Shinzo ABE.jpg;541;553;36089;27;27;0
/net/per610a/home/mvp/mvp_db/news7-lv/2016/2016_12_28_19_00/2016_12_28_19_00.mpg;Shinzo ABE.jpg;1253;1281;36089;62;64;2
/net/per610a/home/mvp/mvp_db/news7-lv/2016/2016_12_28_19_00/2016_12_28_19_00.mpg;Shinzo ABE.jpg;2089;2145;36089;104;107;3
/net/per610a/home/mvp/mvp_db/news7-lv/2016/2016_12_28_19_00/2016_12_28_19_00.mpg;Shinzo ABE.jpg;13337;13705;36089;667;685;18
/net/per610a/home/mvp/mvp_db/news7-lv/2016/2016_12_28_19_00/2016_12_28_19_00.mpg;Shinzo ABE.jpg;7953;8029;36089;397;401;4
/net/per610a/home/mvp/mvp_db/news7-lv/2016/2016_12_28_19_00/2016_12_28_19_00.mpg;Shinzo ABE.jpg;13285;13333;36089;664;667;3
/net/per610a/home/mvp/mvp_db/news7-lv/2016/2016_12_29_19_00/2016_12_29_19_00.mpg;Shinzo ABE.jpg;18809;18977;36081;940;949;9
/net/per610a/home/mvp/mvp_db/news7-lv/2018/2018_01_01_19_00/2018_01_01_19_00.mpg;Shinzo ABE.jpg;11581;11909;24089;579;595;16
/net/per610a/home/mvp/mvp_db/news7-lv/2018/2018_01_01_19_00/2018_01_01_19_00.mpg;Shinzo ABE.jpg;11977;13121;24089;599;656;57
/net/per610a/home/mvp/mvp_db/news7-lv/2018/2018_01_01_19_00/2018_01_01_19_00.mpg;Shinzo ABE.jpg;17797;18249;24089;890;912;22
/net/per610a/home/mvp/mvp_db/news7-lv/2018/2018_01_01_19_00/2018_01_01_19_00.mpg;Taro ASO.jpg;13357;13665;24089;668;683;15
/net/per610a/home/mvp/mvp_db/news7-lv/2018/2018_01_02_19_00/2018_01_02_19_00.mpg;Shinzo ABE.jpg;8209;8537;24089;410;427;17
/net/per610a/home/mvp/mvp_db/news7-lv/2018/2018_01_02_19_00/2018_01_02_19_00.mpg;Shinzo ABE.jpg;9229;9333;24089;461;466;5
/net/per610a/home/mvp/mvp_db/news7-lv/2018/2018_01_03_19_00/2018_01_03_19_00.mpg;Kohei Otsuka.jpg;20289;20605;36089;1015;1031;16
/net/per610a/home/mvp/mvp_db/news7-lv/2018/2018_01_03_19_00/2018_01_03_19_00.mpg;Kohei Otsuka.jpg;22385;22733;36089;1120;1137;17
/net/per610a/home/mvp/mvp_db/news7-lv/2018/2018_01_03_19_00/2018_01_03_19_00.mpg;Yuichiro Tamaki.png;22385;22617;36089;1120;1131;11
/net/per610a/home/mvp/mvp_db/news7-lv/2018/2018_01_04_19_00/2018_01_04_19_00.mpg;Natsuo YAMAGUCHI.jpg;4197;5933;36081;209;296;87
/net/per610a/home/mvp/mvp_db/news7-lv/2018/2018_01_04_19_00/2018_01_04_19_00.mpg;Yuichiro Tamaki.png;4557;4805;36081;227;240;13
/net/per610a/home/mvp/mvp_db/news7-lv/2018/2018_01_04_19_00/2018_01_04_19_00.mpg;Yukio EDANO.jpg;4557;4805;36081;227;240;13
/net/per610a/home/mvp/mvp_db/news7-lv/2018/2018_01_04_19_00/2018_01_04_19_00.mpg;Kazuo SHII.jpg;5989;6353;36081;299;317;18
/net/per610a/home/mvp/mvp_db/news7-lv/2018/2018_01_07_19_00/2018_01_07_19_00.mpg;Shinzo ABE.jpg;12801;13293;36089;640;665;25
/net/per610a/home/mvp/mvp_db/news7-lv/2018/2018_01_08_19_00/2018_01_08_19_00.mpg;Shinzo ABE.jpg;13601;13913;36089;680;696;16
/net/per610a/home/mvp/mvp_db/news7-lv/2018/2018_01_09_19_00/2018_01_09_19_00.mpg;Shinzo ABE.jpg;21141;21233;36089;1057;1062;5
/net/per610a/home/mvp/mvp_db/news7-lv/2018/2018_01_09_19_00/2018_01_09_19_00.mpg;Shinzo ABE.jpg;25013;25053;36089;1251;1253;2
/net/per610a/home/mvp/mvp_db/news7-lv/2018/2018_01_09_19_00/2018_01_09_19_00.mpg;Shinzo ABE.jpg;25269;25481;36089;1264;1275;11
/net/per610a/home/mvp/mvp_db/news7-lv/2018/2018_01_10_19_00/2018_01_10_19_00.mpg;Junichiro KOIZUMI.jpg;16929;17277;36089;847;864;17
/net/per610a/home/mvp/mvp_db/news7-lv/2018/2018_01_13_19_00/2018_01_13_19_00.mpg;Shinzo ABE.jpg;15925;16245;36081;796;812;16
/net/per610a/home/mvp/mvp_db/news7-lv/2018/2018_01_14_19_00/2018_01_14_19_00.mpg;Shinzo ABE.jpg;22633;22653;36081;1132;1133;1
/net/per610a/home/mvp/mvp_db/news7-lv/2018/2018_01_14_19_00/2018_01_14_19_00.mpg;Shinzo ABE.jpg;23401;23753;36081;1170;1188;18
/net/per610a/home/mvp/mvp_db/news7-lv/2018/2018_01_15_19_00/2018_01_15_19_00.mpg;Shinzo ABE.jpg;22505;23073;36089;1126;1154;28
/net/per610a/home/mvp/mvp_db/news7-lv/2018/2018_01_15_19_00/2018_01_15_19_00.mpg;Shinzo ABE.jpg;24885;25689;36089;1245;1285;40
/net/per610a/home/mvp/mvp_db/news7-lv/2018/2018_01_17_19_00/2018_01_17_19_00.mpg;Shinzo ABE.jpg;8389;8533;36081;419;426;7
/net/per610a/home/mvp/mvp_db/news7-lv/2018/2018_01_17_19_00/2018_01_17_19_00.mpg;Kohei Otsuka.jpg;28125;28265;36081;1406;1413;7
/net/per610a/home/mvp/mvp_db/news7-lv/2018/2018_01_18_19_00/2018_01_18_19_00.mpg;Shinzo ABE.jpg;24993;25041;36081;1250;1252;2
/net/per610a/home/mvp/mvp_db/news7-lv/2018/2018_01_18_19_00/2018_01_18_19_00.mpg;Shinzo ABE.jpg;25117;25589;36081;1256;1280;24
/net/per610a/home/mvp/mvp_db/news7-lv/2018/2018_01_20_19_00/2018_01_20_19_00.mpg;Ichiro OZAWA.jpg;21313;21773;36089;1066;1089;23
/net/per610a/home/mvp/mvp_db/news7-lv/2018/2018_01_22_19_00/2018_01_22_19_00.mpg;Shinzo ABE.jpg;16645;16877;38489;832;844;12
/net/per610a/home/mvp/mvp_db/news7-lv/2018/2018_01_22_19_00/2018_01_22_19_00.mpg;Shinzo ABE.jpg;17761;18121;38489;888;906;18
/net/per610a/home/mvp/mvp_db/news7-lv/2018/2018_01_22_19_00/2018_01_22_19_00.mpg;Shinzo ABE.jpg;19357;19873;38489;968;994;26
/net/per610a/home/mvp/mvp_db/news7-lv/2018/2018_01_22_19_00/2018_01_22_19_00.mpg;Shinzo ABE.jpg;20009;20233;38489;1001;1012;11
/net/per610a/home/mvp/mvp_db/news7-lv/2018/2018_01_22_19_00/2018_01_22_19_00.mpg;Shinzo ABE.jpg;21445;21673;38489;1073;1084;11
/net/per610a/home/mvp/mvp_db/news7-lv/2018/2018_01_22_19_00/2018_01_22_19_00.mpg;Shinzo ABE.jpg;21829;21869;38489;1092;1094;2
/net/per610a/home/mvp/mvp_db/news7-lv/2018/2018_01_22_19_00/2018_01_22_19_00.mpg;Shinzo ABE.jpg;22605;22649;38489;1131;1133;2
/net/per610a/home/mvp/mvp_db/news7-lv/2018/2018_01_24_19_00/2018_01_24_19_00.mpg;Yukio EDANO.jpg;16377;17505;36089;819;876;57
/net/per610a/home/mvp/mvp_db/news7-lv/2018/2018_01_24_19_00/2018_01_24_19_00.mpg;Shinzo ABE.jpg;16377;16429;36089;819;822;3
/net/per610a/home/mvp/mvp_db/news7-lv/2018/2018_01_24_19_00/2018_01_24_19_00.mpg;Shinzo ABE.jpg;17509;17561;36089;876;878;2
/net/per610a/home/mvp/mvp_db/news7-lv/2018/2018_01_24_19_00/2018_01_24_19_00.mpg;Shinzo ABE.jpg;18697;18749;36089;935;938;3
/net/per610a/home/mvp/mvp_db/news7-lv/2018/2018_01_24_19_00/2018_01_24_19_00.mpg;Shinzo ABE.jpg;20825;21389;36089;1042;1070;28
/net/per610a/home/mvp/mvp_db/news7-lv/2018/2018_01_25_19_00/2018_01_25_19_00.mpg;Shinzo ABE.jpg;16585;16637;36081;829;832;3
/net/per610a/home/mvp/mvp_db/news7-lv/2018/2018_01_25_19_00/2018_01_25_19_00.mpg;Shinzo ABE.jpg;17553;17605;36081;878;880;2
/net/per610a/home/mvp/mvp_db/news7-lv/2018/2018_01_25_19_00/2018_01_25_19_00.mpg;Shinzo ABE.jpg;18585;18637;36081;929;932;3
/net/per610a/home/mvp/mvp_db/news7-lv/2018/2018_01_25_19_00/2018_01_25_19_00.mpg;Shinzo ABE.jpg;19613;19665;36081;981;983;2
/net/per610a/home/mvp/mvp_db/news7-lv/2018/2018_01_25_19_00/2018_01_25_19_00.mpg;Kazuo SHII.jpg;18585;18937;36081;929;947;18
/net/per610a/home/mvp/mvp_db/news7-lv/2018/2018_01_26_19_00/2018_01_26_19_00.mpg;Junichiro KOIZUMI.jpg;2149;2221;36081;107;111;4
/net/per610a/home/mvp/mvp_db/news7-lv/2018/2018_01_26_19_00/2018_01_26_19_00.mpg;Shinzo ABE.jpg;15929;15997;36081;796;800;4
/net/per610a/home/mvp/mvp_db/news7-lv/2018/2018_01_26_19_00/2018_01_26_19_00.mpg;Shinzo ABE.jpg;16345;16997;36081;817;850;33
/net/per610a/home/mvp/mvp_db/news7-lv/2018/2018_01_26_19_00/2018_01_26_19_00.mpg;Shinzo ABE.jpg;17461;17537;36081;873;877;4
/net/per610a/home/mvp/mvp_db/news7-lv/2018/2018_01_26_19_00/2018_01_26_19_00.mpg;Shinzo ABE.jpg;17809;18253;36081;890;913;23
/net/per610a/home/mvp/mvp_db/news7-lv/2018/2018_01_26_19_00/2018_01_26_19_00.mpg;Shinzo ABE.jpg;18529;18837;36081;926;942;16
/net/per610a/home/mvp/mvp_db/news7-lv/2018/2018_01_26_19_00/2018_01_26_19_00.mpg;Shinzo ABE.jpg;18937;19009;36081;947;950;3
/net/per610a/home/mvp/mvp_db/news7-lv/2018/2018_01_26_19_00/2018_01_26_19_00.mpg;Shinzo ABE.jpg;20309;21005;36081;1015;1050;35
/net/per610a/home/mvp/mvp_db/news7-lv/2018/2018_01_29_19_00/2018_01_29_19_00.mpg;Taro ASO.jpg;4101;4449;36081;205;222;17
/net/per610a/home/mvp/mvp_db/news7-lv/2018/2018_01_31_19_00/2018_01_31_19_00.mpg;Shinzo ABE.jpg;18509;18517;36089;926;926;0
/net/per610a/home/mvp/mvp_db/news7-lv/2018/2018_01_31_19_00/2018_01_31_19_00.mpg;Shinzo ABE.jpg;18769;18997;36089;939;950;11
/net/per610a/home/mvp/mvp_db/news7-lv/2018/2018_01_31_19_00/2018_01_31_19_00.mpg;Shinzo ABE.jpg;19273;19745;36089;964;988;24
/net/per610a/home/mvp/mvp_db/news7-lv/2018/2018_01_31_19_00/2018_01_31_19_00.mpg;Shinzo ABE.jpg;20589;21137;36089;1030;1057;27
/net/per610a/home/mvp/mvp_db/news7-lv/2018/2018_02_04_19_00/2018_02_04_19_00.mpg;Kohei Otsuka.jpg;23813;23901;36081;1191;1195;4
/net/per610a/home/mvp/mvp_db/news7-lv/2018/2018_02_04_19_00/2018_02_04_19_00.mpg;Kohei Otsuka.jpg;24253;24509;36081;1213;1226;13
/net/per610a/home/mvp/mvp_db/news7-lv/2018/2018_02_04_19_00/2018_02_04_19_00.mpg;Kohei Otsuka.jpg;24609;25045;36081;1231;1252;21
/net/per610a/home/mvp/mvp_db/news7-lv/2018/2018_02_05_19_00/2018_02_05_19_00.mpg;Shinzo ABE.jpg;25073;25137;36089;1254;1257;3
/net/per610a/home/mvp/mvp_db/news7-lv/2018/2018_02_05_19_00/2018_02_05_19_00.mpg;Shinzo ABE.jpg;26017;26081;36089;1301;1305;4
/net/per610a/home/mvp/mvp_db/news7-lv/2018/2018_02_07_19_00/2018_02_07_19_00.mpg;Shinzo ABE.jpg;16781;17021;36081;839;851;12
/net/per610a/home/mvp/mvp_db/news7-lv/2018/2018_02_07_19_00/2018_02_07_19_00.mpg;Shinzo ABE.jpg;17577;18781;36081;879;939;60
/net/per610a/home/mvp/mvp_db/news7-lv/2018/2018_02_07_19_00/2018_02_07_19_00.mpg;Shinzo ABE.jpg;20621;21021;36081;1031;1051;20
/net/per610a/home/mvp/mvp_db/news7-lv/2018/2018_02_07_19_00/2018_02_07_19_00.mpg;Shinzo ABE.jpg;21449;21717;36081;1073;1086;13
/net/per610a/home/mvp/mvp_db/news7-lv/2018/2018_02_15_19_00/2018_02_15_19_00.mpg;Kohei Otsuka.jpg;23045;23485;36081;1152;1174;22
/net/per610a/home/mvp/mvp_db/news7-lv/2018/2018_02_15_19_00/2018_02_15_19_00.mpg;Shinzo ABE.jpg;24049;24181;36081;1203;1209;6
/net/per610a/home/mvp/mvp_db/news7-lv/2018/2018_02_20_19_00/2018_02_20_19_00.mpg;Shinzo ABE.jpg;4249;4381;36081;212;219;7
/net/per610a/home/mvp/mvp_db/news7-lv/2018/2018_02_20_19_00/2018_02_20_19_00.mpg;Shinzo ABE.jpg;27529;27889;36081;1377;1395;18
/net/per610a/home/mvp/mvp_db/news7-lv/2018/2018_02_21_19_00/2018_02_21_19_00.mpg;Shinzo ABE.jpg;17905;17977;36089;896;899;3
/net/per610a/home/mvp/mvp_db/news7-lv/2018/2018_02_21_19_00/2018_02_21_19_00.mpg;Shinzo ABE.jpg;18629;19377;36089;932;969;37
/net/per610a/home/mvp/mvp_db/news7-lv/2018/2018_02_21_19_00/2018_02_21_19_00.mpg;Natsuo YAMAGUCHI.jpg;18629;19057;36089;932;953;21
/net/per610a/home/mvp/mvp_db/news7-lv/2018/2018_02_22_19_00/2018_02_22_19_00.mpg;Shinzo ABE.jpg;23265;23593;36089;1164;1180;16
/net/per610a/home/mvp/mvp_db/news7-lv/2018/2018_02_22_19_00/2018_02_22_19_00.mpg;Shinzo ABE.jpg;23661;23777;36089;1184;1189;5
/net/per610a/home/mvp/mvp_db/news7-lv/2018/2018_02_22_19_00/2018_02_22_19_00.mpg;Shinzo ABE.jpg;24101;24241;36089;1206;1213;7
/net/per610a/home/mvp/mvp_db/news7-lv/2018/2018_02_22_19_00/2018_02_22_19_00.mpg;Shinzo ABE.jpg;25161;25237;36089;1259;1262;3
/net/per610a/home/mvp/mvp_db/news7-lv/2018/2018_02_24_19_00/2018_02_24_19_00.mpg;Natsuo YAMAGUCHI.jpg;29697;29725;36081;1485;1487;2
/net/per610a/home/mvp/mvp_db/news7-lv/2018/2018_02_24_19_00/2018_02_24_19_00.mpg;Natsuo YAMAGUCHI.jpg;29817;30397;36081;1491;1520;29
/net/per610a/home/mvp/mvp_db/news7-lv/2018/2018_02_26_19_00/2018_02_26_19_00.mpg;Shinzo ABE.jpg;21069;21081;36089;1054;1054;0
/net/per610a/home/mvp/mvp_db/news7-lv/2018/2018_02_26_19_00/2018_02_26_19_00.mpg;Shinzo ABE.jpg;21305;21325;36089;1066;1067;1
/net/per610a/home/mvp/mvp_db/news7-lv/2018/2018_02_26_19_00/2018_02_26_19_00.mpg;Shinzo ABE.jpg;21717;22445;36089;1086;1123;37
/net/per610a/home/mvp/mvp_db/news7-lv/2018/2018_02_27_19_00/2018_02_27_19_00.mpg;Shinzo ABE.jpg;25293;25501;36081;1265;1275;10
/net/per610a/home/mvp/mvp_db/news7-lv/2018/2018_03_01_19_00/2018_03_01_19_00.mpg;Yukio EDANO.jpg;9993;10389;36089;500;519;19
/net/per610a/home/mvp/mvp_db/news7-lv/2018/2018_03_05_19_00/2018_03_05_19_00.mpg;Shinzo ABE.jpg;19741;19805;36081;987;990;3
/net/per610a/home/mvp/mvp_db/news7-lv/2018/2018_03_05_19_00/2018_03_05_19_00.mpg;Shinzo ABE.jpg;19993;20013;36081;1000;1001;1
/net/per610a/home/mvp/mvp_db/news7-lv/2018/2018_03_05_19_00/2018_03_05_19_00.mpg;Shinzo ABE.jpg;20141;20245;36081;1007;1012;5
/net/per610a/home/mvp/mvp_db/news7-lv/2018/2018_03_06_19_00/2018_03_06_19_00.mpg;Taro ASO.jpg;8829;9085;36081;441;454;13
/net/per610a/home/mvp/mvp_db/news7-lv/2018/2018_03_07_19_00/2018_03_07_19_00.mpg;Ichiro OZAWA.jpg;11909;12349;36081;595;617;22
/net/per610a/home/mvp/mvp_db/news7-lv/2018/2018_03_08_19_00/2018_03_08_19_00.mpg;Shinzo ABE.jpg;3921;4233;36081;196;211;15
/net/per610a/home/mvp/mvp_db/news7-lv/2018/2018_03_08_19_00/2018_03_08_19_00.mpg;Shinzo ABE.jpg;4301;4441;36081;215;222;7
/net/per610a/home/mvp/mvp_db/news7-lv/2018/2018_03_09_19_00/2018_03_09_19_00.mpg;Taro ASO.jpg;865;889;70849;43;44;1
/net/per610a/home/mvp/mvp_db/news7-lv/2018/2018_03_09_19_00/2018_03_09_19_00.mpg;Taro ASO.jpg;50073;66117;70849;2506;3309;803
/net/per610a/home/mvp/mvp_db/news7-lv/2018/2018_03_09_19_00/2018_03_09_19_00.mpg;Taro ASO.jpg;69333;69709;70849;3470;3488;18
/net/per610a/home/mvp/mvp_db/news7-lv/2018/2018_03_09_19_00/2018_03_09_19_00.mpg;Shinzo ABE.jpg;11057;12245;70849;553;612;59
/net/per610a/home/mvp/mvp_db/news7-lv/2018/2018_03_09_19_00/2018_03_09_19_00.mpg;Shinzo ABE.jpg;34401;34565;70849;1721;1729;8
/net/per610a/home/mvp/mvp_db/news7-lv/2018/2018_03_10_19_00/2018_03_10_19_00.mpg;Shinzo ABE.jpg;8105;8497;36089;405;425;20
/net/per610a/home/mvp/mvp_db/news7-lv/2018/2018_03_10_19_00/2018_03_10_19_00.mpg;Shinzo ABE.jpg;8877;9697;36089;444;485;41
/net/per610a/home/mvp/mvp_db/news7-lv/2018/2018_03_10_19_00/2018_03_10_19_00.mpg;Shinzo ABE.jpg;19589;20093;36089;980;1005;25
/net/per610a/home/mvp/mvp_db/news7-lv/2018/2018_03_11_19_00/2018_03_11_19_00.mpg;Taro ASO.jpg;8717;8869;72049;436;443;7
/net/per610a/home/mvp/mvp_db/news7-lv/2018/2018_03_11_19_00/2018_03_11_19_00.mpg;Taro ASO.jpg;10389;10857;72049;519;543;24
/net/per610a/home/mvp/mvp_db/news7-lv/2018/2018_03_12_19_00/2018_03_12_19_00.mpg;Yukio EDANO.jpg;12809;14681;36089;641;734;93
/net/per610a/home/mvp/mvp_db/news7-lv/2018/2018_03_12_19_00/2018_03_12_19_00.mpg;Shinzo ABE.jpg;21985;22381;36089;1100;1120;20
/net/per610a/home/mvp/mvp_db/news7-lv/2018/2018_03_13_19_00/2018_03_13_19_00.mpg;Taro ASO.jpg;573;693;36089;28;34;6
/net/per610a/home/mvp/mvp_db/news7-lv/2018/2018_03_13_19_00/2018_03_13_19_00.mpg;Taro ASO.jpg;1093;1577;36089;54;78;24
/net/per610a/home/mvp/mvp_db/news7-lv/2018/2018_03_13_19_00/2018_03_13_19_00.mpg;Taro ASO.jpg;5285;5541;36089;264;277;13
/net/per610a/home/mvp/mvp_db/news7-lv/2018/2018_03_13_19_00/2018_03_13_19_00.mpg;Yukio EDANO.jpg;6905;8485;36089;345;424;79
/net/per610a/home/mvp/mvp_db/news7-lv/2018/2018_03_13_19_00/2018_03_13_19_00.mpg;Natsuo YAMAGUCHI.jpg;9149;9549;36089;457;477;20
/net/per610a/home/mvp/mvp_db/news7-lv/2018/2018_03_13_19_00/2018_03_13_19_00.mpg;Shinzo ABE.jpg;12113;12189;36089;606;609;3
/net/per610a/home/mvp/mvp_db/news7-lv/2018/2018_03_13_19_00/2018_03_13_19_00.mpg;Shinzo ABE.jpg;12865;13005;36089;643;650;7
/net/per610a/home/mvp/mvp_db/news7-lv/2018/2018_03_14_19_00/2018_03_14_19_00.mpg;Shinzo ABE.jpg;749;813;36089;37;40;3
/net/per610a/home/mvp/mvp_db/news7-lv/2018/2018_03_14_19_00/2018_03_14_19_00.mpg;Shinzo ABE.jpg;1049;1217;36089;52;60;8
/net/per610a/home/mvp/mvp_db/news7-lv/2018/2018_03_14_19_00/2018_03_14_19_00.mpg;Shinzo ABE.jpg;4693;4773;36089;234;238;4
/net/per610a/home/mvp/mvp_db/news7-lv/2018/2018_03_15_19_00/2018_03_15_19_00.mpg;Kazuo SHII.jpg;8525;8805;36089;426;440;14
/net/per610a/home/mvp/mvp_db/news7-lv/2018/2018_03_16_19_00/2018_03_16_19_00.mpg;Taro ASO.jpg;3145;3329;36081;157;166;9
/net/per610a/home/mvp/mvp_db/news7-lv/2018/2018_03_16_19_00/2018_03_16_19_00.mpg;Taro ASO.jpg;4229;4305;36081;211;215;4
/net/per610a/home/mvp/mvp_db/news7-lv/2018/2018_03_16_19_00/2018_03_16_19_00.mpg;Taro ASO.jpg;5297;5309;36081;264;265;1
/net/per610a/home/mvp/mvp_db/news7-lv/2018/2018_03_16_19_00/2018_03_16_19_00.mpg;Shinzo ABE.jpg;14349;15125;36081;717;756;39
/net/per610a/home/mvp/mvp_db/news7-lv/2018/2018_03_16_19_00/2018_03_16_19_00.mpg;Shinzo ABE.jpg;26861;26877;36081;1343;1344;1
/net/per610a/home/mvp/mvp_db/news7-lv/2018/2018_03_18_19_00/2018_03_18_19_00.mpg;Taro ASO.jpg;3765;3961;36081;188;198;10
/net/per610a/home/mvp/mvp_db/news7-lv/2018/2018_03_19_19_00/2018_03_19_19_00.mpg;Shinzo ABE.jpg;321;325;36081;16;16;0
/net/per610a/home/mvp/mvp_db/news7-lv/2018/2018_03_19_19_00/2018_03_19_19_00.mpg;Shinzo ABE.jpg;1453;1817;36081;72;90;18
/net/per610a/home/mvp/mvp_db/news7-lv/2018/2018_03_19_19_00/2018_03_19_19_00.mpg;Shinzo ABE.jpg;3421;3429;36081;171;171;0
/net/per610a/home/mvp/mvp_db/news7-lv/2018/2018_03_19_19_00/2018_03_19_19_00.mpg;Shinzo ABE.jpg;4269;4305;36081;213;215;2
/net/per610a/home/mvp/mvp_db/news7-lv/2018/2018_03_19_19_00/2018_03_19_19_00.mpg;Shinzo ABE.jpg;14229;14445;36081;711;722;11
/net/per610a/home/mvp/mvp_db/news7-lv/2018/2018_03_20_19_00/2018_03_20_19_00.mpg;Shinzo ABE.jpg;705;825;36081;35;41;6
/net/per610a/home/mvp/mvp_db/news7-lv/2018/2018_03_20_19_00/2018_03_20_19_00.mpg;Shinzo ABE.jpg;7389;7429;36081;369;371;2
/net/per610a/home/mvp/mvp_db/news7-lv/2018/2018_03_20_19_00/2018_03_20_19_00.mpg;Natsuo YAMAGUCHI.jpg;865;1261;36081;43;63;20
/net/per610a/home/mvp/mvp_db/news7-lv/2018/2018_03_20_19_00/2018_03_20_19_00.mpg;Yukio EDANO.jpg;3989;4369;36081;199;218;19
/net/per610a/home/mvp/mvp_db/news7-lv/2018/2018_03_20_19_00/2018_03_20_19_00.mpg;Taro ASO.jpg;5345;5773;36081;267;288;21
/net/per610a/home/mvp/mvp_db/news7-lv/2018/2018_03_22_19_00/2018_03_22_19_00.mpg;Natsuo YAMAGUCHI.jpg;16445;16709;36081;822;835;13
/net/per610a/home/mvp/mvp_db/news7-lv/2018/2018_03_23_19_00/2018_03_23_19_00.mpg;Taro ASO.jpg;16569;17505;36081;828;875;47
/net/per610a/home/mvp/mvp_db/news7-lv/2018/2018_03_23_19_00/2018_03_23_19_00.mpg;Taro ASO.jpg;17573;17869;36081;879;893;14
/net/per610a/home/mvp/mvp_db/news7-lv/2018/2018_03_23_19_00/2018_03_23_19_00.mpg;Taro ASO.jpg;18169;18257;36081;908;913;5
/net/per610a/home/mvp/mvp_db/news7-lv/2018/2018_03_23_19_00/2018_03_23_19_00.mpg;Shinzo ABE.jpg;20573;21577;36081;1029;1079;50
/net/per610a/home/mvp/mvp_db/news7-lv/2018/2018_03_24_19_00/2018_03_24_19_00.mpg;Shinzo ABE.jpg;16085;16861;36089;804;843;39
/net/per610a/home/mvp/mvp_db/news7-lv/2018/2018_03_25_19_00/2018_03_25_19_00.mpg;Shinzo ABE.jpg;4337;4669;36081;216;233;17
/net/per610a/home/mvp/mvp_db/news7-lv/2018/2018_03_25_19_00/2018_03_25_19_00.mpg;Shinzo ABE.jpg;4809;4961;36081;240;248;8
/net/per610a/home/mvp/mvp_db/news7-lv/2018/2018_03_25_19_00/2018_03_25_19_00.mpg;Shinzo ABE.jpg;6349;6485;36081;317;324;7
/net/per610a/home/mvp/mvp_db/news7-lv/2018/2018_03_25_19_00/2018_03_25_19_00.mpg;Shinzo ABE.jpg;10173;10357;36081;508;518;10
/net/per610a/home/mvp/mvp_db/news7-lv/2018/2018_03_25_19_00/2018_03_25_19_00.mpg;Shinzo ABE.jpg;10533;10673;36081;526;533;7
/net/per610a/home/mvp/mvp_db/news7-lv/2018/2018_03_25_19_00/2018_03_25_19_00.mpg;Shinzo ABE.jpg;11173;11277;36081;558;564;6
/net/per610a/home/mvp/mvp_db/news7-lv/2018/2018_03_25_19_00/2018_03_25_19_00.mpg;Shinzo ABE.jpg;10941;11065;36081;547;553;6
/net/per610a/home/mvp/mvp_db/news7-lv/2018/2018_03_25_19_00/2018_03_25_19_00.mpg;Shinzo ABE.jpg;11737;11841;36081;587;592;5
/net/per610a/home/mvp/mvp_db/news7-lv/2018/2018_03_25_19_00/2018_03_25_19_00.mpg;Shinzo ABE.jpg;27753;27781;36081;1388;1389;1
/net/per610a/home/mvp/mvp_db/news7-lv/2018/2018_03_25_19_00/2018_03_25_19_00.mpg;Shinzo ABE.jpg;28085;28301;36081;1404;1415;11
/net/per610a/home/mvp/mvp_db/news7-lv/2018/2018_03_27_19_00/2018_03_27_19_00.mpg;Shinzo ABE.jpg;12385;12885;38489;619;644;25
/net/per610a/home/mvp/mvp_db/news7-lv/2018/2018_03_28_19_00/2018_03_28_19_00.mpg;Shinzo ABE.jpg;3237;3261;36089;161;163;2
/net/per610a/home/mvp/mvp_db/news7-lv/2018/2018_03_28_19_00/2018_03_28_19_00.mpg;Shinzo ABE.jpg;6377;6429;36089;319;321;2
/net/per610a/home/mvp/mvp_db/news7-lv/2018/2018_03_28_19_00/2018_03_28_19_00.mpg;Shinzo ABE.jpg;9521;9693;36089;476;485;9
/net/per610a/home/mvp/mvp_db/news7-lv/2018/2018_04_02_19_00/2018_04_02_19_00.mpg;Shinzo ABE.jpg;15541;15977;36089;777;799;22
/net/per610a/home/mvp/mvp_db/news7-lv/2018/2018_04_05_19_00/2018_04_05_19_00.mpg;Yukio EDANO.jpg;12101;12521;36089;605;626;21
/net/per610a/home/mvp/mvp_db/news7-lv/2018/2018_04_05_19_00/2018_04_05_19_00.mpg;YUriko Koike.jpg;19809;20169;36089;991;1009;18
/net/per610a/home/mvp/mvp_db/news7-lv/2018/2018_04_06_19_00/2018_04_06_19_00.mpg;Shinzo ABE.jpg;19881;20041;36081;994;1002;8
/net/per610a/home/mvp/mvp_db/news7-lv/2018/2018_04_09_19_00/2018_04_09_19_00.mpg;Shinzo ABE.jpg;16397;16513;36081;820;826;6
/net/per610a/home/mvp/mvp_db/news7-lv/2018/2018_04_09_19_00/2018_04_09_19_00.mpg;Shinzo ABE.jpg;20089;20097;36081;1004;1005;1
/net/per610a/home/mvp/mvp_db/news7-lv/2018/2018_04_09_19_00/2018_04_09_19_00.mpg;Shinzo ABE.jpg;20181;20349;36081;1009;1017;8
/net/per610a/home/mvp/mvp_db/news7-lv/2018/2018_04_09_19_00/2018_04_09_19_00.mpg;Taro ASO.jpg;22349;22629;36081;1118;1132;14
/net/per610a/home/mvp/mvp_db/news7-lv/2018/2018_04_11_19_00/2018_04_11_19_00.mpg;Yuichiro Tamaki.png;10217;10529;36089;511;526;15
/net/per610a/home/mvp/mvp_db/news7-lv/2018/2018_04_11_19_00/2018_04_11_19_00.mpg;Naoto KAN.jpg;10977;11081;36089;549;554;5
/net/per610a/home/mvp/mvp_db/news7-lv/2018/2018_04_11_19_00/2018_04_11_19_00.mpg;Naoto KAN.jpg;13497;13765;36089;675;688;13
/net/per610a/home/mvp/mvp_db/news7-lv/2018/2018_04_11_19_00/2018_04_11_19_00.mpg;Yukio EDANO.jpg;15537;15901;36089;777;795;18
/net/per610a/home/mvp/mvp_db/news7-lv/2018/2018_04_11_19_00/2018_04_11_19_00.mpg;Shinzo ABE.jpg;28057;28229;36089;1404;1412;8
/net/per610a/home/mvp/mvp_db/news7-lv/2018/2018_04_14_19_00/2018_04_14_19_00.mpg;Shinzo ABE.jpg;2745;3381;36085;137;169;32
/net/per610a/home/mvp/mvp_db/news7-lv/2018/2018_04_14_19_00/2018_04_14_19_00.mpg;Yukio EDANO.jpg;29417;29773;36085;1472;1490;18
/net/per610a/home/mvp/mvp_db/news7-lv/2018/2018_04_15_19_00/2018_04_15_19_00.mpg;Shinzo ABE.jpg;6181;6205;36089;309;310;1
/net/per610a/home/mvp/mvp_db/news7-lv/2018/2018_04_15_19_00/2018_04_15_19_00.mpg;Shinzo ABE.jpg;6425;7101;36089;321;355;34
/net/per610a/home/mvp/mvp_db/news7-lv/2018/2018_04_16_19_00/2018_04_16_19_00.mpg;Taro ASO.jpg;3141;3477;36089;157;173;16
/net/per610a/home/mvp/mvp_db/news7-lv/2018/2018_04_16_19_00/2018_04_16_19_00.mpg;Junichiro KOIZUMI.jpg;11005;11093;36089;550;555;5
/net/per610a/home/mvp/mvp_db/news7-lv/2018/2018_04_17_19_00/2018_04_17_19_00.mpg;Yukio EDANO.jpg;5681;5997;36089;284;300;16
/net/per610a/home/mvp/mvp_db/news7-lv/2018/2018_04_17_19_00/2018_04_17_19_00.mpg;Ichiro OZAWA.jpg;6069;6845;36089;303;342;39
/net/per610a/home/mvp/mvp_db/news7-lv/2018/2018_04_17_19_00/2018_04_17_19_00.mpg;Shinzo ABE.jpg;7685;7765;36089;384;388;4
/net/per610a/home/mvp/mvp_db/news7-lv/2018/2018_04_17_19_00/2018_04_17_19_00.mpg;Shinzo ABE.jpg;10745;10829;36089;537;541;4
/net/per610a/home/mvp/mvp_db/news7-lv/2018/2018_04_17_19_00/2018_04_17_19_00.mpg;Shinzo ABE.jpg;16313;16873;36089;816;844;28
/net/per610a/home/mvp/mvp_db/news7-lv/2018/2018_04_17_19_00/2018_04_17_19_00.mpg;Shinzo ABE.jpg;18421;18421;36089;921;921;0
/net/per610a/home/mvp/mvp_db/news7-lv/2018/2018_04_17_19_00/2018_04_17_19_00.mpg;Shinzo ABE.jpg;19577;19645;36089;979;983;4
/net/per610a/home/mvp/mvp_db/news7-lv/2018/2018_04_18_19_00/2018_04_18_19_00.mpg;Taro ASO.jpg;769;1401;36089;38;70;32
/net/per610a/home/mvp/mvp_db/news7-lv/2018/2018_04_18_19_00/2018_04_18_19_00.mpg;Shinzo ABE.jpg;16545;16557;36089;827;828;1
/net/per610a/home/mvp/mvp_db/news7-lv/2018/2018_04_18_19_00/2018_04_18_19_00.mpg;Shinzo ABE.jpg;19093;19665;36089;955;984;29
/net/per610a/home/mvp/mvp_db/news7-lv/2018/2018_04_18_19_00/2018_04_18_19_00.mpg;Shinzo ABE.jpg;23913;23981;36089;1196;1200;4
/net/per610a/home/mvp/mvp_db/news7-lv/2018/2018_04_18_19_00/2018_04_18_19_00.mpg;Shinzo ABE.jpg;24545;24625;36089;1228;1232;4
/net/per610a/home/mvp/mvp_db/news7-lv/2018/2018_04_18_19_00/2018_04_18_19_00.mpg;Shinzo ABE.jpg;23985;23985;36089;1200;1200;0
/net/per610a/home/mvp/mvp_db/news7-lv/2018/2018_04_18_19_00/2018_04_18_19_00.mpg;Shinzo ABE.jpg;25413;25989;36089;1271;1300;29
/net/per610a/home/mvp/mvp_db/news7-lv/2018/2018_04_19_19_00/2018_04_19_19_00.mpg;Shinzo ABE.jpg;17257;17417;36081;863;871;8
/net/per610a/home/mvp/mvp_db/news7-lv/2018/2018_04_19_19_00/2018_04_19_19_00.mpg;Shinzo ABE.jpg;18201;18201;36081;910;910;0
/net/per610a/home/mvp/mvp_db/news7-lv/2018/2018_04_19_19_00/2018_04_19_19_00.mpg;Shinzo ABE.jpg;18481;18521;36081;924;926;2
/net/per610a/home/mvp/mvp_db/news7-lv/2018/2018_04_19_19_00/2018_04_19_19_00.mpg;Shinzo ABE.jpg;18597;18621;36081;930;931;1
/net/per610a/home/mvp/mvp_db/news7-lv/2018/2018_04_19_19_00/2018_04_19_19_00.mpg;Shinzo ABE.jpg;22473;22689;36081;1124;1135;11
/net/per610a/home/mvp/mvp_db/news7-lv/2018/2018_04_19_19_00/2018_04_19_19_00.mpg;Shinzo ABE.jpg;24145;24741;36081;1207;1237;30
/net/per610a/home/mvp/mvp_db/news7-lv/2018/2018_04_20_19_00/2018_04_20_19_00.mpg;Taro ASO.jpg;437;785;36081;21;39;18
/net/per610a/home/mvp/mvp_db/news7-lv/2018/2018_04_20_19_00/2018_04_20_19_00.mpg;Taro ASO.jpg;3433;3865;36081;171;193;22
/net/per610a/home/mvp/mvp_db/news7-lv/2018/2018_04_22_19_00/2018_04_22_19_00.mpg;Shinzo ABE.jpg;23997;24377;36089;1200;1219;19
/net/per610a/home/mvp/mvp_db/news7-lv/2018/2018_04_22_19_00/2018_04_22_19_00.mpg;Shinzo ABE.jpg;25281;25793;36089;1265;1290;25
/net/per610a/home/mvp/mvp_db/news7-lv/2018/2018_04_24_19_00/2018_04_24_19_00.mpg;Shinzo ABE.jpg;14601;15489;36081;730;774;44
/net/per610a/home/mvp/mvp_db/news7-lv/2018/2018_04_24_19_00/2018_04_24_19_00.mpg;Shinzo ABE.jpg;23045;23585;36081;1152;1179;27
/net/per610a/home/mvp/mvp_db/news7-lv/2018/2018_04_24_19_00/2018_04_24_19_00.mpg;Natsuo YAMAGUCHI.jpg;14601;15489;36081;730;774;44
/net/per610a/home/mvp/mvp_db/news7-lv/2018/2018_04_24_19_00/2018_04_24_19_00.mpg;Yuichiro Tamaki.png;30565;30813;36081;1529;1541;12
/net/per610a/home/mvp/mvp_db/news7-lv/2018/2018_04_25_19_00/2018_04_25_19_00.mpg;Yukio EDANO.jpg;2845;3117;36089;142;155;13
/net/per610a/home/mvp/mvp_db/news7-lv/2018/2018_04_25_19_00/2018_04_25_19_00.mpg;Shinzo ABE.jpg;3801;3885;36089;190;194;4
/net/per610a/home/mvp/mvp_db/news7-lv/2018/2018_04_25_19_00/2018_04_25_19_00.mpg;Shinzo ABE.jpg;4389;4685;36089;219;234;15
/net/per610a/home/mvp/mvp_db/news7-lv/2018/2018_04_26_19_00/2018_04_26_19_00.mpg;YUriko Koike.jpg;17593;17805;36089;880;891;11
/net/per610a/home/mvp/mvp_db/news7-lv/2018/2018_04_27_19_00/2018_04_27_19_00.mpg;Shinzo ABE.jpg;16957;19033;39681;848;952;104
/net/per610a/home/mvp/mvp_db/news7-lv/2018/2018_04_27_19_00/2018_04_27_19_00.mpg;Shinzo ABE.jpg;29757;29829;39681;1488;1492;4
/net/per610a/home/mvp/mvp_db/news7-lv/2018/2018_04_27_19_00/2018_04_27_19_00.mpg;Natsuo YAMAGUCHI.jpg;29169;29557;39681;1459;1478;19
/net/per610a/home/mvp/mvp_db/news7-lv/2018/2018_04_29_19_00/2018_04_29_19_00.mpg;Shinzo ABE.jpg;12405;12689;36081;620;634;14
/net/per610a/home/mvp/mvp_db/news7-lv/2018/2018_05_01_19_00/2018_05_01_19_00.mpg;Shinzo ABE.jpg;27813;27917;36081;1391;1396;5
/net/per610a/home/mvp/mvp_db/news7-lv/2018/2018_05_03_19_00/2018_05_03_19_00.mpg;Yukio EDANO.jpg;11629;12081;36081;581;604;23
/net/per610a/home/mvp/mvp_db/news7-lv/2018/2018_05_03_19_00/2018_05_03_19_00.mpg;Yukio EDANO.jpg;23657;23717;36081;1183;1186;3
/net/per610a/home/mvp/mvp_db/news7-lv/2018/2018_05_03_19_00/2018_05_03_19_00.mpg;Shinzo ABE.jpg;20549;20965;36081;1027;1048;21
/net/per610a/home/mvp/mvp_db/news7-lv/2018/2018_05_03_19_00/2018_05_03_19_00.mpg;Shinzo ABE.jpg;21209;22413;36081;1061;1121;60
/net/per610a/home/mvp/mvp_db/news7-lv/2018/2018_05_04_19_00/2018_05_04_19_00.mpg;Shinzo ABE.jpg;4317;7649;36081;215;382;167
/net/per610a/home/mvp/mvp_db/news7-lv/2018/2018_05_07_19_00/2018_05_07_19_00.mpg;Kohei Otsuka.jpg;7525;7621;36081;376;381;5
/net/per610a/home/mvp/mvp_db/news7-lv/2018/2018_05_07_19_00/2018_05_07_19_00.mpg;Kohei Otsuka.jpg;7705;8165;36081;385;408;23
/net/per610a/home/mvp/mvp_db/news7-lv/2018/2018_05_07_19_00/2018_05_07_19_00.mpg;Kohei Otsuka.jpg;10701;10733;36081;535;536;1
/net/per610a/home/mvp/mvp_db/news7-lv/2018/2018_05_07_19_00/2018_05_07_19_00.mpg;Yukio EDANO.jpg;10461;10561;36081;523;528;5
/net/per610a/home/mvp/mvp_db/news7-lv/2018/2018_05_08_19_00/2018_05_08_19_00.mpg;Shinzo ABE.jpg;14609;14805;36081;730;740;10
/net/per610a/home/mvp/mvp_db/news7-lv/2018/2018_05_09_19_00/2018_05_09_19_00.mpg;Shinzo ABE.jpg;12493;14257;36089;625;713;88
/net/per610a/home/mvp/mvp_db/news7-lv/2018/2018_05_14_19_00/2018_05_14_19_00.mpg;Shinzo ABE.jpg;17945;18401;36089;898;920;22
/net/per610a/home/mvp/mvp_db/news7-lv/2018/2018_05_14_19_00/2018_05_14_19_00.mpg;Shinzo ABE.jpg;22305;22721;36089;1116;1137;21
/net/per610a/home/mvp/mvp_db/news7-lv/2018/2018_05_14_19_00/2018_05_14_19_00.mpg;Shinzo ABE.jpg;25313;25749;36089;1266;1288;22
/net/per610a/home/mvp/mvp_db/news7-lv/2018/2018_05_14_19_00/2018_05_14_19_00.mpg;Shinzo ABE.jpg;23489;23521;36089;1175;1177;2
/net/per610a/home/mvp/mvp_db/news7-lv/2018/2018_05_14_19_00/2018_05_14_19_00.mpg;Shinzo ABE.jpg;23593;23669;36089;1180;1184;4
/net/per610a/home/mvp/mvp_db/news7-lv/2018/2018_05_19_19_00/2018_05_19_19_00.mpg;Shinzo ABE.jpg;18261;18349;36089;913;918;5
/net/per610a/home/mvp/mvp_db/news7-lv/2018/2018_05_19_19_00/2018_05_19_19_00.mpg;Shinzo ABE.jpg;19485;19889;36089;975;995;20
/net/per610a/home/mvp/mvp_db/news7-lv/2018/2018_05_19_19_00/2018_05_19_19_00.mpg;Shinzo ABE.jpg;20353;20517;36089;1018;1026;8
/net/per610a/home/mvp/mvp_db/news7-lv/2018/2018_05_22_19_00/2018_05_22_19_00.mpg;Shinzo ABE.jpg;13841;14169;36081;692;708;16
/net/per610a/home/mvp/mvp_db/news7-lv/2018/2018_05_22_19_00/2018_05_22_19_00.mpg;Shinzo ABE.jpg;14269;14397;36081;713;720;7
/net/per610a/home/mvp/mvp_db/news7-lv/2018/2018_05_23_19_00/2018_05_23_19_00.mpg;Shinzo ABE.jpg;15917;16329;36089;796;817;21
/net/per610a/home/mvp/mvp_db/news7-lv/2018/2018_05_23_19_00/2018_05_23_19_00.mpg;Shinzo ABE.jpg;19189;19485;36089;960;975;15
/net/per610a/home/mvp/mvp_db/news7-lv/2018/2018_05_24_19_00/2018_05_24_19_00.mpg;Shinzo ABE.jpg;21889;22361;36089;1095;1119;24
/net/per610a/home/mvp/mvp_db/news7-lv/2018/2018_05_25_19_00/2018_05_25_19_00.mpg;Shinzo ABE.jpg;2737;3709;36089;136;185;49
/net/per610a/home/mvp/mvp_db/news7-lv/2018/2018_05_26_19_00/2018_05_26_19_00.mpg;Shinzo ABE.jpg;19881;20133;36089;994;1007;13
/net/per610a/home/mvp/mvp_db/news7-lv/2018/2018_05_26_19_00/2018_05_26_19_00.mpg;Shinzo ABE.jpg;20293;20417;36089;1015;1021;6
/net/per610a/home/mvp/mvp_db/news7-lv/2018/2018_05_26_19_00/2018_05_26_19_00.mpg;Shinzo ABE.jpg;21697;21741;36089;1085;1087;2
/net/per610a/home/mvp/mvp_db/news7-lv/2018/2018_05_26_19_00/2018_05_26_19_00.mpg;Shinzo ABE.jpg;21813;22437;36089;1091;1122;31
/net/per610a/home/mvp/mvp_db/news7-lv/2018/2018_05_26_19_00/2018_05_26_19_00.mpg;Shinzo ABE.jpg;23373;23633;36089;1169;1182;13
/net/per610a/home/mvp/mvp_db/news7-lv/2018/2018_05_28_19_00/2018_05_28_19_00.mpg;Shinzo ABE.jpg;10829;11429;36081;541;571;30
/net/per610a/home/mvp/mvp_db/news7-lv/2018/2018_05_30_19_00/2018_05_30_19_00.mpg;Shinzo ABE.jpg;15661;16277;36081;783;814;31
/net/per610a/home/mvp/mvp_db/news7-lv/2018/2018_05_30_19_00/2018_05_30_19_00.mpg;Shinzo ABE.jpg;16773;17813;36081;839;891;52
/net/per610a/home/mvp/mvp_db/news7-lv/2018/2018_05_30_19_00/2018_05_30_19_00.mpg;Shinzo ABE.jpg;18029;18613;36081;901;931;30
/net/per610a/home/mvp/mvp_db/news7-lv/2018/2018_05_30_19_00/2018_05_30_19_00.mpg;Shinzo ABE.jpg;19045;19617;36081;952;981;29
/net/per610a/home/mvp/mvp_db/news7-lv/2018/2018_05_30_19_00/2018_05_30_19_00.mpg;Shinzo ABE.jpg;20557;20781;36081;1028;1039;11
/net/per610a/home/mvp/mvp_db/news7-lv/2018/2018_05_31_19_00/2018_05_31_19_00.mpg;Taro ASO.jpg;6509;6809;36081;325;340;15
/net/per610a/home/mvp/mvp_db/news7-lv/2018/2018_06_01_19_00/2018_06_01_19_00.mpg;Shinzo ABE.jpg;8817;8913;36081;441;445;4
/net/per610a/home/mvp/mvp_db/news7-lv/2018/2018_06_02_19_00/2018_06_02_19_00.mpg;Shinzo ABE.jpg;3097;3593;36089;154;179;25
/net/per610a/home/mvp/mvp_db/news7-lv/2018/2018_06_02_19_00/2018_06_02_19_00.mpg;Shinzo ABE.jpg;8761;8837;36089;438;442;4
/net/per610a/home/mvp/mvp_db/news7-lv/2018/2018_06_04_19_00/2018_06_04_19_00.mpg;Taro ASO.jpg;965;1337;36081;48;66;18
/net/per610a/home/mvp/mvp_db/news7-lv/2018/2018_06_04_19_00/2018_06_04_19_00.mpg;Taro ASO.jpg;7321;7545;36081;366;377;11
/net/per610a/home/mvp/mvp_db/news7-lv/2018/2018_06_05_19_00/2018_06_05_19_00.mpg;Taro ASO.jpg;9001;9001;36081;450;450;0
/net/per610a/home/mvp/mvp_db/news7-lv/2018/2018_06_05_19_00/2018_06_05_19_00.mpg;Taro ASO.jpg;9197;9233;36081;460;461;1
/net/per610a/home/mvp/mvp_db/news7-lv/2018/2018_06_05_19_00/2018_06_05_19_00.mpg;Taro ASO.jpg;9729;9901;36081;486;495;9
/net/per610a/home/mvp/mvp_db/news7-lv/2018/2018_06_05_19_00/2018_06_05_19_00.mpg;Taro ASO.jpg;23925;24021;36081;1196;1201;5
/net/per610a/home/mvp/mvp_db/news7-lv/2018/2018_06_05_19_00/2018_06_05_19_00.mpg;Yukio EDANO.jpg;12065;12741;36081;603;637;34
/net/per610a/home/mvp/mvp_db/news7-lv/2018/2018_06_05_19_00/2018_06_05_19_00.mpg;Shinzo ABE.jpg;12881;13297;36081;644;665;21
/net/per610a/home/mvp/mvp_db/news7-lv/2018/2018_06_05_19_00/2018_06_05_19_00.mpg;Shinzo ABE.jpg;20285;20465;36081;1014;1023;9
/net/per610a/home/mvp/mvp_db/news7-lv/2018/2018_06_05_19_00/2018_06_05_19_00.mpg;Shinzo ABE.jpg;23925;23941;36081;1196;1197;1
/net/per610a/home/mvp/mvp_db/news7-lv/2018/2018_06_05_19_00/2018_06_05_19_00.mpg;Shinzo ABE.jpg;24065;24129;36081;1203;1207;4
/net/per610a/home/mvp/mvp_db/news7-lv/2018/2018_06_06_19_00/2018_06_06_19_00.mpg;Shinzo ABE.jpg;497;589;36089;24;29;5
/net/per610a/home/mvp/mvp_db/news7-lv/2018/2018_06_06_19_00/2018_06_06_19_00.mpg;Shinzo ABE.jpg;5189;5261;36089;259;263;4
/net/per610a/home/mvp/mvp_db/news7-lv/2018/2018_06_06_19_00/2018_06_06_19_00.mpg;Shinzo ABE.jpg;5405;5841;36089;270;292;22
/net/per610a/home/mvp/mvp_db/news7-lv/2018/2018_06_07_19_00/2018_06_07_19_00.mpg;Shinzo ABE.jpg;4281;4597;36081;214;229;15
/net/per610a/home/mvp/mvp_db/news7-lv/2018/2018_06_07_19_00/2018_06_07_19_00.mpg;Shinzo ABE.jpg;8149;8381;36081;407;419;12
/net/per610a/home/mvp/mvp_db/news7-lv/2018/2018_06_08_19_00/2018_06_08_19_00.mpg;Shinzo ABE.jpg;6741;7017;36081;337;351;14
/net/per610a/home/mvp/mvp_db/news7-lv/2018/2018_06_09_19_00/2018_06_09_19_00.mpg;Shinzo ABE.jpg;11681;12117;36085;584;606;22
/net/per610a/home/mvp/mvp_db/news7-lv/2018/2018_06_09_19_00/2018_06_09_19_00.mpg;Shinzo ABE.jpg;18641;19081;36085;932;954;22
/net/per610a/home/mvp/mvp_db/news7-lv/2018/2018_06_10_19_00/2018_06_10_19_00.mpg;Shinzo ABE.jpg;22133;22229;36089;1107;1112;5
/net/per610a/home/mvp/mvp_db/news7-lv/2018/2018_06_11_19_00/2018_06_11_19_00.mpg;Shinzo ABE.jpg;24237;24317;36081;1212;1216;4
/net/per610a/home/mvp/mvp_db/news7-lv/2018/2018_06_11_19_00/2018_06_11_19_00.mpg;Shinzo ABE.jpg;25069;25417;36081;1254;1271;17
/net/per610a/home/mvp/mvp_db/news7-lv/2018/2018_06_11_19_00/2018_06_11_19_00.mpg;Shinzo ABE.jpg;25481;25529;36081;1274;1277;3
/net/per610a/home/mvp/mvp_db/news7-lv/2018/2018_06_11_19_00/2018_06_11_19_00.mpg;Taro ASO.jpg;25661;26253;36081;1283;1313;30
/net/per610a/home/mvp/mvp_db/news7-lv/2018/2018_06_12_19_00/2018_06_12_19_00.mpg;Shinzo ABE.jpg;25789;27221;72041;1290;1362;72
/net/per610a/home/mvp/mvp_db/news7-lv/2018/2018_06_12_19_00/2018_06_12_19_00.mpg;Shinzo ABE.jpg;27301;27601;72041;1366;1381;15
/net/per610a/home/mvp/mvp_db/news7-lv/2018/2018_06_12_19_00/2018_06_12_19_00.mpg;Shinzo ABE.jpg;44697;44857;72041;2236;2244;8
/net/per610a/home/mvp/mvp_db/news7-lv/2018/2018_06_12_19_00/2018_06_12_19_00.mpg;Shinzo ABE.jpg;44965;45005;72041;2250;2252;2
/net/per610a/home/mvp/mvp_db/news7-lv/2018/2018_06_12_19_00/2018_06_12_19_00.mpg;Shinzo ABE.jpg;45145;45309;72041;2259;2267;8
/net/per610a/home/mvp/mvp_db/news7-lv/2018/2018_06_12_19_00/2018_06_12_19_00.mpg;Shinzo ABE.jpg;45889;46289;72041;2296;2316;20
/net/per610a/home/mvp/mvp_db/news7-lv/2018/2018_06_12_19_00/2018_06_12_19_00.mpg;Shinzo ABE.jpg;63553;63861;72041;3180;3195;15
/net/per610a/home/mvp/mvp_db/news7-lv/2018/2018_06_13_19_00/2018_06_13_19_00.mpg;Shinzo ABE.jpg;12453;12597;36081;622;630;8
/net/per610a/home/mvp/mvp_db/news7-lv/2018/2018_06_13_19_00/2018_06_13_19_00.mpg;Shinzo ABE.jpg;13317;13765;36081;666;688;22
/net/per610a/home/mvp/mvp_db/news7-lv/2018/2018_06_13_19_00/2018_06_13_19_00.mpg;Shinzo ABE.jpg;29473;29749;36081;1474;1488;14
/net/per610a/home/mvp/mvp_db/news7-lv/2018/2018_06_13_19_00/2018_06_13_19_00.mpg;Shinzo ABE.jpg;30257;30497;36081;1513;1525;12
/net/per610a/home/mvp/mvp_db/news7-lv/2018/2018_06_14_19_00/2018_06_14_19_00.mpg;Shinzo ABE.jpg;789;825;36089;39;41;2
/net/per610a/home/mvp/mvp_db/news7-lv/2018/2018_06_14_19_00/2018_06_14_19_00.mpg;Shinzo ABE.jpg;1133;1365;36089;56;68;12
/net/per610a/home/mvp/mvp_db/news7-lv/2018/2018_06_14_19_00/2018_06_14_19_00.mpg;Shinzo ABE.jpg;1437;1593;36089;71;79;8
/net/per610a/home/mvp/mvp_db/news7-lv/2018/2018_06_14_19_00/2018_06_14_19_00.mpg;Shinzo ABE.jpg;5121;5233;36089;256;261;5
/net/per610a/home/mvp/mvp_db/news7-lv/2018/2018_06_15_19_00/2018_06_15_19_00.mpg;Shinzo ABE.jpg;10645;10825;36089;532;541;9
/net/per610a/home/mvp/mvp_db/news7-lv/2018/2018_06_15_19_00/2018_06_15_19_00.mpg;Shinzo ABE.jpg;25029;25097;36089;1252;1255;3
/net/per610a/home/mvp/mvp_db/news7-lv/2018/2018_06_15_19_00/2018_06_15_19_00.mpg;Shinzo ABE.jpg;25473;25617;36089;1274;1281;7
/net/per610a/home/mvp/mvp_db/news7-lv/2018/2018_06_15_19_00/2018_06_15_19_00.mpg;Yukiko Kada.jpg;11481;11845;36089;574;592;18
/net/per610a/home/mvp/mvp_db/news7-lv/2018/2018_06_16_19_00/2018_06_16_19_00.mpg;Shinzo ABE.jpg;22537;22613;36085;1127;1131;4
/net/per610a/home/mvp/mvp_db/news7-lv/2018/2018_06_16_19_00/2018_06_16_19_00.mpg;Shinzo ABE.jpg;22785;22953;36085;1140;1148;8
/net/per610a/home/mvp/mvp_db/news7-lv/2018/2018_06_18_19_00/2018_06_18_19_00.mpg;Shinzo ABE.jpg;26777;27673;48069;1339;1384;45
/net/per610a/home/mvp/mvp_db/news7-lv/2018/2018_06_18_19_00/2018_06_18_19_00.mpg;Shinzo ABE.jpg;36125;36661;48069;1807;1834;27
/net/per610a/home/mvp/mvp_db/news7-lv/2018/2018_06_21_19_00/2018_06_21_19_00.mpg;Shinzo ABE.jpg;6317;6393;36089;316;319;3
/net/per610a/home/mvp/mvp_db/news7-lv/2018/2018_06_21_19_00/2018_06_21_19_00.mpg;Shinzo ABE.jpg;6525;6945;36089;326;347;21
/net/per610a/home/mvp/mvp_db/news7-lv/2018/2018_06_22_19_00/2018_06_22_19_00.mpg;Shinzo ABE.jpg;22917;22969;36081;1146;1149;3
/net/per610a/home/mvp/mvp_db/news7-lv/2018/2018_06_22_19_00/2018_06_22_19_00.mpg;Shinzo ABE.jpg;26201;26777;36081;1310;1339;29
/net/per610a/home/mvp/mvp_db/news7-lv/2018/2018_06_25_19_00/2018_06_25_19_00.mpg;Shinzo ABE.jpg;25481;25493;36081;1274;1275;1
/net/per610a/home/mvp/mvp_db/news7-lv/2018/2018_06_25_19_00/2018_06_25_19_00.mpg;Shinzo ABE.jpg;25929;26421;36081;1297;1321;24
/net/per610a/home/mvp/mvp_db/news7-lv/2018/2018_06_25_19_00/2018_06_25_19_00.mpg;Shinzo ABE.jpg;26837;27157;36081;1342;1358;16
/net/per610a/home/mvp/mvp_db/news7-lv/2018/2018_06_27_19_00/2018_06_27_19_00.mpg;Kazuo SHII.jpg;22105;22193;36089;1106;1110;4
/net/per610a/home/mvp/mvp_db/news7-lv/2018/2018_06_27_19_00/2018_06_27_19_00.mpg;YUriko Koike.jpg;31409;31445;36089;1571;1573;2
/net/per610a/home/mvp/mvp_db/news7-lv/2018/2018_06_27_19_00/2018_06_27_19_00.mpg;YUriko Koike.jpg;31677;31861;36089;1585;1594;9
/net/per610a/home/mvp/mvp_db/news7-lv/2018/2018_06_29_19_00/2018_06_29_19_00.mpg;Shinzo ABE.jpg;21737;22377;36081;1087;1119;32
/net/per610a/home/mvp/mvp_db/news7-lv/2018/2018_07_09_19_00/2018_07_09_19_00.mpg;Shinzo ABE.jpg;14653;14749;38481;733;737;4
/net/per610a/home/mvp/mvp_db/news7-lv/2018/2018_07_09_19_00/2018_07_09_19_00.mpg;Shinzo ABE.jpg;28345;28537;38481;1417;1427;10
/net/per610a/home/mvp/mvp_db/news7-lv/2018/2018_07_09_19_00/2018_07_09_19_00.mpg;Shinzo ABE.jpg;27097;27533;38481;1355;1377;22
/net/per610a/home/mvp/mvp_db/news7-lv/2018/2018_07_13_19_00/2018_07_13_19_00.mpg;Ichiro OZAWA.jpg;2469;2669;39681;123;133;10
/net/per610a/home/mvp/mvp_db/news7-lv/2018/2018_07_13_19_00/2018_07_13_19_00.mpg;Ichiro OZAWA.jpg;3537;3905;39681;176;195;19
/net/per610a/home/mvp/mvp_db/news7-lv/2018/2018_07_13_19_00/2018_07_13_19_00.mpg;Shinzo ABE.jpg;18789;19485;39681;939;974;35
/net/per610a/home/mvp/mvp_db/news7-lv/2018/2018_07_16_19_00/2018_07_16_19_00.mpg;Shinzo ABE.jpg;23661;23973;36081;1183;1199;16
/net/per610a/home/mvp/mvp_db/news7-lv/2018/2018_07_17_19_00/2018_07_17_19_00.mpg;Shinzo ABE.jpg;15469;16425;36089;774;821;47
/net/per610a/home/mvp/mvp_db/news7-lv/2018/2018_07_20_19_00/2018_07_20_19_00.mpg;Shinzo ABE.jpg;13073;13105;36081;653;655;2
/net/per610a/home/mvp/mvp_db/news7-lv/2018/2018_07_20_19_00/2018_07_20_19_00.mpg;Shinzo ABE.jpg;21445;21853;36081;1072;1093;21
/net/per610a/home/mvp/mvp_db/news7-lv/2018/2018_07_20_19_00/2018_07_20_19_00.mpg;Yukio EDANO.jpg;13221;13241;36081;661;662;1
/net/per610a/home/mvp/mvp_db/news7-lv/2018/2018_07_20_19_00/2018_07_20_19_00.mpg;Yukio EDANO.jpg;13877;14105;36081;694;705;11
/net/per610a/home/mvp/mvp_db/news7-lv/2018/2018_07_20_19_00/2018_07_20_19_00.mpg;Yukio EDANO.jpg;20529;20613;36081;1026;1031;5
/net/per610a/home/mvp/mvp_db/news7-lv/2018/2018_07_21_19_00/2018_07_21_19_00.mpg;Shinzo ABE.jpg;22061;22805;36081;1103;1140;37
/net/per610a/home/mvp/mvp_db/news7-lv/2018/2018_07_24_19_00/2018_07_24_19_00.mpg;Shinzo ABE.jpg;11685;11797;36081;584;590;6
/net/per610a/home/mvp/mvp_db/news7-lv/2018/2018_07_24_19_00/2018_07_24_19_00.mpg;Shinzo ABE.jpg;12005;12057;36081;600;603;3
/net/per610a/home/mvp/mvp_db/news7-lv/2018/2018_07_24_19_00/2018_07_24_19_00.mpg;Shinzo ABE.jpg;15017;15421;36081;751;771;20
/net/per610a/home/mvp/mvp_db/news7-lv/2018/2018_07_24_19_00/2018_07_24_19_00.mpg;Shinzo ABE.jpg;14313;14321;36081;716;716;0
/net/per610a/home/mvp/mvp_db/news7-lv/2018/2018_07_24_19_00/2018_07_24_19_00.mpg;Shinzo ABE.jpg;14413;14597;36081;721;730;9
/net/per610a/home/mvp/mvp_db/news7-lv/2018/2018_07_29_19_00/2018_07_29_19_00.mpg;Shinzo ABE.jpg;6349;6777;36081;317;339;22
/net/per610a/home/mvp/mvp_db/news7-lv/2018/2018_08_05_19_00/2018_08_05_19_00.mpg;Shinzo ABE.jpg;24377;24745;36081;1219;1237;18
/net/per610a/home/mvp/mvp_db/news7-lv/2018/2018_08_06_19_00/2018_08_06_19_00.mpg;Shinzo ABE.jpg;24897;25289;36081;1245;1265;20
/net/per610a/home/mvp/mvp_db/news7-lv/2018/2018_08_06_19_00/2018_08_06_19_00.mpg;Shinzo ABE.jpg;25869;25901;36081;1294;1295;1
/net/per610a/home/mvp/mvp_db/news7-lv/2018/2018_08_06_19_00/2018_08_06_19_00.mpg;Shinzo ABE.jpg;26085;26337;36081;1304;1317;13
/net/per610a/home/mvp/mvp_db/news7-lv/2018/2018_08_09_19_00/2018_08_09_19_00.mpg;Shinzo ABE.jpg;24213;24361;36081;1211;1218;7
/net/per610a/home/mvp/mvp_db/news7-lv/2018/2018_08_09_19_00/2018_08_09_19_00.mpg;Shinzo ABE.jpg;25017;25165;36081;1251;1258;7
/net/per610a/home/mvp/mvp_db/news7-lv/2018/2018_08_10_19_00/2018_08_10_19_00.mpg;Shinzo ABE.jpg;16093;16509;36081;805;825;20
/net/per610a/home/mvp/mvp_db/news7-lv/2018/2018_08_15_19_00/2018_08_15_19_00.mpg;Kyoko Nakayama.jpg;4673;4781;36081;233;239;6
/net/per610a/home/mvp/mvp_db/news7-lv/2018/2018_08_15_19_00/2018_08_15_19_00.mpg;Kyoko Nakayama.jpg;7765;7765;36081;388;388;0
/net/per610a/home/mvp/mvp_db/news7-lv/2018/2018_08_15_19_00/2018_08_15_19_00.mpg;Kyoko Nakayama.jpg;7857;7969;36081;393;398;5
/net/per610a/home/mvp/mvp_db/news7-lv/2018/2018_08_22_19_00/2018_08_22_19_00.mpg;Yuichiro Tamaki.png;26121;26353;36081;1306;1318;12
/net/per610a/home/mvp/mvp_db/news7-lv/2018/2018_08_22_19_00/2018_08_22_19_00.mpg;Yuichiro Tamaki.png;28225;29045;36081;1411;1453;42
/net/per610a/home/mvp/mvp_db/news7-lv/2018/2018_08_24_19_00/2018_08_24_19_00.mpg;YUriko Koike.jpg;18693;19061;36081;935;953;18
/net/per610a/home/mvp/mvp_db/news7-lv/2018/2018_08_24_19_00/2018_08_24_19_00.mpg;YUriko Koike.jpg;21409;21653;36081;1071;1083;12
/net/per610a/home/mvp/mvp_db/news7-lv/2018/2018_08_24_19_00/2018_08_24_19_00.mpg;Shintaro ISHIHARA.jpg;19261;19421;36081;963;971;8
/net/per610a/home/mvp/mvp_db/news7-lv/2018/2018_08_24_19_00/2018_08_24_19_00.mpg;Shintaro ISHIHARA.jpg;19533;19681;36081;977;984;7
/net/per610a/home/mvp/mvp_db/news7-lv/2018/2018_08_24_19_00/2018_08_24_19_00.mpg;Shinzo ABE.jpg;24769;24881;36081;1239;1244;5
/net/per610a/home/mvp/mvp_db/news7-lv/2018/2018_08_24_19_00/2018_08_24_19_00.mpg;Shinzo ABE.jpg;24893;25161;36081;1245;1258;13
/net/per610a/home/mvp/mvp_db/news7-lv/2018/2018_08_26_19_00/2018_08_26_19_00.mpg;Shinzo ABE.jpg;12269;12917;36081;613;646;33
/net/per610a/home/mvp/mvp_db/news7-lv/2018/2018_08_26_19_00/2018_08_26_19_00.mpg;Shinzo ABE.jpg;13093;13573;36081;654;679;25
/net/per610a/home/mvp/mvp_db/news7-lv/2018/2018_08_26_19_00/2018_08_26_19_00.mpg;Shinzo ABE.jpg;14301;14721;36081;715;736;21
/net/per610a/home/mvp/mvp_db/news7-lv/2018/2018_08_26_19_00/2018_08_26_19_00.mpg;Shinzo ABE.jpg;14845;14949;36081;742;747;5
/net/per610a/home/mvp/mvp_db/news7-lv/2018/2018_08_27_19_00/2018_08_27_19_00.mpg;Shinzo ABE.jpg;10781;11285;36081;539;564;25
/net/per610a/home/mvp/mvp_db/news7-lv/2018/2018_08_27_19_00/2018_08_27_19_00.mpg;Shinzo ABE.jpg;11669;11737;36081;583;587;4
/net/per610a/home/mvp/mvp_db/news7-lv/2018/2018_08_27_19_00/2018_08_27_19_00.mpg;Shinzo ABE.jpg;11817;11869;36081;591;593;2
/net/per610a/home/mvp/mvp_db/news7-lv/2018/2018_08_30_19_00/2018_08_30_19_00.mpg;Shinzo ABE.jpg;16925;17061;36081;846;853;7
/net/per610a/home/mvp/mvp_db/news7-lv/2018/2018_09_01_19_00/2018_09_01_19_00.mpg;Shinzo ABE.jpg;9253;9373;36089;463;469;6
/net/per610a/home/mvp/mvp_db/news7-lv/2018/2018_09_01_19_00/2018_09_01_19_00.mpg;Shinzo ABE.jpg;9445;9497;36089;472;475;3
/net/per610a/home/mvp/mvp_db/news7-lv/2018/2018_09_01_19_00/2018_09_01_19_00.mpg;Shinzo ABE.jpg;10161;10229;36089;508;511;3
/net/per610a/home/mvp/mvp_db/news7-lv/2018/2018_09_03_19_00/2018_09_03_19_00.mpg;Taro Yamamoto.jpg;15909;16069;36081;795;803;8
/net/per610a/home/mvp/mvp_db/news7-lv/2018/2018_09_03_19_00/2018_09_03_19_00.mpg;Shinzo ABE.jpg;19477;19825;36081;974;991;17
/net/per610a/home/mvp/mvp_db/news7-lv/2018/2018_09_03_19_00/2018_09_03_19_00.mpg;Shinzo ABE.jpg;20229;21009;36081;1011;1051;40
/net/per610a/home/mvp/mvp_db/news7-lv/2018/2018_09_05_19_00/2018_09_05_19_00.mpg;Nariaki Nakayama.png;10373;10453;36089;519;523;4
/net/per610a/home/mvp/mvp_db/news7-lv/2018/2018_09_06_19_00/2018_09_06_19_00.mpg;Shinzo ABE.jpg;36481;36505;125989;1825;1826;1
/net/per610a/home/mvp/mvp_db/news7-lv/2018/2018_09_06_19_00/2018_09_06_19_00.mpg;Shinzo ABE.jpg;57421;57445;125989;2873;2874;1
/net/per610a/home/mvp/mvp_db/news7-lv/2018/2018_09_06_19_00/2018_09_06_19_00.mpg;Shinzo ABE.jpg;66749;67325;125989;3340;3369;29
/net/per610a/home/mvp/mvp_db/news7-lv/2018/2018_09_06_19_00/2018_09_06_19_00.mpg;Shinzo ABE.jpg;36565;37033;125989;1829;1853;24
/net/per610a/home/mvp/mvp_db/news7-lv/2018/2018_09_07_19_00/2018_09_07_19_00.mpg;Shinzo ABE.jpg;23777;24829;39689;1189;1242;53
/net/per610a/home/mvp/mvp_db/news7-lv/2018/2018_09_07_19_00/2018_09_07_19_00.mpg;Shinzo ABE.jpg;26661;26909;39689;1334;1346;12
/net/per610a/home/mvp/mvp_db/news7-lv/2018/2018_09_09_19_00/2018_09_09_19_00.mpg;Shinzo ABE.jpg;9521;10229;36081;476;511;35
/net/per610a/home/mvp/mvp_db/news7-lv/2018/2018_09_09_19_00/2018_09_09_19_00.mpg;Yukio HATOYAMA.jpg;17725;18049;36081;886;902;16
/net/per610a/home/mvp/mvp_db/news7-lv/2018/2018_09_10_19_00/2018_09_10_19_00.mpg;Shinzo ABE.jpg;9085;9737;36089;454;487;33
/net/per610a/home/mvp/mvp_db/news7-lv/2018/2018_09_10_19_00/2018_09_10_19_00.mpg;Shinzo ABE.jpg;10717;11129;36089;536;556;20
/net/per610a/home/mvp/mvp_db/news7-lv/2018/2018_09_10_19_00/2018_09_10_19_00.mpg;Shinzo ABE.jpg;11997;12161;36089;600;608;8
/net/per610a/home/mvp/mvp_db/news7-lv/2018/2018_09_10_19_00/2018_09_10_19_00.mpg;Shinzo ABE.jpg;12309;12777;36089;615;639;24
/net/per610a/home/mvp/mvp_db/news7-lv/2018/2018_09_10_19_00/2018_09_10_19_00.mpg;Shinzo ABE.jpg;12853;14721;36089;643;736;93
/net/per610a/home/mvp/mvp_db/news7-lv/2018/2018_09_10_19_00/2018_09_10_19_00.mpg;Shinzo ABE.jpg;15293;16197;36089;765;810;45
/net/per610a/home/mvp/mvp_db/news7-lv/2018/2018_09_10_19_00/2018_09_10_19_00.mpg;Shinzo ABE.jpg;16665;16969;36089;833;849;16
/net/per610a/home/mvp/mvp_db/news7-lv/2018/2018_09_10_19_00/2018_09_10_19_00.mpg;Shinzo ABE.jpg;17177;18349;36089;859;918;59
/net/per610a/home/mvp/mvp_db/news7-lv/2018/2018_09_10_19_00/2018_09_10_19_00.mpg;Shinzo ABE.jpg;21693;21929;36089;1085;1097;12
/net/per610a/home/mvp/mvp_db/news7-lv/2018/2018_09_10_19_00/2018_09_10_19_00.mpg;Shinzo ABE.jpg;22609;22933;36089;1131;1147;16
/net/per610a/home/mvp/mvp_db/news7-lv/2018/2018_09_10_19_00/2018_09_10_19_00.mpg;Shinzo ABE.jpg;17033;17133;36089;852;857;5
/net/per610a/home/mvp/mvp_db/news7-lv/2018/2018_09_13_19_00/2018_09_13_19_00.mpg;Shinzo ABE.jpg;5485;5617;36089;274;281;7
/net/per610a/home/mvp/mvp_db/news7-lv/2018/2018_09_13_19_00/2018_09_13_19_00.mpg;Shinzo ABE.jpg;23889;23965;36089;1195;1199;4
/net/per610a/home/mvp/mvp_db/news7-lv/2018/2018_09_13_19_00/2018_09_13_19_00.mpg;Shinzo ABE.jpg;24597;24901;36089;1230;1246;16
/net/per610a/home/mvp/mvp_db/news7-lv/2018/2018_09_13_19_00/2018_09_13_19_00.mpg;Shinzo ABE.jpg;23313;23689;36089;1166;1185;19
/net/per610a/home/mvp/mvp_db/news7-lv/2018/2018_09_13_19_00/2018_09_13_19_00.mpg;Shinzo ABE.jpg;24325;24401;36089;1217;1221;4
/net/per610a/home/mvp/mvp_db/news7-lv/2018/2018_09_14_19_00/2018_09_14_19_00.mpg;Shinzo ABE.jpg;9093;9605;36081;454;480;26
/net/per610a/home/mvp/mvp_db/news7-lv/2018/2018_09_14_19_00/2018_09_14_19_00.mpg;Shinzo ABE.jpg;9689;10405;36081;484;520;36
/net/per610a/home/mvp/mvp_db/news7-lv/2018/2018_09_14_19_00/2018_09_14_19_00.mpg;Shinzo ABE.jpg;11109;11161;36081;555;558;3
/net/per610a/home/mvp/mvp_db/news7-lv/2018/2018_09_14_19_00/2018_09_14_19_00.mpg;Shinzo ABE.jpg;11273;11469;36081;563;573;10
/net/per610a/home/mvp/mvp_db/news7-lv/2018/2018_09_14_19_00/2018_09_14_19_00.mpg;Shinzo ABE.jpg;11673;13181;36081;583;659;76
/net/per610a/home/mvp/mvp_db/news7-lv/2018/2018_09_16_19_00/2018_09_16_19_00.mpg;Shinzo ABE.jpg;4909;5405;36081;245;270;25
/net/per610a/home/mvp/mvp_db/news7-lv/2018/2018_09_16_19_00/2018_09_16_19_00.mpg;Shinzo ABE.jpg;5605;5649;36081;280;282;2
/net/per610a/home/mvp/mvp_db/news7-lv/2018/2018_09_16_19_00/2018_09_16_19_00.mpg;Shinzo ABE.jpg;6561;6653;36081;328;332;4
/net/per610a/home/mvp/mvp_db/news7-lv/2018/2018_09_16_19_00/2018_09_16_19_00.mpg;Shinzo ABE.jpg;7529;8201;36081;376;410;34
/net/per610a/home/mvp/mvp_db/news7-lv/2018/2018_09_16_19_00/2018_09_16_19_00.mpg;Shinzo ABE.jpg;8649;8897;36081;432;445;13
/net/per610a/home/mvp/mvp_db/news7-lv/2018/2018_09_17_19_00/2018_09_17_19_00.mpg;Shinzo ABE.jpg;13897;14041;36081;695;702;7
/net/per610a/home/mvp/mvp_db/news7-lv/2018/2018_09_17_19_00/2018_09_17_19_00.mpg;Shinzo ABE.jpg;14281;14661;36081;714;733;19
/net/per610a/home/mvp/mvp_db/news7-lv/2018/2018_09_17_19_00/2018_09_17_19_00.mpg;Shinzo ABE.jpg;15501;15613;36081;775;781;6
/net/per610a/home/mvp/mvp_db/news7-lv/2018/2018_09_17_19_00/2018_09_17_19_00.mpg;Shinzo ABE.jpg;16077;16133;36081;804;807;3
/net/per610a/home/mvp/mvp_db/news7-lv/2018/2018_09_17_19_00/2018_09_17_19_00.mpg;Shinzo ABE.jpg;17085;17353;36081;854;868;14
/net/per610a/home/mvp/mvp_db/news7-lv/2018/2018_09_17_19_00/2018_09_17_19_00.mpg;Shinzo ABE.jpg;19133;19329;36081;957;966;9
/net/per610a/home/mvp/mvp_db/news7-lv/2018/2018_09_18_19_00/2018_09_18_19_00.mpg;Shinzo ABE.jpg;18973;19301;36081;949;965;16
/net/per610a/home/mvp/mvp_db/news7-lv/2018/2018_09_18_19_00/2018_09_18_19_00.mpg;Shinzo ABE.jpg;19413;19429;36081;971;971;0
/net/per610a/home/mvp/mvp_db/news7-lv/2018/2018_09_18_19_00/2018_09_18_19_00.mpg;Shinzo ABE.jpg;19493;19505;36081;975;975;0
/net/per610a/home/mvp/mvp_db/news7-lv/2018/2018_09_18_19_00/2018_09_18_19_00.mpg;Shinzo ABE.jpg;19689;19745;36081;984;987;3
/net/per610a/home/mvp/mvp_db/news7-lv/2018/2018_09_18_19_00/2018_09_18_19_00.mpg;Shinzo ABE.jpg;19989;20113;36081;999;1006;7
/net/per610a/home/mvp/mvp_db/news7-lv/2018/2018_09_18_19_00/2018_09_18_19_00.mpg;Shinzo ABE.jpg;29765;29913;36081;1489;1496;7
/net/per610a/home/mvp/mvp_db/news7-lv/2018/2018_09_19_19_00/2018_09_19_19_00.mpg;Shinzo ABE.jpg;27837;28101;36089;1393;1406;13
/net/per610a/home/mvp/mvp_db/news7-lv/2018/2018_09_20_19_00/2018_09_20_19_00.mpg;Shinzo ABE.jpg;2973;3333;38481;148;166;18
/net/per610a/home/mvp/mvp_db/news7-lv/2018/2018_09_20_19_00/2018_09_20_19_00.mpg;Shinzo ABE.jpg;6397;6469;38481;320;323;3
/net/per610a/home/mvp/mvp_db/news7-lv/2018/2018_09_20_19_00/2018_09_20_19_00.mpg;Shinzo ABE.jpg;6981;7233;38481;349;361;12
/net/per610a/home/mvp/mvp_db/news7-lv/2018/2018_09_20_19_00/2018_09_20_19_00.mpg;Shinzo ABE.jpg;10953;11229;38481;547;561;14
/net/per610a/home/mvp/mvp_db/news7-lv/2018/2018_09_20_19_00/2018_09_20_19_00.mpg;Ichiro OZAWA.jpg;5093;6201;38481;254;310;56
/net/per610a/home/mvp/mvp_db/news7-lv/2018/2018_09_20_19_00/2018_09_20_19_00.mpg;Natsuo YAMAGUCHI.jpg;6397;6825;38481;320;341;21
/net/per610a/home/mvp/mvp_db/news7-lv/2018/2018_09_20_19_00/2018_09_20_19_00.mpg;Shinzo ABE.jpg;8089;8409;38481;404;420;16
/net/per610a/home/mvp/mvp_db/news7-lv/2018/2018_09_20_19_00/2018_09_20_19_00.mpg;Shinzo ABE.jpg;8485;8485;38481;424;424;0
/net/per610a/home/mvp/mvp_db/news7-lv/2018/2018_09_20_19_00/2018_09_20_19_00.mpg;Shinzo ABE.jpg;8585;8585;38481;429;429;0
/net/per610a/home/mvp/mvp_db/news7-lv/2018/2018_09_20_19_00/2018_09_20_19_00.mpg;Shinzo ABE.jpg;8969;9177;38481;448;459;11
/net/per610a/home/mvp/mvp_db/news7-lv/2018/2018_09_20_19_00/2018_09_20_19_00.mpg;Shinzo ABE.jpg;9329;9445;38481;466;472;6
/net/per610a/home/mvp/mvp_db/news7-lv/2018/2018_09_20_19_00/2018_09_20_19_00.mpg;Shinzo ABE.jpg;12689;13185;38481;634;659;25
/net/per610a/home/mvp/mvp_db/news7-lv/2018/2018_09_20_19_00/2018_09_20_19_00.mpg;Shinzo ABE.jpg;13341;13653;38481;667;682;15
/net/per610a/home/mvp/mvp_db/news7-lv/2018/2018_09_20_19_00/2018_09_20_19_00.mpg;Shinzo ABE.jpg;13805;14481;38481;690;724;34
/net/per610a/home/mvp/mvp_db/news7-lv/2018/2018_09_20_19_00/2018_09_20_19_00.mpg;Shinzo ABE.jpg;14629;14681;38481;731;734;3
/net/per610a/home/mvp/mvp_db/news7-lv/2018/2018_09_20_19_00/2018_09_20_19_00.mpg;Shinzo ABE.jpg;14825;15613;38481;741;781;40
/net/per610a/home/mvp/mvp_db/news7-lv/2018/2018_09_20_19_00/2018_09_20_19_00.mpg;Shinzo ABE.jpg;16417;16433;38481;821;822;1
/net/per610a/home/mvp/mvp_db/news7-lv/2018/2018_09_20_19_00/2018_09_20_19_00.mpg;Yukio EDANO.jpg;16513;18445;38481;826;922;96
/net/per610a/home/mvp/mvp_db/news7-lv/2018/2018_09_21_19_00/2018_09_21_19_00.mpg;Shinzo ABE.jpg;19189;19373;36081;959;969;10
/net/per610a/home/mvp/mvp_db/news7-lv/2018/2018_09_21_19_00/2018_09_21_19_00.mpg;Shinzo ABE.jpg;19741;19769;36081;987;988;1
/net/per610a/home/mvp/mvp_db/news7-lv/2018/2018_09_21_19_00/2018_09_21_19_00.mpg;Shinzo ABE.jpg;21505;21637;36081;1075;1082;7
/net/per610a/home/mvp/mvp_db/news7-lv/2018/2018_09_21_19_00/2018_09_21_19_00.mpg;Shinzo ABE.jpg;22073;22129;36081;1104;1107;3
/net/per610a/home/mvp/mvp_db/news7-lv/2018/2018_09_23_19_00/2018_09_23_19_00.mpg;Shinzo ABE.jpg;12205;12249;36089;610;612;2
/net/per610a/home/mvp/mvp_db/news7-lv/2018/2018_09_23_19_00/2018_09_23_19_00.mpg;Shinzo ABE.jpg;12509;13277;36089;625;664;39
/net/per610a/home/mvp/mvp_db/news7-lv/2018/2018_09_23_19_00/2018_09_23_19_00.mpg;Shinzo ABE.jpg;19481;20033;36089;974;1002;28
/net/per610a/home/mvp/mvp_db/news7-lv/2018/2018_09_24_19_00/2018_09_24_19_00.mpg;Shinzo ABE.jpg;289;429;36081;14;21;7
/net/per610a/home/mvp/mvp_db/news7-lv/2018/2018_09_24_19_00/2018_09_24_19_00.mpg;Shinzo ABE.jpg;1697;1941;36081;84;97;13
/net/per610a/home/mvp/mvp_db/news7-lv/2018/2018_09_24_19_00/2018_09_24_19_00.mpg;Shinzo ABE.jpg;2961;2981;36081;148;149;1
/net/per610a/home/mvp/mvp_db/news7-lv/2018/2018_09_24_19_00/2018_09_24_19_00.mpg;Shinzo ABE.jpg;3049;3309;36081;152;165;13
/net/per610a/home/mvp/mvp_db/news7-lv/2018/2018_09_25_19_00/2018_09_25_19_00.mpg;Shinzo ABE.jpg;12541;12741;36081;627;637;10
/net/per610a/home/mvp/mvp_db/news7-lv/2018/2018_09_25_19_00/2018_09_25_19_00.mpg;Shinzo ABE.jpg;15013;15053;36081;751;753;2
/net/per610a/home/mvp/mvp_db/news7-lv/2018/2018_09_25_19_00/2018_09_25_19_00.mpg;Shinzo ABE.jpg;16929;17121;36081;846;856;10
/net/per610a/home/mvp/mvp_db/news7-lv/2018/2018_09_26_19_00/2018_09_26_19_00.mpg;Shinzo ABE.jpg;11513;12053;36081;575;602;27
/net/per610a/home/mvp/mvp_db/news7-lv/2018/2018_09_26_19_00/2018_09_26_19_00.mpg;Shinzo ABE.jpg;12169;12681;36081;608;634;26
/net/per610a/home/mvp/mvp_db/news7-lv/2018/2018_09_26_19_00/2018_09_26_19_00.mpg;Shinzo ABE.jpg;15469;15837;36081;773;792;19
/net/per610a/home/mvp/mvp_db/news7-lv/2018/2018_09_27_19_00/2018_09_27_19_00.mpg;Shinzo ABE.jpg;10013;10061;36081;500;503;3
/net/per610a/home/mvp/mvp_db/news7-lv/2018/2018_09_27_19_00/2018_09_27_19_00.mpg;Shinzo ABE.jpg;10161;10349;36081;508;517;9
/net/per610a/home/mvp/mvp_db/news7-lv/2018/2018_09_27_19_00/2018_09_27_19_00.mpg;Shinzo ABE.jpg;10457;10493;36081;523;524;1
/net/per610a/home/mvp/mvp_db/news7-lv/2018/2018_09_27_19_00/2018_09_27_19_00.mpg;Shinzo ABE.jpg;11313;11405;36081;565;570;5
/net/per610a/home/mvp/mvp_db/news7-lv/2018/2018_09_27_19_00/2018_09_27_19_00.mpg;Shinzo ABE.jpg;11485;11569;36081;574;578;4
/net/per610a/home/mvp/mvp_db/news7-lv/2018/2018_09_27_19_00/2018_09_27_19_00.mpg;Shinzo ABE.jpg;11709;12033;36081;585;601;16
/net/per610a/home/mvp/mvp_db/news7-lv/2018/2018_09_27_19_00/2018_09_27_19_00.mpg;Shinzo ABE.jpg;17993;18573;36081;900;929;29
/net/per610a/home/mvp/mvp_db/news7-lv/2018/2018_10_01_19_00/2018_10_01_19_00.mpg;Shinzo ABE.jpg;21789;21933;38481;1089;1097;8
/net/per610a/home/mvp/mvp_db/news7-lv/2018/2018_10_01_19_00/2018_10_01_19_00.mpg;Taro ASO.jpg;23961;24317;38481;1198;1216;18
/net/per610a/home/mvp/mvp_db/news7-lv/2018/2018_10_02_19_00/2018_10_02_19_00.mpg;Shinzo ABE.jpg;129;217;38489;6;10;4
/net/per610a/home/mvp/mvp_db/news7-lv/2018/2018_10_02_19_00/2018_10_02_19_00.mpg;Shinzo ABE.jpg;16393;16681;38489;820;834;14
/net/per610a/home/mvp/mvp_db/news7-lv/2018/2018_10_02_19_00/2018_10_02_19_00.mpg;Taro ASO.jpg;609;661;38489;30;33;3
/net/per610a/home/mvp/mvp_db/news7-lv/2018/2018_10_02_19_00/2018_10_02_19_00.mpg;Taro ASO.jpg;15053;15169;38489;753;759;6
/net/per610a/home/mvp/mvp_db/news7-lv/2018/2018_10_05_19_00/2018_10_05_19_00.mpg;Shinzo ABE.jpg;24601;24649;36081;1230;1233;3
/net/per610a/home/mvp/mvp_db/news7-lv/2018/2018_10_05_19_00/2018_10_05_19_00.mpg;Shinzo ABE.jpg;25553;25797;36081;1278;1290;12
/net/per610a/home/mvp/mvp_db/news7-lv/2018/2018_10_09_19_00/2018_10_09_19_00.mpg;Taro ASO.jpg;23221;23817;36081;1161;1191;30
/net/per610a/home/mvp/mvp_db/news7-lv/2018/2018_10_11_19_00/2018_10_11_19_00.mpg;YUriko Koike.jpg;16597;16873;36089;830;844;14
/net/per610a/home/mvp/mvp_db/news7-lv/2018/2018_10_12_19_00/2018_10_12_19_00.mpg;Shinzo ABE.jpg;1445;1853;36081;72;92;20
/net/per610a/home/mvp/mvp_db/news7-lv/2018/2018_10_12_19_00/2018_10_12_19_00.mpg;Shinzo ABE.jpg;20693;21213;36081;1035;1061;26
/net/per610a/home/mvp/mvp_db/news7-lv/2018/2018_10_14_19_00/2018_10_14_19_00.mpg;Shinzo ABE.jpg;5441;5497;36081;272;274;2
/net/per610a/home/mvp/mvp_db/news7-lv/2018/2018_10_14_19_00/2018_10_14_19_00.mpg;Shinzo ABE.jpg;6225;6813;36081;311;340;29
/net/per610a/home/mvp/mvp_db/news7-lv/2018/2018_10_14_19_00/2018_10_14_19_00.mpg;Shinzo ABE.jpg;10289;10341;36081;514;517;3
/net/per610a/home/mvp/mvp_db/news7-lv/2018/2018_10_14_19_00/2018_10_14_19_00.mpg;Yasuo FUKUDA.jpg;7981;8137;36081;399;407;8
/net/per610a/home/mvp/mvp_db/news7-lv/2018/2018_10_15_19_00/2018_10_15_19_00.mpg;Shinzo ABE.jpg;485;577;36081;24;28;4
/net/per610a/home/mvp/mvp_db/news7-lv/2018/2018_10_15_19_00/2018_10_15_19_00.mpg;Shinzo ABE.jpg;1645;1929;36081;82;96;14
/net/per610a/home/mvp/mvp_db/news7-lv/2018/2018_10_15_19_00/2018_10_15_19_00.mpg;Shinzo ABE.jpg;2013;2277;36081;100;113;13
/net/per610a/home/mvp/mvp_db/news7-lv/2018/2018_10_15_19_00/2018_10_15_19_00.mpg;Shinzo ABE.jpg;10161;10189;36081;508;509;1
/net/per610a/home/mvp/mvp_db/news7-lv/2018/2018_10_15_19_00/2018_10_15_19_00.mpg;Taro ASO.jpg;10381;10597;36081;519;530;11
/net/per610a/home/mvp/mvp_db/news7-lv/2018/2018_10_16_19_00/2018_10_16_19_00.mpg;Shinzo ABE.jpg;6137;6405;36089;307;320;13
/net/per610a/home/mvp/mvp_db/news7-lv/2018/2018_10_16_19_00/2018_10_16_19_00.mpg;Shinzo ABE.jpg;6561;6649;36089;328;332;4
/net/per610a/home/mvp/mvp_db/news7-lv/2018/2018_10_16_19_00/2018_10_16_19_00.mpg;Shinzo ABE.jpg;9297;9969;36089;465;498;33
/net/per610a/home/mvp/mvp_db/news7-lv/2018/2018_10_19_19_00/2018_10_19_19_00.mpg;Shinzo ABE.jpg;17869;17869;36081;893;893;0
/net/per610a/home/mvp/mvp_db/news7-lv/2018/2018_10_19_19_00/2018_10_19_19_00.mpg;Shinzo ABE.jpg;19925;20013;36081;996;1001;5
/net/per610a/home/mvp/mvp_db/news7-lv/2018/2018_10_19_19_00/2018_10_19_19_00.mpg;Shinzo ABE.jpg;23649;23737;36081;1183;1187;4
/net/per610a/home/mvp/mvp_db/news7-lv/2018/2018_10_22_19_00/2018_10_22_19_00.mpg;Shinzo ABE.jpg;9085;9341;36081;454;467;13
/net/per610a/home/mvp/mvp_db/news7-lv/2018/2018_10_24_19_00/2018_10_24_19_00.mpg;Shinzo ABE.jpg;13073;13073;36081;653;653;0
/net/per610a/home/mvp/mvp_db/news7-lv/2018/2018_10_24_19_00/2018_10_24_19_00.mpg;Shinzo ABE.jpg;15529;15781;36081;776;789;13
/net/per610a/home/mvp/mvp_db/news7-lv/2018/2018_10_24_19_00/2018_10_24_19_00.mpg;Shinzo ABE.jpg;15941;16697;36081;797;835;38
/net/per610a/home/mvp/mvp_db/news7-lv/2018/2018_10_24_19_00/2018_10_24_19_00.mpg;Shinzo ABE.jpg;19189;19281;36081;959;964;5
/net/per610a/home/mvp/mvp_db/news7-lv/2018/2018_10_24_19_00/2018_10_24_19_00.mpg;Shinzo ABE.jpg;20025;20289;36081;1001;1014;13
/net/per610a/home/mvp/mvp_db/news7-lv/2018/2018_10_24_19_00/2018_10_24_19_00.mpg;Shinzo ABE.jpg;21253;21361;36081;1063;1068;5
/net/per610a/home/mvp/mvp_db/news7-lv/2018/2018_10_24_19_00/2018_10_24_19_00.mpg;Seiji MAEHARA.jpg;19497;19681;36081;975;984;9
/net/per610a/home/mvp/mvp_db/news7-lv/2018/2018_10_24_19_00/2018_10_24_19_00.mpg;Seiji MAEHARA.jpg;21705;22253;36081;1085;1113;28
/net/per610a/home/mvp/mvp_db/news7-lv/2018/2018_10_24_19_00/2018_10_24_19_00.mpg;Yukio EDANO.jpg;20829;21037;36081;1041;1052;11
/net/per610a/home/mvp/mvp_db/news7-lv/2018/2018_10_25_19_00/2018_10_25_19_00.mpg;Shinzo ABE.jpg;13509;13609;36089;676;681;5
/net/per610a/home/mvp/mvp_db/news7-lv/2018/2018_10_25_19_00/2018_10_25_19_00.mpg;Shinzo ABE.jpg;19905;19965;36089;996;999;3
/net/per610a/home/mvp/mvp_db/news7-lv/2018/2018_10_25_19_00/2018_10_25_19_00.mpg;Shinzo ABE.jpg;14429;14457;36089;722;723;1
/net/per610a/home/mvp/mvp_db/news7-lv/2018/2018_10_25_19_00/2018_10_25_19_00.mpg;Shinzo ABE.jpg;16613;16693;36089;831;835;4
/net/per610a/home/mvp/mvp_db/news7-lv/2018/2018_10_25_19_00/2018_10_25_19_00.mpg;Shinzo ABE.jpg;17533;17649;36089;877;883;6
/net/per610a/home/mvp/mvp_db/news7-lv/2018/2018_10_25_19_00/2018_10_25_19_00.mpg;Shinzo ABE.jpg;18545;18869;36089;928;944;16
/net/per610a/home/mvp/mvp_db/news7-lv/2018/2018_10_26_19_00/2018_10_26_19_00.mpg;Shinzo ABE.jpg;2293;2377;36089;114;118;4
/net/per610a/home/mvp/mvp_db/news7-lv/2018/2018_10_26_19_00/2018_10_26_19_00.mpg;Shinzo ABE.jpg;2929;3101;36089;146;155;9
/net/per610a/home/mvp/mvp_db/news7-lv/2018/2018_10_26_19_00/2018_10_26_19_00.mpg;Shinzo ABE.jpg;3305;3701;36089;165;185;20
/net/per610a/home/mvp/mvp_db/news7-lv/2018/2018_10_26_19_00/2018_10_26_19_00.mpg;Shinzo ABE.jpg;4549;4901;36089;227;245;18
/net/per610a/home/mvp/mvp_db/news7-lv/2018/2018_10_26_19_00/2018_10_26_19_00.mpg;Shinzo ABE.jpg;7317;8017;36089;366;401;35
/net/per610a/home/mvp/mvp_db/news7-lv/2018/2018_10_27_19_00/2018_10_27_19_00.mpg;Yoshihiko Noda.jpg;11517;11773;36089;576;589;13
/net/per610a/home/mvp/mvp_db/news7-lv/2018/2018_10_27_19_00/2018_10_27_19_00.mpg;Shinzo ABE.jpg;25129;25689;36089;1257;1285;28
/net/per610a/home/mvp/mvp_db/news7-lv/2018/2018_10_29_19_00/2018_10_29_19_00.mpg;Yukio EDANO.jpg;12217;12357;36089;611;618;7
/net/per610a/home/mvp/mvp_db/news7-lv/2018/2018_10_29_19_00/2018_10_29_19_00.mpg;Yukio EDANO.jpg;12737;12821;36089;637;641;4
/net/per610a/home/mvp/mvp_db/news7-lv/2018/2018_10_29_19_00/2018_10_29_19_00.mpg;Shinzo ABE.jpg;12221;12353;36089;611;618;7
/net/per610a/home/mvp/mvp_db/news7-lv/2018/2018_10_29_19_00/2018_10_29_19_00.mpg;Shinzo ABE.jpg;12737;12821;36089;637;641;4
/net/per610a/home/mvp/mvp_db/news7-lv/2018/2018_10_29_19_00/2018_10_29_19_00.mpg;Shinzo ABE.jpg;13653;13741;36089;683;687;4
/net/per610a/home/mvp/mvp_db/news7-lv/2018/2018_10_29_19_00/2018_10_29_19_00.mpg;Shinzo ABE.jpg;14057;14801;36089;703;740;37
/net/per610a/home/mvp/mvp_db/news7-lv/2018/2018_10_29_19_00/2018_10_29_19_00.mpg;Shinzo ABE.jpg;15337;15501;36089;767;775;8
/net/per610a/home/mvp/mvp_db/news7-lv/2018/2018_10_29_19_00/2018_10_29_19_00.mpg;Shinzo ABE.jpg;15709;15937;36089;786;797;11
/net/per610a/home/mvp/mvp_db/news7-lv/2018/2018_10_29_19_00/2018_10_29_19_00.mpg;Shinzo ABE.jpg;16065;16241;36089;803;812;9
/net/per610a/home/mvp/mvp_db/news7-lv/2018/2018_10_29_19_00/2018_10_29_19_00.mpg;Shinzo ABE.jpg;16621;16793;36089;831;840;9
/net/per610a/home/mvp/mvp_db/news7-lv/2018/2018_10_29_19_00/2018_10_29_19_00.mpg;Shinzo ABE.jpg;24177;24177;36089;1209;1209;0
/net/per610a/home/mvp/mvp_db/news7-lv/2018/2018_10_29_19_00/2018_10_29_19_00.mpg;Shinzo ABE.jpg;25697;25737;36089;1285;1287;2
/net/per610a/home/mvp/mvp_db/news7-lv/2018/2018_10_29_19_00/2018_10_29_19_00.mpg;Shinzo ABE.jpg;25941;26017;36089;1298;1301;3
/net/per610a/home/mvp/mvp_db/news7-lv/2018/2018_10_29_19_00/2018_10_29_19_00.mpg;Yuichiro Tamaki.png;12225;12357;36089;611;618;7
/net/per610a/home/mvp/mvp_db/news7-lv/2018/2018_10_29_19_00/2018_10_29_19_00.mpg;Yuichiro Tamaki.png;14713;14801;36089;736;740;4
/net/per610a/home/mvp/mvp_db/news7-lv/2018/2018_10_30_19_00/2018_10_30_19_00.mpg;Shinzo ABE.jpg;4925;5485;36081;246;274;28
/net/per610a/home/mvp/mvp_db/news7-lv/2018/2018_10_30_19_00/2018_10_30_19_00.mpg;Shinzo ABE.jpg;15253;15341;36081;763;767;4
/net/per610a/home/mvp/mvp_db/news7-lv/2018/2018_10_30_19_00/2018_10_30_19_00.mpg;Shinzo ABE.jpg;16217;16277;36081;811;814;3
/net/per610a/home/mvp/mvp_db/news7-lv/2018/2018_10_30_19_00/2018_10_30_19_00.mpg;Shinzo ABE.jpg;17217;17441;36081;861;872;11
/net/per610a/home/mvp/mvp_db/news7-lv/2018/2018_10_30_19_00/2018_10_30_19_00.mpg;Shinzo ABE.jpg;18377;18465;36081;919;923;4
/net/per610a/home/mvp/mvp_db/news7-lv/2018/2018_10_30_19_00/2018_10_30_19_00.mpg;Kazuo SHII.jpg;17449;17685;36081;872;884;12
/net/per610a/home/mvp/mvp_db/news7-lv/2018/2018_11_01_19_00/2018_11_01_19_00.mpg;Shinzo ABE.jpg;13077;13333;36089;654;667;13
/net/per610a/home/mvp/mvp_db/news7-lv/2018/2018_11_07_19_00/2018_11_07_19_00.mpg;Shinzo ABE.jpg;16921;17213;36081;846;861;15
/net/per610a/home/mvp/mvp_db/news7-lv/2018/2018_11_07_19_00/2018_11_07_19_00.mpg;Shinzo ABE.jpg;18961;18961;36081;948;948;0
/net/per610a/home/mvp/mvp_db/news7-lv/2018/2018_11_07_19_00/2018_11_07_19_00.mpg;Shinzo ABE.jpg;19457;19465;36081;973;973;0
/net/per610a/home/mvp/mvp_db/news7-lv/2018/2018_11_07_19_00/2018_11_07_19_00.mpg;Shinzo ABE.jpg;21105;21121;36081;1055;1056;1
/net/per610a/home/mvp/mvp_db/news7-lv/2018/2018_11_07_19_00/2018_11_07_19_00.mpg;Shinzo ABE.jpg;21345;21365;36081;1067;1068;1
/net/per610a/home/mvp/mvp_db/news7-lv/2018/2018_11_07_19_00/2018_11_07_19_00.mpg;Shinzo ABE.jpg;21697;21709;36081;1085;1086;1
/net/per610a/home/mvp/mvp_db/news7-lv/2018/2018_11_12_19_00/2018_11_12_19_00.mpg;Shinzo ABE.jpg;4881;5081;36089;244;254;10
/net/per610a/home/mvp/mvp_db/news7-lv/2018/2018_11_12_19_00/2018_11_12_19_00.mpg;Shinzo ABE.jpg;8005;8209;36089;400;410;10
/net/per610a/home/mvp/mvp_db/news7-lv/2018/2018_11_12_19_00/2018_11_12_19_00.mpg;Shinzo ABE.jpg;16877;17261;36089;844;863;19
/net/per610a/home/mvp/mvp_db/news7-lv/2018/2018_11_12_19_00/2018_11_12_19_00.mpg;Shinzo ABE.jpg;17917;17949;36089;896;898;2
/net/per610a/home/mvp/mvp_db/news7-lv/2018/2018_11_12_19_00/2018_11_12_19_00.mpg;Shinzo ABE.jpg;18749;18853;36089;938;943;5
/net/per610a/home/mvp/mvp_db/news7-lv/2018/2018_11_12_19_00/2018_11_12_19_00.mpg;Shinzo ABE.jpg;19045;19049;36089;953;953;0
/net/per610a/home/mvp/mvp_db/news7-lv/2018/2018_11_13_19_00/2018_11_13_19_00.mpg;Shinzo ABE.jpg;329;669;36081;16;33;17
/net/per610a/home/mvp/mvp_db/news7-lv/2018/2018_11_13_19_00/2018_11_13_19_00.mpg;Shinzo ABE.jpg;21505;22109;36081;1075;1106;31
/net/per610a/home/mvp/mvp_db/news7-lv/2018/2018_11_13_19_00/2018_11_13_19_00.mpg;Shinzo ABE.jpg;22213;23333;36081;1111;1167;56
/net/per610a/home/mvp/mvp_db/news7-lv/2018/2018_11_13_19_00/2018_11_13_19_00.mpg;Shinzo ABE.jpg;23729;24209;36081;1187;1211;24
/net/per610a/home/mvp/mvp_db/news7-lv/2018/2018_11_13_19_00/2018_11_13_19_00.mpg;Shinzo ABE.jpg;24657;24853;36081;1233;1243;10
/net/per610a/home/mvp/mvp_db/news7-lv/2018/2018_11_16_19_00/2018_11_16_19_00.mpg;Shinzo ABE.jpg;601;933;36081;30;46;16
/net/per610a/home/mvp/mvp_db/news7-lv/2018/2018_11_16_19_00/2018_11_16_19_00.mpg;Shinzo ABE.jpg;1161;1601;36081;58;80;22
/net/per610a/home/mvp/mvp_db/news7-lv/2018/2018_11_16_19_00/2018_11_16_19_00.mpg;Shinzo ABE.jpg;1681;1709;36081;84;85;1
/net/per610a/home/mvp/mvp_db/news7-lv/2018/2018_11_16_19_00/2018_11_16_19_00.mpg;Shinzo ABE.jpg;1777;2057;36081;88;102;14
/net/per610a/home/mvp/mvp_db/news7-lv/2018/2018_11_16_19_00/2018_11_16_19_00.mpg;Shinzo ABE.jpg;2505;3713;36081;125;185;60
/net/per610a/home/mvp/mvp_db/news7-lv/2018/2018_11_16_19_00/2018_11_16_19_00.mpg;Shinzo ABE.jpg;3805;4985;36081;190;249;59
/net/per610a/home/mvp/mvp_db/news7-lv/2018/2018_11_17_19_00/2018_11_17_19_00.mpg;Shinzo ABE.jpg;6057;6073;36089;303;303;0
/net/per610a/home/mvp/mvp_db/news7-lv/2018/2018_11_17_19_00/2018_11_17_19_00.mpg;Shinzo ABE.jpg;6317;6381;36089;316;319;3
/net/per610a/home/mvp/mvp_db/news7-lv/2018/2018_11_18_19_00/2018_11_18_19_00.mpg;Shinzo ABE.jpg;1681;1781;36081;84;89;5
/net/per610a/home/mvp/mvp_db/news7-lv/2018/2018_11_18_19_00/2018_11_18_19_00.mpg;Shinzo ABE.jpg;1921;1925;36081;96;96;0
/net/per610a/home/mvp/mvp_db/news7-lv/2018/2018_11_18_19_00/2018_11_18_19_00.mpg;Shinzo ABE.jpg;4585;4605;36081;229;230;1
/net/per610a/home/mvp/mvp_db/news7-lv/2018/2018_11_19_19_00/2018_11_19_19_00.mpg;Shinzo ABE.jpg;23293;23625;36089;1165;1182;17
/net/per610a/home/mvp/mvp_db/news7-lv/2018/2018_11_21_19_00/2018_11_21_19_00.mpg;Shinzo ABE.jpg;11461;11521;36081;573;576;3
/net/per610a/home/mvp/mvp_db/news7-lv/2018/2018_11_21_19_00/2018_11_21_19_00.mpg;Shinzo ABE.jpg;14857;14933;36081;743;747;4
/net/per610a/home/mvp/mvp_db/news7-lv/2018/2018_11_21_19_00/2018_11_21_19_00.mpg;Shinzo ABE.jpg;15005;15653;36081;750;783;33
/net/per610a/home/mvp/mvp_db/news7-lv/2018/2018_11_22_19_00/2018_11_22_19_00.mpg;Shinzo ABE.jpg;14645;14649;36089;732;733;1
/net/per610a/home/mvp/mvp_db/news7-lv/2018/2018_11_22_19_00/2018_11_22_19_00.mpg;Shinzo ABE.jpg;16977;17105;36089;849;855;6
/net/per610a/home/mvp/mvp_db/news7-lv/2018/2018_11_24_19_00/2018_11_24_19_00.mpg;Toru Hashimoto.jpg;17013;17341;36081;851;867;16
/net/per610a/home/mvp/mvp_db/news7-lv/2018/2018_11_24_19_00/2018_11_24_19_00.mpg;Shinzo ABE.jpg;18401;18433;36081;920;922;2
/net/per610a/home/mvp/mvp_db/news7-lv/2018/2018_11_24_19_00/2018_11_24_19_00.mpg;Shinzo ABE.jpg;18773;19025;36081;939;951;12
/net/per610a/home/mvp/mvp_db/news7-lv/2018/2018_11_24_19_00/2018_11_24_19_00.mpg;Shinzo ABE.jpg;19177;19197;36081;959;960;1
/net/per610a/home/mvp/mvp_db/news7-lv/2018/2018_11_27_19_00/2018_11_27_19_00.mpg;Shinzo ABE.jpg;7421;7669;36081;371;383;12
/net/per610a/home/mvp/mvp_db/news7-lv/2018/2018_11_28_19_00/2018_11_28_19_00.mpg;Shinzo ABE.jpg;11665;12141;36089;583;607;24
/net/per610a/home/mvp/mvp_db/news7-lv/2018/2018_11_28_19_00/2018_11_28_19_00.mpg;Shinzo ABE.jpg;24793;24837;36089;1240;1242;2
/net/per610a/home/mvp/mvp_db/news7-lv/2018/2018_11_28_19_00/2018_11_28_19_00.mpg;Shinzo ABE.jpg;25585;25833;36089;1280;1292;12
/net/per610a/home/mvp/mvp_db/news7-lv/2018/2018_11_28_19_00/2018_11_28_19_00.mpg;Shinzo ABE.jpg;25925;26021;36089;1297;1302;5
/net/per610a/home/mvp/mvp_db/news7-lv/2018/2018_11_29_19_00/2018_11_29_19_00.mpg;Kohei Otsuka.jpg;25805;26029;36081;1290;1302;12
/net/per610a/home/mvp/mvp_db/news7-lv/2018/2018_11_29_19_00/2018_11_29_19_00.mpg;Yukio EDANO.jpg;26141;26421;36081;1307;1321;14
/net/per610a/home/mvp/mvp_db/news7-lv/2018/2018_11_30_19_00/2018_11_30_19_00.mpg;Shinzo ABE.jpg;965;1013;36081;48;50;2
/net/per610a/home/mvp/mvp_db/news7-lv/2018/2018_11_30_19_00/2018_11_30_19_00.mpg;Shinzo ABE.jpg;5177;5341;36081;258;267;9
/net/per610a/home/mvp/mvp_db/news7-lv/2018/2018_11_30_19_00/2018_11_30_19_00.mpg;Taro ASO.jpg;20973;21841;36081;1049;1092;43
/net/per610a/home/mvp/mvp_db/news7-lv/2018/2018_12_01_19_00/2018_12_01_19_00.mpg;Shinzo ABE.jpg;529;541;36081;26;27;1
/net/per610a/home/mvp/mvp_db/news7-lv/2018/2018_12_01_19_00/2018_12_01_19_00.mpg;Shinzo ABE.jpg;1109;1221;36081;55;61;6
/net/per610a/home/mvp/mvp_db/news7-lv/2018/2018_12_01_19_00/2018_12_01_19_00.mpg;Shinzo ABE.jpg;4597;4685;36081;229;234;5
/net/per610a/home/mvp/mvp_db/news7-lv/2018/2018_12_01_19_00/2018_12_01_19_00.mpg;Shinzo ABE.jpg;5825;5857;36081;291;293;2
/net/per610a/home/mvp/mvp_db/news7-lv/2018/2018_12_01_19_00/2018_12_01_19_00.mpg;Shinzo ABE.jpg;6021;6041;36081;301;302;1
/net/per610a/home/mvp/mvp_db/news7-lv/2018/2018_12_01_19_00/2018_12_01_19_00.mpg;Shinzo ABE.jpg;6257;6329;36081;313;316;3
/net/per610a/home/mvp/mvp_db/news7-lv/2018/2018_12_01_19_00/2018_12_01_19_00.mpg;Shinzo ABE.jpg;2149;2185;36081;107;109;2
/net/per610a/home/mvp/mvp_db/news7-lv/2018/2018_12_01_19_00/2018_12_01_19_00.mpg;Shinzo ABE.jpg;2597;3069;36081;129;153;24
/net/per610a/home/mvp/mvp_db/news7-lv/2018/2018_12_01_19_00/2018_12_01_19_00.mpg;Shinzo ABE.jpg;5413;5441;36081;270;272;2
/net/per610a/home/mvp/mvp_db/news7-lv/2018/2018_12_01_19_00/2018_12_01_19_00.mpg;Shinzo ABE.jpg;8069;8425;36081;403;421;18
/net/per610a/home/mvp/mvp_db/news7-lv/2018/2018_12_01_19_00/2018_12_01_19_00.mpg;Shinzo ABE.jpg;21061;21609;36081;1053;1081;28
/net/per610a/home/mvp/mvp_db/news7-lv/2018/2018_12_02_19_00/2018_12_02_19_00.mpg;Shinzo ABE.jpg;12045;12093;36089;602;605;3
/net/per610a/home/mvp/mvp_db/news7-lv/2018/2018_12_02_19_00/2018_12_02_19_00.mpg;Shinzo ABE.jpg;12505;12609;36089;625;630;5
/net/per610a/home/mvp/mvp_db/news7-lv/2018/2018_12_02_19_00/2018_12_02_19_00.mpg;Kohei Otsuka.jpg;17833;18369;36089;892;919;27
/net/per610a/home/mvp/mvp_db/news7-lv/2018/2018_12_06_19_00/2018_12_06_19_00.mpg;Shinzo ABE.jpg;16189;16669;36089;810;834;24
/net/per610a/home/mvp/mvp_db/news7-lv/2018/2018_12_06_19_00/2018_12_06_19_00.mpg;Shinzo ABE.jpg;16769;16817;36089;839;841;2
/net/per610a/home/mvp/mvp_db/news7-lv/2018/2018_12_06_19_00/2018_12_06_19_00.mpg;Shinzo ABE.jpg;18049;18269;36089;903;914;11
/net/per610a/home/mvp/mvp_db/news7-lv/2018/2018_12_10_19_00/2018_12_10_19_00.mpg;Shinzo ABE.jpg;301;901;36081;15;45;30
/net/per610a/home/mvp/mvp_db/news7-lv/2018/2018_12_10_19_00/2018_12_10_19_00.mpg;Shinzo ABE.jpg;3037;3373;36081;151;168;17
/net/per610a/home/mvp/mvp_db/news7-lv/2018/2018_12_10_19_00/2018_12_10_19_00.mpg;Shinzo ABE.jpg;4505;5349;36081;225;267;42
/net/per610a/home/mvp/mvp_db/news7-lv/2018/2018_12_10_19_00/2018_12_10_19_00.mpg;Shinzo ABE.jpg;5545;6777;36081;277;339;62
/net/per610a/home/mvp/mvp_db/news7-lv/2018/2018_12_10_19_00/2018_12_10_19_00.mpg;Shinzo ABE.jpg;27509;27821;36081;1376;1391;15
/net/per610a/home/mvp/mvp_db/news7-lv/2018/2018_12_10_19_00/2018_12_10_19_00.mpg;Shinzo ABE.jpg;27905;27957;36081;1395;1398;3
/net/per610a/home/mvp/mvp_db/news7-lv/2018/2018_12_10_19_00/2018_12_10_19_00.mpg;Yukio EDANO.jpg;1597;1781;36081;79;89;10
/net/per610a/home/mvp/mvp_db/news7-lv/2018/2018_12_11_19_00/2018_12_11_19_00.mpg;Taro ASO.jpg;21937;22025;36081;1097;1101;4
/net/per610a/home/mvp/mvp_db/news7-lv/2018/2018_12_13_19_00/2018_12_13_19_00.mpg;Yukio HATOYAMA.jpg;25305;25549;36081;1265;1278;13
/net/per610a/home/mvp/mvp_db/news7-lv/2018/2018_12_17_19_00/2018_12_17_19_00.mpg;Taro ASO.jpg;7833;7885;36089;391;394;3
/net/per610a/home/mvp/mvp_db/news7-lv/2018/2018_12_17_19_00/2018_12_17_19_00.mpg;Taro ASO.jpg;10369;10445;36089;518;522;4
/net/per610a/home/mvp/mvp_db/news7-lv/2018/2018_12_18_19_00/2018_12_18_19_00.mpg;Shinzo ABE.jpg;16549;16685;36089;828;834;6
/net/per610a/home/mvp/mvp_db/news7-lv/2018/2018_12_18_19_00/2018_12_18_19_00.mpg;Shinzo ABE.jpg;21009;21069;36089;1051;1054;3
/net/per610a/home/mvp/mvp_db/news7-lv/2018/2018_12_25_19_00/2018_12_25_19_00.mpg;Shinzo ABE.jpg;20721;20757;36089;1036;1038;2
/net/per610a/home/mvp/mvp_db/news7-lv/2018/2018_12_25_19_00/2018_12_25_19_00.mpg;Shinzo ABE.jpg;20889;20981;36089;1045;1049;4
/net/per610a/home/mvp/mvp_db/news7-lv/2018/2018_12_25_19_00/2018_12_25_19_00.mpg;Shinzo ABE.jpg;28105;29117;36089;1406;1457;51
/net/per610a/home/mvp/mvp_db/news7-lv/2017/2017_01_01_19_00/2017_01_01_19_00.mpg;Kohei Otsuka.jpg;8345;8345;24089;417;417;0
/net/per610a/home/mvp/mvp_db/news7-lv/2017/2017_01_01_19_00/2017_01_01_19_00.mpg;Kohei Otsuka.jpg;8457;8761;24089;423;438;15
/net/per610a/home/mvp/mvp_db/news7-lv/2017/2017_01_01_19_00/2017_01_01_19_00.mpg;Kohei Otsuka.jpg;9709;9897;24089;485;495;10
/net/per610a/home/mvp/mvp_db/news7-lv/2017/2017_01_01_19_00/2017_01_01_19_00.mpg;Shinzo ABE.jpg;17973;18313;24089;899;916;17
/net/per610a/home/mvp/mvp_db/news7-lv/2017/2017_01_01_19_00/2017_01_01_19_00.mpg;Shinzo ABE.jpg;18901;19017;24089;945;951;6
/net/per610a/home/mvp/mvp_db/news7-lv/2017/2017_01_01_19_00/2017_01_01_19_00.mpg;Renho.jpg;19685;19833;24089;984;992;8
/net/per610a/home/mvp/mvp_db/news7-lv/2017/2017_01_02_19_00/2017_01_02_19_00.mpg;Shinzo ABE.jpg;30145;30257;36081;1508;1513;5
/net/per610a/home/mvp/mvp_db/news7-lv/2017/2017_01_02_19_00/2017_01_02_19_00.mpg;Shinzo ABE.jpg;30449;30853;36081;1523;1543;20
/net/per610a/home/mvp/mvp_db/news7-lv/2017/2017_01_04_19_00/2017_01_04_19_00.mpg;Shinzo ABE.jpg;1161;1173;36089;58;58;0
/net/per610a/home/mvp/mvp_db/news7-lv/2017/2017_01_04_19_00/2017_01_04_19_00.mpg;Shinzo ABE.jpg;1301;1369;36089;65;68;3
/net/per610a/home/mvp/mvp_db/news7-lv/2017/2017_01_04_19_00/2017_01_04_19_00.mpg;Shinzo ABE.jpg;1869;1977;36089;93;98;5
/net/per610a/home/mvp/mvp_db/news7-lv/2017/2017_01_04_19_00/2017_01_04_19_00.mpg;Shinzo ABE.jpg;2041;2853;36089;102;142;40
/net/per610a/home/mvp/mvp_db/news7-lv/2017/2017_01_04_19_00/2017_01_04_19_00.mpg;Shinzo ABE.jpg;3485;4081;36089;174;204;30
/net/per610a/home/mvp/mvp_db/news7-lv/2017/2017_01_04_19_00/2017_01_04_19_00.mpg;Shinzo ABE.jpg;4349;5265;36089;217;263;46
/net/per610a/home/mvp/mvp_db/news7-lv/2017/2017_01_04_19_00/2017_01_04_19_00.mpg;Natsuo YAMAGUCHI.jpg;5417;6881;36089;271;344;73
/net/per610a/home/mvp/mvp_db/news7-lv/2017/2017_01_04_19_00/2017_01_04_19_00.mpg;YUriko Koike.jpg;7177;7361;36089;359;368;9
/net/per610a/home/mvp/mvp_db/news7-lv/2017/2017_01_04_19_00/2017_01_04_19_00.mpg;YUriko Koike.jpg;7449;7797;36089;372;390;18
/net/per610a/home/mvp/mvp_db/news7-lv/2017/2017_01_04_19_00/2017_01_04_19_00.mpg;YUriko Koike.jpg;9925;10137;36089;496;507;11
/net/per610a/home/mvp/mvp_db/news7-lv/2017/2017_01_04_19_00/2017_01_04_19_00.mpg;YUriko Koike.jpg;8301;8357;36089;415;418;3
/net/per610a/home/mvp/mvp_db/news7-lv/2017/2017_01_04_19_00/2017_01_04_19_00.mpg;YUriko Koike.jpg;9169;9749;36089;458;487;29
/net/per610a/home/mvp/mvp_db/news7-lv/2017/2017_01_04_19_00/2017_01_04_19_00.mpg;YUriko Koike.jpg;10365;10405;36089;518;520;2
/net/per610a/home/mvp/mvp_db/news7-lv/2017/2017_01_06_19_00/2017_01_06_19_00.mpg;YUriko Koike.jpg;477;525;36089;23;26;3
/net/per610a/home/mvp/mvp_db/news7-lv/2017/2017_01_06_19_00/2017_01_06_19_00.mpg;YUriko Koike.jpg;15561;15565;36089;778;778;0
/net/per610a/home/mvp/mvp_db/news7-lv/2017/2017_01_06_19_00/2017_01_06_19_00.mpg;YUriko Koike.jpg;15897;16021;36089;795;801;6
/net/per610a/home/mvp/mvp_db/news7-lv/2017/2017_01_06_19_00/2017_01_06_19_00.mpg;YUriko Koike.jpg;19333;19525;36089;967;977;10
/net/per610a/home/mvp/mvp_db/news7-lv/2017/2017_01_06_19_00/2017_01_06_19_00.mpg;Shinzo ABE.jpg;1741;1925;36089;87;96;9
/net/per610a/home/mvp/mvp_db/news7-lv/2017/2017_01_06_19_00/2017_01_06_19_00.mpg;Shinzo ABE.jpg;6649;7157;36089;332;358;26
/net/per610a/home/mvp/mvp_db/news7-lv/2017/2017_01_06_19_00/2017_01_06_19_00.mpg;Ichiro OZAWA.jpg;17757;18185;36089;888;910;22
/net/per610a/home/mvp/mvp_db/news7-lv/2017/2017_01_08_19_00/2017_01_08_19_00.mpg;Shinzo ABE.jpg;5233;5753;36089;261;287;26
/net/per610a/home/mvp/mvp_db/news7-lv/2017/2017_01_09_19_00/2017_01_09_19_00.mpg;Shinzo ABE.jpg;3193;3525;36081;159;176;17
/net/per610a/home/mvp/mvp_db/news7-lv/2017/2017_01_10_19_00/2017_01_10_19_00.mpg;Shinzo ABE.jpg;10577;10729;36081;529;536;7
/net/per610a/home/mvp/mvp_db/news7-lv/2017/2017_01_10_19_00/2017_01_10_19_00.mpg;Shinzo ABE.jpg;14437;14797;36081;722;740;18
/net/per610a/home/mvp/mvp_db/news7-lv/2017/2017_01_10_19_00/2017_01_10_19_00.mpg;Shinzo ABE.jpg;15573;15725;36081;779;786;7
/net/per610a/home/mvp/mvp_db/news7-lv/2017/2017_01_10_19_00/2017_01_10_19_00.mpg;Shinzo ABE.jpg;16801;17053;36081;840;853;13
/net/per610a/home/mvp/mvp_db/news7-lv/2017/2017_01_10_19_00/2017_01_10_19_00.mpg;Shinzo ABE.jpg;18377;18693;36081;919;935;16
/net/per610a/home/mvp/mvp_db/news7-lv/2017/2017_01_10_19_00/2017_01_10_19_00.mpg;Shinzo ABE.jpg;23321;23669;36081;1166;1184;18
/net/per610a/home/mvp/mvp_db/news7-lv/2017/2017_01_10_19_00/2017_01_10_19_00.mpg;YUriko Koike.jpg;21853;21937;36081;1093;1097;4
/net/per610a/home/mvp/mvp_db/news7-lv/2017/2017_01_10_19_00/2017_01_10_19_00.mpg;YUriko Koike.jpg;25309;25333;36081;1266;1267;1
/net/per610a/home/mvp/mvp_db/news7-lv/2017/2017_01_10_19_00/2017_01_10_19_00.mpg;Shinzo ABE.jpg;21937;21941;36081;1097;1097;0
/net/per610a/home/mvp/mvp_db/news7-lv/2017/2017_01_10_19_00/2017_01_10_19_00.mpg;Shinzo ABE.jpg;23185;23237;36081;1159;1162;3
/net/per610a/home/mvp/mvp_db/news7-lv/2017/2017_01_10_19_00/2017_01_10_19_00.mpg;Shinzo ABE.jpg;24953;25169;36081;1248;1259;11
/net/per610a/home/mvp/mvp_db/news7-lv/2017/2017_01_12_19_00/2017_01_12_19_00.mpg;Shinzo ABE.jpg;18597;18961;36081;930;948;18
/net/per610a/home/mvp/mvp_db/news7-lv/2017/2017_01_12_19_00/2017_01_12_19_00.mpg;Shinzo ABE.jpg;19393;19453;36081;970;973;3
/net/per610a/home/mvp/mvp_db/news7-lv/2017/2017_01_12_19_00/2017_01_12_19_00.mpg;Shinzo ABE.jpg;21409;21721;36081;1071;1086;15
/net/per610a/home/mvp/mvp_db/news7-lv/2017/2017_01_12_19_00/2017_01_12_19_00.mpg;Shinzo ABE.jpg;22669;22733;36081;1134;1137;3
/net/per610a/home/mvp/mvp_db/news7-lv/2017/2017_01_13_19_00/2017_01_13_19_00.mpg;Masashi Nakano.jpg;1165;1433;36081;58;71;13
/net/per610a/home/mvp/mvp_db/news7-lv/2017/2017_01_13_19_00/2017_01_13_19_00.mpg;Masashi Nakano.jpg;32841;33009;36081;1642;1651;9
/net/per610a/home/mvp/mvp_db/news7-lv/2017/2017_01_13_19_00/2017_01_13_19_00.mpg;YUriko Koike.jpg;24809;24965;36081;1241;1248;7
/net/per610a/home/mvp/mvp_db/news7-lv/2017/2017_01_13_19_00/2017_01_13_19_00.mpg;YUriko Koike.jpg;25269;25853;36081;1264;1293;29
/net/per610a/home/mvp/mvp_db/news7-lv/2017/2017_01_13_19_00/2017_01_13_19_00.mpg;YUriko Koike.jpg;26829;27713;36081;1342;1386;44
/net/per610a/home/mvp/mvp_db/news7-lv/2017/2017_01_14_19_00/2017_01_14_19_00.mpg;YUriko Koike.jpg;285;421;36081;14;21;7
/net/per610a/home/mvp/mvp_db/news7-lv/2017/2017_01_14_19_00/2017_01_14_19_00.mpg;YUriko Koike.jpg;1933;2217;36081;96;110;14
/net/per610a/home/mvp/mvp_db/news7-lv/2017/2017_01_14_19_00/2017_01_14_19_00.mpg;YUriko Koike.jpg;3577;4137;36081;178;206;28
/net/per610a/home/mvp/mvp_db/news7-lv/2017/2017_01_14_19_00/2017_01_14_19_00.mpg;Shinzo ABE.jpg;23785;24185;36081;1189;1209;20
/net/per610a/home/mvp/mvp_db/news7-lv/2017/2017_01_14_19_00/2017_01_14_19_00.mpg;Shinzo ABE.jpg;25789;25841;36081;1290;1292;2
/net/per610a/home/mvp/mvp_db/news7-lv/2017/2017_01_14_19_00/2017_01_14_19_00.mpg;Shinzo ABE.jpg;24345;24553;36081;1217;1228;11
/net/per610a/home/mvp/mvp_db/news7-lv/2017/2017_01_14_19_00/2017_01_14_19_00.mpg;Shinzo ABE.jpg;24965;25217;36081;1248;1261;13
/net/per610a/home/mvp/mvp_db/news7-lv/2017/2017_01_14_19_00/2017_01_14_19_00.mpg;Shinzo ABE.jpg;26181;26465;36081;1309;1323;14
/net/per610a/home/mvp/mvp_db/news7-lv/2017/2017_01_14_19_00/2017_01_14_19_00.mpg;Shinzo ABE.jpg;27233;28017;36081;1362;1401;39
/net/per610a/home/mvp/mvp_db/news7-lv/2017/2017_01_15_19_00/2017_01_15_19_00.mpg;Shinzo ABE.jpg;23417;23517;36081;1171;1176;5
/net/per610a/home/mvp/mvp_db/news7-lv/2017/2017_01_15_19_00/2017_01_15_19_00.mpg;Shinzo ABE.jpg;24053;24117;36081;1203;1206;3
/net/per610a/home/mvp/mvp_db/news7-lv/2017/2017_01_16_19_00/2017_01_16_19_00.mpg;YUriko Koike.jpg;289;569;36089;14;28;14
/net/per610a/home/mvp/mvp_db/news7-lv/2017/2017_01_16_19_00/2017_01_16_19_00.mpg;YUriko Koike.jpg;7097;7409;36089;355;370;15
/net/per610a/home/mvp/mvp_db/news7-lv/2017/2017_01_16_19_00/2017_01_16_19_00.mpg;YUriko Koike.jpg;8733;10329;36089;437;516;79
/net/per610a/home/mvp/mvp_db/news7-lv/2017/2017_01_16_19_00/2017_01_16_19_00.mpg;Nariaki Nakayama.png;12433;12573;36089;622;629;7
/net/per610a/home/mvp/mvp_db/news7-lv/2017/2017_01_16_19_00/2017_01_16_19_00.mpg;Yoshihiko Noda.jpg;23965;24493;36089;1199;1225;26
/net/per610a/home/mvp/mvp_db/news7-lv/2017/2017_01_16_19_00/2017_01_16_19_00.mpg;Shinzo ABE.jpg;26053;26089;36089;1303;1305;2
/net/per610a/home/mvp/mvp_db/news7-lv/2017/2017_01_16_19_00/2017_01_16_19_00.mpg;Shinzo ABE.jpg;26777;27089;36089;1340;1355;15
/net/per610a/home/mvp/mvp_db/news7-lv/2017/2017_01_16_19_00/2017_01_16_19_00.mpg;Shinzo ABE.jpg;27309;27557;36089;1366;1379;13
/net/per610a/home/mvp/mvp_db/news7-lv/2017/2017_01_16_19_00/2017_01_16_19_00.mpg;Shinzo ABE.jpg;27909;28001;36089;1396;1401;5
/net/per610a/home/mvp/mvp_db/news7-lv/2017/2017_01_19_19_00/2017_01_19_19_00.mpg;Ichiro OZAWA.jpg;19709;21377;36089;986;1069;83
/net/per610a/home/mvp/mvp_db/news7-lv/2017/2017_01_20_19_00/2017_01_20_19_00.mpg;Shinzo ABE.jpg;24353;25097;36089;1218;1255;37
/net/per610a/home/mvp/mvp_db/news7-lv/2017/2017_01_20_19_00/2017_01_20_19_00.mpg;Shinzo ABE.jpg;26609;26965;36089;1331;1349;18
/net/per610a/home/mvp/mvp_db/news7-lv/2017/2017_01_20_19_00/2017_01_20_19_00.mpg;Shinzo ABE.jpg;28029;28093;36089;1402;1405;3
/net/per610a/home/mvp/mvp_db/news7-lv/2017/2017_01_20_19_00/2017_01_20_19_00.mpg;Shinzo ABE.jpg;28165;28365;36089;1409;1419;10
/net/per610a/home/mvp/mvp_db/news7-lv/2017/2017_01_23_19_00/2017_01_23_19_00.mpg;Shinzo ABE.jpg;10949;11149;36081;547;557;10
/net/per610a/home/mvp/mvp_db/news7-lv/2017/2017_01_23_19_00/2017_01_23_19_00.mpg;Shinzo ABE.jpg;23929;24173;36081;1197;1209;12
/net/per610a/home/mvp/mvp_db/news7-lv/2017/2017_01_23_19_00/2017_01_23_19_00.mpg;Yoshihiko Noda.jpg;24541;25633;36081;1227;1282;55
/net/per610a/home/mvp/mvp_db/news7-lv/2017/2017_01_24_19_00/2017_01_24_19_00.mpg;Shinzo ABE.jpg;15793;16465;36081;790;823;33
/net/per610a/home/mvp/mvp_db/news7-lv/2017/2017_01_24_19_00/2017_01_24_19_00.mpg;Shinzo ABE.jpg;25093;25421;36081;1255;1271;16
/net/per610a/home/mvp/mvp_db/news7-lv/2017/2017_01_24_19_00/2017_01_24_19_00.mpg;Shinzo ABE.jpg;29745;29789;36081;1488;1490;2
/net/per610a/home/mvp/mvp_db/news7-lv/2017/2017_01_24_19_00/2017_01_24_19_00.mpg;Shinzo ABE.jpg;29945;29953;36081;1498;1498;0
/net/per610a/home/mvp/mvp_db/news7-lv/2017/2017_01_25_19_00/2017_01_25_19_00.mpg;YUriko Koike.jpg;8609;8973;36081;430;448;18
/net/per610a/home/mvp/mvp_db/news7-lv/2017/2017_01_25_19_00/2017_01_25_19_00.mpg;YUriko Koike.jpg;9921;10197;36081;496;510;14
/net/per610a/home/mvp/mvp_db/news7-lv/2017/2017_01_25_19_00/2017_01_25_19_00.mpg;YUriko Koike.jpg;11805;12097;36081;590;605;15
/net/per610a/home/mvp/mvp_db/news7-lv/2017/2017_01_25_19_00/2017_01_25_19_00.mpg;Shinzo ABE.jpg;22681;23169;36081;1134;1159;25
/net/per610a/home/mvp/mvp_db/news7-lv/2017/2017_01_27_19_00/2017_01_27_19_00.mpg;Shinzo ABE.jpg;8649;8713;36081;432;435;3
/net/per610a/home/mvp/mvp_db/news7-lv/2017/2017_01_27_19_00/2017_01_27_19_00.mpg;Shinzo ABE.jpg;8961;9241;36081;448;462;14
/net/per610a/home/mvp/mvp_db/news7-lv/2017/2017_01_27_19_00/2017_01_27_19_00.mpg;Shinzo ABE.jpg;24453;24901;36081;1223;1245;22
/net/per610a/home/mvp/mvp_db/news7-lv/2017/2017_01_27_19_00/2017_01_27_19_00.mpg;Shinzo ABE.jpg;8773;8857;36081;438;443;5
/net/per610a/home/mvp/mvp_db/news7-lv/2017/2017_01_27_19_00/2017_01_27_19_00.mpg;Shinzo ABE.jpg;9265;9409;36081;463;470;7
/net/per610a/home/mvp/mvp_db/news7-lv/2017/2017_01_27_19_00/2017_01_27_19_00.mpg;Shinzo ABE.jpg;25357;25521;36081;1268;1276;8
/net/per610a/home/mvp/mvp_db/news7-lv/2017/2017_01_27_19_00/2017_01_27_19_00.mpg;Shinzo ABE.jpg;25593;25621;36081;1280;1281;1
/net/per610a/home/mvp/mvp_db/news7-lv/2017/2017_01_27_19_00/2017_01_27_19_00.mpg;Taro ASO.jpg;19773;19885;36081;989;994;5
/net/per610a/home/mvp/mvp_db/news7-lv/2017/2017_01_28_19_00/2017_01_28_19_00.mpg;Shinzo ABE.jpg;277;373;36081;13;18;5
/net/per610a/home/mvp/mvp_db/news7-lv/2017/2017_01_28_19_00/2017_01_28_19_00.mpg;Shinzo ABE.jpg;1513;1665;36081;75;83;8
/net/per610a/home/mvp/mvp_db/news7-lv/2017/2017_01_28_19_00/2017_01_28_19_00.mpg;Shinzo ABE.jpg;9221;9353;36081;461;467;6
/net/per610a/home/mvp/mvp_db/news7-lv/2017/2017_01_28_19_00/2017_01_28_19_00.mpg;Shinzo ABE.jpg;9725;9781;36081;486;489;3
/net/per610a/home/mvp/mvp_db/news7-lv/2017/2017_01_28_19_00/2017_01_28_19_00.mpg;Shinzo ABE.jpg;10081;10409;36081;504;520;16
/net/per610a/home/mvp/mvp_db/news7-lv/2017/2017_01_28_19_00/2017_01_28_19_00.mpg;Shinzo ABE.jpg;11025;11501;36081;551;575;24
/net/per610a/home/mvp/mvp_db/news7-lv/2017/2017_01_28_19_00/2017_01_28_19_00.mpg;Shinzo ABE.jpg;27981;28089;36081;1399;1405;6
/net/per610a/home/mvp/mvp_db/news7-lv/2017/2017_01_29_19_00/2017_01_29_19_00.mpg;Shinzo ABE.jpg;11697;11877;36089;585;594;9
/net/per610a/home/mvp/mvp_db/news7-lv/2017/2017_01_29_19_00/2017_01_29_19_00.mpg;Shinzo ABE.jpg;12233;12485;36089;612;624;12
/net/per610a/home/mvp/mvp_db/news7-lv/2017/2017_01_30_19_00/2017_01_30_19_00.mpg;Shinzo ABE.jpg;10729;10745;36089;536;537;1
/net/per610a/home/mvp/mvp_db/news7-lv/2017/2017_01_30_19_00/2017_01_30_19_00.mpg;Shinzo ABE.jpg;11069;11561;36089;553;578;25
/net/per610a/home/mvp/mvp_db/news7-lv/2017/2017_01_30_19_00/2017_01_30_19_00.mpg;Shinzo ABE.jpg;12141;13181;36089;607;659;52
/net/per610a/home/mvp/mvp_db/news7-lv/2017/2017_01_31_19_00/2017_01_31_19_00.mpg;Shinzo ABE.jpg;14401;14853;36081;720;743;23
/net/per610a/home/mvp/mvp_db/news7-lv/2017/2017_01_31_19_00/2017_01_31_19_00.mpg;Shinzo ABE.jpg;24853;24997;36081;1243;1250;7
/net/per610a/home/mvp/mvp_db/news7-lv/2017/2017_01_31_19_00/2017_01_31_19_00.mpg;Shinzo ABE.jpg;25437;25473;36081;1272;1274;2
/net/per610a/home/mvp/mvp_db/news7-lv/2017/2017_01_31_19_00/2017_01_31_19_00.mpg;Kyoko Nakayama.jpg;28389;28489;36081;1420;1425;5
/net/per610a/home/mvp/mvp_db/news7-lv/2017/2017_01_31_19_00/2017_01_31_19_00.mpg;Kyoko Nakayama.jpg;28649;28841;36081;1433;1442;9
/net/per610a/home/mvp/mvp_db/news7-lv/2017/2017_02_01_19_00/2017_02_01_19_00.mpg;Shinzo ABE.jpg;417;549;36089;20;27;7
/net/per610a/home/mvp/mvp_db/news7-lv/2017/2017_02_01_19_00/2017_02_01_19_00.mpg;Shinzo ABE.jpg;3773;4061;36089;188;203;15
/net/per610a/home/mvp/mvp_db/news7-lv/2017/2017_02_01_19_00/2017_02_01_19_00.mpg;Shinzo ABE.jpg;12745;13293;36089;637;665;28
/net/per610a/home/mvp/mvp_db/news7-lv/2017/2017_02_03_19_00/2017_02_03_19_00.mpg;Shinzo ABE.jpg;18397;18785;36089;920;940;20
/net/per610a/home/mvp/mvp_db/news7-lv/2017/2017_02_04_19_00/2017_02_04_19_00.mpg;Shinzo ABE.jpg;11213;11213;36081;560;560;0
/net/per610a/home/mvp/mvp_db/news7-lv/2017/2017_02_04_19_00/2017_02_04_19_00.mpg;Shinzo ABE.jpg;18777;19473;36081;939;974;35
/net/per610a/home/mvp/mvp_db/news7-lv/2017/2017_02_04_19_00/2017_02_04_19_00.mpg;Natsuo YAMAGUCHI.jpg;31297;31573;36081;1565;1579;14
/net/per610a/home/mvp/mvp_db/news7-lv/2017/2017_02_06_19_00/2017_02_06_19_00.mpg;Shinzo ABE.jpg;14181;14577;36081;709;729;20
/net/per610a/home/mvp/mvp_db/news7-lv/2017/2017_02_06_19_00/2017_02_06_19_00.mpg;Shinzo ABE.jpg;17165;17869;36081;858;893;35
/net/per610a/home/mvp/mvp_db/news7-lv/2017/2017_02_07_19_00/2017_02_07_19_00.mpg;Shinzo ABE.jpg;7697;8401;36089;385;420;35
/net/per610a/home/mvp/mvp_db/news7-lv/2017/2017_02_07_19_00/2017_02_07_19_00.mpg;Shinzo ABE.jpg;28213;28213;36089;1411;1411;0
/net/per610a/home/mvp/mvp_db/news7-lv/2017/2017_02_07_19_00/2017_02_07_19_00.mpg;Shinzo ABE.jpg;28277;28605;36089;1415;1431;16
/net/per610a/home/mvp/mvp_db/news7-lv/2017/2017_02_07_19_00/2017_02_07_19_00.mpg;Taro ASO.jpg;10685;11205;36089;534;560;26
/net/per610a/home/mvp/mvp_db/news7-lv/2017/2017_02_07_19_00/2017_02_07_19_00.mpg;Shinzo ABE.jpg;12469;12605;36089;623;630;7
/net/per610a/home/mvp/mvp_db/news7-lv/2017/2017_02_08_19_00/2017_02_08_19_00.mpg;Shinzo ABE.jpg;7245;7493;36089;362;374;12
/net/per610a/home/mvp/mvp_db/news7-lv/2017/2017_02_08_19_00/2017_02_08_19_00.mpg;Shinzo ABE.jpg;9061;9209;36089;453;460;7
/net/per610a/home/mvp/mvp_db/news7-lv/2017/2017_02_08_19_00/2017_02_08_19_00.mpg;Shinzo ABE.jpg;13705;13801;36089;685;690;5
/net/per610a/home/mvp/mvp_db/news7-lv/2017/2017_02_08_19_00/2017_02_08_19_00.mpg;Shintaro ISHIHARA.jpg;18597;18849;36089;930;943;13
/net/per610a/home/mvp/mvp_db/news7-lv/2017/2017_02_08_19_00/2017_02_08_19_00.mpg;YUriko Koike.jpg;19477;19637;36089;974;982;8
/net/per610a/home/mvp/mvp_db/news7-lv/2017/2017_02_10_19_00/2017_02_10_19_00.mpg;Shinzo ABE.jpg;8729;8729;36089;436;436;0
/net/per610a/home/mvp/mvp_db/news7-lv/2017/2017_02_10_19_00/2017_02_10_19_00.mpg;Shinzo ABE.jpg;9089;9133;36089;454;457;3
/net/per610a/home/mvp/mvp_db/news7-lv/2017/2017_02_10_19_00/2017_02_10_19_00.mpg;Shinzo ABE.jpg;18705;18853;36089;936;943;7
/net/per610a/home/mvp/mvp_db/news7-lv/2017/2017_02_10_19_00/2017_02_10_19_00.mpg;Shinzo ABE.jpg;19229;19849;36089;962;993;31
/net/per610a/home/mvp/mvp_db/news7-lv/2017/2017_02_10_19_00/2017_02_10_19_00.mpg;YUriko Koike.jpg;30153;30309;36089;1508;1516;8
/net/per610a/home/mvp/mvp_db/news7-lv/2017/2017_02_11_19_00/2017_02_11_19_00.mpg;Shinzo ABE.jpg;917;973;36081;45;48;3
/net/per610a/home/mvp/mvp_db/news7-lv/2017/2017_02_11_19_00/2017_02_11_19_00.mpg;Shinzo ABE.jpg;1069;1513;36081;53;75;22
/net/per610a/home/mvp/mvp_db/news7-lv/2017/2017_02_11_19_00/2017_02_11_19_00.mpg;Shinzo ABE.jpg;2301;2385;36081;115;119;4
/net/per610a/home/mvp/mvp_db/news7-lv/2017/2017_02_11_19_00/2017_02_11_19_00.mpg;Shinzo ABE.jpg;6269;6273;36081;313;313;0
/net/per610a/home/mvp/mvp_db/news7-lv/2017/2017_02_11_19_00/2017_02_11_19_00.mpg;Shinzo ABE.jpg;17493;17589;36081;875;879;4
/net/per610a/home/mvp/mvp_db/news7-lv/2017/2017_02_11_19_00/2017_02_11_19_00.mpg;Shinzo ABE.jpg;16413;16513;36081;821;826;5
/net/per610a/home/mvp/mvp_db/news7-lv/2017/2017_02_11_19_00/2017_02_11_19_00.mpg;Shinzo ABE.jpg;17781;18073;36081;889;904;15
/net/per610a/home/mvp/mvp_db/news7-lv/2017/2017_02_12_19_00/2017_02_12_19_00.mpg;Shinzo ABE.jpg;12765;12873;36081;638;643;5
/net/per610a/home/mvp/mvp_db/news7-lv/2017/2017_02_12_19_00/2017_02_12_19_00.mpg;Shinzo ABE.jpg;15393;15445;36081;770;772;2
/net/per610a/home/mvp/mvp_db/news7-lv/2017/2017_02_12_19_00/2017_02_12_19_00.mpg;Shinzo ABE.jpg;15969;16045;36081;798;802;4
/net/per610a/home/mvp/mvp_db/news7-lv/2017/2017_02_12_19_00/2017_02_12_19_00.mpg;Shinzo ABE.jpg;16369;16433;36081;818;822;4
/net/per610a/home/mvp/mvp_db/news7-lv/2017/2017_02_12_19_00/2017_02_12_19_00.mpg;Shinzo ABE.jpg;14817;14833;36081;741;742;1
/net/per610a/home/mvp/mvp_db/news7-lv/2017/2017_02_12_19_00/2017_02_12_19_00.mpg;Shinzo ABE.jpg;18505;18589;36081;925;929;4
/net/per610a/home/mvp/mvp_db/news7-lv/2017/2017_02_12_19_00/2017_02_12_19_00.mpg;Shinzo ABE.jpg;18933;18949;36081;947;947;0
/net/per610a/home/mvp/mvp_db/news7-lv/2017/2017_02_12_19_00/2017_02_12_19_00.mpg;Shinzo ABE.jpg;19013;19041;36081;951;952;1
/net/per610a/home/mvp/mvp_db/news7-lv/2017/2017_02_12_19_00/2017_02_12_19_00.mpg;Taro ASO.jpg;20581;20829;36081;1029;1041;12
/net/per610a/home/mvp/mvp_db/news7-lv/2017/2017_02_13_19_00/2017_02_13_19_00.mpg;Yoshihiko Noda.jpg;12385;12765;36081;619;638;19
/net/per610a/home/mvp/mvp_db/news7-lv/2017/2017_02_13_19_00/2017_02_13_19_00.mpg;Shinzo ABE.jpg;25293;25293;36081;1265;1265;0
/net/per610a/home/mvp/mvp_db/news7-lv/2017/2017_02_13_19_00/2017_02_13_19_00.mpg;Shinzo ABE.jpg;25373;25501;36081;1269;1275;6
/net/per610a/home/mvp/mvp_db/news7-lv/2017/2017_02_13_19_00/2017_02_13_19_00.mpg;Shinzo ABE.jpg;25905;25961;36081;1295;1298;3
/net/per610a/home/mvp/mvp_db/news7-lv/2017/2017_02_13_19_00/2017_02_13_19_00.mpg;Taro ASO.jpg;26725;27393;36081;1336;1370;34
/net/per610a/home/mvp/mvp_db/news7-lv/2017/2017_02_14_19_00/2017_02_14_19_00.mpg;Shinzo ABE.jpg;17649;18185;36089;883;910;27
/net/per610a/home/mvp/mvp_db/news7-lv/2017/2017_02_14_19_00/2017_02_14_19_00.mpg;Shinzo ABE.jpg;27105;27513;36089;1356;1376;20
/net/per610a/home/mvp/mvp_db/news7-lv/2017/2017_02_16_19_00/2017_02_16_19_00.mpg;YUriko Koike.jpg;20001;20397;36081;1000;1020;20
/net/per610a/home/mvp/mvp_db/news7-lv/2017/2017_02_17_19_00/2017_02_17_19_00.mpg;Shinzo ABE.jpg;29281;29505;36081;1464;1476;12
/net/per610a/home/mvp/mvp_db/news7-lv/2017/2017_02_17_19_00/2017_02_17_19_00.mpg;Shinzo ABE.jpg;29677;29721;36081;1484;1486;2
/net/per610a/home/mvp/mvp_db/news7-lv/2017/2017_02_20_19_00/2017_02_20_19_00.mpg;Kyoko Nakayama.jpg;23597;23701;36089;1180;1186;6
/net/per610a/home/mvp/mvp_db/news7-lv/2017/2017_02_20_19_00/2017_02_20_19_00.mpg;Toranosuke Katayama.jpg;23725;24053;36089;1187;1203;16
/net/per610a/home/mvp/mvp_db/news7-lv/2017/2017_02_20_19_00/2017_02_20_19_00.mpg;Yoshihiko Noda.jpg;25129;25405;36089;1257;1271;14
/net/per610a/home/mvp/mvp_db/news7-lv/2017/2017_02_22_19_00/2017_02_22_19_00.mpg;YUriko Koike.jpg;13805;14113;36081;690;706;16
/net/per610a/home/mvp/mvp_db/news7-lv/2017/2017_02_22_19_00/2017_02_22_19_00.mpg;YUriko Koike.jpg;14257;14545;36081;713;727;14
/net/per610a/home/mvp/mvp_db/news7-lv/2017/2017_02_22_19_00/2017_02_22_19_00.mpg;YUriko Koike.jpg;14693;14809;36081;735;740;5
/net/per610a/home/mvp/mvp_db/news7-lv/2017/2017_02_22_19_00/2017_02_22_19_00.mpg;YUriko Koike.jpg;15373;15633;36081;769;782;13
/net/per610a/home/mvp/mvp_db/news7-lv/2017/2017_02_22_19_00/2017_02_22_19_00.mpg;YUriko Koike.jpg;19037;19177;36081;952;959;7
/net/per610a/home/mvp/mvp_db/news7-lv/2017/2017_02_22_19_00/2017_02_22_19_00.mpg;Shintaro ISHIHARA.jpg;20013;20277;36081;1001;1014;13
/net/per610a/home/mvp/mvp_db/news7-lv/2017/2017_02_24_19_00/2017_02_24_19_00.mpg;Shinzo ABE.jpg;12449;12925;36089;622;646;24
/net/per610a/home/mvp/mvp_db/news7-lv/2017/2017_02_24_19_00/2017_02_24_19_00.mpg;Shinzo ABE.jpg;13101;13617;36089;655;681;26
/net/per610a/home/mvp/mvp_db/news7-lv/2017/2017_02_24_19_00/2017_02_24_19_00.mpg;Shinzo ABE.jpg;13953;14865;36089;698;743;45
/net/per610a/home/mvp/mvp_db/news7-lv/2017/2017_02_24_19_00/2017_02_24_19_00.mpg;Shinzo ABE.jpg;15685;16209;36089;784;811;27
/net/per610a/home/mvp/mvp_db/news7-lv/2017/2017_02_24_19_00/2017_02_24_19_00.mpg;Shinzo ABE.jpg;17245;17685;36089;862;885;23
/net/per610a/home/mvp/mvp_db/news7-lv/2017/2017_02_24_19_00/2017_02_24_19_00.mpg;Shinzo ABE.jpg;21953;22025;36089;1098;1102;4
/net/per610a/home/mvp/mvp_db/news7-lv/2017/2017_02_24_19_00/2017_02_24_19_00.mpg;Shinzo ABE.jpg;22229;22385;36089;1112;1120;8
/net/per610a/home/mvp/mvp_db/news7-lv/2017/2017_02_25_19_00/2017_02_25_19_00.mpg;Shintaro ISHIHARA.jpg;8597;8781;36081;430;439;9
/net/per610a/home/mvp/mvp_db/news7-lv/2017/2017_02_25_19_00/2017_02_25_19_00.mpg;Shintaro ISHIHARA.jpg;13205;13441;36081;660;672;12
/net/per610a/home/mvp/mvp_db/news7-lv/2017/2017_02_25_19_00/2017_02_25_19_00.mpg;YUriko Koike.jpg;8721;9469;36081;436;473;37
/net/per610a/home/mvp/mvp_db/news7-lv/2017/2017_02_25_19_00/2017_02_25_19_00.mpg;YUriko Koike.jpg;12281;12441;36081;614;622;8
/net/per610a/home/mvp/mvp_db/news7-lv/2017/2017_02_26_19_00/2017_02_26_19_00.mpg;YUriko Koike.jpg;15021;15461;36089;751;773;22
/net/per610a/home/mvp/mvp_db/news7-lv/2017/2017_03_01_19_00/2017_03_01_19_00.mpg;Shinzo ABE.jpg;21101;21437;36089;1055;1072;17
/net/per610a/home/mvp/mvp_db/news7-lv/2017/2017_03_01_19_00/2017_03_01_19_00.mpg;Shinzo ABE.jpg;21913;22217;36089;1096;1111;15
/net/per610a/home/mvp/mvp_db/news7-lv/2017/2017_03_01_19_00/2017_03_01_19_00.mpg;Shinzo ABE.jpg;23009;23517;36089;1151;1176;25
/net/per610a/home/mvp/mvp_db/news7-lv/2017/2017_02_27_19_00/2017_02_27_19_00.mpg;Yoshihiko Noda.jpg;25369;25493;36081;1269;1275;6
/net/per610a/home/mvp/mvp_db/news7-lv/2017/2017_02_27_19_00/2017_02_27_19_00.mpg;Shinzo ABE.jpg;25993;26585;36081;1300;1329;29
/net/per610a/home/mvp/mvp_db/news7-lv/2017/2017_02_27_19_00/2017_02_27_19_00.mpg;Shintaro ISHIHARA.jpg;28453;28713;36081;1423;1436;13
/net/per610a/home/mvp/mvp_db/news7-lv/2017/2017_03_02_19_00/2017_03_02_19_00.mpg;Shinzo ABE.jpg;5513;5673;36089;275;283;8
/net/per610a/home/mvp/mvp_db/news7-lv/2017/2017_03_02_19_00/2017_03_02_19_00.mpg;Shinzo ABE.jpg;5901;6925;36089;295;346;51
/net/per610a/home/mvp/mvp_db/news7-lv/2017/2017_03_04_19_00/2017_03_04_19_00.mpg;YUriko Koike.jpg;2329;2545;36081;116;127;11
/net/per610a/home/mvp/mvp_db/news7-lv/2017/2017_03_05_19_00/2017_03_05_19_00.mpg;Shinzo ABE.jpg;23025;23025;36089;1152;1152;0
/net/per610a/home/mvp/mvp_db/news7-lv/2017/2017_03_05_19_00/2017_03_05_19_00.mpg;Shinzo ABE.jpg;25441;25673;36089;1273;1284;11
/net/per610a/home/mvp/mvp_db/news7-lv/2017/2017_03_05_19_00/2017_03_05_19_00.mpg;Shinzo ABE.jpg;26061;26201;36089;1304;1311;7
/net/per610a/home/mvp/mvp_db/news7-lv/2017/2017_03_05_19_00/2017_03_05_19_00.mpg;Natsuo YAMAGUCHI.jpg;23705;24085;36089;1186;1205;19
/net/per610a/home/mvp/mvp_db/news7-lv/2017/2017_03_05_19_00/2017_03_05_19_00.mpg;YUriko Koike.jpg;26505;26657;36089;1326;1333;7
/net/per610a/home/mvp/mvp_db/news7-lv/2017/2017_03_06_19_00/2017_03_06_19_00.mpg;Shinzo ABE.jpg;385;529;36081;19;26;7
/net/per610a/home/mvp/mvp_db/news7-lv/2017/2017_03_06_19_00/2017_03_06_19_00.mpg;Shinzo ABE.jpg;5253;5517;36081;262;275;13
/net/per610a/home/mvp/mvp_db/news7-lv/2017/2017_03_06_19_00/2017_03_06_19_00.mpg;Shinzo ABE.jpg;5641;5989;36081;282;299;17
/net/per610a/home/mvp/mvp_db/news7-lv/2017/2017_03_06_19_00/2017_03_06_19_00.mpg;Shinzo ABE.jpg;24533;24697;36081;1227;1235;8
/net/per610a/home/mvp/mvp_db/news7-lv/2017/2017_03_06_19_00/2017_03_06_19_00.mpg;Shinzo ABE.jpg;25217;25677;36081;1261;1284;23
/net/per610a/home/mvp/mvp_db/news7-lv/2017/2017_03_07_19_00/2017_03_07_19_00.mpg;Shinzo ABE.jpg;1445;1445;36081;72;72;0
/net/per610a/home/mvp/mvp_db/news7-lv/2017/2017_03_07_19_00/2017_03_07_19_00.mpg;Shinzo ABE.jpg;1709;1869;36081;85;93;8
/net/per610a/home/mvp/mvp_db/news7-lv/2017/2017_03_07_19_00/2017_03_07_19_00.mpg;Shinzo ABE.jpg;4005;4969;36081;200;248;48
/net/per610a/home/mvp/mvp_db/news7-lv/2017/2017_03_09_19_00/2017_03_09_19_00.mpg;Shinzo ABE.jpg;17741;17745;36089;887;888;1
/net/per610a/home/mvp/mvp_db/news7-lv/2017/2017_03_09_19_00/2017_03_09_19_00.mpg;Shinzo ABE.jpg;19601;19901;36089;980;995;15
/net/per610a/home/mvp/mvp_db/news7-lv/2017/2017_03_10_19_00/2017_03_10_19_00.mpg;Shinzo ABE.jpg;45;289;38481;2;14;12
/net/per610a/home/mvp/mvp_db/news7-lv/2017/2017_03_10_19_00/2017_03_10_19_00.mpg;Shinzo ABE.jpg;2805;3481;38481;140;174;34
/net/per610a/home/mvp/mvp_db/news7-lv/2017/2017_03_10_19_00/2017_03_10_19_00.mpg;Shinzo ABE.jpg;4697;5033;38481;234;251;17
/net/per610a/home/mvp/mvp_db/news7-lv/2017/2017_03_10_19_00/2017_03_10_19_00.mpg;Shinzo ABE.jpg;7221;7669;38481;361;383;22
/net/per610a/home/mvp/mvp_db/news7-lv/2017/2017_03_10_19_00/2017_03_10_19_00.mpg;Shinzo ABE.jpg;32613;32669;38481;1631;1634;3
/net/per610a/home/mvp/mvp_db/news7-lv/2017/2017_03_10_19_00/2017_03_10_19_00.mpg;Shinzo ABE.jpg;32817;33033;38481;1641;1652;11
/net/per610a/home/mvp/mvp_db/news7-lv/2017/2017_03_11_19_00/2017_03_11_19_00.mpg;Shintaro ISHIHARA.jpg;64761;65129;72041;3240;3259;19
/net/per610a/home/mvp/mvp_db/news7-lv/2017/2017_03_12_19_00/2017_03_12_19_00.mpg;Renho.jpg;19061;20401;36081;953;1020;67
/net/per610a/home/mvp/mvp_db/news7-lv/2017/2017_03_12_19_00/2017_03_12_19_00.mpg;Renho.jpg;21805;21901;36081;1090;1095;5
/net/per610a/home/mvp/mvp_db/news7-lv/2017/2017_03_13_19_00/2017_03_13_19_00.mpg;Shinzo ABE.jpg;753;809;36081;37;40;3
/net/per610a/home/mvp/mvp_db/news7-lv/2017/2017_03_13_19_00/2017_03_13_19_00.mpg;Shinzo ABE.jpg;7041;7081;36081;352;354;2
/net/per610a/home/mvp/mvp_db/news7-lv/2017/2017_03_13_19_00/2017_03_13_19_00.mpg;Shinzo ABE.jpg;10189;10225;36081;509;511;2
/net/per610a/home/mvp/mvp_db/news7-lv/2017/2017_03_13_19_00/2017_03_13_19_00.mpg;Shinzo ABE.jpg;10341;10461;36081;517;523;6
/net/per610a/home/mvp/mvp_db/news7-lv/2017/2017_03_13_19_00/2017_03_13_19_00.mpg;Shinzo ABE.jpg;29153;29297;36081;1458;1465;7
/net/per610a/home/mvp/mvp_db/news7-lv/2017/2017_03_13_19_00/2017_03_13_19_00.mpg;Shinzo ABE.jpg;16833;16969;36081;842;848;6
/net/per610a/home/mvp/mvp_db/news7-lv/2017/2017_03_13_19_00/2017_03_13_19_00.mpg;Shinzo ABE.jpg;20433;20637;36081;1022;1032;10
/net/per610a/home/mvp/mvp_db/news7-lv/2017/2017_03_13_19_00/2017_03_13_19_00.mpg;Shinzo ABE.jpg;21177;21505;36081;1059;1075;16
/net/per610a/home/mvp/mvp_db/news7-lv/2017/2017_03_13_19_00/2017_03_13_19_00.mpg;Shinzo ABE.jpg;21581;21713;36081;1079;1086;7
/net/per610a/home/mvp/mvp_db/news7-lv/2017/2017_03_13_19_00/2017_03_13_19_00.mpg;Shinzo ABE.jpg;22425;22697;36081;1121;1135;14
/net/per610a/home/mvp/mvp_db/news7-lv/2017/2017_03_13_19_00/2017_03_13_19_00.mpg;Shinzo ABE.jpg;22765;22837;36081;1138;1142;4
/net/per610a/home/mvp/mvp_db/news7-lv/2017/2017_03_13_19_00/2017_03_13_19_00.mpg;Shinzo ABE.jpg;23493;23657;36081;1175;1183;8
/net/per610a/home/mvp/mvp_db/news7-lv/2017/2017_03_13_19_00/2017_03_13_19_00.mpg;Shinzo ABE.jpg;27605;27957;36081;1380;1398;18
/net/per610a/home/mvp/mvp_db/news7-lv/2017/2017_03_13_19_00/2017_03_13_19_00.mpg;Shinzo ABE.jpg;28669;28845;36081;1434;1443;9
/net/per610a/home/mvp/mvp_db/news7-lv/2017/2017_03_14_19_00/2017_03_14_19_00.mpg;Shinzo ABE.jpg;6489;6533;36081;324;326;2
/net/per610a/home/mvp/mvp_db/news7-lv/2017/2017_03_14_19_00/2017_03_14_19_00.mpg;Shinzo ABE.jpg;6677;6965;36081;334;348;14
/net/per610a/home/mvp/mvp_db/news7-lv/2017/2017_03_14_19_00/2017_03_14_19_00.mpg;YUriko Koike.jpg;12613;12769;36081;630;638;8
/net/per610a/home/mvp/mvp_db/news7-lv/2017/2017_03_14_19_00/2017_03_14_19_00.mpg;YUriko Koike.jpg;13181;13221;36081;659;661;2
/net/per610a/home/mvp/mvp_db/news7-lv/2017/2017_03_14_19_00/2017_03_14_19_00.mpg;YUriko Koike.jpg;14505;14745;36081;725;737;12
/net/per610a/home/mvp/mvp_db/news7-lv/2017/2017_03_16_19_00/2017_03_16_19_00.mpg;Yukio HATOYAMA.jpg;19325;19733;36081;966;987;21
/net/per610a/home/mvp/mvp_db/news7-lv/2017/2017_03_16_19_00/2017_03_16_19_00.mpg;Shinzo ABE.jpg;20713;20741;36081;1036;1037;1
/net/per610a/home/mvp/mvp_db/news7-lv/2017/2017_03_16_19_00/2017_03_16_19_00.mpg;Shinzo ABE.jpg;20833;20889;36081;1042;1045;3
/net/per610a/home/mvp/mvp_db/news7-lv/2017/2017_03_16_19_00/2017_03_16_19_00.mpg;Shinzo ABE.jpg;21069;21801;36081;1054;1090;36
/net/per610a/home/mvp/mvp_db/news7-lv/2017/2017_03_16_19_00/2017_03_16_19_00.mpg;Natsuo YAMAGUCHI.jpg;32493;32501;36081;1625;1625;0
/net/per610a/home/mvp/mvp_db/news7-lv/2017/2017_03_16_19_00/2017_03_16_19_00.mpg;Natsuo YAMAGUCHI.jpg;32789;33325;36081;1640;1667;27
/net/per610a/home/mvp/mvp_db/news7-lv/2017/2017_03_17_19_00/2017_03_17_19_00.mpg;Shinzo ABE.jpg;14013;14045;38481;700;702;2
/net/per610a/home/mvp/mvp_db/news7-lv/2017/2017_03_17_19_00/2017_03_17_19_00.mpg;Shinzo ABE.jpg;22577;22665;38481;1129;1133;4
/net/per610a/home/mvp/mvp_db/news7-lv/2017/2017_03_17_19_00/2017_03_17_19_00.mpg;Shinzo ABE.jpg;14157;14277;38481;708;714;6
/net/per610a/home/mvp/mvp_db/news7-lv/2017/2017_03_17_19_00/2017_03_17_19_00.mpg;Shinzo ABE.jpg;16753;16989;38481;838;849;11
/net/per610a/home/mvp/mvp_db/news7-lv/2017/2017_03_17_19_00/2017_03_17_19_00.mpg;Shinzo ABE.jpg;18617;18793;38481;931;940;9
/net/per610a/home/mvp/mvp_db/news7-lv/2017/2017_03_17_19_00/2017_03_17_19_00.mpg;Shinzo ABE.jpg;25005;25145;38481;1250;1257;7
/net/per610a/home/mvp/mvp_db/news7-lv/2017/2017_03_17_19_00/2017_03_17_19_00.mpg;Shinzo ABE.jpg;29869;30073;38481;1494;1504;10
/net/per610a/home/mvp/mvp_db/news7-lv/2017/2017_03_18_19_00/2017_03_18_19_00.mpg;Taro ASO.jpg;12897;13241;36081;645;662;17
/net/per610a/home/mvp/mvp_db/news7-lv/2017/2017_03_18_19_00/2017_03_18_19_00.mpg;Shinzo ABE.jpg;15581;15777;36081;779;789;10
/net/per610a/home/mvp/mvp_db/news7-lv/2017/2017_03_19_19_00/2017_03_19_19_00.mpg;Shintaro ISHIHARA.jpg;1;101;36081;0;5;5
/net/per610a/home/mvp/mvp_db/news7-lv/2017/2017_03_19_19_00/2017_03_19_19_00.mpg;Shintaro ISHIHARA.jpg;761;805;36081;38;40;2
/net/per610a/home/mvp/mvp_db/news7-lv/2017/2017_03_19_19_00/2017_03_19_19_00.mpg;Shintaro ISHIHARA.jpg;2449;2577;36081;122;128;6
/net/per610a/home/mvp/mvp_db/news7-lv/2017/2017_03_19_19_00/2017_03_19_19_00.mpg;YUriko Koike.jpg;10201;10589;36081;510;529;19
/net/per610a/home/mvp/mvp_db/news7-lv/2017/2017_03_19_19_00/2017_03_19_19_00.mpg;Shinzo ABE.jpg;17677;17949;36081;884;897;13
/net/per610a/home/mvp/mvp_db/news7-lv/2017/2017_03_20_19_00/2017_03_20_19_00.mpg;Ichiro OZAWA.jpg;65;109;36089;3;5;2
/net/per610a/home/mvp/mvp_db/news7-lv/2017/2017_03_20_19_00/2017_03_20_19_00.mpg;Ichiro OZAWA.jpg;2181;2285;36089;109;114;5
/net/per610a/home/mvp/mvp_db/news7-lv/2017/2017_03_20_19_00/2017_03_20_19_00.mpg;Ichiro OZAWA.jpg;2477;2673;36089;123;133;10
/net/per610a/home/mvp/mvp_db/news7-lv/2017/2017_03_20_19_00/2017_03_20_19_00.mpg;Ichiro OZAWA.jpg;2813;3049;36089;140;152;12
/net/per610a/home/mvp/mvp_db/news7-lv/2017/2017_03_20_19_00/2017_03_20_19_00.mpg;Ichiro OZAWA.jpg;3149;3629;36089;157;181;24
/net/per610a/home/mvp/mvp_db/news7-lv/2017/2017_03_20_19_00/2017_03_20_19_00.mpg;Ichiro OZAWA.jpg;4633;4885;36089;231;244;13
/net/per610a/home/mvp/mvp_db/news7-lv/2017/2017_03_20_19_00/2017_03_20_19_00.mpg;Ichiro OZAWA.jpg;5093;5337;36089;254;267;13
/net/per610a/home/mvp/mvp_db/news7-lv/2017/2017_03_20_19_00/2017_03_20_19_00.mpg;Ichiro OZAWA.jpg;5925;6133;36089;296;306;10
/net/per610a/home/mvp/mvp_db/news7-lv/2017/2017_03_20_19_00/2017_03_20_19_00.mpg;Ichiro OZAWA.jpg;6229;6909;36089;311;345;34
/net/per610a/home/mvp/mvp_db/news7-lv/2017/2017_03_20_19_00/2017_03_20_19_00.mpg;Ichiro OZAWA.jpg;8593;8873;36089;430;444;14
/net/per610a/home/mvp/mvp_db/news7-lv/2017/2017_03_20_19_00/2017_03_20_19_00.mpg;YUriko Koike.jpg;6993;7621;36089;349;381;32
/net/per610a/home/mvp/mvp_db/news7-lv/2017/2017_03_20_19_00/2017_03_20_19_00.mpg;YUriko Koike.jpg;8593;9473;36089;430;474;44
/net/per610a/home/mvp/mvp_db/news7-lv/2017/2017_03_20_19_00/2017_03_20_19_00.mpg;Shinzo ABE.jpg;20521;20737;36089;1026;1037;11
/net/per610a/home/mvp/mvp_db/news7-lv/2017/2017_03_20_19_00/2017_03_20_19_00.mpg;Shinzo ABE.jpg;22077;22157;36089;1104;1108;4
/net/per610a/home/mvp/mvp_db/news7-lv/2017/2017_03_23_19_00/2017_03_23_19_00.mpg;Renho.jpg;15705;16081;36081;785;804;19
/net/per610a/home/mvp/mvp_db/news7-lv/2017/2017_03_24_19_00/2017_03_24_19_00.mpg;Shinzo ABE.jpg;165;213;36089;8;10;2
/net/per610a/home/mvp/mvp_db/news7-lv/2017/2017_03_24_19_00/2017_03_24_19_00.mpg;Shinzo ABE.jpg;325;437;36089;16;21;5
/net/per610a/home/mvp/mvp_db/news7-lv/2017/2017_03_24_19_00/2017_03_24_19_00.mpg;Shinzo ABE.jpg;3649;3797;36089;182;190;8
/net/per610a/home/mvp/mvp_db/news7-lv/2017/2017_03_24_19_00/2017_03_24_19_00.mpg;Shinzo ABE.jpg;3945;3977;36089;197;199;2
/net/per610a/home/mvp/mvp_db/news7-lv/2017/2017_03_24_19_00/2017_03_24_19_00.mpg;Shinzo ABE.jpg;4281;4285;36089;214;214;0
/net/per610a/home/mvp/mvp_db/news7-lv/2017/2017_03_24_19_00/2017_03_24_19_00.mpg;Shinzo ABE.jpg;4385;4713;36089;219;235;16
/net/per610a/home/mvp/mvp_db/news7-lv/2017/2017_03_24_19_00/2017_03_24_19_00.mpg;Shinzo ABE.jpg;9389;9957;36089;469;498;29
/net/per610a/home/mvp/mvp_db/news7-lv/2017/2017_03_24_19_00/2017_03_24_19_00.mpg;Shinzo ABE.jpg;2181;2353;36089;109;117;8
/net/per610a/home/mvp/mvp_db/news7-lv/2017/2017_03_24_19_00/2017_03_24_19_00.mpg;Shinzo ABE.jpg;6913;6937;36089;345;347;2
/net/per610a/home/mvp/mvp_db/news7-lv/2017/2017_03_25_19_00/2017_03_25_19_00.mpg;Kyoko Nakayama.jpg;10733;10925;36081;536;546;10
/net/per610a/home/mvp/mvp_db/news7-lv/2017/2017_04_04_19_00/2017_04_04_19_00.mpg;Shinzo ABE.jpg;7317;7789;36089;366;389;23
/net/per610a/home/mvp/mvp_db/news7-lv/2017/2017_04_04_19_00/2017_04_04_19_00.mpg;Shinzo ABE.jpg;18453;18705;36089;923;936;13
/net/per610a/home/mvp/mvp_db/news7-lv/2017/2017_04_06_19_00/2017_04_06_19_00.mpg;Shinzo ABE.jpg;3425;3461;36081;171;173;2
/net/per610a/home/mvp/mvp_db/news7-lv/2017/2017_04_06_19_00/2017_04_06_19_00.mpg;Shinzo ABE.jpg;4621;5157;36081;231;257;26
/net/per610a/home/mvp/mvp_db/news7-lv/2017/2017_04_06_19_00/2017_04_06_19_00.mpg;Shinzo ABE.jpg;7505;7565;36081;375;378;3
/net/per610a/home/mvp/mvp_db/news7-lv/2017/2017_04_06_19_00/2017_04_06_19_00.mpg;Shinzo ABE.jpg;31273;31641;36081;1564;1582;18
/net/per610a/home/mvp/mvp_db/news7-lv/2017/2017_04_07_19_00/2017_04_07_19_00.mpg;Shinzo ABE.jpg;417;569;36089;20;28;8
/net/per610a/home/mvp/mvp_db/news7-lv/2017/2017_04_07_19_00/2017_04_07_19_00.mpg;Shinzo ABE.jpg;4629;4733;36089;231;236;5
/net/per610a/home/mvp/mvp_db/news7-lv/2017/2017_04_07_19_00/2017_04_07_19_00.mpg;Shinzo ABE.jpg;1365;1517;36089;68;75;7
/net/per610a/home/mvp/mvp_db/news7-lv/2017/2017_04_07_19_00/2017_04_07_19_00.mpg;Shinzo ABE.jpg;5625;5905;36089;281;295;14
/net/per610a/home/mvp/mvp_db/news7-lv/2017/2017_04_08_19_00/2017_04_08_19_00.mpg;Shinzo ABE.jpg;7325;8341;36081;366;417;51
/net/per610a/home/mvp/mvp_db/news7-lv/2017/2017_04_08_19_00/2017_04_08_19_00.mpg;YUriko Koike.jpg;25905;26133;36081;1295;1307;12
/net/per610a/home/mvp/mvp_db/news7-lv/2017/2017_04_08_19_00/2017_04_08_19_00.mpg;Natsuo YAMAGUCHI.jpg;26301;26877;36081;1315;1344;29
/net/per610a/home/mvp/mvp_db/news7-lv/2017/2017_04_09_19_00/2017_04_09_19_00.mpg;Shinzo ABE.jpg;9285;9729;36081;464;486;22
/net/per610a/home/mvp/mvp_db/news7-lv/2017/2017_04_09_19_00/2017_04_09_19_00.mpg;Shinzo ABE.jpg;10973;11721;36081;548;586;38
/net/per610a/home/mvp/mvp_db/news7-lv/2017/2017_04_10_19_00/2017_04_10_19_00.mpg;Shinzo ABE.jpg;22653;22925;36089;1133;1147;14
/net/per610a/home/mvp/mvp_db/news7-lv/2017/2017_04_10_19_00/2017_04_10_19_00.mpg;Shinzo ABE.jpg;24005;24117;36089;1201;1206;5
/net/per610a/home/mvp/mvp_db/news7-lv/2017/2017_04_10_19_00/2017_04_10_19_00.mpg;Shinzo ABE.jpg;28977;29029;36089;1450;1452;2
/net/per610a/home/mvp/mvp_db/news7-lv/2017/2017_04_10_19_00/2017_04_10_19_00.mpg;Shinzo ABE.jpg;29241;29621;36089;1463;1482;19
/net/per610a/home/mvp/mvp_db/news7-lv/2017/2017_04_11_19_00/2017_04_11_19_00.mpg;Ichiro OZAWA.jpg;26405;26577;36089;1321;1329;8
/net/per610a/home/mvp/mvp_db/news7-lv/2017/2017_04_11_19_00/2017_04_11_19_00.mpg;Shinzo ABE.jpg;26613;27157;36089;1331;1359;28
/net/per610a/home/mvp/mvp_db/news7-lv/2017/2017_04_11_19_00/2017_04_11_19_00.mpg;Natsuo YAMAGUCHI.jpg;28113;28725;36089;1406;1437;31
/net/per610a/home/mvp/mvp_db/news7-lv/2017/2017_04_17_19_00/2017_04_17_19_00.mpg;Shinzo ABE.jpg;5393;5405;36081;269;270;1
/net/per610a/home/mvp/mvp_db/news7-lv/2017/2017_04_17_19_00/2017_04_17_19_00.mpg;Shinzo ABE.jpg;6453;6513;36081;322;325;3
/net/per610a/home/mvp/mvp_db/news7-lv/2017/2017_04_18_19_00/2017_04_18_19_00.mpg;Shinzo ABE.jpg;1049;1381;38481;52;69;17
/net/per610a/home/mvp/mvp_db/news7-lv/2017/2017_04_18_19_00/2017_04_18_19_00.mpg;Shinzo ABE.jpg;2529;3561;38481;126;178;52
/net/per610a/home/mvp/mvp_db/news7-lv/2017/2017_04_19_19_00/2017_04_19_19_00.mpg;Shinzo ABE.jpg;1317;1373;36081;65;68;3
/net/per610a/home/mvp/mvp_db/news7-lv/2017/2017_04_19_19_00/2017_04_19_19_00.mpg;Shinzo ABE.jpg;2185;2389;36081;109;119;10
/net/per610a/home/mvp/mvp_db/news7-lv/2017/2017_04_19_19_00/2017_04_19_19_00.mpg;Shinzo ABE.jpg;21873;21941;36081;1094;1097;3
/net/per610a/home/mvp/mvp_db/news7-lv/2017/2017_04_19_19_00/2017_04_19_19_00.mpg;Shinzo ABE.jpg;22033;22397;36081;1102;1120;18
/net/per610a/home/mvp/mvp_db/news7-lv/2017/2017_04_20_19_00/2017_04_20_19_00.mpg;Shinzo ABE.jpg;15953;16397;36081;798;820;22
/net/per610a/home/mvp/mvp_db/news7-lv/2017/2017_04_23_19_00/2017_04_23_19_00.mpg;Shinzo ABE.jpg;8257;9049;36081;413;452;39
/net/per610a/home/mvp/mvp_db/news7-lv/2017/2017_04_24_19_00/2017_04_24_19_00.mpg;Shinzo ABE.jpg;373;481;36081;18;24;6
/net/per610a/home/mvp/mvp_db/news7-lv/2017/2017_04_24_19_00/2017_04_24_19_00.mpg;Shinzo ABE.jpg;6665;7677;36081;333;384;51
/net/per610a/home/mvp/mvp_db/news7-lv/2017/2017_04_25_19_00/2017_04_25_19_00.mpg;Shinzo ABE.jpg;30777;31193;36081;1539;1560;21
/net/per610a/home/mvp/mvp_db/news7-lv/2017/2017_04_26_19_00/2017_04_26_19_00.mpg;Shinzo ABE.jpg;1;77;36089;0;3;3
/net/per610a/home/mvp/mvp_db/news7-lv/2017/2017_04_26_19_00/2017_04_26_19_00.mpg;Shinzo ABE.jpg;613;1389;36089;30;69;39
/net/per610a/home/mvp/mvp_db/news7-lv/2017/2017_04_26_19_00/2017_04_26_19_00.mpg;Shinzo ABE.jpg;2393;2901;36089;119;145;26
/net/per610a/home/mvp/mvp_db/news7-lv/2017/2017_04_26_19_00/2017_04_26_19_00.mpg;Shinzo ABE.jpg;10425;11109;36089;521;555;34
/net/per610a/home/mvp/mvp_db/news7-lv/2017/2017_04_26_19_00/2017_04_26_19_00.mpg;Natsuo YAMAGUCHI.jpg;9041;9293;36089;452;465;13
/net/per610a/home/mvp/mvp_db/news7-lv/2017/2017_04_26_19_00/2017_04_26_19_00.mpg;Natsuo YAMAGUCHI.jpg;10097;10365;36089;505;518;13
/net/per610a/home/mvp/mvp_db/news7-lv/2017/2017_04_26_19_00/2017_04_26_19_00.mpg;Yoshihiko Noda.jpg;11165;11513;36089;558;576;18
/net/per610a/home/mvp/mvp_db/news7-lv/2017/2017_04_26_19_00/2017_04_26_19_00.mpg;YUriko Koike.jpg;29965;30597;36089;1499;1531;32
/net/per610a/home/mvp/mvp_db/news7-lv/2017/2017_04_27_19_00/2017_04_27_19_00.mpg;Ichiro OZAWA.jpg;13009;13741;36081;650;687;37
/net/per610a/home/mvp/mvp_db/news7-lv/2017/2017_04_27_19_00/2017_04_27_19_00.mpg;Natsuo YAMAGUCHI.jpg;13769;14157;36081;688;708;20
/net/per610a/home/mvp/mvp_db/news7-lv/2017/2017_04_27_19_00/2017_04_27_19_00.mpg;YUriko Koike.jpg;19949;20153;36081;997;1008;11
/net/per610a/home/mvp/mvp_db/news7-lv/2017/2017_04_27_19_00/2017_04_27_19_00.mpg;Shinzo ABE.jpg;23649;23681;36081;1183;1184;1
/net/per610a/home/mvp/mvp_db/news7-lv/2017/2017_04_27_19_00/2017_04_27_19_00.mpg;Shinzo ABE.jpg;24269;24685;36081;1214;1234;20
/net/per610a/home/mvp/mvp_db/news7-lv/2017/2017_04_28_19_00/2017_04_28_19_00.mpg;Masashi Nakano.jpg;10893;10969;36081;544;548;4
/net/per610a/home/mvp/mvp_db/news7-lv/2017/2017_04_28_19_00/2017_04_28_19_00.mpg;Masashi Nakano.jpg;11193;11317;36081;559;566;7
/net/per610a/home/mvp/mvp_db/news7-lv/2017/2017_04_28_19_00/2017_04_28_19_00.mpg;Ichiro OZAWA.jpg;19069;19717;36081;953;986;33
/net/per610a/home/mvp/mvp_db/news7-lv/2017/2017_04_28_19_00/2017_04_28_19_00.mpg;Shinzo ABE.jpg;28261;28869;36081;1413;1444;31
/net/per610a/home/mvp/mvp_db/news7-lv/2017/2017_04_28_19_00/2017_04_28_19_00.mpg;Shinzo ABE.jpg;29117;29157;36081;1456;1458;2
/net/per610a/home/mvp/mvp_db/news7-lv/2017/2017_04_28_19_00/2017_04_28_19_00.mpg;Shinzo ABE.jpg;29305;29937;36081;1466;1497;31
/net/per610a/home/mvp/mvp_db/news7-lv/2017/2017_04_29_19_00/2017_04_29_19_00.mpg;Shinzo ABE.jpg;11621;13045;36089;581;652;71
/net/per610a/home/mvp/mvp_db/news7-lv/2017/2017_04_29_19_00/2017_04_29_19_00.mpg;Shinzo ABE.jpg;13165;13261;36089;658;663;5
/net/per610a/home/mvp/mvp_db/news7-lv/2017/2017_04_29_19_00/2017_04_29_19_00.mpg;Shinzo ABE.jpg;14177;14213;36089;709;711;2
/net/per610a/home/mvp/mvp_db/news7-lv/2017/2017_04_29_19_00/2017_04_29_19_00.mpg;Shinzo ABE.jpg;14549;14761;36089;728;738;10
/net/per610a/home/mvp/mvp_db/news7-lv/2017/2017_05_01_19_00/2017_05_01_19_00.mpg;Shinzo ABE.jpg;24937;25429;36081;1247;1272;25
/net/per610a/home/mvp/mvp_db/news7-lv/2017/2017_05_01_19_00/2017_05_01_19_00.mpg;Shinzo ABE.jpg;25493;26181;36081;1275;1309;34
/net/per610a/home/mvp/mvp_db/news7-lv/2017/2017_05_02_19_00/2017_05_02_19_00.mpg;Shinzo ABE.jpg;27273;27305;36089;1364;1366;2
/net/per610a/home/mvp/mvp_db/news7-lv/2017/2017_05_02_19_00/2017_05_02_19_00.mpg;Shinzo ABE.jpg;27609;28521;36089;1381;1427;46
/net/per610a/home/mvp/mvp_db/news7-lv/2017/2017_05_03_19_00/2017_05_03_19_00.mpg;Shinzo ABE.jpg;381;581;36081;19;29;10
/net/per610a/home/mvp/mvp_db/news7-lv/2017/2017_05_03_19_00/2017_05_03_19_00.mpg;Shinzo ABE.jpg;2765;3893;36081;138;194;56
/net/per610a/home/mvp/mvp_db/news7-lv/2017/2017_05_03_19_00/2017_05_03_19_00.mpg;Shinzo ABE.jpg;5105;5909;36081;255;295;40
/net/per610a/home/mvp/mvp_db/news7-lv/2017/2017_05_03_19_00/2017_05_03_19_00.mpg;Shinzo ABE.jpg;6269;9873;36081;313;493;180
/net/per610a/home/mvp/mvp_db/news7-lv/2017/2017_05_03_19_00/2017_05_03_19_00.mpg;Shinzo ABE.jpg;1345;1537;36081;67;76;9
/net/per610a/home/mvp/mvp_db/news7-lv/2017/2017_05_05_19_00/2017_05_05_19_00.mpg;Shinzo ABE.jpg;13761;14257;36089;688;713;25
/net/per610a/home/mvp/mvp_db/news7-lv/2017/2017_05_06_19_00/2017_05_06_19_00.mpg;Taro ASO.jpg;22961;23321;36089;1149;1167;18
/net/per610a/home/mvp/mvp_db/news7-lv/2017/2017_05_06_19_00/2017_05_06_19_00.mpg;Taro ASO.jpg;23585;24125;36089;1180;1207;27
/net/per610a/home/mvp/mvp_db/news7-lv/2017/2017_05_06_19_00/2017_05_06_19_00.mpg;Taro ASO.jpg;24305;24473;36089;1216;1224;8
/net/per610a/home/mvp/mvp_db/news7-lv/2017/2017_05_06_19_00/2017_05_06_19_00.mpg;Taro ASO.jpg;28741;28797;36089;1438;1441;3
/net/per610a/home/mvp/mvp_db/news7-lv/2017/2017_05_08_19_00/2017_05_08_19_00.mpg;Shinzo ABE.jpg;21217;21693;36081;1061;1085;24
/net/per610a/home/mvp/mvp_db/news7-lv/2017/2017_05_08_19_00/2017_05_08_19_00.mpg;Shinzo ABE.jpg;22421;23089;36081;1121;1155;34
/net/per610a/home/mvp/mvp_db/news7-lv/2017/2017_05_08_19_00/2017_05_08_19_00.mpg;Shinzo ABE.jpg;23541;23657;36081;1177;1183;6
/net/per610a/home/mvp/mvp_db/news7-lv/2017/2017_05_08_19_00/2017_05_08_19_00.mpg;Shinzo ABE.jpg;23789;24301;36081;1190;1215;25
/net/per610a/home/mvp/mvp_db/news7-lv/2017/2017_05_08_19_00/2017_05_08_19_00.mpg;Shinzo ABE.jpg;24417;24461;36081;1221;1223;2
/net/per610a/home/mvp/mvp_db/news7-lv/2017/2017_05_09_19_00/2017_05_09_19_00.mpg;Shinzo ABE.jpg;14989;15381;36081;749;769;20
/net/per610a/home/mvp/mvp_db/news7-lv/2017/2017_05_09_19_00/2017_05_09_19_00.mpg;Shinzo ABE.jpg;15793;16629;36081;790;831;41
/net/per610a/home/mvp/mvp_db/news7-lv/2017/2017_05_09_19_00/2017_05_09_19_00.mpg;Shinzo ABE.jpg;17037;17305;36081;852;865;13
/net/per610a/home/mvp/mvp_db/news7-lv/2017/2017_05_09_19_00/2017_05_09_19_00.mpg;Shinzo ABE.jpg;17393;17609;36081;870;880;10
/net/per610a/home/mvp/mvp_db/news7-lv/2017/2017_05_09_19_00/2017_05_09_19_00.mpg;YUriko Koike.jpg;18205;18205;36081;910;910;0
/net/per610a/home/mvp/mvp_db/news7-lv/2017/2017_05_09_19_00/2017_05_09_19_00.mpg;YUriko Koike.jpg;18273;18781;36081;914;939;25
/net/per610a/home/mvp/mvp_db/news7-lv/2017/2017_05_09_19_00/2017_05_09_19_00.mpg;YUriko Koike.jpg;19137;19245;36081;957;962;5
/net/per610a/home/mvp/mvp_db/news7-lv/2017/2017_05_09_19_00/2017_05_09_19_00.mpg;YUriko Koike.jpg;20249;20841;36081;1012;1042;30
/net/per610a/home/mvp/mvp_db/news7-lv/2017/2017_05_09_19_00/2017_05_09_19_00.mpg;YUriko Koike.jpg;21613;21669;36081;1081;1084;3
/net/per610a/home/mvp/mvp_db/news7-lv/2017/2017_05_10_19_00/2017_05_10_19_00.mpg;Shinzo ABE.jpg;25845;26077;36089;1293;1304;11
/net/per610a/home/mvp/mvp_db/news7-lv/2017/2017_05_12_19_00/2017_05_12_19_00.mpg;Ichiro OZAWA.jpg;19133;19225;36081;957;961;4
/net/per610a/home/mvp/mvp_db/news7-lv/2017/2017_05_12_19_00/2017_05_12_19_00.mpg;Ichiro OZAWA.jpg;21481;22469;36081;1074;1124;50
/net/per610a/home/mvp/mvp_db/news7-lv/2017/2017_05_12_19_00/2017_05_12_19_00.mpg;Shinzo ABE.jpg;26289;26933;36081;1315;1347;32
/net/per610a/home/mvp/mvp_db/news7-lv/2017/2017_05_13_19_00/2017_05_13_19_00.mpg;Yoshihiko Noda.jpg;24057;24669;36089;1203;1234;31
/net/per610a/home/mvp/mvp_db/news7-lv/2017/2017_05_13_19_00/2017_05_13_19_00.mpg;Kazuo SHII.jpg;24057;24669;36089;1203;1234;31
/net/per610a/home/mvp/mvp_db/news7-lv/2017/2017_05_14_19_00/2017_05_14_19_00.mpg;Shinzo ABE.jpg;2117;2401;36089;105;120;15
/net/per610a/home/mvp/mvp_db/news7-lv/2017/2017_05_15_19_00/2017_05_15_19_00.mpg;Shinzo ABE.jpg;25781;26153;36089;1290;1308;18
/net/per610a/home/mvp/mvp_db/news7-lv/2017/2017_05_15_19_00/2017_05_15_19_00.mpg;Shinzo ABE.jpg;26165;26401;36089;1309;1321;12
/net/per610a/home/mvp/mvp_db/news7-lv/2017/2017_05_16_19_00/2017_05_16_19_00.mpg;Shinzo ABE.jpg;17949;18621;36089;898;931;33
/net/per610a/home/mvp/mvp_db/news7-lv/2017/2017_05_17_19_00/2017_05_17_19_00.mpg;Renho.jpg;22901;23305;36081;1145;1165;20
/net/per610a/home/mvp/mvp_db/news7-lv/2017/2017_05_18_19_00/2017_05_18_19_00.mpg;Renho.jpg;5285;5697;36089;264;285;21
/net/per610a/home/mvp/mvp_db/news7-lv/2017/2017_05_19_19_00/2017_05_19_19_00.mpg;Renho.jpg;929;1345;36089;46;67;21
/net/per610a/home/mvp/mvp_db/news7-lv/2017/2017_05_21_19_00/2017_05_21_19_00.mpg;Shinzo ABE.jpg;1009;2277;38481;50;113;63
/net/per610a/home/mvp/mvp_db/news7-lv/2017/2017_05_21_19_00/2017_05_21_19_00.mpg;Shinzo ABE.jpg;22893;23097;38481;1145;1155;10
/net/per610a/home/mvp/mvp_db/news7-lv/2017/2017_05_21_19_00/2017_05_21_19_00.mpg;Shinzo ABE.jpg;33937;34361;38481;1697;1718;21
/net/per610a/home/mvp/mvp_db/news7-lv/2017/2017_05_23_19_00/2017_05_23_19_00.mpg;YUriko Koike.jpg;19681;20173;36081;984;1009;25
/net/per610a/home/mvp/mvp_db/news7-lv/2017/2017_05_24_19_00/2017_05_24_19_00.mpg;YUriko Koike.jpg;9257;9681;36081;463;484;21
/net/per610a/home/mvp/mvp_db/news7-lv/2017/2017_05_24_19_00/2017_05_24_19_00.mpg;YUriko Koike.jpg;12013;12777;36081;600;639;39
/net/per610a/home/mvp/mvp_db/news7-lv/2017/2017_05_25_19_00/2017_05_25_19_00.mpg;Shinzo ABE.jpg;9005;9109;36081;450;455;5
/net/per610a/home/mvp/mvp_db/news7-lv/2017/2017_05_26_19_00/2017_05_26_19_00.mpg;Shinzo ABE.jpg;329;365;36081;16;18;2
/net/per610a/home/mvp/mvp_db/news7-lv/2017/2017_05_26_19_00/2017_05_26_19_00.mpg;Shinzo ABE.jpg;885;885;36081;44;44;0
/net/per610a/home/mvp/mvp_db/news7-lv/2017/2017_05_26_19_00/2017_05_26_19_00.mpg;Shinzo ABE.jpg;1361;1505;36081;68;75;7
/net/per610a/home/mvp/mvp_db/news7-lv/2017/2017_05_26_19_00/2017_05_26_19_00.mpg;Shinzo ABE.jpg;5093;5129;36081;254;256;2
/net/per610a/home/mvp/mvp_db/news7-lv/2017/2017_05_27_19_00/2017_05_27_19_00.mpg;Shinzo ABE.jpg;2065;2181;36085;103;109;6
/net/per610a/home/mvp/mvp_db/news7-lv/2017/2017_05_29_19_00/2017_05_29_19_00.mpg;Shinzo ABE.jpg;1977;2441;36089;98;122;24
/net/per610a/home/mvp/mvp_db/news7-lv/2017/2017_05_29_19_00/2017_05_29_19_00.mpg;Shinzo ABE.jpg;7437;7505;36089;372;375;3
/net/per610a/home/mvp/mvp_db/news7-lv/2017/2017_05_29_19_00/2017_05_29_19_00.mpg;Yoshihiko Noda.jpg;12609;13649;36089;630;683;53
/net/per610a/home/mvp/mvp_db/news7-lv/2017/2017_05_30_19_00/2017_05_30_19_00.mpg;Shinzo ABE.jpg;7845;8333;36089;392;417;25
/net/per610a/home/mvp/mvp_db/news7-lv/2017/2017_05_30_19_00/2017_05_30_19_00.mpg;Shinzo ABE.jpg;14241;14305;36089;712;715;3
/net/per610a/home/mvp/mvp_db/news7-lv/2017/2017_05_30_19_00/2017_05_30_19_00.mpg;Shinzo ABE.jpg;14881;15093;36089;744;755;11
/net/per610a/home/mvp/mvp_db/news7-lv/2017/2017_05_30_19_00/2017_05_30_19_00.mpg;Shinzo ABE.jpg;15181;15477;36089;759;774;15
/net/per610a/home/mvp/mvp_db/news7-lv/2017/2017_05_30_19_00/2017_05_30_19_00.mpg;Shinzo ABE.jpg;16909;17225;36089;846;861;15
/net/per610a/home/mvp/mvp_db/news7-lv/2017/2017_05_30_19_00/2017_05_30_19_00.mpg;YUriko Koike.jpg;29381;30149;36089;1470;1508;38
/net/per610a/home/mvp/mvp_db/news7-lv/2017/2017_06_01_19_00/2017_06_01_19_00.mpg;Yoshihiko Noda.jpg;5021;5157;36089;251;258;7
/net/per610a/home/mvp/mvp_db/news7-lv/2017/2017_06_09_19_00/2017_06_09_19_00.mpg;Renho.jpg;5817;6045;36089;291;302;11
/net/per610a/home/mvp/mvp_db/news7-lv/2017/2017_06_09_19_00/2017_06_09_19_00.mpg;Shinzo ABE.jpg;7657;7805;36089;383;390;7
/net/per610a/home/mvp/mvp_db/news7-lv/2017/2017_06_09_19_00/2017_06_09_19_00.mpg;Shinzo ABE.jpg;19357;19713;36089;968;986;18
/net/per610a/home/mvp/mvp_db/news7-lv/2017/2017_06_09_19_00/2017_06_09_19_00.mpg;Shinzo ABE.jpg;28829;29541;36089;1442;1478;36
/net/per610a/home/mvp/mvp_db/news7-lv/2017/2017_06_12_19_00/2017_06_12_19_00.mpg;Shinzo ABE.jpg;20269;20453;36081;1013;1023;10
/net/per610a/home/mvp/mvp_db/news7-lv/2017/2017_06_14_19_00/2017_06_14_19_00.mpg;Yoshihiko Noda.jpg;1473;1541;36089;73;77;4
/net/per610a/home/mvp/mvp_db/news7-lv/2017/2017_06_14_19_00/2017_06_14_19_00.mpg;Yoshihiko Noda.jpg;4145;4229;36089;207;211;4
/net/per610a/home/mvp/mvp_db/news7-lv/2017/2017_06_14_19_00/2017_06_14_19_00.mpg;Yoshihiko Noda.jpg;4385;4637;36089;219;232;13
/net/per610a/home/mvp/mvp_db/news7-lv/2017/2017_06_14_19_00/2017_06_14_19_00.mpg;Yoshihiko Noda.jpg;8765;8821;36089;438;441;3
/net/per610a/home/mvp/mvp_db/news7-lv/2017/2017_06_15_19_00/2017_06_15_19_00.mpg;Shinzo ABE.jpg;14821;15021;36081;741;751;10
/net/per610a/home/mvp/mvp_db/news7-lv/2017/2017_06_15_19_00/2017_06_15_19_00.mpg;Shinzo ABE.jpg;16585;16873;36081;829;844;15
/net/per610a/home/mvp/mvp_db/news7-lv/2017/2017_06_15_19_00/2017_06_15_19_00.mpg;Shinzo ABE.jpg;23741;23817;36081;1187;1191;4
/net/per610a/home/mvp/mvp_db/news7-lv/2017/2017_06_16_19_00/2017_06_16_19_00.mpg;Shinzo ABE.jpg;4889;4913;36089;244;245;1
/net/per610a/home/mvp/mvp_db/news7-lv/2017/2017_06_16_19_00/2017_06_16_19_00.mpg;Shinzo ABE.jpg;6517;6753;36089;326;337;11
/net/per610a/home/mvp/mvp_db/news7-lv/2017/2017_06_17_19_00/2017_06_17_19_00.mpg;YUriko Koike.jpg;16305;16781;36089;815;839;24
/net/per610a/home/mvp/mvp_db/news7-lv/2017/2017_06_19_19_00/2017_06_19_19_00.mpg;Shinzo ABE.jpg;1129;1161;36081;56;58;2
/net/per610a/home/mvp/mvp_db/news7-lv/2017/2017_06_19_19_00/2017_06_19_19_00.mpg;Shinzo ABE.jpg;4429;5629;36081;221;281;60
/net/per610a/home/mvp/mvp_db/news7-lv/2017/2017_06_19_19_00/2017_06_19_19_00.mpg;Shinzo ABE.jpg;5857;6193;36081;293;309;16
/net/per610a/home/mvp/mvp_db/news7-lv/2017/2017_06_19_19_00/2017_06_19_19_00.mpg;Yoshihiko Noda.jpg;8369;8805;36081;418;440;22
/net/per610a/home/mvp/mvp_db/news7-lv/2017/2017_06_19_19_00/2017_06_19_19_00.mpg;Yoshihiko Noda.jpg;8997;9461;36081;450;473;23
/net/per610a/home/mvp/mvp_db/news7-lv/2017/2017_06_19_19_00/2017_06_19_19_00.mpg;Ichiro OZAWA.jpg;9629;9709;36081;481;485;4
/net/per610a/home/mvp/mvp_db/news7-lv/2017/2017_06_19_19_00/2017_06_19_19_00.mpg;Ichiro OZAWA.jpg;9889;10957;36081;494;548;54
/net/per610a/home/mvp/mvp_db/news7-lv/2017/2017_06_20_19_00/2017_06_20_19_00.mpg;YUriko Koike.jpg;733;921;36089;36;46;10
/net/per610a/home/mvp/mvp_db/news7-lv/2017/2017_06_20_19_00/2017_06_20_19_00.mpg;YUriko Koike.jpg;1897;2277;36089;94;113;19
/net/per610a/home/mvp/mvp_db/news7-lv/2017/2017_06_20_19_00/2017_06_20_19_00.mpg;YUriko Koike.jpg;3157;3449;36089;157;172;15
/net/per610a/home/mvp/mvp_db/news7-lv/2017/2017_06_20_19_00/2017_06_20_19_00.mpg;YUriko Koike.jpg;3713;3713;36089;185;185;0
/net/per610a/home/mvp/mvp_db/news7-lv/2017/2017_06_20_19_00/2017_06_20_19_00.mpg;YUriko Koike.jpg;3817;4129;36089;191;206;15
/net/per610a/home/mvp/mvp_db/news7-lv/2017/2017_06_20_19_00/2017_06_20_19_00.mpg;YUriko Koike.jpg;5601;5957;36089;280;298;18
/net/per610a/home/mvp/mvp_db/news7-lv/2017/2017_06_20_19_00/2017_06_20_19_00.mpg;YUriko Koike.jpg;7597;7757;36089;380;388;8
/net/per610a/home/mvp/mvp_db/news7-lv/2017/2017_06_20_19_00/2017_06_20_19_00.mpg;Renho.jpg;16597;16749;36089;830;838;8
/net/per610a/home/mvp/mvp_db/news7-lv/2017/2017_06_22_19_00/2017_06_22_19_00.mpg;Natsuo YAMAGUCHI.jpg;9517;9913;36089;476;496;20
/net/per610a/home/mvp/mvp_db/news7-lv/2017/2017_06_22_19_00/2017_06_22_19_00.mpg;Natsuo YAMAGUCHI.jpg;12629;12993;36089;631;650;19
/net/per610a/home/mvp/mvp_db/news7-lv/2017/2017_06_22_19_00/2017_06_22_19_00.mpg;Yoshihiko Noda.jpg;11145;11273;36089;557;564;7
/net/per610a/home/mvp/mvp_db/news7-lv/2017/2017_06_22_19_00/2017_06_22_19_00.mpg;Yoshihiko Noda.jpg;11653;11661;36089;583;583;0
/net/per610a/home/mvp/mvp_db/news7-lv/2017/2017_06_22_19_00/2017_06_22_19_00.mpg;Yoshihiko Noda.jpg;12181;12533;36089;609;627;18
/net/per610a/home/mvp/mvp_db/news7-lv/2017/2017_06_22_19_00/2017_06_22_19_00.mpg;YUriko Koike.jpg;19973;20333;36089;999;1017;18
/net/per610a/home/mvp/mvp_db/news7-lv/2017/2017_06_22_19_00/2017_06_22_19_00.mpg;YUriko Koike.jpg;20797;20801;36089;1040;1040;0
/net/per610a/home/mvp/mvp_db/news7-lv/2017/2017_06_22_19_00/2017_06_22_19_00.mpg;YUriko Koike.jpg;20961;21397;36089;1048;1070;22
/net/per610a/home/mvp/mvp_db/news7-lv/2017/2017_06_22_19_00/2017_06_22_19_00.mpg;YUriko Koike.jpg;21653;21721;36089;1083;1086;3
/net/per610a/home/mvp/mvp_db/news7-lv/2017/2017_06_22_19_00/2017_06_22_19_00.mpg;YUriko Koike.jpg;21829;22257;36089;1092;1113;21
/net/per610a/home/mvp/mvp_db/news7-lv/2017/2017_06_22_19_00/2017_06_22_19_00.mpg;YUriko Koike.jpg;22729;22805;36089;1137;1141;4
/net/per610a/home/mvp/mvp_db/news7-lv/2017/2017_06_23_19_00/2017_06_23_19_00.mpg;Shinzo ABE.jpg;23401;23745;36081;1170;1187;17
/net/per610a/home/mvp/mvp_db/news7-lv/2017/2017_06_24_19_00/2017_06_24_19_00.mpg;Shinzo ABE.jpg;3641;5089;36089;182;254;72
/net/per610a/home/mvp/mvp_db/news7-lv/2017/2017_06_24_19_00/2017_06_24_19_00.mpg;Shinzo ABE.jpg;5277;5933;36089;264;296;32
/net/per610a/home/mvp/mvp_db/news7-lv/2017/2017_06_24_19_00/2017_06_24_19_00.mpg;Shinzo ABE.jpg;6441;6757;36089;322;338;16
/net/per610a/home/mvp/mvp_db/news7-lv/2017/2017_07_01_19_00/2017_07_01_19_00.mpg;Shinzo ABE.jpg;1089;1197;36081;54;59;5
/net/per610a/home/mvp/mvp_db/news7-lv/2017/2017_07_01_19_00/2017_07_01_19_00.mpg;Mizuho FUKUSHIMA.jpg;5537;5873;36081;276;293;17
/net/per610a/home/mvp/mvp_db/news7-lv/2017/2017_07_03_19_00/2017_07_03_19_00.mpg;Shinzo ABE.jpg;397;481;36089;19;24;5
/net/per610a/home/mvp/mvp_db/news7-lv/2017/2017_07_03_19_00/2017_07_03_19_00.mpg;Shinzo ABE.jpg;9997;10309;36089;500;515;15
/net/per610a/home/mvp/mvp_db/news7-lv/2017/2017_07_03_19_00/2017_07_03_19_00.mpg;Shinzo ABE.jpg;14061;14277;36089;703;714;11
/net/per610a/home/mvp/mvp_db/news7-lv/2017/2017_07_03_19_00/2017_07_03_19_00.mpg;Shinzo ABE.jpg;14425;14741;36089;721;737;16
/net/per610a/home/mvp/mvp_db/news7-lv/2017/2017_07_03_19_00/2017_07_03_19_00.mpg;Shinzo ABE.jpg;11837;12249;36089;592;612;20
/net/per610a/home/mvp/mvp_db/news7-lv/2017/2017_07_03_19_00/2017_07_03_19_00.mpg;Taro ASO.jpg;12661;12877;36089;633;644;11
/net/per610a/home/mvp/mvp_db/news7-lv/2017/2017_07_03_19_00/2017_07_03_19_00.mpg;Shinzo ABE.jpg;13829;13981;36089;692;699;7
/net/per610a/home/mvp/mvp_db/news7-lv/2017/2017_07_03_19_00/2017_07_03_19_00.mpg;Shinzo ABE.jpg;16401;16465;36089;820;823;3
/net/per610a/home/mvp/mvp_db/news7-lv/2017/2017_07_03_19_00/2017_07_03_19_00.mpg;Yoshihiko Noda.jpg;15553;16353;36089;778;818;40
/net/per610a/home/mvp/mvp_db/news7-lv/2017/2017_07_04_19_00/2017_07_04_19_00.mpg;Yoshihiko Noda.jpg;18461;18565;36081;923;928;5
/net/per610a/home/mvp/mvp_db/news7-lv/2017/2017_07_06_19_00/2017_07_06_19_00.mpg;Shinzo ABE.jpg;52429;54789;72049;2624;2742;118
/net/per610a/home/mvp/mvp_db/news7-lv/2017/2017_07_07_19_00/2017_07_07_19_00.mpg;Shinzo ABE.jpg;15809;15881;36089;791;794;3
/net/per610a/home/mvp/mvp_db/news7-lv/2017/2017_07_07_19_00/2017_07_07_19_00.mpg;Shinzo ABE.jpg;18925;19225;36089;947;962;15
/net/per610a/home/mvp/mvp_db/news7-lv/2017/2017_07_07_19_00/2017_07_07_19_00.mpg;Shinzo ABE.jpg;21909;22489;36089;1096;1125;29
/net/per610a/home/mvp/mvp_db/news7-lv/2017/2017_07_09_19_00/2017_07_09_19_00.mpg;Shinzo ABE.jpg;20717;21429;36081;1036;1072;36
/net/per610a/home/mvp/mvp_db/news7-lv/2017/2017_07_09_19_00/2017_07_09_19_00.mpg;Shinzo ABE.jpg;22277;22301;36081;1114;1115;1
/net/per610a/home/mvp/mvp_db/news7-lv/2017/2017_07_09_19_00/2017_07_09_19_00.mpg;Shinzo ABE.jpg;22489;23021;36081;1125;1151;26
/net/per610a/home/mvp/mvp_db/news7-lv/2017/2017_07_10_19_00/2017_07_10_19_00.mpg;Takeo Hiranuma.jpeg;16121;16505;36081;806;825;19
/net/per610a/home/mvp/mvp_db/news7-lv/2017/2017_07_13_19_00/2017_07_13_19_00.mpg;Takeo Hiranuma.jpeg;13013;13305;36081;650;665;15
/net/per610a/home/mvp/mvp_db/news7-lv/2017/2017_07_13_19_00/2017_07_13_19_00.mpg;Shinzo ABE.jpg;22017;22937;36081;1101;1147;46
/net/per610a/home/mvp/mvp_db/news7-lv/2017/2017_07_14_19_00/2017_07_14_19_00.mpg;Shinzo ABE.jpg;24617;25181;36089;1231;1260;29
/net/per610a/home/mvp/mvp_db/news7-lv/2017/2017_07_14_19_00/2017_07_14_19_00.mpg;Shinzo ABE.jpg;25269;25329;36089;1264;1267;3
/net/per610a/home/mvp/mvp_db/news7-lv/2017/2017_07_14_19_00/2017_07_14_19_00.mpg;Shinzo ABE.jpg;25973;26245;36089;1299;1313;14
/net/per610a/home/mvp/mvp_db/news7-lv/2017/2017_07_14_19_00/2017_07_14_19_00.mpg;Shinzo ABE.jpg;26469;26717;36089;1324;1336;12
/net/per610a/home/mvp/mvp_db/news7-lv/2017/2017_07_18_19_00/2017_07_18_19_00.mpg;Renho.jpg;19405;19821;36089;971;991;20
/net/per610a/home/mvp/mvp_db/news7-lv/2017/2017_07_18_19_00/2017_07_18_19_00.mpg;Renho.jpg;19885;19925;36089;995;997;2
/net/per610a/home/mvp/mvp_db/news7-lv/2017/2017_07_18_19_00/2017_07_18_19_00.mpg;Renho.jpg;19969;20273;36089;999;1014;15
/net/per610a/home/mvp/mvp_db/news7-lv/2017/2017_07_20_19_00/2017_07_20_19_00.mpg;Shinzo ABE.jpg;31773;31897;36089;1590;1596;6
/net/per610a/home/mvp/mvp_db/news7-lv/2017/2017_07_20_19_00/2017_07_20_19_00.mpg;Shinzo ABE.jpg;32365;32985;36089;1619;1650;31
/net/per610a/home/mvp/mvp_db/news7-lv/2017/2017_07_21_19_00/2017_07_21_19_00.mpg;Shinzo ABE.jpg;8857;8937;36089;443;447;4
/net/per610a/home/mvp/mvp_db/news7-lv/2017/2017_07_21_19_00/2017_07_21_19_00.mpg;Shinzo ABE.jpg;9057;9629;36089;453;481;28
/net/per610a/home/mvp/mvp_db/news7-lv/2017/2017_07_21_19_00/2017_07_21_19_00.mpg;Natsuo YAMAGUCHI.jpg;9057;9993;36089;453;500;47
/net/per610a/home/mvp/mvp_db/news7-lv/2017/2017_07_24_19_00/2017_07_24_19_00.mpg;Shinzo ABE.jpg;3849;3945;36081;192;197;5
/net/per610a/home/mvp/mvp_db/news7-lv/2017/2017_07_24_19_00/2017_07_24_19_00.mpg;YUriko Koike.jpg;20005;20277;36081;1000;1014;14
/net/per610a/home/mvp/mvp_db/news7-lv/2017/2017_07_25_19_00/2017_07_25_19_00.mpg;Yoshihiko Noda.jpg;15849;16381;36081;792;819;27
/net/per610a/home/mvp/mvp_db/news7-lv/2017/2017_07_25_19_00/2017_07_25_19_00.mpg;Yoshihiko Noda.jpg;17325;17369;36081;866;868;2
/net/per610a/home/mvp/mvp_db/news7-lv/2017/2017_07_25_19_00/2017_07_25_19_00.mpg;Renho.jpg;16425;16425;36081;821;821;0
/net/per610a/home/mvp/mvp_db/news7-lv/2017/2017_07_25_19_00/2017_07_25_19_00.mpg;Renho.jpg;16681;17113;36081;834;856;22
/net/per610a/home/mvp/mvp_db/news7-lv/2017/2017_07_26_19_00/2017_07_26_19_00.mpg;Takeo Hiranuma.jpeg;7017;7517;36081;351;376;25
/net/per610a/home/mvp/mvp_db/news7-lv/2017/2017_07_27_19_00/2017_07_27_19_00.mpg;Renho.jpg;5;61;36089;0;3;3
/net/per610a/home/mvp/mvp_db/news7-lv/2017/2017_07_27_19_00/2017_07_27_19_00.mpg;Renho.jpg;4497;4937;36089;225;247;22
/net/per610a/home/mvp/mvp_db/news7-lv/2017/2017_07_27_19_00/2017_07_27_19_00.mpg;Renho.jpg;6173;6201;36089;308;310;2
/net/per610a/home/mvp/mvp_db/news7-lv/2017/2017_07_27_19_00/2017_07_27_19_00.mpg;Renho.jpg;10153;10249;36089;508;512;4
/net/per610a/home/mvp/mvp_db/news7-lv/2017/2017_07_27_19_00/2017_07_27_19_00.mpg;Renho.jpg;10453;11317;36089;523;566;43
/net/per610a/home/mvp/mvp_db/news7-lv/2017/2017_07_27_19_00/2017_07_27_19_00.mpg;Shinzo ABE.jpg;2845;3021;36089;142;151;9
/net/per610a/home/mvp/mvp_db/news7-lv/2017/2017_07_27_19_00/2017_07_27_19_00.mpg;Shinzo ABE.jpg;32829;33033;36089;1642;1653;11
/net/per610a/home/mvp/mvp_db/news7-lv/2017/2017_07_27_19_00/2017_07_27_19_00.mpg;Yoshihiko Noda.jpg;6169;6249;36089;308;312;4
/net/per610a/home/mvp/mvp_db/news7-lv/2017/2017_07_27_19_00/2017_07_27_19_00.mpg;Yoshihiko Noda.jpg;10153;10249;36089;508;512;4
/net/per610a/home/mvp/mvp_db/news7-lv/2017/2017_07_27_19_00/2017_07_27_19_00.mpg;Renho.jpg;6937;7145;36089;347;357;10
/net/per610a/home/mvp/mvp_db/news7-lv/2017/2017_07_27_19_00/2017_07_27_19_00.mpg;Kazuo SHII.jpg;8521;10281;36089;426;514;88
/net/per610a/home/mvp/mvp_db/news7-lv/2017/2017_07_27_19_00/2017_07_27_19_00.mpg;Seiji MAEHARA.jpg;11321;11729;36089;566;586;20
/net/per610a/home/mvp/mvp_db/news7-lv/2017/2017_07_27_19_00/2017_07_27_19_00.mpg;Yuichiro Tamaki.png;11321;11729;36089;566;586;20
/net/per610a/home/mvp/mvp_db/news7-lv/2017/2017_07_28_19_00/2017_07_28_19_00.mpg;Shinzo ABE.jpg;2957;3605;36081;147;180;33
/net/per610a/home/mvp/mvp_db/news7-lv/2017/2017_07_28_19_00/2017_07_28_19_00.mpg;Shinzo ABE.jpg;9921;10213;36081;496;510;14
/net/per610a/home/mvp/mvp_db/news7-lv/2017/2017_07_28_19_00/2017_07_28_19_00.mpg;Shinzo ABE.jpg;10437;10493;36081;522;524;2
/net/per610a/home/mvp/mvp_db/news7-lv/2017/2017_07_28_19_00/2017_07_28_19_00.mpg;Shinzo ABE.jpg;12025;12209;36081;601;610;9
/net/per610a/home/mvp/mvp_db/news7-lv/2017/2017_07_28_19_00/2017_07_28_19_00.mpg;Shinzo ABE.jpg;12313;12353;36081;615;617;2
/net/per610a/home/mvp/mvp_db/news7-lv/2017/2017_07_28_19_00/2017_07_28_19_00.mpg;Shinzo ABE.jpg;12701;12745;36081;635;637;2
/net/per610a/home/mvp/mvp_db/news7-lv/2017/2017_07_28_19_00/2017_07_28_19_00.mpg;Shinzo ABE.jpg;13009;13045;36081;650;652;2
/net/per610a/home/mvp/mvp_db/news7-lv/2017/2017_07_28_19_00/2017_07_28_19_00.mpg;Renho.jpg;13165;13597;36081;658;680;22
/net/per610a/home/mvp/mvp_db/news7-lv/2017/2017_07_28_19_00/2017_07_28_19_00.mpg;Seiji MAEHARA.jpg;15125;15257;36081;756;763;7
/net/per610a/home/mvp/mvp_db/news7-lv/2017/2017_07_28_19_00/2017_07_28_19_00.mpg;Naoto KAN.jpg;15605;16273;36081;780;814;34
/net/per610a/home/mvp/mvp_db/news7-lv/2017/2017_07_29_19_00/2017_07_29_19_00.mpg;Shinzo ABE.jpg;7689;8721;36085;384;436;52
/net/per610a/home/mvp/mvp_db/news7-lv/2017/2017_07_31_19_00/2017_07_31_19_00.mpg;Shinzo ABE.jpg;6489;6645;36081;324;332;8
/net/per610a/home/mvp/mvp_db/news7-lv/2017/2017_07_31_19_00/2017_07_31_19_00.mpg;Shinzo ABE.jpg;15021;15265;36081;751;763;12
/net/per610a/home/mvp/mvp_db/news7-lv/2017/2017_08_01_19_00/2017_08_01_19_00.mpg;Shinzo ABE.jpg;14813;15161;36081;741;758;17
/net/per610a/home/mvp/mvp_db/news7-lv/2017/2017_08_01_19_00/2017_08_01_19_00.mpg;Shinzo ABE.jpg;15509;15681;36081;775;784;9
/net/per610a/home/mvp/mvp_db/news7-lv/2017/2017_08_01_19_00/2017_08_01_19_00.mpg;Shinzo ABE.jpg;15781;15905;36081;789;795;6
/net/per610a/home/mvp/mvp_db/news7-lv/2017/2017_08_01_19_00/2017_08_01_19_00.mpg;Seiji MAEHARA.jpg;18141;18973;36081;907;949;42
/net/per610a/home/mvp/mvp_db/news7-lv/2017/2017_08_02_19_00/2017_08_02_19_00.mpg;Shinzo ABE.jpg;2913;3021;36089;145;151;6
/net/per610a/home/mvp/mvp_db/news7-lv/2017/2017_08_02_19_00/2017_08_02_19_00.mpg;Taro ASO.jpg;6337;6661;36089;317;333;16
/net/per610a/home/mvp/mvp_db/news7-lv/2017/2017_08_02_19_00/2017_08_02_19_00.mpg;Seiji MAEHARA.jpg;12349;13093;36089;617;655;38
/net/per610a/home/mvp/mvp_db/news7-lv/2017/2017_08_02_19_00/2017_08_02_19_00.mpg;Seiji MAEHARA.jpg;13177;13641;36089;659;682;23
/net/per610a/home/mvp/mvp_db/news7-lv/2017/2017_08_03_19_00/2017_08_03_19_00.mpg;Shinzo ABE.jpg;8289;8377;38481;414;419;5
/net/per610a/home/mvp/mvp_db/news7-lv/2017/2017_08_03_19_00/2017_08_03_19_00.mpg;Shinzo ABE.jpg;12461;13345;38481;623;667;44
/net/per610a/home/mvp/mvp_db/news7-lv/2017/2017_08_03_19_00/2017_08_03_19_00.mpg;Shinzo ABE.jpg;14293;15057;38481;715;753;38
/net/per610a/home/mvp/mvp_db/news7-lv/2017/2017_08_03_19_00/2017_08_03_19_00.mpg;Shinzo ABE.jpg;15157;16197;38481;758;810;52
/net/per610a/home/mvp/mvp_db/news7-lv/2017/2017_08_03_19_00/2017_08_03_19_00.mpg;Shinzo ABE.jpg;22057;22185;38481;1103;1109;6
/net/per610a/home/mvp/mvp_db/news7-lv/2017/2017_08_07_19_00/2017_08_07_19_00.mpg;Shinzo ABE.jpg;17809;18073;38481;890;904;14
/net/per610a/home/mvp/mvp_db/news7-lv/2017/2017_08_07_19_00/2017_08_07_19_00.mpg;Shinzo ABE.jpg;18745;18817;38481;937;941;4
/net/per610a/home/mvp/mvp_db/news7-lv/2017/2017_08_07_19_00/2017_08_07_19_00.mpg;Shinzo ABE.jpg;19017;19141;38481;951;957;6
/net/per610a/home/mvp/mvp_db/news7-lv/2017/2017_08_07_19_00/2017_08_07_19_00.mpg;Shinzo ABE.jpg;24869;25529;38481;1244;1277;33
/net/per610a/home/mvp/mvp_db/news7-lv/2017/2017_08_08_19_00/2017_08_08_19_00.mpg;Yukio EDANO.jpg;25777;27301;36089;1289;1366;77
/net/per610a/home/mvp/mvp_db/news7-lv/2017/2017_08_08_19_00/2017_08_08_19_00.mpg;Seiji MAEHARA.jpg;27577;27689;36089;1380;1385;5
/net/per610a/home/mvp/mvp_db/news7-lv/2017/2017_08_09_19_00/2017_08_09_19_00.mpg;Shinzo ABE.jpg;8169;8641;36089;408;432;24
/net/per610a/home/mvp/mvp_db/news7-lv/2017/2017_08_12_19_00/2017_08_12_19_00.mpg;Shinzo ABE.jpg;4209;4453;36089;210;222;12
/net/per610a/home/mvp/mvp_db/news7-lv/2017/2017_08_14_19_00/2017_08_14_19_00.mpg;Shinzo ABE.jpg;5825;5905;36081;291;295;4
/net/per610a/home/mvp/mvp_db/news7-lv/2017/2017_08_14_19_00/2017_08_14_19_00.mpg;Shinzo ABE.jpg;9437;9477;36081;472;474;2
/net/per610a/home/mvp/mvp_db/news7-lv/2017/2017_08_14_19_00/2017_08_14_19_00.mpg;Shinzo ABE.jpg;9801;10457;36081;490;523;33
/net/per610a/home/mvp/mvp_db/news7-lv/2017/2017_08_15_19_00/2017_08_15_19_00.mpg;Shinzo ABE.jpg;2097;2417;36081;104;120;16
/net/per610a/home/mvp/mvp_db/news7-lv/2017/2017_08_15_19_00/2017_08_15_19_00.mpg;Shinzo ABE.jpg;9441;9609;36081;472;480;8
/net/per610a/home/mvp/mvp_db/news7-lv/2017/2017_08_15_19_00/2017_08_15_19_00.mpg;Shinzo ABE.jpg;13089;13149;36081;654;657;3
/net/per610a/home/mvp/mvp_db/news7-lv/2017/2017_08_15_19_00/2017_08_15_19_00.mpg;Shinzo ABE.jpg;15957;16685;36081;798;834;36
/net/per610a/home/mvp/mvp_db/news7-lv/2017/2017_08_17_19_00/2017_08_17_19_00.mpg;Shinzo ABE.jpg;7521;7729;36089;376;386;10
/net/per610a/home/mvp/mvp_db/news7-lv/2017/2017_08_20_19_00/2017_08_20_19_00.mpg;Shinzo ABE.jpg;12673;13081;36089;634;654;20
/net/per610a/home/mvp/mvp_db/news7-lv/2017/2017_08_20_19_00/2017_08_20_19_00.mpg;Shinzo ABE.jpg;13325;13929;36089;666;697;31
/net/per610a/home/mvp/mvp_db/news7-lv/2017/2017_08_21_19_00/2017_08_21_19_00.mpg;Yukio EDANO.jpg;13257;13493;36081;663;675;12
/net/per610a/home/mvp/mvp_db/news7-lv/2017/2017_08_21_19_00/2017_08_21_19_00.mpg;Yukio EDANO.jpg;14081;14213;36081;704;711;7
/net/per610a/home/mvp/mvp_db/news7-lv/2017/2017_08_21_19_00/2017_08_21_19_00.mpg;Yukio EDANO.jpg;19113;19225;36081;956;961;5
/net/per610a/home/mvp/mvp_db/news7-lv/2017/2017_08_21_19_00/2017_08_21_19_00.mpg;Yukio EDANO.jpg;19505;19557;36081;975;978;3
/net/per610a/home/mvp/mvp_db/news7-lv/2017/2017_08_21_19_00/2017_08_21_19_00.mpg;Yukio EDANO.jpg;19669;19981;36081;983;999;16
/net/per610a/home/mvp/mvp_db/news7-lv/2017/2017_08_21_19_00/2017_08_21_19_00.mpg;YUriko Koike.jpg;15525;15653;36081;776;783;7
/net/per610a/home/mvp/mvp_db/news7-lv/2017/2017_08_21_19_00/2017_08_21_19_00.mpg;Yukio HATOYAMA.jpg;28233;28349;36081;1412;1418;6
/net/per610a/home/mvp/mvp_db/news7-lv/2017/2017_08_21_19_00/2017_08_21_19_00.mpg;Yukio HATOYAMA.jpg;28465;28665;36081;1423;1434;11
/net/per610a/home/mvp/mvp_db/news7-lv/2017/2017_08_22_19_00/2017_08_22_19_00.mpg;Yukio EDANO.jpg;20489;20949;36089;1025;1048;23
/net/per610a/home/mvp/mvp_db/news7-lv/2017/2017_08_22_19_00/2017_08_22_19_00.mpg;Seiji MAEHARA.jpg;21093;21553;36089;1055;1078;23
/net/per610a/home/mvp/mvp_db/news7-lv/2017/2017_08_22_19_00/2017_08_22_19_00.mpg;Seiji MAEHARA.jpg;22353;22837;36089;1118;1142;24
/net/per610a/home/mvp/mvp_db/news7-lv/2017/2017_08_23_19_00/2017_08_23_19_00.mpg;Yukio EDANO.jpg;29601;29697;36081;1480;1485;5
/net/per610a/home/mvp/mvp_db/news7-lv/2017/2017_08_27_19_00/2017_08_27_19_00.mpg;Yukio EDANO.jpg;2289;2537;36081;114;126;12
/net/per610a/home/mvp/mvp_db/news7-lv/2017/2017_08_29_19_00/2017_08_29_19_00.mpg;Shinzo ABE.jpg;4081;4745;36089;204;237;33
/net/per610a/home/mvp/mvp_db/news7-lv/2017/2017_08_30_19_00/2017_08_30_19_00.mpg;Shinzo ABE.jpg;9109;9309;36081;455;465;10
/net/per610a/home/mvp/mvp_db/news7-lv/2017/2017_08_30_19_00/2017_08_30_19_00.mpg;Shinzo ABE.jpg;9949;10309;36081;497;515;18
/net/per610a/home/mvp/mvp_db/news7-lv/2017/2017_08_31_19_00/2017_08_31_19_00.mpg;Shinzo ABE.jpg;2841;3313;36081;142;165;23
/net/per610a/home/mvp/mvp_db/news7-lv/2017/2017_08_31_19_00/2017_08_31_19_00.mpg;Shinzo ABE.jpg;19477;19513;36081;974;976;2
/net/per610a/home/mvp/mvp_db/news7-lv/2017/2017_08_31_19_00/2017_08_31_19_00.mpg;Shinzo ABE.jpg;19709;19709;36081;985;985;0
/net/per610a/home/mvp/mvp_db/news7-lv/2017/2017_08_31_19_00/2017_08_31_19_00.mpg;Shinzo ABE.jpg;20825;22993;36081;1041;1150;109
/net/per610a/home/mvp/mvp_db/news7-lv/2017/2017_09_03_19_00/2017_09_03_19_00.mpg;Shinzo ABE.jpg;2113;2333;38481;105;116;11
/net/per610a/home/mvp/mvp_db/news7-lv/2017/2017_09_03_19_00/2017_09_03_19_00.mpg;Shinzo ABE.jpg;7633;8385;38481;381;419;38
/net/per610a/home/mvp/mvp_db/news7-lv/2017/2017_09_05_19_00/2017_09_05_19_00.mpg;Seiji MAEHARA.jpg;19153;19485;36081;958;974;16
/net/per610a/home/mvp/mvp_db/news7-lv/2017/2017_09_06_19_00/2017_09_06_19_00.mpg;Shinzo ABE.jpg;1957;2085;36081;97;104;7
/net/per610a/home/mvp/mvp_db/news7-lv/2017/2017_09_06_19_00/2017_09_06_19_00.mpg;Shinzo ABE.jpg;6417;6925;36081;321;346;25
/net/per610a/home/mvp/mvp_db/news7-lv/2017/2017_09_06_19_00/2017_09_06_19_00.mpg;Shinzo ABE.jpg;8833;8885;36081;441;444;3
/net/per610a/home/mvp/mvp_db/news7-lv/2017/2017_09_06_19_00/2017_09_06_19_00.mpg;Shinzo ABE.jpg;8997;9057;36081;450;453;3
/net/per610a/home/mvp/mvp_db/news7-lv/2017/2017_09_07_19_00/2017_09_07_19_00.mpg;Shinzo ABE.jpg;217;297;36089;10;14;4
/net/per610a/home/mvp/mvp_db/news7-lv/2017/2017_09_07_19_00/2017_09_07_19_00.mpg;Shinzo ABE.jpg;857;993;36089;42;49;7
/net/per610a/home/mvp/mvp_db/news7-lv/2017/2017_09_07_19_00/2017_09_07_19_00.mpg;Shinzo ABE.jpg;1189;1301;36089;59;65;6
/net/per610a/home/mvp/mvp_db/news7-lv/2017/2017_09_07_19_00/2017_09_07_19_00.mpg;Shinzo ABE.jpg;2101;2101;36089;105;105;0
/net/per610a/home/mvp/mvp_db/news7-lv/2017/2017_09_07_19_00/2017_09_07_19_00.mpg;Shinzo ABE.jpg;2213;2325;36089;110;116;6
/net/per610a/home/mvp/mvp_db/news7-lv/2017/2017_09_07_19_00/2017_09_07_19_00.mpg;Shinzo ABE.jpg;5509;5525;36089;275;276;1
/net/per610a/home/mvp/mvp_db/news7-lv/2017/2017_09_07_19_00/2017_09_07_19_00.mpg;Shinzo ABE.jpg;5653;5973;36089;282;298;16
/net/per610a/home/mvp/mvp_db/news7-lv/2017/2017_09_07_19_00/2017_09_07_19_00.mpg;Shinzo ABE.jpg;6229;6317;36089;311;316;5
/net/per610a/home/mvp/mvp_db/news7-lv/2017/2017_09_07_19_00/2017_09_07_19_00.mpg;Shinzo ABE.jpg;6437;6633;36089;322;331;9
/net/per610a/home/mvp/mvp_db/news7-lv/2017/2017_09_07_19_00/2017_09_07_19_00.mpg;Shinzo ABE.jpg;7969;8073;36089;398;403;5
/net/per610a/home/mvp/mvp_db/news7-lv/2017/2017_09_07_19_00/2017_09_07_19_00.mpg;Shinzo ABE.jpg;8785;9017;36089;439;451;12
/net/per610a/home/mvp/mvp_db/news7-lv/2017/2017_09_12_19_00/2017_09_12_19_00.mpg;Shinzo ABE.jpg;2217;2589;36089;110;129;19
/net/per610a/home/mvp/mvp_db/news7-lv/2017/2017_09_12_19_00/2017_09_12_19_00.mpg;Yukio HATOYAMA.jpg;27201;27825;36089;1361;1392;31
/net/per610a/home/mvp/mvp_db/news7-lv/2017/2017_09_14_19_00/2017_09_14_19_00.mpg;Shinzo ABE.jpg;16109;16721;36081;805;836;31
/net/per610a/home/mvp/mvp_db/news7-lv/2017/2017_09_14_19_00/2017_09_14_19_00.mpg;Shinzo ABE.jpg;18313;18401;36081;916;920;4
/net/per610a/home/mvp/mvp_db/news7-lv/2017/2017_09_15_19_00/2017_09_15_19_00.mpg;Shinzo ABE.jpg;2473;2497;36089;123;124;1
/net/per610a/home/mvp/mvp_db/news7-lv/2017/2017_09_15_19_00/2017_09_15_19_00.mpg;Shinzo ABE.jpg;2765;3157;36089;138;157;19
/net/per610a/home/mvp/mvp_db/news7-lv/2017/2017_09_15_19_00/2017_09_15_19_00.mpg;Shinzo ABE.jpg;12069;12713;36089;603;636;33
/net/per610a/home/mvp/mvp_db/news7-lv/2017/2017_09_16_19_00/2017_09_16_19_00.mpg;YUriko Koike.jpg;24297;24369;36081;1215;1219;4
/net/per610a/home/mvp/mvp_db/news7-lv/2017/2017_09_16_19_00/2017_09_16_19_00.mpg;YUriko Koike.jpg;24817;25213;36081;1241;1261;20
/net/per610a/home/mvp/mvp_db/news7-lv/2017/2017_09_16_19_00/2017_09_16_19_00.mpg;YUriko Koike.jpg;26341;26717;36081;1317;1336;19
/net/per610a/home/mvp/mvp_db/news7-lv/2017/2017_09_17_19_00/2017_09_17_19_00.mpg;Shinzo ABE.jpg;50793;51409;72049;2542;2572;30
/net/per610a/home/mvp/mvp_db/news7-lv/2017/2017_09_17_19_00/2017_09_17_19_00.mpg;Shinzo ABE.jpg;52121;54085;72049;2608;2706;98
/net/per610a/home/mvp/mvp_db/news7-lv/2017/2017_09_17_19_00/2017_09_17_19_00.mpg;Natsuo YAMAGUCHI.jpg;52121;52465;72049;2608;2625;17
/net/per610a/home/mvp/mvp_db/news7-lv/2017/2017_09_17_19_00/2017_09_17_19_00.mpg;Ichiro OZAWA.jpg;54137;54561;72049;2709;2730;21
/net/per610a/home/mvp/mvp_db/news7-lv/2017/2017_09_18_19_00/2017_09_18_19_00.mpg;Natsuo YAMAGUCHI.jpg;14513;14649;36089;726;733;7
/net/per610a/home/mvp/mvp_db/news7-lv/2017/2017_09_18_19_00/2017_09_18_19_00.mpg;Seiji MAEHARA.jpg;15065;15657;36089;753;783;30
/net/per610a/home/mvp/mvp_db/news7-lv/2017/2017_09_18_19_00/2017_09_18_19_00.mpg;Kazuo SHII.jpg;15749;16277;36089;788;814;26
/net/per610a/home/mvp/mvp_db/news7-lv/2017/2017_09_18_19_00/2017_09_18_19_00.mpg;YUriko Koike.jpg;16337;16893;36089;817;845;28
/net/per610a/home/mvp/mvp_db/news7-lv/2017/2017_09_19_19_00/2017_09_19_19_00.mpg;Ichiro OZAWA.jpg;181;341;36081;9;17;8
/net/per610a/home/mvp/mvp_db/news7-lv/2017/2017_09_19_19_00/2017_09_19_19_00.mpg;Ichiro OZAWA.jpg;1717;2577;36081;85;128;43
/net/per610a/home/mvp/mvp_db/news7-lv/2017/2017_09_19_19_00/2017_09_19_19_00.mpg;Ichiro OZAWA.jpg;3829;4033;36081;191;201;10
/net/per610a/home/mvp/mvp_db/news7-lv/2017/2017_09_19_19_00/2017_09_19_19_00.mpg;Seiji MAEHARA.jpg;1717;2281;36081;85;114;29
/net/per610a/home/mvp/mvp_db/news7-lv/2017/2017_09_19_19_00/2017_09_19_19_00.mpg;Natsuo YAMAGUCHI.jpg;4081;4433;36081;204;221;17
/net/per610a/home/mvp/mvp_db/news7-lv/2017/2017_09_19_19_00/2017_09_19_19_00.mpg;Ichiro Matsui.jpeg;6169;6573;36081;308;328;20
/net/per610a/home/mvp/mvp_db/news7-lv/2017/2017_09_20_19_00/2017_09_20_19_00.mpg;Shinzo ABE.jpg;6493;6677;36081;324;334;10
/net/per610a/home/mvp/mvp_db/news7-lv/2017/2017_09_20_19_00/2017_09_20_19_00.mpg;Toranosuke Katayama.jpg;9273;9361;36081;463;468;5
/net/per610a/home/mvp/mvp_db/news7-lv/2017/2017_09_20_19_00/2017_09_20_19_00.mpg;Toranosuke Katayama.jpg;9429;9593;36081;471;479;8
/net/per610a/home/mvp/mvp_db/news7-lv/2017/2017_09_20_19_00/2017_09_20_19_00.mpg;Sadakazu TANIGAKI.jpg;12997;14181;36081;650;709;59
/net/per610a/home/mvp/mvp_db/news7-lv/2017/2017_09_20_19_00/2017_09_20_19_00.mpg;Sadakazu TANIGAKI.jpg;14665;14957;36081;733;748;15
/net/per610a/home/mvp/mvp_db/news7-lv/2017/2017_09_21_19_00/2017_09_21_19_00.mpg;Seiji MAEHARA.jpg;13585;13877;36081;679;694;15
/net/per610a/home/mvp/mvp_db/news7-lv/2017/2017_09_21_19_00/2017_09_21_19_00.mpg;Seiji MAEHARA.jpg;16345;16517;36081;817;826;9
/net/per610a/home/mvp/mvp_db/news7-lv/2017/2017_09_21_19_00/2017_09_21_19_00.mpg;Natsuo YAMAGUCHI.jpg;15737;16241;36081;787;812;25
/net/per610a/home/mvp/mvp_db/news7-lv/2017/2017_09_21_19_00/2017_09_21_19_00.mpg;Kazuo SHII.jpg;17037;17865;36081;852;893;41
/net/per610a/home/mvp/mvp_db/news7-lv/2017/2017_09_21_19_00/2017_09_21_19_00.mpg;Seiji Mataichi.jpg;17869;18005;36081;893;900;7
/net/per610a/home/mvp/mvp_db/news7-lv/2017/2017_09_22_19_00/2017_09_22_19_00.mpg;Yorihisa Matsuno.png;15897;16153;36089;795;808;13
/net/per610a/home/mvp/mvp_db/news7-lv/2017/2017_09_22_19_00/2017_09_22_19_00.mpg;Yukio EDANO.jpg;18317;18637;36089;916;932;16
/net/per610a/home/mvp/mvp_db/news7-lv/2017/2017_09_22_19_00/2017_09_22_19_00.mpg;YUriko Koike.jpg;20029;20153;36089;1002;1008;6
/net/per610a/home/mvp/mvp_db/news7-lv/2017/2017_09_23_19_00/2017_09_23_19_00.mpg;Shinzo ABE.jpg;8453;8941;36081;422;447;25
/net/per610a/home/mvp/mvp_db/news7-lv/2017/2017_09_23_19_00/2017_09_23_19_00.mpg;Shinzo ABE.jpg;9917;10513;36081;496;525;29
/net/per610a/home/mvp/mvp_db/news7-lv/2017/2017_09_23_19_00/2017_09_23_19_00.mpg;Shinzo ABE.jpg;10673;10841;36081;533;542;9
/net/per610a/home/mvp/mvp_db/news7-lv/2017/2017_09_23_19_00/2017_09_23_19_00.mpg;Shinzo ABE.jpg;10933;11089;36081;546;554;8
/net/per610a/home/mvp/mvp_db/news7-lv/2017/2017_09_23_19_00/2017_09_23_19_00.mpg;Seiji MAEHARA.jpg;11109;12217;36081;555;611;56
/net/per610a/home/mvp/mvp_db/news7-lv/2017/2017_09_24_19_00/2017_09_24_19_00.mpg;Kyoko Nakayama.jpg;2229;2253;36081;111;112;1
/net/per610a/home/mvp/mvp_db/news7-lv/2017/2017_09_24_19_00/2017_09_24_19_00.mpg;Kyoko Nakayama.jpg;2445;2657;36081;122;132;10
/net/per610a/home/mvp/mvp_db/news7-lv/2017/2017_09_25_19_00/2017_09_25_19_00.mpg;Shinzo ABE.jpg;53;213;38481;2;10;8
/net/per610a/home/mvp/mvp_db/news7-lv/2017/2017_09_25_19_00/2017_09_25_19_00.mpg;Shinzo ABE.jpg;289;337;38481;14;16;2
/net/per610a/home/mvp/mvp_db/news7-lv/2017/2017_09_25_19_00/2017_09_25_19_00.mpg;Shinzo ABE.jpg;749;789;38481;37;39;2
/net/per610a/home/mvp/mvp_db/news7-lv/2017/2017_09_25_19_00/2017_09_25_19_00.mpg;Shinzo ABE.jpg;869;1589;38481;43;79;36
/net/per610a/home/mvp/mvp_db/news7-lv/2017/2017_09_25_19_00/2017_09_25_19_00.mpg;Shinzo ABE.jpg;2801;2857;38481;140;142;2
/net/per610a/home/mvp/mvp_db/news7-lv/2017/2017_09_25_19_00/2017_09_25_19_00.mpg;Shinzo ABE.jpg;2925;2981;38481;146;149;3
/net/per610a/home/mvp/mvp_db/news7-lv/2017/2017_09_25_19_00/2017_09_25_19_00.mpg;Shinzo ABE.jpg;3117;3173;38481;155;158;3
/net/per610a/home/mvp/mvp_db/news7-lv/2017/2017_09_25_19_00/2017_09_25_19_00.mpg;Shinzo ABE.jpg;3481;3529;38481;174;176;2
/net/per610a/home/mvp/mvp_db/news7-lv/2017/2017_09_25_19_00/2017_09_25_19_00.mpg;Shinzo ABE.jpg;3785;4849;38481;189;242;53
/net/per610a/home/mvp/mvp_db/news7-lv/2017/2017_09_25_19_00/2017_09_25_19_00.mpg;Shinzo ABE.jpg;5561;6653;38481;278;332;54
/net/per610a/home/mvp/mvp_db/news7-lv/2017/2017_09_25_19_00/2017_09_25_19_00.mpg;Shinzo ABE.jpg;7829;7981;38481;391;399;8
/net/per610a/home/mvp/mvp_db/news7-lv/2017/2017_09_25_19_00/2017_09_25_19_00.mpg;Shinzo ABE.jpg;9273;9401;38481;463;470;7
/net/per610a/home/mvp/mvp_db/news7-lv/2017/2017_09_25_19_00/2017_09_25_19_00.mpg;Shinzo ABE.jpg;9545;9629;38481;477;481;4
/net/per610a/home/mvp/mvp_db/news7-lv/2017/2017_09_25_19_00/2017_09_25_19_00.mpg;Shinzo ABE.jpg;10381;10473;38481;519;523;4
/net/per610a/home/mvp/mvp_db/news7-lv/2017/2017_09_25_19_00/2017_09_25_19_00.mpg;Shinzo ABE.jpg;21233;21445;38481;1062;1072;10
/net/per610a/home/mvp/mvp_db/news7-lv/2017/2017_09_25_19_00/2017_09_25_19_00.mpg;Shinzo ABE.jpg;23237;23409;38481;1162;1171;9
/net/per610a/home/mvp/mvp_db/news7-lv/2017/2017_09_25_19_00/2017_09_25_19_00.mpg;YUriko Koike.jpg;477;557;38481;23;27;4
/net/per610a/home/mvp/mvp_db/news7-lv/2017/2017_09_25_19_00/2017_09_25_19_00.mpg;YUriko Koike.jpg;2185;2365;38481;109;118;9
/net/per610a/home/mvp/mvp_db/news7-lv/2017/2017_09_25_19_00/2017_09_25_19_00.mpg;YUriko Koike.jpg;19709;19737;38481;985;987;2
/net/per610a/home/mvp/mvp_db/news7-lv/2017/2017_09_25_19_00/2017_09_25_19_00.mpg;YUriko Koike.jpg;22845;23233;38481;1142;1162;20
/net/per610a/home/mvp/mvp_db/news7-lv/2017/2017_09_25_19_00/2017_09_25_19_00.mpg;Seiji MAEHARA.jpg;1229;1573;38481;61;78;17
/net/per610a/home/mvp/mvp_db/news7-lv/2017/2017_09_25_19_00/2017_09_25_19_00.mpg;Seiji MAEHARA.jpg;15537;17121;38481;777;856;79
/net/per610a/home/mvp/mvp_db/news7-lv/2017/2017_09_25_19_00/2017_09_25_19_00.mpg;Shinzo ABE.jpg;1781;1965;38481;89;98;9
/net/per610a/home/mvp/mvp_db/news7-lv/2017/2017_09_25_19_00/2017_09_25_19_00.mpg;Shinzo ABE.jpg;9913;9973;38481;495;498;3
/net/per610a/home/mvp/mvp_db/news7-lv/2017/2017_09_25_19_00/2017_09_25_19_00.mpg;Shinzo ABE.jpg;10073;10377;38481;503;519;16
/net/per610a/home/mvp/mvp_db/news7-lv/2017/2017_09_25_19_00/2017_09_25_19_00.mpg;Shinzo ABE.jpg;32457;32553;38481;1623;1628;5
/net/per610a/home/mvp/mvp_db/news7-lv/2017/2017_09_25_19_00/2017_09_25_19_00.mpg;YUriko Koike.jpg;2397;2733;38481;119;136;17
/net/per610a/home/mvp/mvp_db/news7-lv/2017/2017_09_25_19_00/2017_09_25_19_00.mpg;YUriko Koike.jpg;17209;18593;38481;860;930;70
/net/per610a/home/mvp/mvp_db/news7-lv/2017/2017_09_25_19_00/2017_09_25_19_00.mpg;YUriko Koike.jpg;18849;19149;38481;942;957;15
/net/per610a/home/mvp/mvp_db/news7-lv/2017/2017_09_25_19_00/2017_09_25_19_00.mpg;YUriko Koike.jpg;19817;20257;38481;991;1013;22
/net/per610a/home/mvp/mvp_db/news7-lv/2017/2017_09_25_19_00/2017_09_25_19_00.mpg;Natsuo YAMAGUCHI.jpg;2801;2925;38481;140;146;6
/net/per610a/home/mvp/mvp_db/news7-lv/2017/2017_09_25_19_00/2017_09_25_19_00.mpg;Natsuo YAMAGUCHI.jpg;3037;3105;38481;151;155;4
/net/per610a/home/mvp/mvp_db/news7-lv/2017/2017_09_26_19_00/2017_09_26_19_00.mpg;YUriko Koike.jpg;17673;17773;36081;884;889;5
/net/per610a/home/mvp/mvp_db/news7-lv/2017/2017_09_26_19_00/2017_09_26_19_00.mpg;Natsuo YAMAGUCHI.jpg;18497;19049;36081;925;952;27
/net/per610a/home/mvp/mvp_db/news7-lv/2017/2017_09_27_19_00/2017_09_27_19_00.mpg;Yorihisa Matsuno.png;1849;1905;36089;92;95;3
/net/per610a/home/mvp/mvp_db/news7-lv/2017/2017_09_27_19_00/2017_09_27_19_00.mpg;Yorihisa Matsuno.png;6445;6657;36089;322;333;11
/net/per610a/home/mvp/mvp_db/news7-lv/2017/2017_09_27_19_00/2017_09_27_19_00.mpg;Seiji MAEHARA.jpg;3897;4513;36089;195;225;30
/net/per610a/home/mvp/mvp_db/news7-lv/2017/2017_09_27_19_00/2017_09_27_19_00.mpg;Seiji MAEHARA.jpg;11509;12165;36089;575;608;33
/net/per610a/home/mvp/mvp_db/news7-lv/2017/2017_09_27_19_00/2017_09_27_19_00.mpg;Shinzo ABE.jpg;6789;6921;36089;339;346;7
/net/per610a/home/mvp/mvp_db/news7-lv/2017/2017_09_28_19_00/2017_09_28_19_00.mpg;Shinzo ABE.jpg;769;1273;72049;38;63;25
/net/per610a/home/mvp/mvp_db/news7-lv/2017/2017_09_28_19_00/2017_09_28_19_00.mpg;Shinzo ABE.jpg;1809;1861;72049;90;93;3
/net/per610a/home/mvp/mvp_db/news7-lv/2017/2017_09_28_19_00/2017_09_28_19_00.mpg;Shinzo ABE.jpg;4301;4377;72049;215;219;4
/net/per610a/home/mvp/mvp_db/news7-lv/2017/2017_09_28_19_00/2017_09_28_19_00.mpg;Shinzo ABE.jpg;10737;11057;72049;537;553;16
/net/per610a/home/mvp/mvp_db/news7-lv/2017/2017_09_28_19_00/2017_09_28_19_00.mpg;Shinzo ABE.jpg;11785;11797;72049;589;590;1
/net/per610a/home/mvp/mvp_db/news7-lv/2017/2017_09_28_19_00/2017_09_28_19_00.mpg;Shinzo ABE.jpg;28005;28033;72049;1401;1403;2
/net/per610a/home/mvp/mvp_db/news7-lv/2017/2017_09_28_19_00/2017_09_28_19_00.mpg;Shinzo ABE.jpg;70825;71465;72049;3544;3576;32
/net/per610a/home/mvp/mvp_db/news7-lv/2017/2017_09_28_19_00/2017_09_28_19_00.mpg;YUriko Koike.jpg;953;1477;72049;47;73;26
/net/per610a/home/mvp/mvp_db/news7-lv/2017/2017_09_28_19_00/2017_09_28_19_00.mpg;YUriko Koike.jpg;2961;3301;72049;148;165;17
/net/per610a/home/mvp/mvp_db/news7-lv/2017/2017_09_28_19_00/2017_09_28_19_00.mpg;YUriko Koike.jpg;8601;9645;72049;430;482;52
/net/per610a/home/mvp/mvp_db/news7-lv/2017/2017_09_28_19_00/2017_09_28_19_00.mpg;YUriko Koike.jpg;41785;43937;72049;2091;2199;108
/net/per610a/home/mvp/mvp_db/news7-lv/2017/2017_09_28_19_00/2017_09_28_19_00.mpg;YUriko Koike.jpg;70645;70821;72049;3535;3544;9
/net/per610a/home/mvp/mvp_db/news7-lv/2017/2017_09_28_19_00/2017_09_28_19_00.mpg;Kazuo SHII.jpg;2149;2349;72049;107;117;10
/net/per610a/home/mvp/mvp_db/news7-lv/2017/2017_09_28_19_00/2017_09_28_19_00.mpg;Kazuo SHII.jpg;9749;10165;72049;487;508;21
/net/per610a/home/mvp/mvp_db/news7-lv/2017/2017_09_28_19_00/2017_09_28_19_00.mpg;Kazuo SHII.jpg;37193;39557;72049;1861;1979;118
/net/per610a/home/mvp/mvp_db/news7-lv/2017/2017_09_28_19_00/2017_09_28_19_00.mpg;Natsuo YAMAGUCHI.jpg;6141;6457;72049;307;323;16
/net/per610a/home/mvp/mvp_db/news7-lv/2017/2017_09_28_19_00/2017_09_28_19_00.mpg;Natsuo YAMAGUCHI.jpg;6533;6597;72049;326;330;4
/net/per610a/home/mvp/mvp_db/news7-lv/2017/2017_09_28_19_00/2017_09_28_19_00.mpg;Natsuo YAMAGUCHI.jpg;31629;31657;72049;1583;1584;1
/net/per610a/home/mvp/mvp_db/news7-lv/2017/2017_09_28_19_00/2017_09_28_19_00.mpg;Yoshihiko Noda.jpg;7809;7829;72049;390;391;1
/net/per610a/home/mvp/mvp_db/news7-lv/2017/2017_09_28_19_00/2017_09_28_19_00.mpg;Yoshihiko Noda.jpg;7925;8113;72049;396;406;10
/net/per610a/home/mvp/mvp_db/news7-lv/2017/2017_09_28_19_00/2017_09_28_19_00.mpg;Ichiro OZAWA.jpg;43949;45757;72049;2199;2290;91
/net/per610a/home/mvp/mvp_db/news7-lv/2017/2017_09_28_19_00/2017_09_28_19_00.mpg;Masashi Nakano.jpg;47581;48453;72049;2381;2425;44
/net/per610a/home/mvp/mvp_db/news7-lv/2017/2017_09_29_19_00/2017_09_29_19_00.mpg;YUriko Koike.jpg;1673;1941;36081;83;97;14
/net/per610a/home/mvp/mvp_db/news7-lv/2017/2017_09_30_19_00/2017_09_30_19_00.mpg;YUriko Koike.jpg;841;845;36089;42;42;0
/net/per610a/home/mvp/mvp_db/news7-lv/2017/2017_09_30_19_00/2017_09_30_19_00.mpg;YUriko Koike.jpg;2769;2865;36089;138;143;5
/net/per610a/home/mvp/mvp_db/news7-lv/2017/2017_09_30_19_00/2017_09_30_19_00.mpg;Shinzo ABE.jpg;5541;9237;36089;277;462;185
/net/per610a/home/mvp/mvp_db/news7-lv/2017/2017_09_30_19_00/2017_09_30_19_00.mpg;Masashi Nakano.jpg;12709;12825;36089;635;641;6
/net/per610a/home/mvp/mvp_db/news7-lv/2017/2017_09_30_19_00/2017_09_30_19_00.mpg;Masashi Nakano.jpg;12993;13397;36089;650;670;20
/net/per610a/home/mvp/mvp_db/news7-lv/2017/2017_09_30_19_00/2017_09_30_19_00.mpg;Masashi Nakano.jpg;13705;14229;36089;685;712;27
/net/per610a/home/mvp/mvp_db/news7-lv/2017/2017_10_01_19_00/2017_10_01_19_00.mpg;Shinzo ABE.jpg;5609;6473;36081;280;323;43
/net/per610a/home/mvp/mvp_db/news7-lv/2017/2017_10_02_19_00/2017_10_02_19_00.mpg;Yukio EDANO.jpg;557;585;36081;27;29;2
/net/per610a/home/mvp/mvp_db/news7-lv/2017/2017_10_02_19_00/2017_10_02_19_00.mpg;Yukio EDANO.jpg;817;877;36081;40;43;3
/net/per610a/home/mvp/mvp_db/news7-lv/2017/2017_10_02_19_00/2017_10_02_19_00.mpg;Yukio EDANO.jpg;993;2109;36081;49;105;56
/net/per610a/home/mvp/mvp_db/news7-lv/2017/2017_10_02_19_00/2017_10_02_19_00.mpg;Yukio EDANO.jpg;6045;6245;36081;302;312;10
/net/per610a/home/mvp/mvp_db/news7-lv/2017/2017_10_02_19_00/2017_10_02_19_00.mpg;Yukio EDANO.jpg;6601;6797;36081;330;340;10
/net/per610a/home/mvp/mvp_db/news7-lv/2017/2017_10_02_19_00/2017_10_02_19_00.mpg;Kenji Eda.jpg;3593;3985;36081;179;199;20
/net/per610a/home/mvp/mvp_db/news7-lv/2017/2017_10_02_19_00/2017_10_02_19_00.mpg;Yoshihiko Noda.jpg;3593;3985;36081;179;199;20
/net/per610a/home/mvp/mvp_db/news7-lv/2017/2017_10_02_19_00/2017_10_02_19_00.mpg;Shinzo ABE.jpg;6045;6233;36081;302;311;9
/net/per610a/home/mvp/mvp_db/news7-lv/2017/2017_10_02_19_00/2017_10_02_19_00.mpg;Kazuo SHII.jpg;6045;6245;36081;302;312;10
/net/per610a/home/mvp/mvp_db/news7-lv/2017/2017_10_02_19_00/2017_10_02_19_00.mpg;YUriko Koike.jpg;6045;6245;36081;302;312;10
/net/per610a/home/mvp/mvp_db/news7-lv/2017/2017_10_02_19_00/2017_10_02_19_00.mpg;YUriko Koike.jpg;6497;6797;36081;325;340;15
/net/per610a/home/mvp/mvp_db/news7-lv/2017/2017_10_02_19_00/2017_10_02_19_00.mpg;YUriko Koike.jpg;19101;19193;36081;955;960;5
/net/per610a/home/mvp/mvp_db/news7-lv/2017/2017_10_02_19_00/2017_10_02_19_00.mpg;Natsuo YAMAGUCHI.jpg;6049;6241;36081;302;312;10
/net/per610a/home/mvp/mvp_db/news7-lv/2017/2017_10_02_19_00/2017_10_02_19_00.mpg;Shinzo ABE.jpg;8449;8601;36081;422;430;8
/net/per610a/home/mvp/mvp_db/news7-lv/2017/2017_10_02_19_00/2017_10_02_19_00.mpg;Shinzo ABE.jpg;10785;11045;36081;539;552;13
/net/per610a/home/mvp/mvp_db/news7-lv/2017/2017_10_02_19_00/2017_10_02_19_00.mpg;Shinzo ABE.jpg;20429;20953;36081;1021;1048;27
/net/per610a/home/mvp/mvp_db/news7-lv/2017/2017_10_03_19_00/2017_10_03_19_00.mpg;YUriko Koike.jpg;965;1685;36089;48;84;36
/net/per610a/home/mvp/mvp_db/news7-lv/2017/2017_10_03_19_00/2017_10_03_19_00.mpg;YUriko Koike.jpg;9497;9937;36089;475;497;22
/net/per610a/home/mvp/mvp_db/news7-lv/2017/2017_10_03_19_00/2017_10_03_19_00.mpg;Kenji Eda.jpg;2249;2993;36089;112;149;37
/net/per610a/home/mvp/mvp_db/news7-lv/2017/2017_10_03_19_00/2017_10_03_19_00.mpg;Yoshihiko Noda.jpg;2249;3493;36089;112;174;62
/net/per610a/home/mvp/mvp_db/news7-lv/2017/2017_10_03_19_00/2017_10_03_19_00.mpg;Ichiro OZAWA.jpg;3553;4109;36089;177;205;28
/net/per610a/home/mvp/mvp_db/news7-lv/2017/2017_10_03_19_00/2017_10_03_19_00.mpg;Yukio EDANO.jpg;5017;5217;36089;251;261;10
/net/per610a/home/mvp/mvp_db/news7-lv/2017/2017_10_03_19_00/2017_10_03_19_00.mpg;Yukio EDANO.jpg;8709;9737;36089;435;487;52
/net/per610a/home/mvp/mvp_db/news7-lv/2017/2017_10_04_19_00/2017_10_04_19_00.mpg;Shinzo ABE.jpg;461;637;36081;23;31;8
/net/per610a/home/mvp/mvp_db/news7-lv/2017/2017_10_04_19_00/2017_10_04_19_00.mpg;Shinzo ABE.jpg;737;4517;36081;36;225;189
/net/per610a/home/mvp/mvp_db/news7-lv/2017/2017_10_04_19_00/2017_10_04_19_00.mpg;Kazuo SHII.jpg;4521;5257;36081;226;262;36
/net/per610a/home/mvp/mvp_db/news7-lv/2017/2017_10_05_19_00/2017_10_05_19_00.mpg;YUriko Koike.jpg;293;537;36081;14;26;12
/net/per610a/home/mvp/mvp_db/news7-lv/2017/2017_10_05_19_00/2017_10_05_19_00.mpg;YUriko Koike.jpg;1001;1081;36081;50;54;4
/net/per610a/home/mvp/mvp_db/news7-lv/2017/2017_10_05_19_00/2017_10_05_19_00.mpg;YUriko Koike.jpg;1461;1513;36081;73;75;2
/net/per610a/home/mvp/mvp_db/news7-lv/2017/2017_10_05_19_00/2017_10_05_19_00.mpg;Seiji MAEHARA.jpg;1001;1217;36081;50;60;10
/net/per610a/home/mvp/mvp_db/news7-lv/2017/2017_10_05_19_00/2017_10_05_19_00.mpg;YUriko Koike.jpg;1617;2061;36081;80;103;23
/net/per610a/home/mvp/mvp_db/news7-lv/2017/2017_10_05_19_00/2017_10_05_19_00.mpg;Natsuo YAMAGUCHI.jpg;5973;6905;36081;298;345;47
/net/per610a/home/mvp/mvp_db/news7-lv/2017/2017_10_05_19_00/2017_10_05_19_00.mpg;Natsuo YAMAGUCHI.jpg;8089;8849;36081;404;442;38
/net/per610a/home/mvp/mvp_db/news7-lv/2017/2017_10_05_19_00/2017_10_05_19_00.mpg;Natsuo YAMAGUCHI.jpg;9433;9901;36081;471;495;24
/net/per610a/home/mvp/mvp_db/news7-lv/2017/2017_10_06_19_00/2017_10_06_19_00.mpg;Shinzo ABE.jpg;10269;10585;36081;513;529;16
/net/per610a/home/mvp/mvp_db/news7-lv/2017/2017_10_06_19_00/2017_10_06_19_00.mpg;YUriko Koike.jpg;11097;11613;36081;555;580;25
/net/per610a/home/mvp/mvp_db/news7-lv/2017/2017_10_06_19_00/2017_10_06_19_00.mpg;YUriko Koike.jpg;11969;13525;36081;598;676;78
/net/per610a/home/mvp/mvp_db/news7-lv/2017/2017_10_06_19_00/2017_10_06_19_00.mpg;YUriko Koike.jpg;15649;15889;36081;782;794;12
/net/per610a/home/mvp/mvp_db/news7-lv/2017/2017_10_06_19_00/2017_10_06_19_00.mpg;YUriko Koike.jpg;16337;16437;36081;817;822;5
/net/per610a/home/mvp/mvp_db/news7-lv/2017/2017_10_06_19_00/2017_10_06_19_00.mpg;YUriko Koike.jpg;17017;17129;36081;851;856;5
/net/per610a/home/mvp/mvp_db/news7-lv/2017/2017_10_06_19_00/2017_10_06_19_00.mpg;YUriko Koike.jpg;17913;18025;36081;896;901;5
/net/per610a/home/mvp/mvp_db/news7-lv/2017/2017_10_07_19_00/2017_10_07_19_00.mpg;Shinzo ABE.jpg;457;1429;36081;22;71;49
/net/per610a/home/mvp/mvp_db/news7-lv/2017/2017_10_07_19_00/2017_10_07_19_00.mpg;YUriko Koike.jpg;1921;2757;36081;96;137;41
/net/per610a/home/mvp/mvp_db/news7-lv/2017/2017_10_07_19_00/2017_10_07_19_00.mpg;Yukio EDANO.jpg;4101;4885;36081;205;244;39
/net/per610a/home/mvp/mvp_db/news7-lv/2017/2017_10_07_19_00/2017_10_07_19_00.mpg;Yukio EDANO.jpg;6769;6829;36081;338;341;3
/net/per610a/home/mvp/mvp_db/news7-lv/2017/2017_10_08_19_00/2017_10_08_19_00.mpg;Shinzo ABE.jpg;1513;1865;36089;75;93;18
/net/per610a/home/mvp/mvp_db/news7-lv/2017/2017_10_08_19_00/2017_10_08_19_00.mpg;Shinzo ABE.jpg;5301;5937;36089;265;297;32
/net/per610a/home/mvp/mvp_db/news7-lv/2017/2017_10_08_19_00/2017_10_08_19_00.mpg;Shinzo ABE.jpg;6417;6717;36089;321;336;15
/net/per610a/home/mvp/mvp_db/news7-lv/2017/2017_10_08_19_00/2017_10_08_19_00.mpg;Natsuo YAMAGUCHI.jpg;2461;2709;36089;123;135;12
/net/per610a/home/mvp/mvp_db/news7-lv/2017/2017_10_08_19_00/2017_10_08_19_00.mpg;YUriko Koike.jpg;2985;3433;36089;149;171;22
/net/per610a/home/mvp/mvp_db/news7-lv/2017/2017_10_08_19_00/2017_10_08_19_00.mpg;YUriko Koike.jpg;6049;6281;36089;302;314;12
/net/per610a/home/mvp/mvp_db/news7-lv/2017/2017_10_08_19_00/2017_10_08_19_00.mpg;YUriko Koike.jpg;6781;7245;36089;339;362;23
/net/per610a/home/mvp/mvp_db/news7-lv/2017/2017_10_08_19_00/2017_10_08_19_00.mpg;YUriko Koike.jpg;7485;8805;36089;374;440;66
/net/per610a/home/mvp/mvp_db/news7-lv/2017/2017_10_08_19_00/2017_10_08_19_00.mpg;YUriko Koike.jpg;9029;9925;36089;451;496;45
/net/per610a/home/mvp/mvp_db/news7-lv/2017/2017_10_08_19_00/2017_10_08_19_00.mpg;Kazuo SHII.jpg;3525;3897;36089;176;195;19
/net/per610a/home/mvp/mvp_db/news7-lv/2017/2017_10_08_19_00/2017_10_08_19_00.mpg;Yukio EDANO.jpg;4373;4589;36089;218;229;11
/net/per610a/home/mvp/mvp_db/news7-lv/2017/2017_10_09_19_00/2017_10_09_19_00.mpg;Shinzo ABE.jpg;613;705;36081;30;35;5
/net/per610a/home/mvp/mvp_db/news7-lv/2017/2017_10_09_19_00/2017_10_09_19_00.mpg;Yukio EDANO.jpg;3053;3349;36081;152;167;15
/net/per610a/home/mvp/mvp_db/news7-lv/2017/2017_10_10_19_00/2017_10_10_19_00.mpg;Shinzo ABE.jpg;985;2121;125989;49;106;57
/net/per610a/home/mvp/mvp_db/news7-lv/2017/2017_10_10_19_00/2017_10_10_19_00.mpg;Shinzo ABE.jpg;109465;109973;125989;5478;5503;25
/net/per610a/home/mvp/mvp_db/news7-lv/2017/2017_10_10_19_00/2017_10_10_19_00.mpg;Natsuo YAMAGUCHI.jpg;3169;4021;125989;158;201;43
/net/per610a/home/mvp/mvp_db/news7-lv/2017/2017_10_10_19_00/2017_10_10_19_00.mpg;Kazuo SHII.jpg;4037;4777;125989;202;239;37
/net/per610a/home/mvp/mvp_db/news7-lv/2017/2017_10_10_19_00/2017_10_10_19_00.mpg;Yukio EDANO.jpg;4829;5057;125989;241;253;12
/net/per610a/home/mvp/mvp_db/news7-lv/2017/2017_10_10_19_00/2017_10_10_19_00.mpg;Masashi Nakano.jpg;6533;6889;125989;326;344;18
/net/per610a/home/mvp/mvp_db/news7-lv/2017/2017_10_10_19_00/2017_10_10_19_00.mpg;Yoshihiko Noda.jpg;11301;11429;125989;565;571;6
/net/per610a/home/mvp/mvp_db/news7-lv/2017/2017_10_10_19_00/2017_10_10_19_00.mpg;YUriko Koike.jpg;108149;108981;125989;5412;5453;41
/net/per610a/home/mvp/mvp_db/news7-lv/2017/2017_10_11_19_00/2017_10_11_19_00.mpg;Kohei Otsuka.jpg;31105;31257;36081;1556;1563;7
/net/per610a/home/mvp/mvp_db/news7-lv/2017/2017_10_14_19_00/2017_10_14_19_00.mpg;Shinzo ABE.jpg;745;1009;36089;37;50;13
/net/per610a/home/mvp/mvp_db/news7-lv/2017/2017_10_14_19_00/2017_10_14_19_00.mpg;YUriko Koike.jpg;2813;4569;36089;140;228;88
/net/per610a/home/mvp/mvp_db/news7-lv/2017/2017_10_14_19_00/2017_10_14_19_00.mpg;Yukio EDANO.jpg;4653;4977;36089;232;249;17
/net/per610a/home/mvp/mvp_db/news7-lv/2017/2017_10_15_19_00/2017_10_15_19_00.mpg;Shinzo ABE.jpg;2481;3785;36089;124;189;65
/net/per610a/home/mvp/mvp_db/news7-lv/2017/2017_10_16_19_00/2017_10_16_19_00.mpg;Shinzo ABE.jpg;15529;16149;36089;777;808;31
/net/per610a/home/mvp/mvp_db/news7-lv/2017/2017_10_19_19_00/2017_10_19_19_00.mpg;Shinzo ABE.jpg;10733;10929;36089;537;546;9
/net/per610a/home/mvp/mvp_db/news7-lv/2017/2017_10_19_19_00/2017_10_19_19_00.mpg;Natsuo YAMAGUCHI.jpg;13081;14909;36089;654;746;92
/net/per610a/home/mvp/mvp_db/news7-lv/2017/2017_10_19_19_00/2017_10_19_19_00.mpg;Yukio EDANO.jpg;14913;16285;36089;746;814;68
/net/per610a/home/mvp/mvp_db/news7-lv/2017/2017_10_20_19_00/2017_10_20_19_00.mpg;Shinzo ABE.jpg;18133;19101;36089;907;955;48
/net/per610a/home/mvp/mvp_db/news7-lv/2017/2017_10_20_19_00/2017_10_20_19_00.mpg;Yukio EDANO.jpg;22009;22509;36089;1101;1126;25
/net/per610a/home/mvp/mvp_db/news7-lv/2017/2017_10_20_19_00/2017_10_20_19_00.mpg;Ichiro Matsui.jpeg;22513;22517;36089;1126;1126;0
/net/per610a/home/mvp/mvp_db/news7-lv/2017/2017_10_20_19_00/2017_10_20_19_00.mpg;Ichiro Matsui.jpeg;22821;22913;36089;1142;1146;4
/net/per610a/home/mvp/mvp_db/news7-lv/2017/2017_10_21_19_00/2017_10_21_19_00.mpg;Shinzo ABE.jpg;8609;9237;36089;430;462;32
/net/per610a/home/mvp/mvp_db/news7-lv/2017/2017_10_21_19_00/2017_10_21_19_00.mpg;Shinzo ABE.jpg;9533;9681;36089;477;484;7
/net/per610a/home/mvp/mvp_db/news7-lv/2017/2017_10_21_19_00/2017_10_21_19_00.mpg;YUriko Koike.jpg;9805;11017;36089;490;551;61
/net/per610a/home/mvp/mvp_db/news7-lv/2017/2017_10_21_19_00/2017_10_21_19_00.mpg;Ichiro Matsui.jpeg;12877;13801;36089;644;690;46
/net/per610a/home/mvp/mvp_db/news7-lv/2017/2017_10_23_19_00/2017_10_23_19_00.mpg;Shinzo ABE.jpg;5;61;36081;0;3;3
/net/per610a/home/mvp/mvp_db/news7-lv/2017/2017_10_23_19_00/2017_10_23_19_00.mpg;Shinzo ABE.jpg;281;345;36081;14;17;3
/net/per610a/home/mvp/mvp_db/news7-lv/2017/2017_10_23_19_00/2017_10_23_19_00.mpg;Shinzo ABE.jpg;481;601;36081;24;30;6
/net/per610a/home/mvp/mvp_db/news7-lv/2017/2017_10_23_19_00/2017_10_23_19_00.mpg;Shinzo ABE.jpg;961;1521;36081;48;76;28
/net/per610a/home/mvp/mvp_db/news7-lv/2017/2017_10_23_19_00/2017_10_23_19_00.mpg;Shinzo ABE.jpg;2901;2929;36081;145;146;1
/net/per610a/home/mvp/mvp_db/news7-lv/2017/2017_10_23_19_00/2017_10_23_19_00.mpg;Shinzo ABE.jpg;3009;3037;36081;150;151;1
/net/per610a/home/mvp/mvp_db/news7-lv/2017/2017_10_23_19_00/2017_10_23_19_00.mpg;Shinzo ABE.jpg;3161;3197;36081;158;159;1
/net/per610a/home/mvp/mvp_db/news7-lv/2017/2017_10_23_19_00/2017_10_23_19_00.mpg;Shinzo ABE.jpg;3273;3273;36081;163;163;0
/net/per610a/home/mvp/mvp_db/news7-lv/2017/2017_10_23_19_00/2017_10_23_19_00.mpg;Shinzo ABE.jpg;5749;6877;36081;287;344;57
/net/per610a/home/mvp/mvp_db/news7-lv/2017/2017_10_23_19_00/2017_10_23_19_00.mpg;Shinzo ABE.jpg;6949;7513;36081;347;375;28
/net/per610a/home/mvp/mvp_db/news7-lv/2017/2017_10_23_19_00/2017_10_23_19_00.mpg;Shinzo ABE.jpg;9149;9513;36081;457;475;18
/net/per610a/home/mvp/mvp_db/news7-lv/2017/2017_10_23_19_00/2017_10_23_19_00.mpg;Shinzo ABE.jpg;10917;11313;36081;546;565;19
/net/per610a/home/mvp/mvp_db/news7-lv/2017/2017_10_23_19_00/2017_10_23_19_00.mpg;YUriko Koike.jpg;2193;2505;36081;109;125;16
/net/per610a/home/mvp/mvp_db/news7-lv/2017/2017_10_23_19_00/2017_10_23_19_00.mpg;Natsuo YAMAGUCHI.jpg;2945;2985;36081;147;149;2
/net/per610a/home/mvp/mvp_db/news7-lv/2017/2017_10_23_19_00/2017_10_23_19_00.mpg;Natsuo YAMAGUCHI.jpg;3193;3237;36081;159;161;2
/net/per610a/home/mvp/mvp_db/news7-lv/2017/2017_10_23_19_00/2017_10_23_19_00.mpg;Natsuo YAMAGUCHI.jpg;3345;3605;36081;167;180;13
/net/per610a/home/mvp/mvp_db/news7-lv/2017/2017_10_23_19_00/2017_10_23_19_00.mpg;Natsuo YAMAGUCHI.jpg;10565;10889;36081;528;544;16
/net/per610a/home/mvp/mvp_db/news7-lv/2017/2017_10_23_19_00/2017_10_23_19_00.mpg;Yukio EDANO.jpg;11997;12197;36081;600;610;10
/net/per610a/home/mvp/mvp_db/news7-lv/2017/2017_10_23_19_00/2017_10_23_19_00.mpg;Seiji MAEHARA.jpg;13589;13801;36081;679;690;11
/net/per610a/home/mvp/mvp_db/news7-lv/2017/2017_10_24_19_00/2017_10_24_19_00.mpg;YUriko Koike.jpg;6941;7365;36081;347;368;21
/net/per610a/home/mvp/mvp_db/news7-lv/2017/2017_10_24_19_00/2017_10_24_19_00.mpg;Yukio EDANO.jpg;7749;7793;36081;387;389;2
/net/per610a/home/mvp/mvp_db/news7-lv/2017/2017_10_24_19_00/2017_10_24_19_00.mpg;Yukio EDANO.jpg;7953;8201;36081;397;410;13
/net/per610a/home/mvp/mvp_db/news7-lv/2017/2017_10_24_19_00/2017_10_24_19_00.mpg;Yukio EDANO.jpg;8321;8869;36081;416;443;27
/net/per610a/home/mvp/mvp_db/news7-lv/2017/2017_10_24_19_00/2017_10_24_19_00.mpg;Shinzo ABE.jpg;26593;27365;36081;1330;1368;38
/net/per610a/home/mvp/mvp_db/news7-lv/2017/2017_10_25_19_00/2017_10_25_19_00.mpg;YUriko Koike.jpg;1;33;36081;0;1;1
/net/per610a/home/mvp/mvp_db/news7-lv/2017/2017_10_25_19_00/2017_10_25_19_00.mpg;YUriko Koike.jpg;725;789;36081;36;39;3
/net/per610a/home/mvp/mvp_db/news7-lv/2017/2017_10_25_19_00/2017_10_25_19_00.mpg;YUriko Koike.jpg;3201;3713;36081;160;185;25
/net/per610a/home/mvp/mvp_db/news7-lv/2017/2017_10_25_19_00/2017_10_25_19_00.mpg;Kohei Otsuka.jpg;729;781;36081;36;39;3
/net/per610a/home/mvp/mvp_db/news7-lv/2017/2017_10_25_19_00/2017_10_25_19_00.mpg;Seiji MAEHARA.jpg;3781;4489;36081;189;224;35
/net/per610a/home/mvp/mvp_db/news7-lv/2017/2017_10_26_19_00/2017_10_26_19_00.mpg;Shinzo ABE.jpg;22617;23525;36089;1131;1177;46
/net/per610a/home/mvp/mvp_db/news7-lv/2017/2017_10_26_19_00/2017_10_26_19_00.mpg;YUriko Koike.jpg;23529;24369;36089;1177;1219;42
/net/per610a/home/mvp/mvp_db/news7-lv/2017/2017_10_27_19_00/2017_10_27_19_00.mpg;YUriko Koike.jpg;20033;21029;36081;1002;1052;50
/net/per610a/home/mvp/mvp_db/news7-lv/2017/2017_10_27_19_00/2017_10_27_19_00.mpg;YUriko Koike.jpg;21177;21281;36081;1059;1064;5
/net/per610a/home/mvp/mvp_db/news7-lv/2017/2017_10_28_19_00/2017_10_28_19_00.mpg;YUriko Koike.jpg;14665;14837;36089;733;742;9
/net/per610a/home/mvp/mvp_db/news7-lv/2017/2017_10_30_19_00/2017_10_30_19_00.mpg;Yukio EDANO.jpg;933;1317;36081;46;65;19
/net/per610a/home/mvp/mvp_db/news7-lv/2017/2017_10_30_19_00/2017_10_30_19_00.mpg;Yukio EDANO.jpg;3949;4013;36081;197;200;3
/net/per610a/home/mvp/mvp_db/news7-lv/2017/2017_10_31_19_00/2017_10_31_19_00.mpg;Shinzo ABE.jpg;15845;16025;36089;792;801;9
/net/per610a/home/mvp/mvp_db/news7-lv/2017/2017_10_31_19_00/2017_10_31_19_00.mpg;Shinzo ABE.jpg;21201;21413;36089;1060;1071;11
/net/per610a/home/mvp/mvp_db/news7-lv/2017/2017_10_31_19_00/2017_10_31_19_00.mpg;Yukio EDANO.jpg;19665;20361;36089;984;1018;34
/net/per610a/home/mvp/mvp_db/news7-lv/2017/2017_11_01_19_00/2017_11_01_19_00.mpg;Shinzo ABE.jpg;1;37;36081;0;1;1
/net/per610a/home/mvp/mvp_db/news7-lv/2017/2017_11_01_19_00/2017_11_01_19_00.mpg;Shinzo ABE.jpg;321;637;36081;16;31;15
/net/per610a/home/mvp/mvp_db/news7-lv/2017/2017_11_01_19_00/2017_11_01_19_00.mpg;Shinzo ABE.jpg;2485;2805;36081;124;140;16
/net/per610a/home/mvp/mvp_db/news7-lv/2017/2017_11_01_19_00/2017_11_01_19_00.mpg;Shinzo ABE.jpg;3229;3241;36081;161;162;1
/net/per610a/home/mvp/mvp_db/news7-lv/2017/2017_11_01_19_00/2017_11_01_19_00.mpg;Shinzo ABE.jpg;4493;4493;36081;224;224;0
/net/per610a/home/mvp/mvp_db/news7-lv/2017/2017_11_01_19_00/2017_11_01_19_00.mpg;Shinzo ABE.jpg;5301;5353;36081;265;267;2
/net/per610a/home/mvp/mvp_db/news7-lv/2017/2017_11_01_19_00/2017_11_01_19_00.mpg;Shinzo ABE.jpg;11065;11253;36081;553;562;9
/net/per610a/home/mvp/mvp_db/news7-lv/2017/2017_11_01_19_00/2017_11_01_19_00.mpg;Yukio EDANO.jpg;2937;3161;36081;146;158;12
/net/per610a/home/mvp/mvp_db/news7-lv/2017/2017_11_02_19_00/2017_11_02_19_00.mpg;Natsuo YAMAGUCHI.jpg;16361;16609;36081;818;830;12
/net/per610a/home/mvp/mvp_db/news7-lv/2017/2017_11_02_19_00/2017_11_02_19_00.mpg;Kohei Otsuka.jpg;18881;19417;36081;944;971;27
/net/per610a/home/mvp/mvp_db/news7-lv/2017/2017_11_04_19_00/2017_11_04_19_00.mpg;Shinzo ABE.jpg;6257;6353;36081;313;317;4
/net/per610a/home/mvp/mvp_db/news7-lv/2017/2017_11_04_19_00/2017_11_04_19_00.mpg;Shinzo ABE.jpg;11209;11225;36081;560;561;1
/net/per610a/home/mvp/mvp_db/news7-lv/2017/2017_11_05_19_00/2017_11_05_19_00.mpg;Shinzo ABE.jpg;5509;5677;36081;275;283;8
/net/per610a/home/mvp/mvp_db/news7-lv/2017/2017_11_05_19_00/2017_11_05_19_00.mpg;Shinzo ABE.jpg;8145;8425;36081;407;421;14
/net/per610a/home/mvp/mvp_db/news7-lv/2017/2017_11_05_19_00/2017_11_05_19_00.mpg;Shinzo ABE.jpg;10325;10405;36081;516;520;4
/net/per610a/home/mvp/mvp_db/news7-lv/2017/2017_11_07_19_00/2017_11_07_19_00.mpg;Shinzo ABE.jpg;305;353;36089;15;17;2
/net/per610a/home/mvp/mvp_db/news7-lv/2017/2017_11_07_19_00/2017_11_07_19_00.mpg;Shinzo ABE.jpg;15577;15617;36089;779;781;2
/net/per610a/home/mvp/mvp_db/news7-lv/2017/2017_11_07_19_00/2017_11_07_19_00.mpg;Shinzo ABE.jpg;15701;15769;36089;785;789;4
/net/per610a/home/mvp/mvp_db/news7-lv/2017/2017_11_08_19_00/2017_11_08_19_00.mpg;Yuichiro Tamaki.png;14405;14797;36081;720;740;20
/net/per610a/home/mvp/mvp_db/news7-lv/2017/2017_11_08_19_00/2017_11_08_19_00.mpg;Yuichiro Tamaki.png;14885;14965;36081;744;748;4
/net/per610a/home/mvp/mvp_db/news7-lv/2017/2017_11_08_19_00/2017_11_08_19_00.mpg;Yuichiro Tamaki.png;15093;15877;36081;755;794;39
/net/per610a/home/mvp/mvp_db/news7-lv/2017/2017_11_08_19_00/2017_11_08_19_00.mpg;Yuichiro Tamaki.png;15981;16693;36081;799;835;36
/net/per610a/home/mvp/mvp_db/news7-lv/2017/2017_11_09_19_00/2017_11_09_19_00.mpg;Shinzo ABE.jpg;5345;5405;36081;267;270;3
/net/per610a/home/mvp/mvp_db/news7-lv/2017/2017_11_09_19_00/2017_11_09_19_00.mpg;Shinzo ABE.jpg;5513;5965;36081;275;298;23
/net/per610a/home/mvp/mvp_db/news7-lv/2017/2017_11_09_19_00/2017_11_09_19_00.mpg;Shinzo ABE.jpg;17713;18485;36081;886;924;38
/net/per610a/home/mvp/mvp_db/news7-lv/2017/2017_11_09_19_00/2017_11_09_19_00.mpg;Yuichiro Tamaki.png;18649;19297;36081;932;965;33
/net/per610a/home/mvp/mvp_db/news7-lv/2017/2017_11_09_19_00/2017_11_09_19_00.mpg;Yuichiro Tamaki.png;19369;20001;36081;968;1000;32
/net/per610a/home/mvp/mvp_db/news7-lv/2017/2017_11_10_19_00/2017_11_10_19_00.mpg;Shinzo ABE.jpg;10729;10953;36081;536;547;11
/net/per610a/home/mvp/mvp_db/news7-lv/2017/2017_11_10_19_00/2017_11_10_19_00.mpg;Shinzo ABE.jpg;11889;12089;36081;594;604;10
/net/per610a/home/mvp/mvp_db/news7-lv/2017/2017_11_10_19_00/2017_11_10_19_00.mpg;Shinzo ABE.jpg;12281;12589;36081;614;629;15
/net/per610a/home/mvp/mvp_db/news7-lv/2017/2017_11_10_19_00/2017_11_10_19_00.mpg;Yuichiro Tamaki.png;20829;21309;36081;1041;1066;25
/net/per610a/home/mvp/mvp_db/news7-lv/2017/2017_11_10_19_00/2017_11_10_19_00.mpg;Yuichiro Tamaki.png;21673;22129;36081;1084;1107;23
/net/per610a/home/mvp/mvp_db/news7-lv/2017/2017_11_10_19_00/2017_11_10_19_00.mpg;Yuichiro Tamaki.png;22193;22269;36081;1110;1114;4
/net/per610a/home/mvp/mvp_db/news7-lv/2017/2017_11_10_19_00/2017_11_10_19_00.mpg;Yuichiro Tamaki.png;22357;22789;36081;1118;1140;22
/net/per610a/home/mvp/mvp_db/news7-lv/2017/2017_11_10_19_00/2017_11_10_19_00.mpg;YUriko Koike.jpg;23381;24029;36081;1169;1202;33
/net/per610a/home/mvp/mvp_db/news7-lv/2017/2017_11_11_19_00/2017_11_11_19_00.mpg;Shinzo ABE.jpg;7885;7941;36081;394;397;3
/net/per610a/home/mvp/mvp_db/news7-lv/2017/2017_11_11_19_00/2017_11_11_19_00.mpg;Shinzo ABE.jpg;8149;8217;36081;407;411;4
/net/per610a/home/mvp/mvp_db/news7-lv/2017/2017_11_11_19_00/2017_11_11_19_00.mpg;Shinzo ABE.jpg;11057;11125;36081;553;556;3
/net/per610a/home/mvp/mvp_db/news7-lv/2017/2017_11_12_19_00/2017_11_12_19_00.mpg;Shinzo ABE.jpg;26809;26933;36081;1341;1347;6
/net/per610a/home/mvp/mvp_db/news7-lv/2017/2017_11_13_19_00/2017_11_13_19_00.mpg;Yukio HATOYAMA.jpg;7057;7561;36089;353;378;25
/net/per610a/home/mvp/mvp_db/news7-lv/2017/2017_11_13_19_00/2017_11_13_19_00.mpg;Yukio HATOYAMA.jpg;8241;8529;36089;412;426;14
/net/per610a/home/mvp/mvp_db/news7-lv/2017/2017_11_13_19_00/2017_11_13_19_00.mpg;Shinzo ABE.jpg;14753;14793;36089;738;740;2
/net/per610a/home/mvp/mvp_db/news7-lv/2017/2017_11_13_19_00/2017_11_13_19_00.mpg;Shinzo ABE.jpg;18529;18641;36089;927;932;5
/net/per610a/home/mvp/mvp_db/news7-lv/2017/2017_11_13_19_00/2017_11_13_19_00.mpg;Shinzo ABE.jpg;22005;22229;36089;1101;1112;11
/net/per610a/home/mvp/mvp_db/news7-lv/2017/2017_11_13_19_00/2017_11_13_19_00.mpg;Shinzo ABE.jpg;28549;28629;36089;1428;1432;4
/net/per610a/home/mvp/mvp_db/news7-lv/2017/2017_11_13_19_00/2017_11_13_19_00.mpg;Shinzo ABE.jpg;22677;22761;36089;1134;1139;5
/net/per610a/home/mvp/mvp_db/news7-lv/2017/2017_11_13_19_00/2017_11_13_19_00.mpg;Shinzo ABE.jpg;23041;23217;36089;1153;1161;8
/net/per610a/home/mvp/mvp_db/news7-lv/2017/2017_11_14_19_00/2017_11_14_19_00.mpg;YUriko Koike.jpg;6905;7221;36089;345;361;16
/net/per610a/home/mvp/mvp_db/news7-lv/2017/2017_11_14_19_00/2017_11_14_19_00.mpg;YUriko Koike.jpg;7529;7585;36089;376;379;3
/net/per610a/home/mvp/mvp_db/news7-lv/2017/2017_11_14_19_00/2017_11_14_19_00.mpg;YUriko Koike.jpg;9261;10769;36089;463;538;75
/net/per610a/home/mvp/mvp_db/news7-lv/2017/2017_11_14_19_00/2017_11_14_19_00.mpg;YUriko Koike.jpg;11513;11545;36089;576;577;1
/net/per610a/home/mvp/mvp_db/news7-lv/2017/2017_11_14_19_00/2017_11_14_19_00.mpg;YUriko Koike.jpg;11773;11813;36089;589;591;2
/net/per610a/home/mvp/mvp_db/news7-lv/2017/2017_11_14_19_00/2017_11_14_19_00.mpg;YUriko Koike.jpg;8205;8249;36089;410;412;2
/net/per610a/home/mvp/mvp_db/news7-lv/2017/2017_11_14_19_00/2017_11_14_19_00.mpg;YUriko Koike.jpg;8549;8597;36089;427;430;3
/net/per610a/home/mvp/mvp_db/news7-lv/2017/2017_11_14_19_00/2017_11_14_19_00.mpg;Seiji MAEHARA.jpg;8393;8597;36089;420;430;10
/net/per610a/home/mvp/mvp_db/news7-lv/2017/2017_11_14_19_00/2017_11_14_19_00.mpg;Shinzo ABE.jpg;26469;26681;36089;1324;1335;11
/net/per610a/home/mvp/mvp_db/news7-lv/2017/2017_11_14_19_00/2017_11_14_19_00.mpg;Shinzo ABE.jpg;28473;28609;36089;1424;1431;7
/net/per610a/home/mvp/mvp_db/news7-lv/2017/2017_11_14_19_00/2017_11_14_19_00.mpg;Shinzo ABE.jpg;28857;29013;36089;1444;1451;7
/net/per610a/home/mvp/mvp_db/news7-lv/2017/2017_11_16_19_00/2017_11_16_19_00.mpg;Toranosuke Katayama.jpg;18833;19253;36081;942;963;21
/net/per610a/home/mvp/mvp_db/news7-lv/2017/2017_11_17_19_00/2017_11_17_19_00.mpg;Shinzo ABE.jpg;9141;10209;36089;457;510;53
/net/per610a/home/mvp/mvp_db/news7-lv/2017/2017_11_17_19_00/2017_11_17_19_00.mpg;Shinzo ABE.jpg;11465;11473;36089;573;574;1
/net/per610a/home/mvp/mvp_db/news7-lv/2017/2017_11_17_19_00/2017_11_17_19_00.mpg;Kohei Otsuka.jpg;12261;14165;36089;613;708;95
/net/per610a/home/mvp/mvp_db/news7-lv/2017/2017_11_20_19_00/2017_11_20_19_00.mpg;Shinzo ABE.jpg;21433;21505;36081;1072;1075;3
/net/per610a/home/mvp/mvp_db/news7-lv/2017/2017_11_20_19_00/2017_11_20_19_00.mpg;Shinzo ABE.jpg;21685;22061;36081;1084;1103;19
/net/per610a/home/mvp/mvp_db/news7-lv/2017/2017_11_22_19_00/2017_11_22_19_00.mpg;Shinzo ABE.jpg;1673;1953;36081;83;97;14
/net/per610a/home/mvp/mvp_db/news7-lv/2017/2017_11_22_19_00/2017_11_22_19_00.mpg;Shinzo ABE.jpg;23865;23869;36081;1193;1194;1
/net/per610a/home/mvp/mvp_db/news7-lv/2017/2017_11_25_19_00/2017_11_25_19_00.mpg;Ichiro Matsui.jpeg;11089;11109;36081;554;555;1
/net/per610a/home/mvp/mvp_db/news7-lv/2017/2017_11_25_19_00/2017_11_25_19_00.mpg;Ichiro Matsui.jpeg;12741;12741;36081;637;637;0
/net/per610a/home/mvp/mvp_db/news7-lv/2017/2017_11_25_19_00/2017_11_25_19_00.mpg;Ichiro Matsui.jpeg;12809;13173;36081;640;658;18
/net/per610a/home/mvp/mvp_db/news7-lv/2017/2017_11_25_19_00/2017_11_25_19_00.mpg;YUriko Koike.jpg;24057;24325;36081;1203;1216;13
/net/per610a/home/mvp/mvp_db/news7-lv/2017/2017_11_29_19_00/2017_11_29_19_00.mpg;Shinzo ABE.jpg;6685;7129;36081;334;356;22
/net/per610a/home/mvp/mvp_db/news7-lv/2017/2017_11_29_19_00/2017_11_29_19_00.mpg;Shinzo ABE.jpg;22461;23025;36081;1123;1151;28
/net/per610a/home/mvp/mvp_db/news7-lv/2017/2017_11_29_19_00/2017_11_29_19_00.mpg;Shinzo ABE.jpg;24097;24137;36081;1205;1207;2
/net/per610a/home/mvp/mvp_db/news7-lv/2017/2017_11_29_19_00/2017_11_29_19_00.mpg;Shinzo ABE.jpg;24269;24565;36081;1214;1228;14
/net/per610a/home/mvp/mvp_db/news7-lv/2017/2017_11_29_19_00/2017_11_29_19_00.mpg;YUriko Koike.jpg;26649;27005;36081;1333;1350;17
/net/per610a/home/mvp/mvp_db/news7-lv/2017/2017_11_30_19_00/2017_11_30_19_00.mpg;Shinzo ABE.jpg;20049;20573;36089;1003;1029;26
/net/per610a/home/mvp/mvp_db/news7-lv/2017/2017_11_30_19_00/2017_11_30_19_00.mpg;Shinzo ABE.jpg;20893;21161;36089;1045;1058;13
/net/per610a/home/mvp/mvp_db/news7-lv/2017/2017_11_30_19_00/2017_11_30_19_00.mpg;Shinzo ABE.jpg;22721;22837;36089;1137;1142;5
/net/per610a/home/mvp/mvp_db/news7-lv/2017/2017_11_30_19_00/2017_11_30_19_00.mpg;Shinzo ABE.jpg;23081;23097;36089;1155;1155;0
/net/per610a/home/mvp/mvp_db/news7-lv/2017/2017_11_30_19_00/2017_11_30_19_00.mpg;Shinzo ABE.jpg;24713;24713;36089;1236;1236;0
/net/per610a/home/mvp/mvp_db/news7-lv/2017/2017_11_30_19_00/2017_11_30_19_00.mpg;Shinzo ABE.jpg;24929;24933;36089;1247;1247;0
/net/per610a/home/mvp/mvp_db/news7-lv/2017/2017_12_01_19_00/2017_12_01_19_00.mpg;Shinzo ABE.jpg;1981;2073;72049;99;103;4
/net/per610a/home/mvp/mvp_db/news7-lv/2017/2017_12_01_19_00/2017_12_01_19_00.mpg;Shinzo ABE.jpg;3365;4009;72049;168;200;32
/net/per610a/home/mvp/mvp_db/news7-lv/2017/2017_12_01_19_00/2017_12_01_19_00.mpg;Shinzo ABE.jpg;9269;9433;72049;463;472;9
/net/per610a/home/mvp/mvp_db/news7-lv/2017/2017_12_01_19_00/2017_12_01_19_00.mpg;Shinzo ABE.jpg;31713;31797;72049;1587;1591;4
/net/per610a/home/mvp/mvp_db/news7-lv/2017/2017_12_01_19_00/2017_12_01_19_00.mpg;Shinzo ABE.jpg;59769;60305;72049;2991;3018;27
/net/per610a/home/mvp/mvp_db/news7-lv/2017/2017_12_01_19_00/2017_12_01_19_00.mpg;Shinzo ABE.jpg;61685;61781;72049;3087;3092;5
/net/per610a/home/mvp/mvp_db/news7-lv/2017/2017_12_01_19_00/2017_12_01_19_00.mpg;Yukio HATOYAMA.jpg;31557;31649;72049;1579;1584;5
/net/per610a/home/mvp/mvp_db/news7-lv/2017/2017_12_01_19_00/2017_12_01_19_00.mpg;Junichiro KOIZUMI.jpg;35125;35341;72049;1757;1768;11
/net/per610a/home/mvp/mvp_db/news7-lv/2017/2017_12_01_19_00/2017_12_01_19_00.mpg;YUriko Koike.jpg;53321;53405;72049;2668;2672;4
/net/per610a/home/mvp/mvp_db/news7-lv/2017/2017_12_01_19_00/2017_12_01_19_00.mpg;Shinzo ABE.jpg;61957;62121;72049;3100;3109;9
/net/per610a/home/mvp/mvp_db/news7-lv/2017/2017_12_01_19_00/2017_12_01_19_00.mpg;Shinzo ABE.jpg;62953;63049;72049;3150;3155;5
/net/per610a/home/mvp/mvp_db/news7-lv/2017/2017_12_02_19_00/2017_12_02_19_00.mpg;Shinzo ABE.jpg;1501;1585;36081;75;79;4
/net/per610a/home/mvp/mvp_db/news7-lv/2017/2017_12_04_19_00/2017_12_04_19_00.mpg;Shinzo ABE.jpg;4885;5417;36081;244;270;26
/net/per610a/home/mvp/mvp_db/news7-lv/2017/2017_12_07_19_00/2017_12_07_19_00.mpg;YUriko Koike.jpg;23813;24029;36081;1191;1202;11
/net/per610a/home/mvp/mvp_db/news7-lv/2017/2017_12_07_19_00/2017_12_07_19_00.mpg;Shinzo ABE.jpg;23813;24029;36081;1191;1202;11
/net/per610a/home/mvp/mvp_db/news7-lv/2017/2017_12_08_19_00/2017_12_08_19_00.mpg;Shinzo ABE.jpg;12401;12541;36089;620;627;7
/net/per610a/home/mvp/mvp_db/news7-lv/2017/2017_12_08_19_00/2017_12_08_19_00.mpg;Shinzo ABE.jpg;14641;14693;36089;732;735;3
/net/per610a/home/mvp/mvp_db/news7-lv/2017/2017_12_08_19_00/2017_12_08_19_00.mpg;Shinzo ABE.jpg;20637;20989;36089;1032;1050;18
/net/per610a/home/mvp/mvp_db/news7-lv/2017/2017_12_08_19_00/2017_12_08_19_00.mpg;Shinzo ABE.jpg;24457;24601;36089;1223;1231;8
/net/per610a/home/mvp/mvp_db/news7-lv/2017/2017_12_08_19_00/2017_12_08_19_00.mpg;Shinzo ABE.jpg;13213;13393;36089;661;670;9
/net/per610a/home/mvp/mvp_db/news7-lv/2017/2017_12_11_19_00/2017_12_11_19_00.mpg;Shinzo ABE.jpg;25421;25793;36081;1271;1290;19
/net/per610a/home/mvp/mvp_db/news7-lv/2017/2017_12_11_19_00/2017_12_11_19_00.mpg;Shinzo ABE.jpg;26533;26937;36081;1327;1347;20
/net/per610a/home/mvp/mvp_db/news7-lv/2017/2017_12_18_19_00/2017_12_18_19_00.mpg;Taro ASO.jpg;23789;23857;36081;1190;1193;3
/net/per610a/home/mvp/mvp_db/news7-lv/2017/2017_12_18_19_00/2017_12_18_19_00.mpg;Taro ASO.jpg;24049;24073;36081;1203;1204;1
/net/per610a/home/mvp/mvp_db/news7-lv/2017/2017_12_18_19_00/2017_12_18_19_00.mpg;Taro ASO.jpg;25405;25837;36081;1270;1292;22
/net/per610a/home/mvp/mvp_db/news7-lv/2017/2017_12_18_19_00/2017_12_18_19_00.mpg;Shinzo ABE.jpg;28773;29157;36081;1439;1458;19
/net/per610a/home/mvp/mvp_db/news7-lv/2017/2017_12_23_19_00/2017_12_23_19_00.mpg;Shinzo ABE.jpg;8969;9421;36081;448;471;23
/net/per610a/home/mvp/mvp_db/news7-lv/2017/2017_12_24_19_00/2017_12_24_19_00.mpg;Shinzo ABE.jpg;28813;28893;36089;1441;1445;4
/net/per610a/home/mvp/mvp_db/news7-lv/2017/2017_12_24_19_00/2017_12_24_19_00.mpg;Shinzo ABE.jpg;28985;29093;36089;1450;1455;5
/net/per610a/home/mvp/mvp_db/news7-lv/2017/2017_12_24_19_00/2017_12_24_19_00.mpg;Shinzo ABE.jpg;29301;29369;36089;1466;1469;3
/net/per610a/home/mvp/mvp_db/news7-lv/2017/2017_12_25_19_00/2017_12_25_19_00.mpg;Kohei Otsuka.jpg;27197;27297;36081;1360;1365;5
/net/per610a/home/mvp/mvp_db/news7-lv/2017/2017_12_26_19_00/2017_12_26_19_00.mpg;Shinzo ABE.jpg;10781;10921;36081;539;546;7
/net/per610a/home/mvp/mvp_db/news7-lv/2017/2017_12_26_19_00/2017_12_26_19_00.mpg;Shinzo ABE.jpg;10989;11081;36081;549;554;5
/net/per610a/home/mvp/mvp_db/news7-lv/2017/2017_12_26_19_00/2017_12_26_19_00.mpg;Shinzo ABE.jpg;11325;11345;36081;566;567;1
/net/per610a/home/mvp/mvp_db/news7-lv/2017/2017_12_26_19_00/2017_12_26_19_00.mpg;Shinzo ABE.jpg;11517;11813;36081;576;590;14
/net/per610a/home/mvp/mvp_db/news7-lv/2017/2017_12_26_19_00/2017_12_26_19_00.mpg;Shinzo ABE.jpg;11941;12169;36081;597;608;11
/net/per610a/home/mvp/mvp_db/news7-lv/2017/2017_12_26_19_00/2017_12_26_19_00.mpg;Shinzo ABE.jpg;12301;12381;36081;615;619;4
/net/per610a/home/mvp/mvp_db/news7-lv/2017/2017_12_26_19_00/2017_12_26_19_00.mpg;Shinzo ABE.jpg;12465;12637;36081;623;632;9
/net/per610a/home/mvp/mvp_db/news7-lv/2017/2017_12_26_19_00/2017_12_26_19_00.mpg;Shinzo ABE.jpg;13201;13481;36081;660;674;14
/net/per610a/home/mvp/mvp_db/news7-lv/2017/2017_12_26_19_00/2017_12_26_19_00.mpg;Shinzo ABE.jpg;14953;15093;36081;748;755;7
/net/per610a/home/mvp/mvp_db/news7-lv/2017/2017_12_26_19_00/2017_12_26_19_00.mpg;Shinzo ABE.jpg;18113;18305;36081;906;915;9
/net/per610a/home/mvp/mvp_db/news7-lv/2017/2017_12_26_19_00/2017_12_26_19_00.mpg;Shinzo ABE.jpg;18457;18773;36081;923;939;16
/net/per610a/home/mvp/mvp_db/news7-lv/2017/2017_12_26_19_00/2017_12_26_19_00.mpg;Shinzo ABE.jpg;18877;19021;36081;944;951;7
/net/per610a/home/mvp/mvp_db/news7-lv/2017/2017_12_26_19_00/2017_12_26_19_00.mpg;Shinzo ABE.jpg;19105;19865;36081;955;993;38
/net/per610a/home/mvp/mvp_db/news7-lv/2017/2017_12_26_19_00/2017_12_26_19_00.mpg;Shinzo ABE.jpg;20249;20573;36081;1012;1029;17
/net/per610a/home/mvp/mvp_db/news7-lv/2017/2017_12_26_19_00/2017_12_26_19_00.mpg;Shinzo ABE.jpg;20709;20849;36081;1035;1042;7
/net/per610a/home/mvp/mvp_db/news7-lv/2017/2017_12_26_19_00/2017_12_26_19_00.mpg;Shinzo ABE.jpg;21777;21889;36081;1089;1095;6
/net/per610a/home/mvp/mvp_db/news7-lv/2017/2017_12_26_19_00/2017_12_26_19_00.mpg;Ichiro OZAWA.jpg;19397;19605;36081;970;980;10
/net/per610a/home/mvp/mvp_db/news7-lv/2017/2017_12_26_19_00/2017_12_26_19_00.mpg;Sadakazu TANIGAKI.jpg;19397;19605;36081;970;980;10
/net/per610a/home/mvp/mvp_db/news7-lv/2017/2017_12_26_19_00/2017_12_26_19_00.mpg;Kohei Otsuka.jpg;23945;24065;36081;1197;1203;6
/net/per610a/home/mvp/mvp_db/news7-lv/2017/2017_12_28_19_00/2017_12_28_19_00.mpg;Yuichiro Tamaki.png;31341;31409;36089;1568;1571;3
/net/per610a/home/mvp/mvp_db/news7-lv/2017/2017_12_28_19_00/2017_12_28_19_00.mpg;Yuichiro Tamaki.png;31697;31737;36089;1586;1588;2
/net/per610a/home/mvp/mvp_db/news7-lv/2017/2017_12_28_19_00/2017_12_28_19_00.mpg;Yuichiro Tamaki.png;31801;31813;36089;1591;1592;1
/net/per610a/home/mvp/mvp_db/news7-lv/2019/2019_01_01_19_00/2019_01_01_19_00.mpg;Yukio EDANO.jpg;14961;15457;24089;748;773;25
/net/per610a/home/mvp/mvp_db/news7-lv/2019/2019_01_01_19_00/2019_01_01_19_00.mpg;Yukio EDANO.jpg;16937;17277;24089;847;864;17
/net/per610a/home/mvp/mvp_db/news7-lv/2019/2019_01_01_19_00/2019_01_01_19_00.mpg;Shinzo ABE.jpg;14965;15457;24089;748;773;25
/net/per610a/home/mvp/mvp_db/news7-lv/2019/2019_01_01_19_00/2019_01_01_19_00.mpg;Shinzo ABE.jpg;15741;16017;24089;787;801;14
/net/per610a/home/mvp/mvp_db/news7-lv/2019/2019_01_01_19_00/2019_01_01_19_00.mpg;Shinzo ABE.jpg;17733;18269;24089;887;913;26
/net/per610a/home/mvp/mvp_db/news7-lv/2019/2019_01_01_19_00/2019_01_01_19_00.mpg;Shinzo ABE.jpg;18665;18677;24089;933;934;1
/net/per610a/home/mvp/mvp_db/news7-lv/2019/2019_01_01_19_00/2019_01_01_19_00.mpg;Natsuo YAMAGUCHI.jpg;17925;18041;24089;896;902;6
/net/per610a/home/mvp/mvp_db/news7-lv/2019/2019_01_01_19_00/2019_01_01_19_00.mpg;Shinzo ABE.jpg;18821;18961;24089;941;948;7
/net/per610a/home/mvp/mvp_db/news7-lv/2019/2019_01_02_19_00/2019_01_02_19_00.mpg;Shinzo ABE.jpg;13825;13853;24089;691;692;1
/net/per610a/home/mvp/mvp_db/news7-lv/2019/2019_01_02_19_00/2019_01_02_19_00.mpg;Shinzo ABE.jpg;14837;15109;24089;742;755;13
/net/per610a/home/mvp/mvp_db/news7-lv/2019/2019_01_02_19_00/2019_01_02_19_00.mpg;Shinzo ABE.jpg;15173;15209;24089;758;760;2
/net/per610a/home/mvp/mvp_db/news7-lv/2019/2019_01_04_19_00/2019_01_04_19_00.mpg;Shinzo ABE.jpg;10601;10901;36081;530;545;15
/net/per610a/home/mvp/mvp_db/news7-lv/2019/2019_01_04_19_00/2019_01_04_19_00.mpg;Shinzo ABE.jpg;11185;11465;36081;559;573;14
/net/per610a/home/mvp/mvp_db/news7-lv/2019/2019_01_04_19_00/2019_01_04_19_00.mpg;Shinzo ABE.jpg;11797;12505;36081;590;625;35
/net/per610a/home/mvp/mvp_db/news7-lv/2019/2019_01_04_19_00/2019_01_04_19_00.mpg;Shinzo ABE.jpg;12705;13017;36081;635;651;16
/net/per610a/home/mvp/mvp_db/news7-lv/2019/2019_01_04_19_00/2019_01_04_19_00.mpg;Shinzo ABE.jpg;13129;13533;36081;656;677;21
/net/per610a/home/mvp/mvp_db/news7-lv/2019/2019_01_04_19_00/2019_01_04_19_00.mpg;Shinzo ABE.jpg;13769;14085;36081;688;704;16
/net/per610a/home/mvp/mvp_db/news7-lv/2019/2019_01_04_19_00/2019_01_04_19_00.mpg;Kazuo SHII.jpg;14765;14873;36081;738;744;6
/net/per610a/home/mvp/mvp_db/news7-lv/2019/2019_01_04_19_00/2019_01_04_19_00.mpg;Yukio EDANO.jpg;14769;14873;36081;738;744;6
/net/per610a/home/mvp/mvp_db/news7-lv/2019/2019_01_05_19_00/2019_01_05_19_00.mpg;Shinzo ABE.jpg;23313;23393;36081;1166;1170;4
/net/per610a/home/mvp/mvp_db/news7-lv/2019/2019_01_05_19_00/2019_01_05_19_00.mpg;Shinzo ABE.jpg;23605;23705;36081;1180;1185;5
/net/per610a/home/mvp/mvp_db/news7-lv/2019/2019_01_05_19_00/2019_01_05_19_00.mpg;Shinzo ABE.jpg;28585;28637;36081;1430;1432;2
/net/per610a/home/mvp/mvp_db/news7-lv/2019/2019_01_05_19_00/2019_01_05_19_00.mpg;Shinzo ABE.jpg;28701;29357;36081;1435;1468;33
/net/per610a/home/mvp/mvp_db/news7-lv/2019/2019_01_06_19_00/2019_01_06_19_00.mpg;Shinzo ABE.jpg;26421;27565;36089;1322;1379;57
/net/per610a/home/mvp/mvp_db/news7-lv/2019/2019_01_11_19_00/2019_01_11_19_00.mpg;YUriko Koike.jpg;3705;4409;36089;185;220;35
/net/per610a/home/mvp/mvp_db/news7-lv/2019/2019_01_12_19_00/2019_01_12_19_00.mpg;YUriko Koike.jpg;4433;4689;36089;221;234;13
/net/per610a/home/mvp/mvp_db/news7-lv/2019/2019_01_14_19_00/2019_01_14_19_00.mpg;Shinzo ABE.jpg;5257;5553;36089;263;277;14
/net/per610a/home/mvp/mvp_db/news7-lv/2019/2019_01_14_19_00/2019_01_14_19_00.mpg;Shinzo ABE.jpg;6957;7217;36089;348;361;13
/net/per610a/home/mvp/mvp_db/news7-lv/2019/2019_01_14_19_00/2019_01_14_19_00.mpg;Shinzo ABE.jpg;7385;8137;36089;369;407;38
/net/per610a/home/mvp/mvp_db/news7-lv/2019/2019_01_14_19_00/2019_01_14_19_00.mpg;Shinzo ABE.jpg;12945;13313;36089;647;666;19
/net/per610a/home/mvp/mvp_db/news7-lv/2019/2019_01_15_19_00/2019_01_15_19_00.mpg;Shinzo ABE.jpg;18413;18665;36129;921;934;13
/net/per610a/home/mvp/mvp_db/news7-lv/2019/2019_01_15_19_00/2019_01_15_19_00.mpg;Shinzo ABE.jpg;19985;20217;36129;1000;1011;11
/net/per610a/home/mvp/mvp_db/news7-lv/2019/2019_01_15_19_00/2019_01_15_19_00.mpg;Shinzo ABE.jpg;22001;22237;36129;1100;1112;12
/net/per610a/home/mvp/mvp_db/news7-lv/2019/2019_01_15_19_00/2019_01_15_19_00.mpg;Shinzo ABE.jpg;22645;22769;36129;1133;1139;6
/net/per610a/home/mvp/mvp_db/news7-lv/2019/2019_01_17_19_00/2019_01_17_19_00.mpg;Shinzo ABE.jpg;6869;7029;36081;343;351;8
/net/per610a/home/mvp/mvp_db/news7-lv/2019/2019_01_19_19_00/2019_01_19_19_00.mpg;Shinzo ABE.jpg;13397;13401;36081;670;670;0
/net/per610a/home/mvp/mvp_db/news7-lv/2019/2019_01_19_19_00/2019_01_19_19_00.mpg;Shinzo ABE.jpg;13809;13817;36081;690;691;1
/net/per610a/home/mvp/mvp_db/news7-lv/2019/2019_01_19_19_00/2019_01_19_19_00.mpg;Shinzo ABE.jpg;14273;14945;36081;714;747;33
/net/per610a/home/mvp/mvp_db/news7-lv/2019/2019_01_19_19_00/2019_01_19_19_00.mpg;Shinzo ABE.jpg;15781;15801;36081;789;790;1
/net/per610a/home/mvp/mvp_db/news7-lv/2019/2019_01_20_19_00/2019_01_20_19_00.mpg;Shinzo ABE.jpg;31285;31361;36089;1565;1569;4
/net/per610a/home/mvp/mvp_db/news7-lv/2019/2019_01_20_19_00/2019_01_20_19_00.mpg;Shinzo ABE.jpg;31473;31821;36089;1575;1592;17
/net/per610a/home/mvp/mvp_db/news7-lv/2019/2019_01_21_19_00/2019_01_21_19_00.mpg;Takeo Hiranuma.jpeg;9053;9437;36089;453;472;19
/net/per610a/home/mvp/mvp_db/news7-lv/2019/2019_01_21_19_00/2019_01_21_19_00.mpg;Shinzo ABE.jpg;9441;9913;36089;472;496;24
/net/per610a/home/mvp/mvp_db/news7-lv/2019/2019_01_21_19_00/2019_01_21_19_00.mpg;Shinzo ABE.jpg;11125;11601;36089;556;580;24
/net/per610a/home/mvp/mvp_db/news7-lv/2019/2019_01_21_19_00/2019_01_21_19_00.mpg;Shinzo ABE.jpg;11905;11949;36089;595;597;2
/net/per610a/home/mvp/mvp_db/news7-lv/2019/2019_01_21_19_00/2019_01_21_19_00.mpg;Shinzo ABE.jpg;13021;13181;36089;651;659;8
/net/per610a/home/mvp/mvp_db/news7-lv/2019/2019_01_24_19_00/2019_01_24_19_00.mpg;Natsuo YAMAGUCHI.jpg;18725;19009;36081;936;950;14
/net/per610a/home/mvp/mvp_db/news7-lv/2019/2019_01_28_19_00/2019_01_28_19_00.mpg;Shinzo ABE.jpg;305;673;36081;15;33;18
/net/per610a/home/mvp/mvp_db/news7-lv/2019/2019_01_28_19_00/2019_01_28_19_00.mpg;Shinzo ABE.jpg;2313;2797;36081;115;139;24
/net/per610a/home/mvp/mvp_db/news7-lv/2019/2019_01_28_19_00/2019_01_28_19_00.mpg;Shinzo ABE.jpg;2889;3341;36081;144;167;23
/net/per610a/home/mvp/mvp_db/news7-lv/2019/2019_01_28_19_00/2019_01_28_19_00.mpg;Shinzo ABE.jpg;3433;3905;36081;171;195;24
/net/per610a/home/mvp/mvp_db/news7-lv/2019/2019_01_28_19_00/2019_01_28_19_00.mpg;Shinzo ABE.jpg;5277;5345;36081;263;267;4
/net/per610a/home/mvp/mvp_db/news7-lv/2019/2019_01_28_19_00/2019_01_28_19_00.mpg;Shinzo ABE.jpg;5649;6065;36081;282;303;21
/net/per610a/home/mvp/mvp_db/news7-lv/2019/2019_01_28_19_00/2019_01_28_19_00.mpg;Shinzo ABE.jpg;6293;6473;36081;314;323;9
/net/per610a/home/mvp/mvp_db/news7-lv/2019/2019_01_28_19_00/2019_01_28_19_00.mpg;Shinzo ABE.jpg;7097;7501;36081;355;375;20
/net/per610a/home/mvp/mvp_db/news7-lv/2019/2019_01_28_19_00/2019_01_28_19_00.mpg;Shinzo ABE.jpg;7705;7709;36081;385;385;0
/net/per610a/home/mvp/mvp_db/news7-lv/2019/2019_01_28_19_00/2019_01_28_19_00.mpg;Shinzo ABE.jpg;7789;8673;36081;389;433;44
/net/per610a/home/mvp/mvp_db/news7-lv/2019/2019_01_28_19_00/2019_01_28_19_00.mpg;Ichiro OZAWA.jpg;4685;5269;36081;234;263;29
/net/per610a/home/mvp/mvp_db/news7-lv/2019/2019_01_28_19_00/2019_01_28_19_00.mpg;Yuichiro Tamaki.png;6753;6873;36081;337;343;6
/net/per610a/home/mvp/mvp_db/news7-lv/2019/2019_01_29_19_00/2019_01_29_19_00.mpg;Shinzo ABE.jpg;7041;7137;36081;352;357;5
/net/per610a/home/mvp/mvp_db/news7-lv/2019/2019_01_30_19_00/2019_01_30_19_00.mpg;Yuichiro Tamaki.png;497;561;36081;24;28;4
/net/per610a/home/mvp/mvp_db/news7-lv/2019/2019_01_30_19_00/2019_01_30_19_00.mpg;Yuichiro Tamaki.png;5241;6669;36081;262;333;71
/net/per610a/home/mvp/mvp_db/news7-lv/2019/2019_01_30_19_00/2019_01_30_19_00.mpg;Yuichiro Tamaki.png;6997;7529;36081;350;376;26
/net/per610a/home/mvp/mvp_db/news7-lv/2019/2019_01_30_19_00/2019_01_30_19_00.mpg;Shinzo ABE.jpg;1505;1513;36081;75;75;0
/net/per610a/home/mvp/mvp_db/news7-lv/2019/2019_01_30_19_00/2019_01_30_19_00.mpg;Shinzo ABE.jpg;8009;8045;36081;400;402;2
/net/per610a/home/mvp/mvp_db/news7-lv/2019/2019_01_30_19_00/2019_01_30_19_00.mpg;Shinzo ABE.jpg;29825;29921;36081;1492;1496;4
/net/per610a/home/mvp/mvp_db/news7-lv/2019/2019_01_30_19_00/2019_01_30_19_00.mpg;Shinzo ABE.jpg;3993;4473;36081;199;223;24
/net/per610a/home/mvp/mvp_db/news7-lv/2019/2019_01_30_19_00/2019_01_30_19_00.mpg;Shinzo ABE.jpg;6893;6985;36081;344;349;5
/net/per610a/home/mvp/mvp_db/news7-lv/2019/2019_01_31_19_00/2019_01_31_19_00.mpg;Kazuo SHII.jpg;26329;27393;36081;1317;1370;53
/net/per610a/home/mvp/mvp_db/news7-lv/2019/2019_01_31_19_00/2019_01_31_19_00.mpg;Yoshihiko Noda.jpg;28689;28985;36081;1435;1450;15
/net/per610a/home/mvp/mvp_db/news7-lv/2019/2019_02_02_19_00/2019_02_02_19_00.mpg;Natsuo YAMAGUCHI.jpg;27733;28053;36081;1387;1403;16
/net/per610a/home/mvp/mvp_db/news7-lv/2019/2019_02_04_19_00/2019_02_04_19_00.mpg;Shinzo ABE.jpg;26165;27037;36081;1308;1352;44
/net/per610a/home/mvp/mvp_db/news7-lv/2019/2019_02_04_19_00/2019_02_04_19_00.mpg;Shinzo ABE.jpg;27801;28333;36081;1390;1417;27
/net/per610a/home/mvp/mvp_db/news7-lv/2019/2019_02_05_19_00/2019_02_05_19_00.mpg;Shinzo ABE.jpg;329;657;36081;16;32;16
/net/per610a/home/mvp/mvp_db/news7-lv/2019/2019_02_07_19_00/2019_02_07_19_00.mpg;Shinzo ABE.jpg;19049;19245;36081;952;962;10
/net/per610a/home/mvp/mvp_db/news7-lv/2019/2019_02_07_19_00/2019_02_07_19_00.mpg;Shinzo ABE.jpg;22893;22957;36081;1145;1148;3
/net/per610a/home/mvp/mvp_db/news7-lv/2019/2019_02_08_19_00/2019_02_08_19_00.mpg;Shinzo ABE.jpg;18269;18533;36089;914;927;13
/net/per610a/home/mvp/mvp_db/news7-lv/2019/2019_02_08_19_00/2019_02_08_19_00.mpg;Shinzo ABE.jpg;23585;23617;36089;1180;1181;1
/net/per610a/home/mvp/mvp_db/news7-lv/2019/2019_02_08_19_00/2019_02_08_19_00.mpg;Shinzo ABE.jpg;26617;26769;36089;1331;1339;8
/net/per610a/home/mvp/mvp_db/news7-lv/2019/2019_02_08_19_00/2019_02_08_19_00.mpg;Shinzo ABE.jpg;27221;27361;36089;1362;1369;7
/net/per610a/home/mvp/mvp_db/news7-lv/2019/2019_02_09_19_00/2019_02_09_19_00.mpg;Shinzo ABE.jpg;19037;20053;36089;952;1003;51
/net/per610a/home/mvp/mvp_db/news7-lv/2019/2019_02_09_19_00/2019_02_09_19_00.mpg;Shinzo ABE.jpg;20257;20361;36089;1013;1018;5
/net/per610a/home/mvp/mvp_db/news7-lv/2019/2019_02_09_19_00/2019_02_09_19_00.mpg;Shinzo ABE.jpg;20725;21517;36089;1037;1076;39
/net/per610a/home/mvp/mvp_db/news7-lv/2019/2019_02_10_19_00/2019_02_10_19_00.mpg;Shinzo ABE.jpg;6681;7229;36089;334;361;27
/net/per610a/home/mvp/mvp_db/news7-lv/2019/2019_02_10_19_00/2019_02_10_19_00.mpg;Shinzo ABE.jpg;8097;8349;36089;405;417;12
/net/per610a/home/mvp/mvp_db/news7-lv/2019/2019_02_10_19_00/2019_02_10_19_00.mpg;Natsuo YAMAGUCHI.jpg;7765;8093;36089;388;404;16
/net/per610a/home/mvp/mvp_db/news7-lv/2019/2019_02_12_19_00/2019_02_12_19_00.mpg;Shinzo ABE.jpg;20673;21025;36081;1034;1051;17
/net/per610a/home/mvp/mvp_db/news7-lv/2019/2019_02_12_19_00/2019_02_12_19_00.mpg;Shinzo ABE.jpg;21765;22085;36081;1088;1104;16
/net/per610a/home/mvp/mvp_db/news7-lv/2019/2019_02_12_19_00/2019_02_12_19_00.mpg;Shinzo ABE.jpg;23089;23497;36081;1155;1175;20
/net/per610a/home/mvp/mvp_db/news7-lv/2019/2019_02_12_19_00/2019_02_12_19_00.mpg;Yuichiro Tamaki.png;24373;24657;36081;1219;1233;14
/net/per610a/home/mvp/mvp_db/news7-lv/2019/2019_02_13_19_00/2019_02_13_19_00.mpg;Shinzo ABE.jpg;7273;7389;36089;363;369;6
/net/per610a/home/mvp/mvp_db/news7-lv/2019/2019_02_13_19_00/2019_02_13_19_00.mpg;Shinzo ABE.jpg;9649;9921;36089;482;496;14
/net/per610a/home/mvp/mvp_db/news7-lv/2019/2019_02_13_19_00/2019_02_13_19_00.mpg;Shinzo ABE.jpg;23617;23765;36089;1181;1189;8
/net/per610a/home/mvp/mvp_db/news7-lv/2019/2019_02_13_19_00/2019_02_13_19_00.mpg;Shinzo ABE.jpg;12485;12665;36089;624;633;9
/net/per610a/home/mvp/mvp_db/news7-lv/2019/2019_02_18_19_00/2019_02_18_19_00.mpg;Shinzo ABE.jpg;5077;5269;36081;253;263;10
/net/per610a/home/mvp/mvp_db/news7-lv/2019/2019_02_18_19_00/2019_02_18_19_00.mpg;Shinzo ABE.jpg;17085;17265;36081;854;863;9
/net/per610a/home/mvp/mvp_db/news7-lv/2019/2019_02_18_19_00/2019_02_18_19_00.mpg;Shinzo ABE.jpg;16025;16145;36081;801;807;6
/net/per610a/home/mvp/mvp_db/news7-lv/2019/2019_02_18_19_00/2019_02_18_19_00.mpg;Kohei Otsuka.jpg;31013;31501;36081;1551;1575;24
/net/per610a/home/mvp/mvp_db/news7-lv/2019/2019_02_18_19_00/2019_02_18_19_00.mpg;Kohei Otsuka.jpg;32321;32597;36081;1616;1630;14
/net/per610a/home/mvp/mvp_db/news7-lv/2019/2019_02_19_19_00/2019_02_19_19_00.mpg;Shinzo ABE.jpg;24009;24569;36081;1201;1229;28
/net/per610a/home/mvp/mvp_db/news7-lv/2019/2019_02_20_19_00/2019_02_20_19_00.mpg;Shinzo ABE.jpg;18765;18829;36089;939;942;3
/net/per610a/home/mvp/mvp_db/news7-lv/2019/2019_02_20_19_00/2019_02_20_19_00.mpg;Shinzo ABE.jpg;19253;19413;36089;963;971;8
/net/per610a/home/mvp/mvp_db/news7-lv/2019/2019_02_22_19_00/2019_02_22_19_00.mpg;Shinzo ABE.jpg;28313;28537;36081;1416;1427;11
/net/per610a/home/mvp/mvp_db/news7-lv/2019/2019_02_22_19_00/2019_02_22_19_00.mpg;Shinzo ABE.jpg;28733;29237;36081;1437;1462;25
/net/per610a/home/mvp/mvp_db/news7-lv/2019/2019_02_24_19_00/2019_02_24_19_00.mpg;Shinzo ABE.jpg;857;877;36081;42;43;1
/net/per610a/home/mvp/mvp_db/news7-lv/2019/2019_02_24_19_00/2019_02_24_19_00.mpg;Shinzo ABE.jpg;961;1049;36081;48;52;4
/net/per610a/home/mvp/mvp_db/news7-lv/2019/2019_02_25_19_00/2019_02_25_19_00.mpg;Shinzo ABE.jpg;3613;4001;36081;180;200;20
/net/per610a/home/mvp/mvp_db/news7-lv/2019/2019_02_25_19_00/2019_02_25_19_00.mpg;Shinzo ABE.jpg;7425;7545;36081;371;377;6
/net/per610a/home/mvp/mvp_db/news7-lv/2019/2019_02_25_19_00/2019_02_25_19_00.mpg;Shinzo ABE.jpg;8821;9049;36081;441;452;11
/net/per610a/home/mvp/mvp_db/news7-lv/2019/2019_02_25_19_00/2019_02_25_19_00.mpg;Shinzo ABE.jpg;21229;21277;36081;1062;1064;2
/net/per610a/home/mvp/mvp_db/news7-lv/2019/2019_02_28_19_00/2019_02_28_19_00.mpg;Shinzo ABE.jpg;22941;23461;38481;1147;1173;26
/net/per610a/home/mvp/mvp_db/news7-lv/2019/2019_02_28_19_00/2019_02_28_19_00.mpg;Yukio EDANO.jpg;26401;26705;38481;1320;1335;15
/net/per610a/home/mvp/mvp_db/news7-lv/2019/2019_03_01_19_00/2019_03_01_19_00.mpg;Shinzo ABE.jpg;11517;11589;36081;576;579;3
/net/per610a/home/mvp/mvp_db/news7-lv/2019/2019_03_01_19_00/2019_03_01_19_00.mpg;Shinzo ABE.jpg;27253;27837;36081;1363;1392;29
/net/per610a/home/mvp/mvp_db/news7-lv/2019/2019_03_01_19_00/2019_03_01_19_00.mpg;Shinzo ABE.jpg;27989;28001;36081;1400;1400;0
/net/per610a/home/mvp/mvp_db/news7-lv/2019/2019_03_05_19_00/2019_03_05_19_00.mpg;YUriko Koike.jpg;15489;16097;36081;774;805;31
/net/per610a/home/mvp/mvp_db/news7-lv/2019/2019_03_05_19_00/2019_03_05_19_00.mpg;YUriko Koike.jpg;16201;16429;36081;810;821;11
/net/per610a/home/mvp/mvp_db/news7-lv/2019/2019_03_05_19_00/2019_03_05_19_00.mpg;YUriko Koike.jpg;16997;16997;36081;850;850;0
/net/per610a/home/mvp/mvp_db/news7-lv/2019/2019_03_05_19_00/2019_03_05_19_00.mpg;YUriko Koike.jpg;17225;17285;36081;861;864;3
/net/per610a/home/mvp/mvp_db/news7-lv/2019/2019_03_05_19_00/2019_03_05_19_00.mpg;YUriko Koike.jpg;19969;20401;36081;998;1020;22
/net/per610a/home/mvp/mvp_db/news7-lv/2019/2019_03_05_19_00/2019_03_05_19_00.mpg;YUriko Koike.jpg;20733;21369;36081;1037;1069;32
/net/per610a/home/mvp/mvp_db/news7-lv/2019/2019_03_06_19_00/2019_03_06_19_00.mpg;Shinzo ABE.jpg;25233;25581;36081;1262;1279;17
/net/per610a/home/mvp/mvp_db/news7-lv/2019/2019_03_08_19_00/2019_03_08_19_00.mpg;YUriko Koike.jpg;17377;17641;36081;869;882;13
/net/per610a/home/mvp/mvp_db/news7-lv/2019/2019_03_08_19_00/2019_03_08_19_00.mpg;Shinzo ABE.jpg;28881;28905;36081;1444;1446;2
/net/per610a/home/mvp/mvp_db/news7-lv/2019/2019_03_08_19_00/2019_03_08_19_00.mpg;Shinzo ABE.jpg;29053;29293;36081;1453;1465;12
/net/per610a/home/mvp/mvp_db/news7-lv/2019/2019_03_09_19_00/2019_03_09_19_00.mpg;Shinzo ABE.jpg;13085;13653;36081;654;683;29
/net/per610a/home/mvp/mvp_db/news7-lv/2019/2019_03_09_19_00/2019_03_09_19_00.mpg;Shinzo ABE.jpg;20325;20485;36081;1016;1024;8
/net/per610a/home/mvp/mvp_db/news7-lv/2019/2019_03_11_19_00/2019_03_11_19_00.mpg;Shinzo ABE.jpg;60017;60365;72041;3003;3020;17
/net/per610a/home/mvp/mvp_db/news7-lv/2019/2019_03_11_19_00/2019_03_11_19_00.mpg;Shinzo ABE.jpg;60917;60941;72041;3048;3049;1
/net/per610a/home/mvp/mvp_db/news7-lv/2019/2019_03_11_19_00/2019_03_11_19_00.mpg;Shinzo ABE.jpg;61085;61201;72041;3056;3062;6
/net/per610a/home/mvp/mvp_db/news7-lv/2019/2019_03_11_19_00/2019_03_11_19_00.mpg;Shinzo ABE.jpg;62237;62605;72041;3114;3132;18
/net/per610a/home/mvp/mvp_db/news7-lv/2019/2019_03_15_19_00/2019_03_15_19_00.mpg;YUriko Koike.jpg;26909;27169;36081;1346;1359;13
/net/per610a/home/mvp/mvp_db/news7-lv/2019/2019_03_17_19_00/2019_03_17_19_00.mpg;Shinzo ABE.jpg;10425;10713;36081;521;535;14
/net/per610a/home/mvp/mvp_db/news7-lv/2019/2019_03_19_19_00/2019_03_19_19_00.mpg;Shinzo ABE.jpg;23749;23889;36089;1188;1195;7
/net/per610a/home/mvp/mvp_db/news7-lv/2019/2019_03_20_19_00/2019_03_20_19_00.mpg;Shinzo ABE.jpg;19997;20017;36081;1000;1001;1
/net/per610a/home/mvp/mvp_db/news7-lv/2019/2019_03_20_19_00/2019_03_20_19_00.mpg;Shinzo ABE.jpg;21193;21261;36081;1060;1063;3
/net/per610a/home/mvp/mvp_db/news7-lv/2019/2019_03_20_19_00/2019_03_20_19_00.mpg;Shinzo ABE.jpg;23161;23705;36081;1158;1185;27
/net/per610a/home/mvp/mvp_db/news7-lv/2019/2019_03_21_19_00/2019_03_21_19_00.mpg;Taro Yamamoto.jpg;14101;14817;36081;705;741;36
/net/per610a/home/mvp/mvp_db/news7-lv/2019/2019_03_21_19_00/2019_03_21_19_00.mpg;Seiji Mataichi.jpg;14821;15037;36081;741;752;11
/net/per610a/home/mvp/mvp_db/news7-lv/2019/2019_03_22_19_00/2019_03_22_19_00.mpg;Shinzo ABE.jpg;13269;13357;36089;664;668;4
/net/per610a/home/mvp/mvp_db/news7-lv/2019/2019_03_22_19_00/2019_03_22_19_00.mpg;Shinzo ABE.jpg;15985;16565;36089;799;828;29
/net/per610a/home/mvp/mvp_db/news7-lv/2019/2019_03_27_19_00/2019_03_27_19_00.mpg;Shinzo ABE.jpg;3325;3761;36081;166;188;22
/net/per610a/home/mvp/mvp_db/news7-lv/2019/2019_03_29_19_00/2019_03_29_19_00.mpg;Ichiro OZAWA.jpg;17493;17741;36081;875;887;12
/net/per610a/home/mvp/mvp_db/news7-lv/2019/2019_03_31_19_00/2019_03_31_19_00.mpg;Shinzo ABE.jpg;7941;8477;36089;397;424;27
/net/per610a/home/mvp/mvp_db/news7-lv/2019/2019_03_31_19_00/2019_03_31_19_00.mpg;Yasuo FUKUDA.jpg;15469;15617;36089;774;781;7
/net/per610a/home/mvp/mvp_db/news7-lv/2019/2019_03_31_19_00/2019_03_31_19_00.mpg;Yasuo FUKUDA.jpg;17861;17969;36089;893;899;6
/net/per610a/home/mvp/mvp_db/news7-lv/2019/2019_04_01_19_00/2019_04_01_19_00.mpg;Shinzo ABE.jpg;8545;8969;48069;427;448;21
/net/per610a/home/mvp/mvp_db/news7-lv/2019/2019_04_01_19_00/2019_04_01_19_00.mpg;Shinzo ABE.jpg;26621;26941;48069;1331;1347;16
/net/per610a/home/mvp/mvp_db/news7-lv/2019/2019_04_03_19_00/2019_04_03_19_00.mpg;Shinzo ABE.jpg;24869;24953;36081;1244;1248;4
/net/per610a/home/mvp/mvp_db/news7-lv/2019/2019_04_04_19_00/2019_04_04_19_00.mpg;Renho.jpg;22909;23497;36081;1146;1175;29
/net/per610a/home/mvp/mvp_db/news7-lv/2019/2019_04_06_19_00/2019_04_06_19_00.mpg;Yuichiro Tamaki.png;11929;13277;36081;596;664;68
/net/per610a/home/mvp/mvp_db/news7-lv/2019/2019_04_06_19_00/2019_04_06_19_00.mpg;Ichiro Matsui.jpeg;13285;14081;36081;664;704;40
/net/per610a/home/mvp/mvp_db/news7-lv/2019/2019_04_10_19_00/2019_04_10_19_00.mpg;Shinzo ABE.jpg;14425;14869;36081;721;743;22
/net/per610a/home/mvp/mvp_db/news7-lv/2019/2019_04_14_19_00/2019_04_14_19_00.mpg;Shinzo ABE.jpg;16789;16837;36089;840;842;2
/net/per610a/home/mvp/mvp_db/news7-lv/2019/2019_04_14_19_00/2019_04_14_19_00.mpg;Shinzo ABE.jpg;26577;27345;36089;1329;1368;39
/net/per610a/home/mvp/mvp_db/news7-lv/2019/2019_04_16_19_00/2019_04_16_19_00.mpg;Ichiro OZAWA.jpg;22081;22237;36089;1104;1112;8
/net/per610a/home/mvp/mvp_db/news7-lv/2019/2019_04_22_19_00/2019_04_22_19_00.mpg;Shinzo ABE.jpg;3805;4105;36081;190;205;15
/net/per610a/home/mvp/mvp_db/news7-lv/2019/2019_04_22_19_00/2019_04_22_19_00.mpg;Shinzo ABE.jpg;11925;12093;36081;596;604;8
/net/per610a/home/mvp/mvp_db/news7-lv/2019/2019_04_22_19_00/2019_04_22_19_00.mpg;Natsuo YAMAGUCHI.jpg;16825;18465;36081;841;923;82
/net/per610a/home/mvp/mvp_db/news7-lv/2019/2019_04_23_19_00/2019_04_23_19_00.mpg;Shinzo ABE.jpg;19413;20089;36089;971;1005;34
/net/per610a/home/mvp/mvp_db/news7-lv/2019/2019_04_23_19_00/2019_04_23_19_00.mpg;Shinzo ABE.jpg;20197;20257;36089;1010;1013;3
/net/per610a/home/mvp/mvp_db/news7-lv/2019/2019_04_23_19_00/2019_04_23_19_00.mpg;Shinzo ABE.jpg;20581;21205;36089;1029;1061;32
/net/per610a/home/mvp/mvp_db/news7-lv/2019/2019_04_23_19_00/2019_04_23_19_00.mpg;Shinzo ABE.jpg;21985;22125;36089;1100;1107;7
/net/per610a/home/mvp/mvp_db/news7-lv/2019/2019_04_23_19_00/2019_04_23_19_00.mpg;Yuichiro Tamaki.png;22541;22609;36089;1128;1131;3
/net/per610a/home/mvp/mvp_db/news7-lv/2019/2019_04_23_19_00/2019_04_23_19_00.mpg;Yuichiro Tamaki.png;22721;22941;36089;1137;1148;11
/net/per610a/home/mvp/mvp_db/news7-lv/2019/2019_04_26_19_00/2019_04_26_19_00.mpg;Yuichiro Tamaki.png;17397;17621;36089;870;881;11
/net/per610a/home/mvp/mvp_db/news7-lv/2019/2019_04_26_19_00/2019_04_26_19_00.mpg;Yuichiro Tamaki.png;17685;17725;36089;885;887;2
/net/per610a/home/mvp/mvp_db/news7-lv/2019/2019_04_26_19_00/2019_04_26_19_00.mpg;Yuichiro Tamaki.png;17937;18453;36089;897;923;26
/net/per610a/home/mvp/mvp_db/news7-lv/2019/2019_04_26_19_00/2019_04_26_19_00.mpg;Kazuo SHII.jpg;19033;19133;36089;952;957;5
/net/per610a/home/mvp/mvp_db/news7-lv/2019/2019_04_27_19_00/2019_04_27_19_00.mpg;Shinzo ABE.jpg;11637;11653;36089;582;583;1
/net/per610a/home/mvp/mvp_db/news7-lv/2019/2019_04_27_19_00/2019_04_27_19_00.mpg;Shinzo ABE.jpg;12209;12333;36089;610;617;7
/net/per610a/home/mvp/mvp_db/news7-lv/2019/2019_04_27_19_00/2019_04_27_19_00.mpg;Shinzo ABE.jpg;12525;12813;36089;626;641;15
/net/per610a/home/mvp/mvp_db/news7-lv/2019/2019_04_27_19_00/2019_04_27_19_00.mpg;Shinzo ABE.jpg;13073;13445;36089;654;672;18
/net/per610a/home/mvp/mvp_db/news7-lv/2019/2019_05_03_19_00/2019_05_03_19_00.mpg;Shinzo ABE.jpg;13957;14445;36081;698;722;24
/net/per610a/home/mvp/mvp_db/news7-lv/2019/2019_05_03_19_00/2019_05_03_19_00.mpg;Yukio EDANO.jpg;16833;18117;36081;842;906;64
/net/per610a/home/mvp/mvp_db/news7-lv/2019/2019_05_06_19_00/2019_05_06_19_00.mpg;Shinzo ABE.jpg;14237;14861;36089;712;743;31
/net/per610a/home/mvp/mvp_db/news7-lv/2019/2019_05_07_19_00/2019_05_07_19_00.mpg;Shinzo ABE.jpg;25933;26117;36089;1297;1306;9
/net/per610a/home/mvp/mvp_db/news7-lv/2019/2019_05_09_19_00/2019_05_09_19_00.mpg;Shinzo ABE.jpg;861;1089;36081;43;54;11
/net/per610a/home/mvp/mvp_db/news7-lv/2019/2019_05_09_19_00/2019_05_09_19_00.mpg;Shinzo ABE.jpg;3541;3981;36081;177;199;22
/net/per610a/home/mvp/mvp_db/news7-lv/2019/2019_05_09_19_00/2019_05_09_19_00.mpg;Shinzo ABE.jpg;5133;5353;36081;256;267;11
/net/per610a/home/mvp/mvp_db/news7-lv/2019/2019_05_13_19_00/2019_05_13_19_00.mpg;Shinzo ABE.jpg;22885;23033;36081;1144;1152;8
/net/per610a/home/mvp/mvp_db/news7-lv/2019/2019_05_14_19_00/2019_05_14_19_00.mpg;Shinzo ABE.jpg;6397;7445;36081;320;372;52
/net/per610a/home/mvp/mvp_db/news7-lv/2019/2019_05_14_19_00/2019_05_14_19_00.mpg;Natsuo YAMAGUCHI.jpg;9301;9757;36081;465;488;23
/net/per610a/home/mvp/mvp_db/news7-lv/2019/2019_05_15_19_00/2019_05_15_19_00.mpg;Shinzo ABE.jpg;7513;7713;36081;375;385;10
/net/per610a/home/mvp/mvp_db/news7-lv/2019/2019_05_15_19_00/2019_05_15_19_00.mpg;Shinzo ABE.jpg;10673;11181;36081;533;559;26
/net/per610a/home/mvp/mvp_db/news7-lv/2019/2019_05_17_19_00/2019_05_17_19_00.mpg;Ichiro Matsui.jpeg;11137;11421;36081;557;571;14
/net/per610a/home/mvp/mvp_db/news7-lv/2019/2019_05_17_19_00/2019_05_17_19_00.mpg;Shinzo ABE.jpg;17365;17529;36081;868;876;8
/net/per610a/home/mvp/mvp_db/news7-lv/2019/2019_05_17_19_00/2019_05_17_19_00.mpg;Shinzo ABE.jpg;19901;20021;36081;995;1001;6
/net/per610a/home/mvp/mvp_db/news7-lv/2019/2019_05_17_19_00/2019_05_17_19_00.mpg;Shinzo ABE.jpg;25713;25781;36081;1286;1289;3
/net/per610a/home/mvp/mvp_db/news7-lv/2019/2019_05_17_19_00/2019_05_17_19_00.mpg;Yukio EDANO.jpg;18913;19877;36081;946;994;48
/net/per610a/home/mvp/mvp_db/news7-lv/2019/2019_05_19_19_00/2019_05_19_19_00.mpg;Shinzo ABE.jpg;20177;20373;36089;1009;1019;10
/net/per610a/home/mvp/mvp_db/news7-lv/2019/2019_05_19_19_00/2019_05_19_19_00.mpg;Shinzo ABE.jpg;32413;32497;36089;1622;1626;4
/net/per610a/home/mvp/mvp_db/news7-lv/2019/2019_05_20_19_00/2019_05_20_19_00.mpg;Shinzo ABE.jpg;17485;17661;36081;874;883;9
/net/per610a/home/mvp/mvp_db/news7-lv/2019/2019_05_21_19_00/2019_05_21_19_00.mpg;Shinzo ABE.jpg;23525;23561;36089;1177;1179;2
/net/per610a/home/mvp/mvp_db/news7-lv/2019/2019_05_21_19_00/2019_05_21_19_00.mpg;Shinzo ABE.jpg;25973;26221;36089;1299;1312;13
/net/per610a/home/mvp/mvp_db/news7-lv/2019/2019_05_25_19_00/2019_05_25_19_00.mpg;Shinzo ABE.jpg;10721;10805;36089;536;540;4
/net/per610a/home/mvp/mvp_db/news7-lv/2019/2019_05_25_19_00/2019_05_25_19_00.mpg;Shinzo ABE.jpg;12253;12293;36089;613;615;2
/net/per610a/home/mvp/mvp_db/news7-lv/2019/2019_05_25_19_00/2019_05_25_19_00.mpg;Shinzo ABE.jpg;14277;14377;36089;714;719;5
/net/per610a/home/mvp/mvp_db/news7-lv/2019/2019_05_26_19_00/2019_05_26_19_00.mpg;Shinzo ABE.jpg;15113;15213;36089;756;761;5
/net/per610a/home/mvp/mvp_db/news7-lv/2019/2019_05_26_19_00/2019_05_26_19_00.mpg;Shinzo ABE.jpg;15481;15513;36089;774;776;2
/net/per610a/home/mvp/mvp_db/news7-lv/2019/2019_05_26_19_00/2019_05_26_19_00.mpg;Shinzo ABE.jpg;22341;22613;36089;1118;1131;13
/net/per610a/home/mvp/mvp_db/news7-lv/2019/2019_05_26_19_00/2019_05_26_19_00.mpg;Shinzo ABE.jpg;24781;24825;36089;1240;1242;2
/net/per610a/home/mvp/mvp_db/news7-lv/2019/2019_05_26_19_00/2019_05_26_19_00.mpg;Shinzo ABE.jpg;24941;25365;36089;1248;1269;21
/net/per610a/home/mvp/mvp_db/news7-lv/2019/2019_05_27_19_00/2019_05_27_19_00.mpg;Shinzo ABE.jpg;12833;12965;72049;642;648;6
/net/per610a/home/mvp/mvp_db/news7-lv/2019/2019_05_27_19_00/2019_05_27_19_00.mpg;Shinzo ABE.jpg;13369;13445;72049;669;672;3
/net/per610a/home/mvp/mvp_db/news7-lv/2019/2019_05_27_19_00/2019_05_27_19_00.mpg;Shinzo ABE.jpg;16305;16317;72049;816;816;0
/net/per610a/home/mvp/mvp_db/news7-lv/2019/2019_05_27_19_00/2019_05_27_19_00.mpg;Shinzo ABE.jpg;28965;29153;72049;1449;1459;10
/net/per610a/home/mvp/mvp_db/news7-lv/2019/2019_05_27_19_00/2019_05_27_19_00.mpg;Shinzo ABE.jpg;30213;30617;72049;1512;1532;20
/net/per610a/home/mvp/mvp_db/news7-lv/2019/2019_05_27_19_00/2019_05_27_19_00.mpg;Shinzo ABE.jpg;31253;31265;72049;1564;1564;0
/net/per610a/home/mvp/mvp_db/news7-lv/2019/2019_05_27_19_00/2019_05_27_19_00.mpg;Shinzo ABE.jpg;31349;31793;72049;1568;1591;23
/net/per610a/home/mvp/mvp_db/news7-lv/2019/2019_05_27_19_00/2019_05_27_19_00.mpg;Shinzo ABE.jpg;32493;33021;72049;1626;1652;26
/net/per610a/home/mvp/mvp_db/news7-lv/2019/2019_05_28_19_00/2019_05_28_19_00.mpg;Shinzo ABE.jpg;12857;12865;39681;643;643;0
/net/per610a/home/mvp/mvp_db/news7-lv/2019/2019_05_28_19_00/2019_05_28_19_00.mpg;Shinzo ABE.jpg;20769;20769;39681;1039;1039;0
/net/per610a/home/mvp/mvp_db/news7-lv/2019/2019_05_28_19_00/2019_05_28_19_00.mpg;Shinzo ABE.jpg;21537;22145;39681;1077;1108;31
/net/per610a/home/mvp/mvp_db/news7-lv/2019/2019_05_28_19_00/2019_05_28_19_00.mpg;Shinzo ABE.jpg;23137;23181;39681;1157;1160;3
/net/per610a/home/mvp/mvp_db/news7-lv/2019/2019_05_28_19_00/2019_05_28_19_00.mpg;Shinzo ABE.jpg;23301;23353;39681;1166;1168;2
/net/per610a/home/mvp/mvp_db/news7-lv/2019/2019_05_29_19_00/2019_05_29_19_00.mpg;Kazuo SHII.jpg;27413;27557;36081;1371;1378;7
/net/per610a/home/mvp/mvp_db/news7-lv/2019/2019_05_31_19_00/2019_05_31_19_00.mpg;Shinzo ABE.jpg;26781;26897;36089;1340;1346;6
/net/per610a/home/mvp/mvp_db/news7-lv/2019/2019_05_31_19_00/2019_05_31_19_00.mpg;Shinzo ABE.jpg;27669;27873;36089;1384;1394;10
/net/per610a/home/mvp/mvp_db/news7-lv/2019/2019_06_03_19_00/2019_06_03_19_00.mpg;Shinzo ABE.jpg;16293;16617;36081;815;831;16
/net/per610a/home/mvp/mvp_db/news7-lv/2019/2019_06_03_19_00/2019_06_03_19_00.mpg;Shinzo ABE.jpg;16889;17337;36081;844;867;23
/net/per610a/home/mvp/mvp_db/news7-lv/2019/2019_06_03_19_00/2019_06_03_19_00.mpg;Shinzo ABE.jpg;19613;20065;36081;981;1003;22
/net/per610a/home/mvp/mvp_db/news7-lv/2019/2019_06_06_19_00/2019_06_06_19_00.mpg;Shinzo ABE.jpg;18081;18169;36081;904;908;4
/net/per610a/home/mvp/mvp_db/news7-lv/2019/2019_06_06_19_00/2019_06_06_19_00.mpg;Shinzo ABE.jpg;18385;18533;36081;919;927;8
/net/per610a/home/mvp/mvp_db/news7-lv/2019/2019_06_06_19_00/2019_06_06_19_00.mpg;Shinzo ABE.jpg;19289;19713;36081;964;986;22
/net/per610a/home/mvp/mvp_db/news7-lv/2019/2019_06_06_19_00/2019_06_06_19_00.mpg;Shinzo ABE.jpg;18661;18693;36081;933;935;2
/net/per610a/home/mvp/mvp_db/news7-lv/2019/2019_06_06_19_00/2019_06_06_19_00.mpg;Shinzo ABE.jpg;19285;19285;36081;964;964;0
/net/per610a/home/mvp/mvp_db/news7-lv/2019/2019_06_06_19_00/2019_06_06_19_00.mpg;Shinzo ABE.jpg;20293;20329;36081;1015;1016;1
/net/per610a/home/mvp/mvp_db/news7-lv/2019/2019_06_06_19_00/2019_06_06_19_00.mpg;Shinzo ABE.jpg;20417;20841;36081;1021;1042;21
/net/per610a/home/mvp/mvp_db/news7-lv/2019/2019_06_07_19_00/2019_06_07_19_00.mpg;Shinzo ABE.jpg;17417;18109;36089;871;906;35
/net/per610a/home/mvp/mvp_db/news7-lv/2019/2019_06_07_19_00/2019_06_07_19_00.mpg;Shinzo ABE.jpg;18689;18749;36089;935;938;3
/net/per610a/home/mvp/mvp_db/news7-lv/2019/2019_06_07_19_00/2019_06_07_19_00.mpg;Shinzo ABE.jpg;20617;20741;36089;1031;1037;6
/net/per610a/home/mvp/mvp_db/news7-lv/2019/2019_06_07_19_00/2019_06_07_19_00.mpg;Shinzo ABE.jpg;21573;21689;36089;1079;1085;6
/net/per610a/home/mvp/mvp_db/news7-lv/2019/2019_06_07_19_00/2019_06_07_19_00.mpg;Shinzo ABE.jpg;21841;21977;36089;1092;1099;7
/net/per610a/home/mvp/mvp_db/news7-lv/2019/2019_06_07_19_00/2019_06_07_19_00.mpg;Shinzo ABE.jpg;23613;23789;36089;1181;1190;9
/net/per610a/home/mvp/mvp_db/news7-lv/2019/2019_06_07_19_00/2019_06_07_19_00.mpg;Shinzo ABE.jpg;24069;24153;36089;1204;1208;4
/net/per610a/home/mvp/mvp_db/news7-lv/2019/2019_06_08_19_00/2019_06_08_19_00.mpg;Taro ASO.jpg;12629;12829;36081;631;641;10
/net/per610a/home/mvp/mvp_db/news7-lv/2019/2019_06_08_19_00/2019_06_08_19_00.mpg;Taro ASO.jpg;13381;13749;36081;669;687;18
/net/per610a/home/mvp/mvp_db/news7-lv/2019/2019_06_08_19_00/2019_06_08_19_00.mpg;Taro ASO.jpg;15973;16389;36081;799;819;20
/net/per610a/home/mvp/mvp_db/news7-lv/2019/2019_06_09_19_00/2019_06_09_19_00.mpg;Shinzo ABE.jpg;32217;32485;36089;1612;1625;13
/net/per610a/home/mvp/mvp_db/news7-lv/2019/2019_06_10_19_00/2019_06_10_19_00.mpg;Shinzo ABE.jpg;10309;11189;36089;515;559;44
/net/per610a/home/mvp/mvp_db/news7-lv/2019/2019_06_10_19_00/2019_06_10_19_00.mpg;Shinzo ABE.jpg;24829;25037;36089;1242;1252;10
/net/per610a/home/mvp/mvp_db/news7-lv/2019/2019_06_10_19_00/2019_06_10_19_00.mpg;Shinzo ABE.jpg;25133;25361;36089;1257;1269;12
/net/per610a/home/mvp/mvp_db/news7-lv/2019/2019_06_10_19_00/2019_06_10_19_00.mpg;Shinzo ABE.jpg;25693;26145;36089;1285;1308;23
/net/per610a/home/mvp/mvp_db/news7-lv/2019/2019_06_11_19_00/2019_06_11_19_00.mpg;Yukio EDANO.jpg;9897;10341;36089;495;517;22
/net/per610a/home/mvp/mvp_db/news7-lv/2019/2019_06_12_19_00/2019_06_12_19_00.mpg;Shinzo ABE.jpg;5269;5289;36081;263;264;1
/net/per610a/home/mvp/mvp_db/news7-lv/2019/2019_06_12_19_00/2019_06_12_19_00.mpg;Shinzo ABE.jpg;6093;6281;36081;304;314;10
/net/per610a/home/mvp/mvp_db/news7-lv/2019/2019_06_13_19_00/2019_06_13_19_00.mpg;Yuichiro Tamaki.png;24741;24745;36081;1237;1237;0
/net/per610a/home/mvp/mvp_db/news7-lv/2019/2019_06_13_19_00/2019_06_13_19_00.mpg;Yuichiro Tamaki.png;24833;24973;36081;1242;1249;7
/net/per610a/home/mvp/mvp_db/news7-lv/2019/2019_06_14_19_00/2019_06_14_19_00.mpg;Taro ASO.jpg;23585;23617;36089;1180;1181;1
/net/per610a/home/mvp/mvp_db/news7-lv/2019/2019_06_14_19_00/2019_06_14_19_00.mpg;Taro ASO.jpg;24917;24917;36089;1246;1246;0
/net/per610a/home/mvp/mvp_db/news7-lv/2019/2019_06_14_19_00/2019_06_14_19_00.mpg;Taro ASO.jpg;25001;25001;36089;1251;1251;0
/net/per610a/home/mvp/mvp_db/news7-lv/2019/2019_06_14_19_00/2019_06_14_19_00.mpg;Taro ASO.jpg;25081;25237;36089;1255;1262;7
/net/per610a/home/mvp/mvp_db/news7-lv/2019/2019_06_14_19_00/2019_06_14_19_00.mpg;Taro ASO.jpg;25385;25537;36089;1270;1277;7
/net/per610a/home/mvp/mvp_db/news7-lv/2019/2019_06_14_19_00/2019_06_14_19_00.mpg;Taro ASO.jpg;25645;25785;36089;1283;1290;7
/net/per610a/home/mvp/mvp_db/news7-lv/2019/2019_06_14_19_00/2019_06_14_19_00.mpg;Taro ASO.jpg;25857;26849;36089;1293;1343;50
/net/per610a/home/mvp/mvp_db/news7-lv/2019/2019_06_15_19_00/2019_06_15_19_00.mpg;Shinzo ABE.jpg;18813;18961;36081;941;948;7
/net/per610a/home/mvp/mvp_db/news7-lv/2019/2019_06_15_19_00/2019_06_15_19_00.mpg;Shinzo ABE.jpg;19069;19189;36081;953;959;6
/net/per610a/home/mvp/mvp_db/news7-lv/2019/2019_06_16_19_00/2019_06_16_19_00.mpg;Ichiro OZAWA.jpg;15849;16393;36081;792;820;28
/net/per610a/home/mvp/mvp_db/news7-lv/2019/2019_06_17_19_00/2019_06_17_19_00.mpg;Shinzo ABE.jpg;21301;21685;36081;1065;1084;19
/net/per610a/home/mvp/mvp_db/news7-lv/2019/2019_06_19_19_00/2019_06_19_19_00.mpg;Akihiro OHTA.jpg;10065;10289;36089;503;514;11
/net/per610a/home/mvp/mvp_db/news7-lv/2019/2019_06_19_19_00/2019_06_19_19_00.mpg;Akihiro OHTA.jpg;11581;11789;36089;579;589;10
/net/per610a/home/mvp/mvp_db/news7-lv/2019/2019_06_19_19_00/2019_06_19_19_00.mpg;Yukio EDANO.jpg;17437;17497;36089;872;875;3
/net/per610a/home/mvp/mvp_db/news7-lv/2019/2019_06_19_19_00/2019_06_19_19_00.mpg;Yukio EDANO.jpg;17949;19085;36089;898;955;57
/net/per610a/home/mvp/mvp_db/news7-lv/2019/2019_06_19_19_00/2019_06_19_19_00.mpg;Yukio EDANO.jpg;23141;24193;36089;1158;1210;52
/net/per610a/home/mvp/mvp_db/news7-lv/2019/2019_06_19_19_00/2019_06_19_19_00.mpg;Shinzo ABE.jpg;20625;21013;36089;1032;1051;19
/net/per610a/home/mvp/mvp_db/news7-lv/2019/2019_06_19_19_00/2019_06_19_19_00.mpg;Shinzo ABE.jpg;21429;21473;36089;1072;1074;2
/net/per610a/home/mvp/mvp_db/news7-lv/2019/2019_06_20_19_00/2019_06_20_19_00.mpg;Taro ASO.jpg;28989;29213;36089;1450;1461;11
/net/per610a/home/mvp/mvp_db/news7-lv/2019/2019_06_21_19_00/2019_06_21_19_00.mpg;Shinzo ABE.jpg;20581;20789;36081;1029;1039;10
/net/per610a/home/mvp/mvp_db/news7-lv/2019/2019_06_21_19_00/2019_06_21_19_00.mpg;Shinzo ABE.jpg;25489;25993;36081;1275;1300;25
/net/per610a/home/mvp/mvp_db/news7-lv/2019/2019_06_21_19_00/2019_06_21_19_00.mpg;Shinzo ABE.jpg;26085;26113;36081;1304;1306;2
/net/per610a/home/mvp/mvp_db/news7-lv/2019/2019_06_21_19_00/2019_06_21_19_00.mpg;Shinzo ABE.jpg;26305;26365;36081;1315;1318;3
/net/per610a/home/mvp/mvp_db/news7-lv/2019/2019_06_22_19_00/2019_06_22_19_00.mpg;Shinzo ABE.jpg;17473;17689;36081;874;884;10
/net/per610a/home/mvp/mvp_db/news7-lv/2019/2019_06_24_19_00/2019_06_24_19_00.mpg;Yukio EDANO.jpg;5617;5989;39681;280;299;19
/net/per610a/home/mvp/mvp_db/news7-lv/2019/2019_06_24_19_00/2019_06_24_19_00.mpg;Yukio EDANO.jpg;8785;9661;39681;439;483;44
/net/per610a/home/mvp/mvp_db/news7-lv/2019/2019_06_24_19_00/2019_06_24_19_00.mpg;Yukio EDANO.jpg;12109;13097;39681;605;655;50
/net/per610a/home/mvp/mvp_db/news7-lv/2019/2019_06_24_19_00/2019_06_24_19_00.mpg;Shinzo ABE.jpg;6269;6313;39681;313;315;2
/net/per610a/home/mvp/mvp_db/news7-lv/2019/2019_06_24_19_00/2019_06_24_19_00.mpg;Shinzo ABE.jpg;6937;6973;39681;347;348;1
/net/per610a/home/mvp/mvp_db/news7-lv/2019/2019_06_24_19_00/2019_06_24_19_00.mpg;Shinzo ABE.jpg;7977;8021;39681;399;401;2
/net/per610a/home/mvp/mvp_db/news7-lv/2019/2019_06_25_19_00/2019_06_25_19_00.mpg;Shinzo ABE.jpg;3057;3153;36089;152;157;5
/net/per610a/home/mvp/mvp_db/news7-lv/2019/2019_06_25_19_00/2019_06_25_19_00.mpg;Shinzo ABE.jpg;4353;4385;36089;217;219;2
/net/per610a/home/mvp/mvp_db/news7-lv/2019/2019_06_25_19_00/2019_06_25_19_00.mpg;Shinzo ABE.jpg;4505;4621;36089;225;231;6
/net/per610a/home/mvp/mvp_db/news7-lv/2019/2019_06_25_19_00/2019_06_25_19_00.mpg;Shinzo ABE.jpg;7689;7957;36089;384;398;14
/net/per610a/home/mvp/mvp_db/news7-lv/2019/2019_06_25_19_00/2019_06_25_19_00.mpg;Shinzo ABE.jpg;9405;9689;36089;470;484;14
/net/per610a/home/mvp/mvp_db/news7-lv/2019/2019_06_25_19_00/2019_06_25_19_00.mpg;Yukio EDANO.jpg;3205;3497;36089;160;175;15
/net/per610a/home/mvp/mvp_db/news7-lv/2019/2019_06_25_19_00/2019_06_25_19_00.mpg;Yukio EDANO.jpg;7313;7345;36089;365;367;2
/net/per610a/home/mvp/mvp_db/news7-lv/2019/2019_06_25_19_00/2019_06_25_19_00.mpg;Kazuo SHII.jpg;3501;3585;36089;175;179;4
/net/per610a/home/mvp/mvp_db/news7-lv/2019/2019_06_25_19_00/2019_06_25_19_00.mpg;Kazuo SHII.jpg;7353;7481;36089;367;374;7
/net/per610a/home/mvp/mvp_db/news7-lv/2019/2019_06_25_19_00/2019_06_25_19_00.mpg;Natsuo YAMAGUCHI.jpg;9405;9689;36089;470;484;14
/net/per610a/home/mvp/mvp_db/news7-lv/2019/2019_06_26_19_00/2019_06_26_19_00.mpg;Yoshihiko Noda.jpg;5197;5289;39681;260;264;4
/net/per610a/home/mvp/mvp_db/news7-lv/2019/2019_06_26_19_00/2019_06_26_19_00.mpg;Shinzo ABE.jpg;9185;10429;39681;459;521;62
/net/per610a/home/mvp/mvp_db/news7-lv/2019/2019_06_26_19_00/2019_06_26_19_00.mpg;Shinzo ABE.jpg;10697;11301;39681;535;565;30
/net/per610a/home/mvp/mvp_db/news7-lv/2019/2019_06_26_19_00/2019_06_26_19_00.mpg;Shinzo ABE.jpg;15381;15753;39681;769;788;19
/net/per610a/home/mvp/mvp_db/news7-lv/2019/2019_06_26_19_00/2019_06_26_19_00.mpg;Natsuo YAMAGUCHI.jpg;15381;15753;39681;769;788;19
/net/per610a/home/mvp/mvp_db/news7-lv/2019/2019_06_26_19_00/2019_06_26_19_00.mpg;Natsuo YAMAGUCHI.jpg;19669;19733;39681;984;987;3
/net/per610a/home/mvp/mvp_db/news7-lv/2019/2019_06_27_19_00/2019_06_27_19_00.mpg;Shinzo ABE.jpg;7613;7637;39681;380;382;2
/net/per610a/home/mvp/mvp_db/news7-lv/2019/2019_06_27_19_00/2019_06_27_19_00.mpg;Shinzo ABE.jpg;8213;8445;39681;410;422;12
/net/per610a/home/mvp/mvp_db/news7-lv/2019/2019_06_27_19_00/2019_06_27_19_00.mpg;Shinzo ABE.jpg;9013;9293;39681;450;464;14
/net/per610a/home/mvp/mvp_db/news7-lv/2019/2019_06_27_19_00/2019_06_27_19_00.mpg;Shinzo ABE.jpg;12349;12677;39681;617;634;17
/net/per610a/home/mvp/mvp_db/news7-lv/2019/2019_06_28_19_00/2019_06_28_19_00.mpg;Shinzo ABE.jpg;217;349;57661;10;17;7
/net/per610a/home/mvp/mvp_db/news7-lv/2019/2019_06_28_19_00/2019_06_28_19_00.mpg;Shinzo ABE.jpg;1121;1193;57661;56;59;3
/net/per610a/home/mvp/mvp_db/news7-lv/2019/2019_06_28_19_00/2019_06_28_19_00.mpg;Shinzo ABE.jpg;2817;2857;57661;140;142;2
/net/per610a/home/mvp/mvp_db/news7-lv/2019/2019_06_28_19_00/2019_06_28_19_00.mpg;Shinzo ABE.jpg;6445;6465;57661;322;323;1
/net/per610a/home/mvp/mvp_db/news7-lv/2019/2019_06_28_19_00/2019_06_28_19_00.mpg;Shinzo ABE.jpg;6625;7009;57661;331;350;19
/net/per610a/home/mvp/mvp_db/news7-lv/2019/2019_06_28_19_00/2019_06_28_19_00.mpg;Shinzo ABE.jpg;7313;7333;57661;365;366;1
/net/per610a/home/mvp/mvp_db/news7-lv/2019/2019_06_28_19_00/2019_06_28_19_00.mpg;Shinzo ABE.jpg;8321;8365;57661;416;418;2
/net/per610a/home/mvp/mvp_db/news7-lv/2019/2019_06_28_19_00/2019_06_28_19_00.mpg;Shinzo ABE.jpg;15025;15209;57661;751;760;9
/net/per610a/home/mvp/mvp_db/news7-lv/2019/2019_06_29_19_00/2019_06_29_19_00.mpg;Shinzo ABE.jpg;26733;26929;38481;1337;1347;10
/net/per610a/home/mvp/mvp_db/news7-lv/2019/2019_07_01_19_00/2019_07_01_19_00.mpg;Kazuo SHII.jpg;27385;28085;39681;1369;1404;35
/net/per610a/home/mvp/mvp_db/news7-lv/2019/2019_07_02_19_00/2019_07_02_19_00.mpg;Shinzo ABE.jpg;23877;23925;36081;1194;1196;2
/net/per610a/home/mvp/mvp_db/news7-lv/2019/2019_07_02_19_00/2019_07_02_19_00.mpg;Shinzo ABE.jpg;24113;24201;36081;1206;1210;4
/net/per610a/home/mvp/mvp_db/news7-lv/2019/2019_07_02_19_00/2019_07_02_19_00.mpg;Natsuo YAMAGUCHI.jpg;24821;27621;36081;1241;1381;140
/net/per610a/home/mvp/mvp_db/news7-lv/2019/2019_07_03_19_00/2019_07_03_19_00.mpg;Shinzo ABE.jpg;26957;27181;42081;1349;1360;11
/net/per610a/home/mvp/mvp_db/news7-lv/2019/2019_07_03_19_00/2019_07_03_19_00.mpg;Shinzo ABE.jpg;27245;27313;42081;1363;1366;3
/net/per610a/home/mvp/mvp_db/news7-lv/2019/2019_07_03_19_00/2019_07_03_19_00.mpg;Shinzo ABE.jpg;27393;28737;42081;1370;1438;68
/net/per610a/home/mvp/mvp_db/news7-lv/2019/2019_07_03_19_00/2019_07_03_19_00.mpg;Shinzo ABE.jpg;29641;32613;42081;1483;1632;149
/net/per610a/home/mvp/mvp_db/news7-lv/2019/2019_07_03_19_00/2019_07_03_19_00.mpg;Shinzo ABE.jpg;32701;33729;42081;1636;1688;52
/net/per610a/home/mvp/mvp_db/news7-lv/2019/2019_07_03_19_00/2019_07_03_19_00.mpg;Kazuo SHII.jpg;28817;29477;42081;1442;1475;33
/net/per610a/home/mvp/mvp_db/news7-lv/2019/2019_07_04_19_00/2019_07_04_19_00.mpg;Shinzo ABE.jpg;929;2121;125989;46;106;60
/net/per610a/home/mvp/mvp_db/news7-lv/2019/2019_07_04_19_00/2019_07_04_19_00.mpg;Yukio EDANO.jpg;2137;2365;125989;106;118;12
/net/per610a/home/mvp/mvp_db/news7-lv/2019/2019_07_04_19_00/2019_07_04_19_00.mpg;Yuichiro Tamaki.png;3009;3781;125989;150;189;39
/net/per610a/home/mvp/mvp_db/news7-lv/2019/2019_07_04_19_00/2019_07_04_19_00.mpg;Yuichiro Tamaki.png;61017;71725;125989;3053;3589;536
/net/per610a/home/mvp/mvp_db/news7-lv/2019/2019_07_04_19_00/2019_07_04_19_00.mpg;Natsuo YAMAGUCHI.jpg;3797;4193;125989;190;209;19
/net/per610a/home/mvp/mvp_db/news7-lv/2019/2019_07_04_19_00/2019_07_04_19_00.mpg;Natsuo YAMAGUCHI.jpg;9481;9537;125989;474;477;3
/net/per610a/home/mvp/mvp_db/news7-lv/2019/2019_07_04_19_00/2019_07_04_19_00.mpg;Kazuo SHII.jpg;4569;5233;125989;228;261;33
/net/per610a/home/mvp/mvp_db/news7-lv/2019/2019_07_04_19_00/2019_07_04_19_00.mpg;Kazuo SHII.jpg;81845;91317;125989;4095;4569;474
/net/per610a/home/mvp/mvp_db/news7-lv/2019/2019_07_04_19_00/2019_07_04_19_00.mpg;Ichiro Matsui.jpeg;5249;5905;125989;262;295;33
/net/per610a/home/mvp/mvp_db/news7-lv/2019/2019_07_04_19_00/2019_07_04_19_00.mpg;Natsuo YAMAGUCHI.jpg;71917;81497;125989;3599;4078;479
/net/per610a/home/mvp/mvp_db/news7-lv/2019/2019_07_06_19_00/2019_07_06_19_00.mpg;Shinzo ABE.jpg;23281;23601;36089;1165;1181;16
/net/per610a/home/mvp/mvp_db/news7-lv/2019/2019_07_06_19_00/2019_07_06_19_00.mpg;Kazuo SHII.jpg;26625;27441;36089;1332;1373;41
/net/per610a/home/mvp/mvp_db/news7-lv/2019/2019_07_07_19_00/2019_07_07_19_00.mpg;Shinzo ABE.jpg;15505;18809;36089;775;941;166
/net/per610a/home/mvp/mvp_db/news7-lv/2019/2019_07_07_19_00/2019_07_07_19_00.mpg;Shinzo ABE.jpg;18901;21321;36089;945;1066;121
/net/per610a/home/mvp/mvp_db/news7-lv/2019/2019_07_07_19_00/2019_07_07_19_00.mpg;Kazuo SHII.jpg;21325;22233;36089;1067;1112;45
/net/per610a/home/mvp/mvp_db/news7-lv/2019/2019_07_09_19_00/2019_07_09_19_00.mpg;Shinzo ABE.jpg;725;817;36089;36;40;4
/net/per610a/home/mvp/mvp_db/news7-lv/2019/2019_07_09_19_00/2019_07_09_19_00.mpg;Shinzo ABE.jpg;5241;6017;36089;262;301;39
/net/per610a/home/mvp/mvp_db/news7-lv/2019/2019_07_12_19_00/2019_07_12_19_00.mpg;Shinzo ABE.jpg;11089;11197;36089;554;560;6
/net/per610a/home/mvp/mvp_db/news7-lv/2019/2019_07_12_19_00/2019_07_12_19_00.mpg;Yuichiro Tamaki.png;23737;23789;36089;1187;1190;3
/net/per610a/home/mvp/mvp_db/news7-lv/2019/2019_07_12_19_00/2019_07_12_19_00.mpg;Yuichiro Tamaki.png;23877;24073;36089;1194;1204;10
/net/per610a/home/mvp/mvp_db/news7-lv/2019/2019_07_12_19_00/2019_07_12_19_00.mpg;Yukio EDANO.jpg;23737;23789;36089;1187;1190;3
/net/per610a/home/mvp/mvp_db/news7-lv/2019/2019_07_12_19_00/2019_07_12_19_00.mpg;Yukio EDANO.jpg;23877;23989;36089;1194;1200;6
/net/per610a/home/mvp/mvp_db/news7-lv/2019/2019_07_13_19_00/2019_07_13_19_00.mpg;Shinzo ABE.jpg;20857;21825;36089;1043;1092;49
/net/per610a/home/mvp/mvp_db/news7-lv/2019/2019_07_13_19_00/2019_07_13_19_00.mpg;Yuichiro Tamaki.png;23137;23405;36089;1157;1171;14
/net/per610a/home/mvp/mvp_db/news7-lv/2019/2019_07_15_19_00/2019_07_15_19_00.mpg;Shinzo ABE.jpg;21321;22597;36089;1066;1130;64
/net/per610a/home/mvp/mvp_db/news7-lv/2019/2019_07_22_19_00/2019_07_22_19_00.mpg;Shinzo ABE.jpg;753;973;36081;37;48;11
/net/per610a/home/mvp/mvp_db/news7-lv/2019/2019_07_22_19_00/2019_07_22_19_00.mpg;Shinzo ABE.jpg;1341;1377;36081;67;68;1
/net/per610a/home/mvp/mvp_db/news7-lv/2019/2019_07_22_19_00/2019_07_22_19_00.mpg;Shinzo ABE.jpg;1553;1937;36081;77;96;19
/net/per610a/home/mvp/mvp_db/news7-lv/2019/2019_07_22_19_00/2019_07_22_19_00.mpg;Shinzo ABE.jpg;2021;2097;36081;101;104;3
/net/per610a/home/mvp/mvp_db/news7-lv/2019/2019_07_22_19_00/2019_07_22_19_00.mpg;Shinzo ABE.jpg;4497;4729;36081;224;236;12
/net/per610a/home/mvp/mvp_db/news7-lv/2019/2019_07_22_19_00/2019_07_22_19_00.mpg;Shinzo ABE.jpg;5049;5673;36081;252;283;31
/net/per610a/home/mvp/mvp_db/news7-lv/2019/2019_07_22_19_00/2019_07_22_19_00.mpg;Shinzo ABE.jpg;6725;7185;36081;336;359;23
/net/per610a/home/mvp/mvp_db/news7-lv/2019/2019_07_22_19_00/2019_07_22_19_00.mpg;Shinzo ABE.jpg;7305;7781;36081;365;389;24
/net/per610a/home/mvp/mvp_db/news7-lv/2019/2019_07_22_19_00/2019_07_22_19_00.mpg;Shinzo ABE.jpg;9201;9529;36081;460;476;16
/net/per610a/home/mvp/mvp_db/news7-lv/2019/2019_07_22_19_00/2019_07_22_19_00.mpg;Natsuo YAMAGUCHI.jpg;1341;1341;36081;67;67;0
/net/per610a/home/mvp/mvp_db/news7-lv/2019/2019_07_22_19_00/2019_07_22_19_00.mpg;Natsuo YAMAGUCHI.jpg;4469;4501;36081;223;225;2
/net/per610a/home/mvp/mvp_db/news7-lv/2019/2019_07_22_19_00/2019_07_22_19_00.mpg;Natsuo YAMAGUCHI.jpg;4573;4625;36081;228;231;3
/net/per610a/home/mvp/mvp_db/news7-lv/2019/2019_07_22_19_00/2019_07_22_19_00.mpg;Natsuo YAMAGUCHI.jpg;4701;4785;36081;235;239;4
/net/per610a/home/mvp/mvp_db/news7-lv/2019/2019_07_30_19_00/2019_07_30_19_00.mpg;YUriko Koike.jpg;16185;16461;36089;809;823;14
/net/per610a/home/mvp/mvp_db/news7-lv/2019/2019_07_30_19_00/2019_07_30_19_00.mpg;YUriko Koike.jpg;16777;16997;36089;839;850;11
/net/per610a/home/mvp/mvp_db/news7-lv/2019/2019_07_30_19_00/2019_07_30_19_00.mpg;YUriko Koike.jpg;17121;17337;36089;856;867;11
/net/per610a/home/mvp/mvp_db/news7-lv/2019/2019_07_30_19_00/2019_07_30_19_00.mpg;YUriko Koike.jpg;20177;20465;36089;1009;1024;15
/net/per610a/home/mvp/mvp_db/news7-lv/2019/2019_07_31_19_00/2019_07_31_19_00.mpg;Shinzo ABE.jpg;26801;27189;36081;1340;1360;20
/net/per610a/home/mvp/mvp_db/news7-lv/2019/2019_07_31_19_00/2019_07_31_19_00.mpg;Shinzo ABE.jpg;28457;28837;36081;1423;1442;19
/net/per610a/home/mvp/mvp_db/news7-lv/2019/2019_07_31_19_00/2019_07_31_19_00.mpg;Shinzo ABE.jpg;29425;29573;36081;1472;1479;7
/net/per610a/home/mvp/mvp_db/news7-lv/2019/2019_08_02_19_00/2019_08_02_19_00.mpg;Shinzo ABE.jpg;2625;2641;36089;131;132;1
/net/per610a/home/mvp/mvp_db/news7-lv/2019/2019_08_02_19_00/2019_08_02_19_00.mpg;Shinzo ABE.jpg;2821;2885;36089;141;144;3
/net/per610a/home/mvp/mvp_db/news7-lv/2019/2019_08_03_19_00/2019_08_03_19_00.mpg;Shinzo ABE.jpg;1837;1841;36089;91;92;1
/net/per610a/home/mvp/mvp_db/news7-lv/2019/2019_08_03_19_00/2019_08_03_19_00.mpg;Shinzo ABE.jpg;1957;2045;36089;97;102;5
/net/per610a/home/mvp/mvp_db/news7-lv/2019/2019_08_05_19_00/2019_08_05_19_00.mpg;Shinzo ABE.jpg;26065;26457;36081;1303;1323;20
/net/per610a/home/mvp/mvp_db/news7-lv/2019/2019_08_05_19_00/2019_08_05_19_00.mpg;Shinzo ABE.jpg;27081;27105;36081;1354;1355;1
/net/per610a/home/mvp/mvp_db/news7-lv/2019/2019_08_05_19_00/2019_08_05_19_00.mpg;Shinzo ABE.jpg;27285;27397;36081;1364;1370;6
/net/per610a/home/mvp/mvp_db/news7-lv/2019/2019_08_05_19_00/2019_08_05_19_00.mpg;Shinzo ABE.jpg;27477;27933;36081;1374;1397;23
/net/per610a/home/mvp/mvp_db/news7-lv/2019/2019_08_05_19_00/2019_08_05_19_00.mpg;Shinzo ABE.jpg;28865;28913;36081;1444;1446;2
/net/per610a/home/mvp/mvp_db/news7-lv/2019/2019_08_06_19_00/2019_08_06_19_00.mpg;Shinzo ABE.jpg;24585;25489;36081;1229;1275;46
/net/per610a/home/mvp/mvp_db/news7-lv/2019/2019_08_08_19_00/2019_08_08_19_00.mpg;Shinzo ABE.jpg;12633;13025;36081;631;651;20
/net/per610a/home/mvp/mvp_db/news7-lv/2019/2019_08_08_19_00/2019_08_08_19_00.mpg;Shinzo ABE.jpg;16433;16601;36081;822;830;8
/net/per610a/home/mvp/mvp_db/news7-lv/2019/2019_08_09_19_00/2019_08_09_19_00.mpg;Shinzo ABE.jpg;15101;15101;36089;755;755;0
/net/per610a/home/mvp/mvp_db/news7-lv/2019/2019_08_09_19_00/2019_08_09_19_00.mpg;Shinzo ABE.jpg;15449;15593;36089;773;780;7
/net/per610a/home/mvp/mvp_db/news7-lv/2019/2019_08_10_19_00/2019_08_10_19_00.mpg;Yukio EDANO.jpg;12121;12565;36081;606;628;22
/net/per610a/home/mvp/mvp_db/news7-lv/2019/2019_08_10_19_00/2019_08_10_19_00.mpg;Yukio EDANO.jpg;13265;13453;36081;663;673;10
/net/per610a/home/mvp/mvp_db/news7-lv/2019/2019_08_20_19_00/2019_08_20_19_00.mpg;Yukio EDANO.jpg;16297;16617;36081;815;831;16
/net/per610a/home/mvp/mvp_db/news7-lv/2019/2019_08_20_19_00/2019_08_20_19_00.mpg;Yukio EDANO.jpg;16685;16717;36081;834;836;2
/net/per610a/home/mvp/mvp_db/news7-lv/2019/2019_08_20_19_00/2019_08_20_19_00.mpg;Yukio EDANO.jpg;17033;17101;36081;852;855;3
/net/per610a/home/mvp/mvp_db/news7-lv/2019/2019_08_20_19_00/2019_08_20_19_00.mpg;Yukio EDANO.jpg;17485;17493;36081;874;875;1
/net/per610a/home/mvp/mvp_db/news7-lv/2019/2019_08_20_19_00/2019_08_20_19_00.mpg;Yukio EDANO.jpg;17709;18149;36081;885;907;22
/net/per610a/home/mvp/mvp_db/news7-lv/2019/2019_08_20_19_00/2019_08_20_19_00.mpg;Yukio EDANO.jpg;19109;19205;36081;955;960;5
/net/per610a/home/mvp/mvp_db/news7-lv/2019/2019_08_20_19_00/2019_08_20_19_00.mpg;Shinzo ABE.jpg;18729;18821;36081;936;941;5
/net/per610a/home/mvp/mvp_db/news7-lv/2019/2019_08_22_19_00/2019_08_22_19_00.mpg;Shinzo ABE.jpg;5605;5621;39681;280;281;1
/net/per610a/home/mvp/mvp_db/news7-lv/2019/2019_08_22_19_00/2019_08_22_19_00.mpg;Shinzo ABE.jpg;5685;5761;39681;284;288;4
/net/per610a/home/mvp/mvp_db/news7-lv/2019/2019_08_22_19_00/2019_08_22_19_00.mpg;Shinzo ABE.jpg;14297;14753;39681;715;738;23
/net/per610a/home/mvp/mvp_db/news7-lv/2019/2019_08_22_19_00/2019_08_22_19_00.mpg;Shinzo ABE.jpg;9353;9469;39681;467;473;6
/net/per610a/home/mvp/mvp_db/news7-lv/2019/2019_08_23_19_00/2019_08_23_19_00.mpg;Shinzo ABE.jpg;493;941;36081;24;47;23
/net/per610a/home/mvp/mvp_db/news7-lv/2019/2019_08_24_19_00/2019_08_24_19_00.mpg;Shinzo ABE.jpg;5185;5365;36073;259;268;9
/net/per610a/home/mvp/mvp_db/news7-lv/2019/2019_08_24_19_00/2019_08_24_19_00.mpg;Shinzo ABE.jpg;7701;7913;36073;385;395;10
/net/per610a/home/mvp/mvp_db/news7-lv/2019/2019_08_24_19_00/2019_08_24_19_00.mpg;Shinzo ABE.jpg;14961;15013;36073;748;751;3
/net/per610a/home/mvp/mvp_db/news7-lv/2019/2019_08_24_19_00/2019_08_24_19_00.mpg;Shinzo ABE.jpg;22533;22565;36073;1127;1129;2
/net/per610a/home/mvp/mvp_db/news7-lv/2019/2019_08_24_19_00/2019_08_24_19_00.mpg;Shinzo ABE.jpg;22781;22849;36073;1139;1143;4
/net/per610a/home/mvp/mvp_db/news7-lv/2019/2019_08_25_19_00/2019_08_25_19_00.mpg;Shinzo ABE.jpg;1645;1693;36081;82;84;2
/net/per610a/home/mvp/mvp_db/news7-lv/2019/2019_08_25_19_00/2019_08_25_19_00.mpg;Shinzo ABE.jpg;4949;5457;36081;247;272;25
/net/per610a/home/mvp/mvp_db/news7-lv/2019/2019_08_25_19_00/2019_08_25_19_00.mpg;Shinzo ABE.jpg;8601;8733;36081;430;436;6
/net/per610a/home/mvp/mvp_db/news7-lv/2019/2019_08_25_19_00/2019_08_25_19_00.mpg;Shinzo ABE.jpg;8845;9189;36081;442;459;17
/net/per610a/home/mvp/mvp_db/news7-lv/2019/2019_08_25_19_00/2019_08_25_19_00.mpg;Shinzo ABE.jpg;11933;12161;36081;596;608;12
/net/per610a/home/mvp/mvp_db/news7-lv/2019/2019_08_25_19_00/2019_08_25_19_00.mpg;Shinzo ABE.jpg;12553;12961;36081;627;648;21
/net/per610a/home/mvp/mvp_db/news7-lv/2019/2019_08_28_19_00/2019_08_28_19_00.mpg;Shinzo ABE.jpg;29897;30053;36081;1495;1503;8
/net/per610a/home/mvp/mvp_db/news7-lv/2019/2019_08_30_19_00/2019_08_30_19_00.mpg;Taro ASO.jpg;24449;24665;36081;1223;1233;10
/net/per610a/home/mvp/mvp_db/news7-lv/2019/2019_08_30_19_00/2019_08_30_19_00.mpg;Shinzo ABE.jpg;25429;25533;36081;1272;1277;5
/net/per610a/home/mvp/mvp_db/news7-lv/2019/2019_08_30_19_00/2019_08_30_19_00.mpg;Shinzo ABE.jpg;26521;27009;36081;1326;1351;25
/net/per610a/home/mvp/mvp_db/news7-lv/2019/2019_08_30_19_00/2019_08_30_19_00.mpg;Shinzo ABE.jpg;27125;27189;36081;1356;1360;4
/net/per610a/home/mvp/mvp_db/news7-lv/2019/2019_08_30_19_00/2019_08_30_19_00.mpg;Shinzo ABE.jpg;27417;27489;36081;1371;1375;4
/net/per610a/home/mvp/mvp_db/news7-lv/2019/2019_09_03_19_00/2019_09_03_19_00.mpg;Shinzo ABE.jpg;6937;6977;36089;347;349;2
/net/per610a/home/mvp/mvp_db/news7-lv/2019/2019_09_03_19_00/2019_09_03_19_00.mpg;Shinzo ABE.jpg;7189;7297;36089;359;365;6
/net/per610a/home/mvp/mvp_db/news7-lv/2019/2019_09_03_19_00/2019_09_03_19_00.mpg;Shinzo ABE.jpg;7541;7665;36089;377;383;6
/net/per610a/home/mvp/mvp_db/news7-lv/2019/2019_09_03_19_00/2019_09_03_19_00.mpg;Shinzo ABE.jpg;7757;8237;36089;388;412;24
/net/per610a/home/mvp/mvp_db/news7-lv/2019/2019_09_03_19_00/2019_09_03_19_00.mpg;Shinzo ABE.jpg;8401;8421;36089;420;421;1
/net/per610a/home/mvp/mvp_db/news7-lv/2019/2019_09_03_19_00/2019_09_03_19_00.mpg;Taro ASO.jpg;8241;8397;36089;412;420;8
/net/per610a/home/mvp/mvp_db/news7-lv/2019/2019_09_04_19_00/2019_09_04_19_00.mpg;Shinzo ABE.jpg;2917;3141;36081;145;157;12
/net/per610a/home/mvp/mvp_db/news7-lv/2019/2019_09_05_19_00/2019_09_05_19_00.mpg;Shinzo ABE.jpg;21009;21077;39681;1050;1054;4
/net/per610a/home/mvp/mvp_db/news7-lv/2019/2019_09_05_19_00/2019_09_05_19_00.mpg;Shinzo ABE.jpg;21581;21713;39681;1079;1086;7
/net/per610a/home/mvp/mvp_db/news7-lv/2019/2019_09_05_19_00/2019_09_05_19_00.mpg;Shinzo ABE.jpg;22781;23209;39681;1139;1161;22
/net/per610a/home/mvp/mvp_db/news7-lv/2019/2019_09_05_19_00/2019_09_05_19_00.mpg;Shinzo ABE.jpg;25213;25357;39681;1261;1268;7
/net/per610a/home/mvp/mvp_db/news7-lv/2019/2019_09_09_19_00/2019_09_09_19_00.mpg;Shinzo ABE.jpg;23641;24013;36081;1182;1201;19
/net/per610a/home/mvp/mvp_db/news7-lv/2019/2019_09_09_19_00/2019_09_09_19_00.mpg;Shinzo ABE.jpg;24849;24929;36081;1243;1247;4
/net/per610a/home/mvp/mvp_db/news7-lv/2019/2019_09_09_19_00/2019_09_09_19_00.mpg;Shinzo ABE.jpg;25521;25913;36081;1276;1296;20
/net/per610a/home/mvp/mvp_db/news7-lv/2019/2019_09_09_19_00/2019_09_09_19_00.mpg;Shinzo ABE.jpg;27273;27593;36081;1364;1380;16
/net/per610a/home/mvp/mvp_db/news7-lv/2019/2019_09_10_19_00/2019_09_10_19_00.mpg;Shinzo ABE.jpg;5125;5305;36089;256;265;9
/net/per610a/home/mvp/mvp_db/news7-lv/2019/2019_09_10_19_00/2019_09_10_19_00.mpg;Shinzo ABE.jpg;8981;9117;36089;449;456;7
/net/per610a/home/mvp/mvp_db/news7-lv/2019/2019_09_10_19_00/2019_09_10_19_00.mpg;Shinzo ABE.jpg;10305;10429;36089;515;521;6
/net/per610a/home/mvp/mvp_db/news7-lv/2019/2019_09_10_19_00/2019_09_10_19_00.mpg;Shinzo ABE.jpg;11329;11421;36089;566;571;5
/net/per610a/home/mvp/mvp_db/news7-lv/2019/2019_09_10_19_00/2019_09_10_19_00.mpg;Shinzo ABE.jpg;12357;13161;36089;618;658;40
/net/per610a/home/mvp/mvp_db/news7-lv/2019/2019_09_10_19_00/2019_09_10_19_00.mpg;Taro ASO.jpg;6841;7989;36089;342;399;57
/net/per610a/home/mvp/mvp_db/news7-lv/2019/2019_09_10_19_00/2019_09_10_19_00.mpg;Taro ASO.jpg;10725;10889;36089;536;544;8
/net/per610a/home/mvp/mvp_db/news7-lv/2019/2019_09_12_19_00/2019_09_12_19_00.mpg;Shinzo ABE.jpg;13853;14117;36081;693;706;13
/net/per610a/home/mvp/mvp_db/news7-lv/2019/2019_09_19_19_00/2019_09_19_19_00.mpg;Ichiro OZAWA.jpg;10597;10973;36089;530;549;19
/net/per610a/home/mvp/mvp_db/news7-lv/2019/2019_09_19_19_00/2019_09_19_19_00.mpg;Kyoko Nakayama.jpg;15913;16037;36089;796;802;6
/net/per610a/home/mvp/mvp_db/news7-lv/2019/2019_09_19_19_00/2019_09_19_19_00.mpg;Yukio EDANO.jpg;23785;23829;36089;1190;1192;2
/net/per610a/home/mvp/mvp_db/news7-lv/2019/2019_09_19_19_00/2019_09_19_19_00.mpg;Yukio EDANO.jpg;24189;24205;36089;1210;1211;1
/net/per610a/home/mvp/mvp_db/news7-lv/2019/2019_09_19_19_00/2019_09_19_19_00.mpg;Yukio EDANO.jpg;25193;25225;36089;1260;1262;2
/net/per610a/home/mvp/mvp_db/news7-lv/2019/2019_09_19_19_00/2019_09_19_19_00.mpg;Yukio EDANO.jpg;25597;25637;36089;1280;1282;2
/net/per610a/home/mvp/mvp_db/news7-lv/2019/2019_09_23_19_00/2019_09_23_19_00.mpg;Shinzo ABE.jpg;17349;17525;36081;867;876;9
/net/per610a/home/mvp/mvp_db/news7-lv/2019/2019_09_23_19_00/2019_09_23_19_00.mpg;Shinzo ABE.jpg;19693;19745;36081;985;987;2
/net/per610a/home/mvp/mvp_db/news7-lv/2019/2019_09_25_19_00/2019_09_25_19_00.mpg;Shinzo ABE.jpg;2581;2625;36081;129;131;2
/net/per610a/home/mvp/mvp_db/news7-lv/2019/2019_09_25_19_00/2019_09_25_19_00.mpg;Shinzo ABE.jpg;2713;2821;36081;135;141;6
/net/per610a/home/mvp/mvp_db/news7-lv/2019/2019_09_25_19_00/2019_09_25_19_00.mpg;Shinzo ABE.jpg;6201;6465;36081;310;323;13
/net/per610a/home/mvp/mvp_db/news7-lv/2019/2019_09_25_19_00/2019_09_25_19_00.mpg;Shinzo ABE.jpg;7437;7713;36081;372;385;13
/net/per610a/home/mvp/mvp_db/news7-lv/2019/2019_09_26_19_00/2019_09_26_19_00.mpg;Shinzo ABE.jpg;621;689;36081;31;34;3
/net/per610a/home/mvp/mvp_db/news7-lv/2019/2019_09_26_19_00/2019_09_26_19_00.mpg;Shinzo ABE.jpg;1945;2097;36081;97;104;7
/net/per610a/home/mvp/mvp_db/news7-lv/2019/2019_09_26_19_00/2019_09_26_19_00.mpg;Shinzo ABE.jpg;3985;4057;36081;199;202;3
/net/per610a/home/mvp/mvp_db/news7-lv/2019/2019_09_30_19_00/2019_09_30_19_00.mpg;Shinzo ABE.jpg;12185;12481;36081;609;624;15
/net/per610a/home/mvp/mvp_db/news7-lv/2019/2019_10_01_19_00/2019_10_01_19_00.mpg;Shinzo ABE.jpg;12729;13717;36081;636;686;50
/net/per610a/home/mvp/mvp_db/news7-lv/2019/2019_10_01_19_00/2019_10_01_19_00.mpg;Shinzo ABE.jpg;13969;14053;36081;698;703;5
/net/per610a/home/mvp/mvp_db/news7-lv/2019/2019_10_01_19_00/2019_10_01_19_00.mpg;Shinzo ABE.jpg;14217;14413;36081;711;721;10
/net/per610a/home/mvp/mvp_db/news7-lv/2019/2019_10_01_19_00/2019_10_01_19_00.mpg;Natsuo YAMAGUCHI.jpg;32461;32853;36081;1623;1643;20
/net/per610a/home/mvp/mvp_db/news7-lv/2019/2019_10_01_19_00/2019_10_01_19_00.mpg;Natsuo YAMAGUCHI.jpg;33121;33321;36081;1656;1666;10
/net/per610a/home/mvp/mvp_db/news7-lv/2019/2019_10_04_19_00/2019_10_04_19_00.mpg;Shinzo ABE.jpg;533;553;36081;26;27;1
/net/per610a/home/mvp/mvp_db/news7-lv/2019/2019_10_04_19_00/2019_10_04_19_00.mpg;Shinzo ABE.jpg;1329;1825;36081;66;91;25
/net/per610a/home/mvp/mvp_db/news7-lv/2019/2019_10_04_19_00/2019_10_04_19_00.mpg;Shinzo ABE.jpg;2573;3485;36081;128;174;46
/net/per610a/home/mvp/mvp_db/news7-lv/2019/2019_10_04_19_00/2019_10_04_19_00.mpg;Shinzo ABE.jpg;3701;4085;36081;185;204;19
/net/per610a/home/mvp/mvp_db/news7-lv/2019/2019_10_09_19_00/2019_10_09_19_00.mpg;Natsuo YAMAGUCHI.jpg;23465;23873;39681;1173;1194;21
/net/per610a/home/mvp/mvp_db/news7-lv/2019/2019_10_10_19_00/2019_10_10_19_00.mpg;Yuichiro Tamaki.png;21985;21997;36081;1099;1100;1
/net/per610a/home/mvp/mvp_db/news7-lv/2019/2019_10_10_19_00/2019_10_10_19_00.mpg;Yuichiro Tamaki.png;22241;22485;36081;1112;1124;12
/net/per610a/home/mvp/mvp_db/news7-lv/2019/2019_10_13_19_00/2019_10_13_19_00.mpg;Shinzo ABE.jpg;38497;38569;72049;1926;1930;4
/net/per610a/home/mvp/mvp_db/news7-lv/2019/2019_10_13_19_00/2019_10_13_19_00.mpg;Shinzo ABE.jpg;38689;39185;72049;1936;1961;25
/net/per610a/home/mvp/mvp_db/news7-lv/2019/2019_10_14_19_00/2019_10_14_19_00.mpg;Shinzo ABE.jpg;31669;32373;48069;1584;1619;35
/net/per610a/home/mvp/mvp_db/news7-lv/2019/2019_10_15_19_00/2019_10_15_19_00.mpg;Taro Yamamoto.jpg;37133;37673;72041;1858;1885;27
/net/per610a/home/mvp/mvp_db/news7-lv/2019/2019_10_15_19_00/2019_10_15_19_00.mpg;Shinzo ABE.jpg;49245;49669;72041;2464;2485;21
/net/per610a/home/mvp/mvp_db/news7-lv/2019/2019_10_16_19_00/2019_10_16_19_00.mpg;YUriko Koike.jpg;24589;24589;72049;1230;1230;0
/net/per610a/home/mvp/mvp_db/news7-lv/2019/2019_10_16_19_00/2019_10_16_19_00.mpg;YUriko Koike.jpg;24833;25153;72049;1242;1258;16
/net/per610a/home/mvp/mvp_db/news7-lv/2019/2019_10_16_19_00/2019_10_16_19_00.mpg;YUriko Koike.jpg;43681;43689;72049;2186;2186;0
/net/per610a/home/mvp/mvp_db/news7-lv/2019/2019_10_16_19_00/2019_10_16_19_00.mpg;YUriko Koike.jpg;44197;44373;72049;2212;2220;8
/net/per610a/home/mvp/mvp_db/news7-lv/2019/2019_10_16_19_00/2019_10_16_19_00.mpg;Shinzo ABE.jpg;29581;29993;72049;1480;1501;21
/net/per610a/home/mvp/mvp_db/news7-lv/2019/2019_10_16_19_00/2019_10_16_19_00.mpg;Shinzo ABE.jpg;48549;48597;72049;2429;2432;3
/net/per610a/home/mvp/mvp_db/news7-lv/2019/2019_10_16_19_00/2019_10_16_19_00.mpg;YUriko Koike.jpg;43785;43865;72049;2191;2195;4
/net/per610a/home/mvp/mvp_db/news7-lv/2019/2019_10_17_19_00/2019_10_17_19_00.mpg;Shinzo ABE.jpg;10945;10989;90029;547;550;3
/net/per610a/home/mvp/mvp_db/news7-lv/2019/2019_10_17_19_00/2019_10_17_19_00.mpg;Shinzo ABE.jpg;11185;11965;90029;559;598;39
/net/per610a/home/mvp/mvp_db/news7-lv/2019/2019_10_17_19_00/2019_10_17_19_00.mpg;Shinzo ABE.jpg;18093;18533;90029;905;927;22
/net/per610a/home/mvp/mvp_db/news7-lv/2019/2019_10_18_19_00/2019_10_18_19_00.mpg;Shinzo ABE.jpg;18985;19521;36081;949;976;27
/net/per610a/home/mvp/mvp_db/news7-lv/2019/2019_10_18_19_00/2019_10_18_19_00.mpg;Shinzo ABE.jpg;22545;22777;36081;1127;1139;12
/net/per610a/home/mvp/mvp_db/news7-lv/2019/2019_10_18_19_00/2019_10_18_19_00.mpg;Shinzo ABE.jpg;28497;28533;36081;1425;1427;2
/net/per610a/home/mvp/mvp_db/news7-lv/2019/2019_10_21_19_00/2019_10_21_19_00.mpg;Shinzo ABE.jpg;20249;20281;36081;1012;1014;2
/net/per610a/home/mvp/mvp_db/news7-lv/2019/2019_10_21_19_00/2019_10_21_19_00.mpg;Shinzo ABE.jpg;20517;20713;36081;1026;1036;10
/net/per610a/home/mvp/mvp_db/news7-lv/2019/2019_10_23_19_00/2019_10_23_19_00.mpg;Shinzo ABE.jpg;5181;5193;36081;259;259;0
/net/per610a/home/mvp/mvp_db/news7-lv/2019/2019_10_23_19_00/2019_10_23_19_00.mpg;Shinzo ABE.jpg;5361;5381;36081;268;269;1
/net/per610a/home/mvp/mvp_db/news7-lv/2019/2019_10_23_19_00/2019_10_23_19_00.mpg;Shinzo ABE.jpg;5985;6033;36081;299;301;2
/net/per610a/home/mvp/mvp_db/news7-lv/2019/2019_10_24_19_00/2019_10_24_19_00.mpg;Shinzo ABE.jpg;11857;11969;36089;593;598;5
/net/per610a/home/mvp/mvp_db/news7-lv/2019/2019_10_24_19_00/2019_10_24_19_00.mpg;Shinzo ABE.jpg;12093;12153;36089;605;608;3
/net/per610a/home/mvp/mvp_db/news7-lv/2019/2019_10_24_19_00/2019_10_24_19_00.mpg;Shinzo ABE.jpg;12257;12885;36089;613;644;31
/net/per610a/home/mvp/mvp_db/news7-lv/2019/2019_10_24_19_00/2019_10_24_19_00.mpg;Shinzo ABE.jpg;13261;13321;36089;663;666;3
/net/per610a/home/mvp/mvp_db/news7-lv/2019/2019_10_24_19_00/2019_10_24_19_00.mpg;Shinzo ABE.jpg;15341;15373;36089;767;769;2
/net/per610a/home/mvp/mvp_db/news7-lv/2019/2019_10_25_19_00/2019_10_25_19_00.mpg;Shinzo ABE.jpg;17101;17233;36081;855;862;7
/net/per610a/home/mvp/mvp_db/news7-lv/2019/2019_10_25_19_00/2019_10_25_19_00.mpg;Shinzo ABE.jpg;27593;27697;36081;1380;1385;5
/net/per610a/home/mvp/mvp_db/news7-lv/2019/2019_10_26_19_00/2019_10_26_19_00.mpg;Yukio EDANO.jpg;25305;25421;36073;1266;1272;6
/net/per610a/home/mvp/mvp_db/news7-lv/2019/2019_10_28_19_00/2019_10_28_19_00.mpg;Shinzo ABE.jpg;27389;27837;36089;1370;1393;23
/net/per610a/home/mvp/mvp_db/news7-lv/2019/2019_10_28_19_00/2019_10_28_19_00.mpg;Shinzo ABE.jpg;28689;29213;36089;1435;1461;26
/net/per610a/home/mvp/mvp_db/news7-lv/2019/2019_10_29_19_00/2019_10_29_19_00.mpg;Shinzo ABE.jpg;18713;19049;36081;936;952;16
/net/per610a/home/mvp/mvp_db/news7-lv/2019/2019_10_30_19_00/2019_10_30_19_00.mpg;YUriko Koike.jpg;7361;7669;36081;368;383;15
/net/per610a/home/mvp/mvp_db/news7-lv/2019/2019_10_31_19_00/2019_10_31_19_00.mpg;Taro ASO.jpg;14561;14905;36081;728;745;17
/net/per610a/home/mvp/mvp_db/news7-lv/2019/2019_10_31_19_00/2019_10_31_19_00.mpg;Shinzo ABE.jpg;15601;15601;36081;780;780;0
/net/per610a/home/mvp/mvp_db/news7-lv/2019/2019_10_31_19_00/2019_10_31_19_00.mpg;Shinzo ABE.jpg;21445;21653;36081;1072;1083;11
/net/per610a/home/mvp/mvp_db/news7-lv/2019/2019_10_31_19_00/2019_10_31_19_00.mpg;Shinzo ABE.jpg;20605;20613;36081;1030;1031;1
/net/per610a/home/mvp/mvp_db/news7-lv/2019/2019_10_31_19_00/2019_10_31_19_00.mpg;Shinzo ABE.jpg;21233;21397;36081;1062;1070;8
/net/per610a/home/mvp/mvp_db/news7-lv/2019/2019_10_31_19_00/2019_10_31_19_00.mpg;Shinzo ABE.jpg;21769;21797;36081;1089;1090;1
/net/per610a/home/mvp/mvp_db/news7-lv/2019/2019_10_31_19_00/2019_10_31_19_00.mpg;Shinzo ABE.jpg;21889;22473;36081;1095;1124;29
/net/per610a/home/mvp/mvp_db/news7-lv/2019/2019_10_31_19_00/2019_10_31_19_00.mpg;Shinzo ABE.jpg;23677;24385;36081;1184;1219;35
/net/per610a/home/mvp/mvp_db/news7-lv/2019/2019_11_01_19_00/2019_11_01_19_00.mpg;Yukio EDANO.jpg;8513;8817;36089;426;441;15
/net/per610a/home/mvp/mvp_db/news7-lv/2019/2019_11_01_19_00/2019_11_01_19_00.mpg;Yuichiro Tamaki.png;9169;9529;36089;458;476;18
/net/per610a/home/mvp/mvp_db/news7-lv/2019/2019_11_01_19_00/2019_11_01_19_00.mpg;YUriko Koike.jpg;10285;10437;36089;514;522;8
/net/per610a/home/mvp/mvp_db/news7-lv/2019/2019_11_01_19_00/2019_11_01_19_00.mpg;YUriko Koike.jpg;12533;12777;36089;627;639;12
/net/per610a/home/mvp/mvp_db/news7-lv/2019/2019_11_01_19_00/2019_11_01_19_00.mpg;Shinzo ABE.jpg;20905;21097;36089;1046;1055;9
/net/per610a/home/mvp/mvp_db/news7-lv/2019/2019_11_04_19_00/2019_11_04_19_00.mpg;Shinzo ABE.jpg;1093;1225;36089;54;61;7
/net/per610a/home/mvp/mvp_db/news7-lv/2019/2019_11_04_19_00/2019_11_04_19_00.mpg;Shinzo ABE.jpg;4925;5169;36089;246;258;12
/net/per610a/home/mvp/mvp_db/news7-lv/2019/2019_11_04_19_00/2019_11_04_19_00.mpg;Shinzo ABE.jpg;7189;7245;36089;359;362;3
/net/per610a/home/mvp/mvp_db/news7-lv/2019/2019_11_08_19_00/2019_11_08_19_00.mpg;Shinzo ABE.jpg;1577;1865;36081;78;93;15
/net/per610a/home/mvp/mvp_db/news7-lv/2019/2019_11_08_19_00/2019_11_08_19_00.mpg;Shinzo ABE.jpg;2025;2345;36081;101;117;16
/net/per610a/home/mvp/mvp_db/news7-lv/2019/2019_11_08_19_00/2019_11_08_19_00.mpg;Shinzo ABE.jpg;25357;25441;36081;1268;1272;4
/net/per610a/home/mvp/mvp_db/news7-lv/2019/2019_11_11_19_00/2019_11_11_19_00.mpg;Shinzo ABE.jpg;14837;15089;36089;742;755;13
/net/per610a/home/mvp/mvp_db/news7-lv/2019/2019_11_11_19_00/2019_11_11_19_00.mpg;Shinzo ABE.jpg;15665;15805;36089;783;790;7
/net/per610a/home/mvp/mvp_db/news7-lv/2019/2019_11_12_19_00/2019_11_12_19_00.mpg;Shinzo ABE.jpg;27517;27697;36089;1377;1386;9
/net/per610a/home/mvp/mvp_db/news7-lv/2019/2019_11_13_19_00/2019_11_13_19_00.mpg;Takako DOI.jpg;7341;7393;36089;367;369;2
/net/per610a/home/mvp/mvp_db/news7-lv/2019/2019_11_13_19_00/2019_11_13_19_00.mpg;Takako DOI.jpg;7469;7813;36089;373;390;17
/net/per610a/home/mvp/mvp_db/news7-lv/2019/2019_11_13_19_00/2019_11_13_19_00.mpg;Shinzo ABE.jpg;7837;8173;36089;392;409;17
/net/per610a/home/mvp/mvp_db/news7-lv/2019/2019_11_13_19_00/2019_11_13_19_00.mpg;YUriko Koike.jpg;21845;21905;36089;1093;1096;3
/net/per610a/home/mvp/mvp_db/news7-lv/2019/2019_11_13_19_00/2019_11_13_19_00.mpg;YUriko Koike.jpg;22133;22221;36089;1107;1112;5
/net/per610a/home/mvp/mvp_db/news7-lv/2019/2019_11_14_19_00/2019_11_14_19_00.mpg;Nariaki Nakayama.png;10045;10493;36081;502;524;22
/net/per610a/home/mvp/mvp_db/news7-lv/2019/2019_11_14_19_00/2019_11_14_19_00.mpg;Nariaki Nakayama.png;10565;10733;36081;528;536;8
/net/per610a/home/mvp/mvp_db/news7-lv/2019/2019_11_14_19_00/2019_11_14_19_00.mpg;Nariaki Nakayama.png;11557;11893;36081;578;594;16
/net/per610a/home/mvp/mvp_db/news7-lv/2019/2019_11_15_19_00/2019_11_15_19_00.mpg;Shinzo ABE.jpg;7361;7705;36081;368;385;17
/net/per610a/home/mvp/mvp_db/news7-lv/2019/2019_11_15_19_00/2019_11_15_19_00.mpg;Shinzo ABE.jpg;10345;10625;36081;517;531;14
/net/per610a/home/mvp/mvp_db/news7-lv/2019/2019_11_15_19_00/2019_11_15_19_00.mpg;Shinzo ABE.jpg;9837;9889;36081;492;494;2
/net/per610a/home/mvp/mvp_db/news7-lv/2019/2019_11_15_19_00/2019_11_15_19_00.mpg;Shinzo ABE.jpg;10777;10829;36081;539;541;2
/net/per610a/home/mvp/mvp_db/news7-lv/2019/2019_11_16_19_00/2019_11_16_19_00.mpg;Ichiro OZAWA.jpg;11205;11205;36089;560;560;0
/net/per610a/home/mvp/mvp_db/news7-lv/2019/2019_11_16_19_00/2019_11_16_19_00.mpg;Ichiro OZAWA.jpg;13829;13997;36089;692;700;8
/net/per610a/home/mvp/mvp_db/news7-lv/2019/2019_11_16_19_00/2019_11_16_19_00.mpg;Ichiro OZAWA.jpg;18541;18853;36089;927;943;16
/net/per610a/home/mvp/mvp_db/news7-lv/2019/2019_11_16_19_00/2019_11_16_19_00.mpg;Shinzo ABE.jpg;12485;12709;36089;624;635;11
/net/per610a/home/mvp/mvp_db/news7-lv/2019/2019_11_16_19_00/2019_11_16_19_00.mpg;Shinzo ABE.jpg;18949;19045;36089;948;953;5
/net/per610a/home/mvp/mvp_db/news7-lv/2019/2019_11_16_19_00/2019_11_16_19_00.mpg;Shinzo ABE.jpg;19337;19341;36089;967;967;0
/net/per610a/home/mvp/mvp_db/news7-lv/2019/2019_11_16_19_00/2019_11_16_19_00.mpg;Shinzo ABE.jpg;19073;19273;36089;954;964;10
/net/per610a/home/mvp/mvp_db/news7-lv/2019/2019_11_16_19_00/2019_11_16_19_00.mpg;Shinzo ABE.jpg;21845;21925;36089;1093;1097;4
/net/per610a/home/mvp/mvp_db/news7-lv/2019/2019_11_16_19_00/2019_11_16_19_00.mpg;Shinzo ABE.jpg;22265;22789;36089;1114;1140;26
/net/per610a/home/mvp/mvp_db/news7-lv/2019/2019_11_17_19_00/2019_11_17_19_00.mpg;Shinzo ABE.jpg;15033;15069;36081;752;753;1
/net/per610a/home/mvp/mvp_db/news7-lv/2019/2019_11_17_19_00/2019_11_17_19_00.mpg;Shinzo ABE.jpg;15165;15249;36081;758;762;4
/net/per610a/home/mvp/mvp_db/news7-lv/2019/2019_11_17_19_00/2019_11_17_19_00.mpg;Shinzo ABE.jpg;15421;15509;36081;771;775;4
/net/per610a/home/mvp/mvp_db/news7-lv/2019/2019_11_17_19_00/2019_11_17_19_00.mpg;Shinzo ABE.jpg;15917;15945;36081;796;797;1
/net/per610a/home/mvp/mvp_db/news7-lv/2019/2019_11_17_19_00/2019_11_17_19_00.mpg;Shinzo ABE.jpg;22377;22509;36081;1119;1126;7
/net/per610a/home/mvp/mvp_db/news7-lv/2019/2019_11_17_19_00/2019_11_17_19_00.mpg;Shinzo ABE.jpg;24873;24893;36081;1244;1245;1
/net/per610a/home/mvp/mvp_db/news7-lv/2019/2019_11_17_19_00/2019_11_17_19_00.mpg;Shinzo ABE.jpg;26125;26137;36081;1306;1307;1
/net/per610a/home/mvp/mvp_db/news7-lv/2019/2019_11_18_19_00/2019_11_18_19_00.mpg;Shinzo ABE.jpg;16889;16937;36081;844;847;3
/net/per610a/home/mvp/mvp_db/news7-lv/2019/2019_11_18_19_00/2019_11_18_19_00.mpg;Shinzo ABE.jpg;19733;19805;36081;987;990;3
/net/per610a/home/mvp/mvp_db/news7-lv/2019/2019_11_18_19_00/2019_11_18_19_00.mpg;Shinzo ABE.jpg;22325;22377;36081;1116;1119;3
/net/per610a/home/mvp/mvp_db/news7-lv/2019/2019_11_18_19_00/2019_11_18_19_00.mpg;Shinzo ABE.jpg;22525;22529;36081;1126;1127;1
/net/per610a/home/mvp/mvp_db/news7-lv/2019/2019_11_18_19_00/2019_11_18_19_00.mpg;Shinzo ABE.jpg;23833;23861;36081;1192;1193;1
/net/per610a/home/mvp/mvp_db/news7-lv/2019/2019_11_18_19_00/2019_11_18_19_00.mpg;Shinzo ABE.jpg;17169;17177;36081;858;859;1
/net/per610a/home/mvp/mvp_db/news7-lv/2019/2019_11_18_19_00/2019_11_18_19_00.mpg;Shinzo ABE.jpg;20269;20453;36081;1013;1023;10
/net/per610a/home/mvp/mvp_db/news7-lv/2019/2019_11_18_19_00/2019_11_18_19_00.mpg;Shinzo ABE.jpg;23057;23105;36081;1153;1155;2
/net/per610a/home/mvp/mvp_db/news7-lv/2019/2019_11_18_19_00/2019_11_18_19_00.mpg;Shinzo ABE.jpg;24465;24533;36081;1223;1227;4
/net/per610a/home/mvp/mvp_db/news7-lv/2019/2019_11_18_19_00/2019_11_18_19_00.mpg;Shinzo ABE.jpg;24637;25189;36081;1232;1260;28
/net/per610a/home/mvp/mvp_db/news7-lv/2019/2019_11_20_19_00/2019_11_20_19_00.mpg;Junichiro KOIZUMI.jpg;21505;21605;36081;1075;1080;5
/net/per610a/home/mvp/mvp_db/news7-lv/2019/2019_11_20_19_00/2019_11_20_19_00.mpg;Shinzo ABE.jpg;23277;23473;36081;1164;1174;10
/net/per610a/home/mvp/mvp_db/news7-lv/2019/2019_11_21_19_00/2019_11_21_19_00.mpg;Shinzo ABE.jpg;19233;19461;36081;962;973;11
/net/per610a/home/mvp/mvp_db/news7-lv/2019/2019_11_22_19_00/2019_11_22_19_00.mpg;Shinzo ABE.jpg;849;941;36081;42;47;5
/net/per610a/home/mvp/mvp_db/news7-lv/2019/2019_11_23_19_00/2019_11_23_19_00.mpg;Shinzo ABE.jpg;13853;14029;36081;693;701;8
/net/per610a/home/mvp/mvp_db/news7-lv/2019/2019_11_23_19_00/2019_11_23_19_00.mpg;Shinzo ABE.jpg;15041;15377;36081;752;769;17
/net/per610a/home/mvp/mvp_db/news7-lv/2019/2019_11_25_19_00/2019_11_25_19_00.mpg;Shinzo ABE.jpg;21385;21389;36081;1069;1070;1
/net/per610a/home/mvp/mvp_db/news7-lv/2019/2019_11_25_19_00/2019_11_25_19_00.mpg;Shinzo ABE.jpg;32397;32993;36081;1620;1650;30
/net/per610a/home/mvp/mvp_db/news7-lv/2019/2019_11_25_19_00/2019_11_25_19_00.mpg;Shinzo ABE.jpg;33409;35261;36081;1671;1763;92
/net/per610a/home/mvp/mvp_db/news7-lv/2019/2019_11_27_19_00/2019_11_27_19_00.mpg;Shinzo ABE.jpg;20761;21061;36081;1038;1053;15
/net/per610a/home/mvp/mvp_db/news7-lv/2019/2019_11_27_19_00/2019_11_27_19_00.mpg;Shinzo ABE.jpg;21561;21773;36081;1078;1089;11
/net/per610a/home/mvp/mvp_db/news7-lv/2019/2019_11_28_19_00/2019_11_28_19_00.mpg;Shinzo ABE.jpg;3569;4197;36081;178;209;31
/net/per610a/home/mvp/mvp_db/news7-lv/2019/2019_11_29_19_00/2019_11_29_19_00.mpg;Shinzo ABE.jpg;8097;8161;36081;405;408;3
/net/per610a/home/mvp/mvp_db/news7-lv/2019/2019_11_29_19_00/2019_11_29_19_00.mpg;Shinzo ABE.jpg;20549;20637;36081;1027;1032;5
/net/per610a/home/mvp/mvp_db/news7-lv/2019/2019_11_29_19_00/2019_11_29_19_00.mpg;Shinzo ABE.jpg;20705;20769;36081;1035;1038;3
/net/per610a/home/mvp/mvp_db/news7-lv/2019/2019_11_29_19_00/2019_11_29_19_00.mpg;Shinzo ABE.jpg;21837;21965;36081;1092;1098;6
/net/per610a/home/mvp/mvp_db/news7-lv/2019/2019_11_29_19_00/2019_11_29_19_00.mpg;Shinzo ABE.jpg;27157;27193;36081;1358;1360;2
/net/per610a/home/mvp/mvp_db/news7-lv/2019/2019_11_29_19_00/2019_11_29_19_00.mpg;Shinzo ABE.jpg;27265;27317;36081;1363;1366;3
/net/per610a/home/mvp/mvp_db/news7-lv/2019/2019_12_02_19_00/2019_12_02_19_00.mpg;YUriko Koike.jpg;20405;20561;36081;1020;1028;8
/net/per610a/home/mvp/mvp_db/news7-lv/2019/2019_12_05_19_00/2019_12_05_19_00.mpg;Shinzo ABE.jpg;1153;1341;36081;57;67;10
/net/per610a/home/mvp/mvp_db/news7-lv/2019/2019_12_05_19_00/2019_12_05_19_00.mpg;Shinzo ABE.jpg;1913;2013;36081;95;100;5
/net/per610a/home/mvp/mvp_db/news7-lv/2019/2019_12_05_19_00/2019_12_05_19_00.mpg;Shinzo ABE.jpg;6633;6661;36081;331;333;2
/net/per610a/home/mvp/mvp_db/news7-lv/2019/2019_12_05_19_00/2019_12_05_19_00.mpg;Taro ASO.jpg;14353;14713;36081;718;736;18
/net/per610a/home/mvp/mvp_db/news7-lv/2019/2019_12_06_19_00/2019_12_06_19_00.mpg;Seiji Mataichi.jpg;10653;11033;36081;532;551;19
/net/per610a/home/mvp/mvp_db/news7-lv/2019/2019_12_06_19_00/2019_12_06_19_00.mpg;Yukio EDANO.jpg;10653;11033;36081;532;551;19
/net/per610a/home/mvp/mvp_db/news7-lv/2019/2019_12_06_19_00/2019_12_06_19_00.mpg;Yukio EDANO.jpg;12973;13381;36081;648;669;21
/net/per610a/home/mvp/mvp_db/news7-lv/2019/2019_12_06_19_00/2019_12_06_19_00.mpg;Yukio EDANO.jpg;14473;15761;36081;724;788;64
/net/per610a/home/mvp/mvp_db/news7-lv/2019/2019_12_06_19_00/2019_12_06_19_00.mpg;Yuichiro Tamaki.png;10653;11373;36081;532;568;36
/net/per610a/home/mvp/mvp_db/news7-lv/2019/2019_12_06_19_00/2019_12_06_19_00.mpg;Yuichiro Tamaki.png;12149;12885;36081;607;644;37
/net/per610a/home/mvp/mvp_db/news7-lv/2019/2019_12_06_19_00/2019_12_06_19_00.mpg;Yuichiro Tamaki.png;15237;15861;36081;762;793;31
/net/per610a/home/mvp/mvp_db/news7-lv/2019/2019_12_06_19_00/2019_12_06_19_00.mpg;Yukio EDANO.jpg;11509;11673;36081;575;583;8
/net/per610a/home/mvp/mvp_db/news7-lv/2019/2019_12_06_19_00/2019_12_06_19_00.mpg;Yukio EDANO.jpg;12025;12113;36081;601;605;4
/net/per610a/home/mvp/mvp_db/news7-lv/2019/2019_12_06_19_00/2019_12_06_19_00.mpg;Yukio EDANO.jpg;15961;16025;36081;798;801;3
/net/per610a/home/mvp/mvp_db/news7-lv/2019/2019_12_06_19_00/2019_12_06_19_00.mpg;Yukio EDANO.jpg;16653;16781;36081;833;839;6
/net/per610a/home/mvp/mvp_db/news7-lv/2019/2019_12_06_19_00/2019_12_06_19_00.mpg;Yukio EDANO.jpg;28281;28365;36081;1414;1418;4
/net/per610a/home/mvp/mvp_db/news7-lv/2019/2019_12_06_19_00/2019_12_06_19_00.mpg;Yuichiro Tamaki.png;16037;16593;36081;802;830;28
/net/per610a/home/mvp/mvp_db/news7-lv/2019/2019_12_06_19_00/2019_12_06_19_00.mpg;Yuichiro Tamaki.png;28373;28613;36081;1419;1431;12
/net/per610a/home/mvp/mvp_db/news7-lv/2019/2019_12_06_19_00/2019_12_06_19_00.mpg;Shinzo ABE.jpg;16925;17073;36081;846;854;8
/net/per610a/home/mvp/mvp_db/hodost-lv/2014/2014_01_05_04_56/2014_01_05_10_00.mpg;Shinzo ABE.jpg;1093;1181;209805;54;59;5
/net/per610a/home/mvp/mvp_db/hodost-lv/2014/2014_01_05_04_56/2014_01_05_10_00.mpg;Shinzo ABE.jpg;1257;1357;209805;62;67;5
/net/per610a/home/mvp/mvp_db/hodost-lv/2014/2014_01_05_04_56/2014_01_05_10_00.mpg;Shinzo ABE.jpg;21489;21777;209805;1075;1089;14
/net/per610a/home/mvp/mvp_db/hodost-lv/2014/2014_01_05_04_56/2014_01_05_10_00.mpg;Shinzo ABE.jpg;22729;22789;209805;1137;1140;3
/net/per610a/home/mvp/mvp_db/hodost-lv/2014/2014_01_05_04_56/2014_01_05_10_00.mpg;Shinzo ABE.jpg;39333;39365;209805;1968;1970;2
/net/per610a/home/mvp/mvp_db/hodost-lv/2014/2014_01_05_04_56/2014_01_05_10_00.mpg;Shinzo ABE.jpg;39629;39757;209805;1983;1989;6
/net/per610a/home/mvp/mvp_db/hodost-lv/2014/2014_01_05_04_56/2014_01_05_10_00.mpg;Shinzo ABE.jpg;138273;138273;209805;6920;6920;0
/net/per610a/home/mvp/mvp_db/hodost-lv/2014/2014_01_05_04_56/2014_01_05_10_00.mpg;Shinzo ABE.jpg;203917;204189;209805;10205;10218;13
/net/per610a/home/mvp/mvp_db/hodost-lv/2014/2014_01_05_04_56/2014_01_05_10_00.mpg;Shintaro ISHIHARA.jpg;1441;1557;209805;72;77;5
/net/per610a/home/mvp/mvp_db/hodost-lv/2014/2014_01_05_04_56/2014_01_05_10_00.mpg;Shintaro ISHIHARA.jpg;9317;9425;209805;466;471;5
/net/per610a/home/mvp/mvp_db/hodost-lv/2014/2014_01_05_04_56/2014_01_05_10_00.mpg;Shintaro ISHIHARA.jpg;9493;9649;209805;475;482;7
/net/per610a/home/mvp/mvp_db/hodost-lv/2014/2014_01_05_04_56/2014_01_05_10_00.mpg;Shintaro ISHIHARA.jpg;14653;14845;209805;733;742;9
/net/per610a/home/mvp/mvp_db/hodost-lv/2014/2014_01_05_04_56/2014_01_05_10_00.mpg;Shintaro ISHIHARA.jpg;14985;15033;209805;749;752;3
/net/per610a/home/mvp/mvp_db/hodost-lv/2014/2014_01_05_04_56/2014_01_05_10_00.mpg;Shintaro ISHIHARA.jpg;19293;19805;209805;965;991;26
/net/per610a/home/mvp/mvp_db/hodost-lv/2014/2014_01_05_04_56/2014_01_05_10_00.mpg;Shintaro ISHIHARA.jpg;19937;20097;209805;997;1005;8
/net/per610a/home/mvp/mvp_db/hodost-lv/2014/2014_01_05_04_56/2014_01_05_10_00.mpg;Shintaro ISHIHARA.jpg;28297;28733;209805;1416;1437;21
/net/per610a/home/mvp/mvp_db/hodost-lv/2014/2014_01_05_04_56/2014_01_05_10_00.mpg;Shintaro ISHIHARA.jpg;28929;29145;209805;1447;1458;11
/net/per610a/home/mvp/mvp_db/hodost-lv/2014/2014_01_05_04_56/2014_01_05_10_00.mpg;Shintaro ISHIHARA.jpg;29613;29613;209805;1482;1482;0
/net/per610a/home/mvp/mvp_db/hodost-lv/2014/2014_01_05_04_56/2014_01_05_10_00.mpg;Shintaro ISHIHARA.jpg;29701;30141;209805;1486;1508;22
/net/per610a/home/mvp/mvp_db/hodost-lv/2014/2014_01_05_04_56/2014_01_05_10_00.mpg;Shintaro ISHIHARA.jpg;30329;30585;209805;1517;1530;13
/net/per610a/home/mvp/mvp_db/hodost-lv/2014/2014_01_05_04_56/2014_01_05_10_00.mpg;Shintaro ISHIHARA.jpg;30769;30957;209805;1539;1549;10
/net/per610a/home/mvp/mvp_db/hodost-lv/2014/2014_01_05_04_56/2014_01_05_10_00.mpg;Shintaro ISHIHARA.jpg;31137;31401;209805;1558;1571;13
/net/per610a/home/mvp/mvp_db/hodost-lv/2014/2014_01_05_04_56/2014_01_05_10_00.mpg;Shintaro ISHIHARA.jpg;32249;32589;209805;1613;1630;17
/net/per610a/home/mvp/mvp_db/hodost-lv/2014/2014_01_05_04_56/2014_01_05_10_00.mpg;Shintaro ISHIHARA.jpg;32801;33053;209805;1641;1654;13
/net/per610a/home/mvp/mvp_db/hodost-lv/2014/2014_01_05_04_56/2014_01_05_10_00.mpg;Shintaro ISHIHARA.jpg;33117;33417;209805;1657;1672;15
/net/per610a/home/mvp/mvp_db/hodost-lv/2014/2014_01_05_04_56/2014_01_05_10_00.mpg;Shintaro ISHIHARA.jpg;33741;34093;209805;1688;1706;18
/net/per610a/home/mvp/mvp_db/hodost-lv/2014/2014_01_05_04_56/2014_01_05_10_00.mpg;Shintaro ISHIHARA.jpg;34181;34517;209805;1710;1727;17
/net/per610a/home/mvp/mvp_db/hodost-lv/2014/2014_01_05_04_56/2014_01_05_10_00.mpg;Shintaro ISHIHARA.jpg;34745;35117;209805;1738;1757;19
/net/per610a/home/mvp/mvp_db/hodost-lv/2014/2014_01_05_04_56/2014_01_05_10_00.mpg;Shintaro ISHIHARA.jpg;35221;35433;209805;1762;1773;11
/net/per610a/home/mvp/mvp_db/hodost-lv/2014/2014_01_05_04_56/2014_01_05_10_00.mpg;Shintaro ISHIHARA.jpg;35569;36161;209805;1780;1809;29
/net/per610a/home/mvp/mvp_db/hodost-lv/2014/2014_01_05_04_56/2014_01_05_10_00.mpg;Shintaro ISHIHARA.jpg;36313;36673;209805;1817;1835;18
/net/per610a/home/mvp/mvp_db/hodost-lv/2014/2014_01_05_04_56/2014_01_05_10_00.mpg;Shintaro ISHIHARA.jpg;37117;37321;209805;1857;1867;10
/net/per610a/home/mvp/mvp_db/hodost-lv/2014/2014_01_05_04_56/2014_01_05_10_00.mpg;Shintaro ISHIHARA.jpg;42425;43057;209805;2123;2154;31
/net/per610a/home/mvp/mvp_db/hodost-lv/2014/2014_01_05_04_56/2014_01_05_10_00.mpg;Shintaro ISHIHARA.jpg;43333;44365;209805;2168;2220;52
/net/per610a/home/mvp/mvp_db/hodost-lv/2014/2014_01_05_04_56/2014_01_05_10_00.mpg;Shintaro ISHIHARA.jpg;44569;44637;209805;2230;2233;3
/net/per610a/home/mvp/mvp_db/hodost-lv/2014/2014_01_05_04_56/2014_01_05_10_00.mpg;Shintaro ISHIHARA.jpg;44977;45405;209805;2250;2272;22
/net/per610a/home/mvp/mvp_db/hodost-lv/2014/2014_01_05_04_56/2014_01_05_10_00.mpg;Shintaro ISHIHARA.jpg;45581;46133;209805;2281;2308;27
/net/per610a/home/mvp/mvp_db/hodost-lv/2014/2014_01_05_04_56/2014_01_05_10_00.mpg;Shintaro ISHIHARA.jpg;46325;46765;209805;2318;2340;22
/net/per610a/home/mvp/mvp_db/hodost-lv/2014/2014_01_05_04_56/2014_01_05_10_00.mpg;Shintaro ISHIHARA.jpg;47157;47301;209805;2360;2367;7
/net/per610a/home/mvp/mvp_db/hodost-lv/2014/2014_01_05_04_56/2014_01_05_10_00.mpg;Shintaro ISHIHARA.jpg;47493;47897;209805;2376;2397;21
/net/per610a/home/mvp/mvp_db/hodost-lv/2014/2014_01_05_04_56/2014_01_05_10_00.mpg;Shintaro ISHIHARA.jpg;48221;48861;209805;2413;2445;32
/net/per610a/home/mvp/mvp_db/hodost-lv/2014/2014_01_05_04_56/2014_01_05_10_00.mpg;Shintaro ISHIHARA.jpg;49037;49549;209805;2454;2479;25
/net/per610a/home/mvp/mvp_db/hodost-lv/2014/2014_01_05_04_56/2014_01_05_10_00.mpg;Shintaro ISHIHARA.jpg;49777;50209;209805;2491;2512;21
/net/per610a/home/mvp/mvp_db/hodost-lv/2014/2014_01_05_04_56/2014_01_05_10_00.mpg;Shintaro ISHIHARA.jpg;50341;50625;209805;2519;2533;14
/net/per610a/home/mvp/mvp_db/hodost-lv/2014/2014_01_05_04_56/2014_01_05_10_00.mpg;Shintaro ISHIHARA.jpg;50845;51025;209805;2544;2553;9
/net/per610a/home/mvp/mvp_db/hodost-lv/2014/2014_01_05_04_56/2014_01_05_10_00.mpg;Shintaro ISHIHARA.jpg;51129;51757;209805;2558;2590;32
/net/per610a/home/mvp/mvp_db/hodost-lv/2014/2014_01_05_04_56/2014_01_05_10_00.mpg;Shintaro ISHIHARA.jpg;51881;52257;209805;2596;2615;19
/net/per610a/home/mvp/mvp_db/hodost-lv/2014/2014_01_05_04_56/2014_01_05_10_00.mpg;Shintaro ISHIHARA.jpg;52385;52785;209805;2621;2641;20
/net/per610a/home/mvp/mvp_db/hodost-lv/2014/2014_01_05_04_56/2014_01_05_10_00.mpg;Shintaro ISHIHARA.jpg;52873;53297;209805;2646;2667;21
/net/per610a/home/mvp/mvp_db/hodost-lv/2014/2014_01_05_04_56/2014_01_05_10_00.mpg;Shintaro ISHIHARA.jpg;53545;53865;209805;2679;2695;16
/net/per610a/home/mvp/mvp_db/hodost-lv/2014/2014_01_06_04_56/2014_01_06_21_54.mpg;Shinzo ABE.jpg;2297;2613;91121;114;130;16
/net/per610a/home/mvp/mvp_db/hodost-lv/2014/2014_01_06_04_56/2014_01_06_21_54.mpg;Shinzo ABE.jpg;12377;12429;91121;619;621;2
/net/per610a/home/mvp/mvp_db/hodost-lv/2014/2014_01_06_04_56/2014_01_06_21_54.mpg;Shinzo ABE.jpg;13501;13581;91121;675;679;4
/net/per610a/home/mvp/mvp_db/hodost-lv/2014/2014_01_06_04_56/2014_01_06_21_54.mpg;Shinzo ABE.jpg;16425;16485;91121;821;824;3
/net/per610a/home/mvp/mvp_db/hodost-lv/2014/2014_01_06_04_56/2014_01_06_21_54.mpg;Shinzo ABE.jpg;16625;17249;91121;831;863;32
/net/per610a/home/mvp/mvp_db/hodost-lv/2014/2014_01_06_04_56/2014_01_06_21_54.mpg;Shinzo ABE.jpg;19485;19577;91121;975;979;4
/net/per610a/home/mvp/mvp_db/hodost-lv/2014/2014_01_06_04_56/2014_01_06_21_54.mpg;Shinzo ABE.jpg;50469;50565;91121;2525;2530;5
/net/per610a/home/mvp/mvp_db/hodost-lv/2014/2014_01_07_04_56/2014_01_07_21_54.mpg;Shinzo ABE.jpg;26489;27181;91125;1325;1360;35
/net/per610a/home/mvp/mvp_db/hodost-lv/2014/2014_01_07_04_56/2014_01_07_21_54.mpg;Shinzo ABE.jpg;28061;28101;91125;1404;1406;2
/net/per610a/home/mvp/mvp_db/hodost-lv/2014/2014_01_07_04_56/2014_01_07_21_54.mpg;Shinzo ABE.jpg;47429;47433;91125;2373;2373;0
/net/per610a/home/mvp/mvp_db/hodost-lv/2014/2014_01_07_04_56/2014_01_07_21_54.mpg;Shinzo ABE.jpg;73957;74085;91125;3700;3707;7
/net/per610a/home/mvp/mvp_db/hodost-lv/2014/2014_01_09_04_56/2014_01_09_22_09.mpg;Shinzo ABE.jpg;72157;72281;91121;3610;3617;7
/net/per610a/home/mvp/mvp_db/hodost-lv/2014/2014_01_09_04_56/2014_01_09_22_09.mpg;Shinzo ABE.jpg;72585;72649;91121;3632;3635;3
/net/per610a/home/mvp/mvp_db/hodost-lv/2014/2014_01_09_04_56/2014_01_09_22_09.mpg;Shinzo ABE.jpg;72745;72945;91121;3640;3650;10
/net/per610a/home/mvp/mvp_db/hodost-lv/2014/2014_01_09_04_56/2014_01_09_22_09.mpg;Shinzo ABE.jpg;73673;73693;91121;3686;3687;1
/net/per610a/home/mvp/mvp_db/hodost-lv/2014/2014_01_10_04_56/2014_01_10_21_54.mpg;Junichiro KOIZUMI.jpg;36773;37169;91113;1840;1860;20
/net/per610a/home/mvp/mvp_db/hodost-lv/2014/2014_01_14_04_56/2014_01_14_21_54.mpg;Shinzo ABE.jpg;13345;14249;91117;667;713;46
/net/per610a/home/mvp/mvp_db/hodost-lv/2014/2014_01_15_04_56/2014_01_15_21_54.mpg;Shinzo ABE.jpg;11713;11749;91117;586;587;1
/net/per610a/home/mvp/mvp_db/hodost-lv/2014/2014_01_15_04_56/2014_01_15_21_54.mpg;Shinzo ABE.jpg;13269;13405;91117;664;670;6
/net/per610a/home/mvp/mvp_db/hodost-lv/2014/2014_01_15_04_56/2014_01_15_21_54.mpg;Shinzo ABE.jpg;13517;13813;91117;676;691;15
/net/per610a/home/mvp/mvp_db/hodost-lv/2014/2014_01_15_04_56/2014_01_15_21_54.mpg;Akihiro OHTA.jpg;24405;24821;91117;1221;1242;21
/net/per610a/home/mvp/mvp_db/hodost-lv/2014/2014_01_20_04_56/2014_01_20_21_54.mpg;Shinzo ABE.jpg;15125;15261;91121;756;763;7
/net/per610a/home/mvp/mvp_db/hodost-lv/2014/2014_01_20_04_56/2014_01_20_21_54.mpg;Shinzo ABE.jpg;29877;30057;91121;1495;1504;9
/net/per610a/home/mvp/mvp_db/hodost-lv/2014/2014_01_20_04_56/2014_01_20_21_54.mpg;Shinzo ABE.jpg;67925;67977;91121;3399;3401;2
/net/per610a/home/mvp/mvp_db/hodost-lv/2014/2014_01_20_04_56/2014_01_20_21_54.mpg;Shinzo ABE.jpg;68065;68261;91121;3406;3416;10
/net/per610a/home/mvp/mvp_db/hodost-lv/2014/2014_01_20_04_56/2014_01_20_21_54.mpg;Yukio HATOYAMA.jpg;27997;28149;91121;1401;1408;7
/net/per610a/home/mvp/mvp_db/hodost-lv/2014/2014_01_21_04_56/2014_01_21_21_54.mpg;Akihiro OHTA.jpg;28221;28309;91113;1412;1416;4
/net/per610a/home/mvp/mvp_db/hodost-lv/2014/2014_01_21_04_56/2014_01_21_21_54.mpg;Shinzo ABE.jpg;35541;35929;91113;1778;1798;20
/net/per610a/home/mvp/mvp_db/hodost-lv/2014/2014_01_22_04_56/2014_01_22_21_54.mpg;Yukio HATOYAMA.jpg;7901;8597;91117;395;430;35
/net/per610a/home/mvp/mvp_db/hodost-lv/2014/2014_01_23_04_56/2014_01_23_21_54.mpg;Shinzo ABE.jpg;64449;64465;91117;3225;3226;1
/net/per610a/home/mvp/mvp_db/hodost-lv/2014/2014_01_23_04_56/2014_01_23_21_54.mpg;Shinzo ABE.jpg;64685;65033;91117;3237;3254;17
/net/per610a/home/mvp/mvp_db/hodost-lv/2014/2014_01_23_04_56/2014_01_23_21_54.mpg;Shinzo ABE.jpg;65417;65489;91117;3273;3277;4
/net/per610a/home/mvp/mvp_db/hodost-lv/2014/2014_01_23_04_56/2014_01_23_21_54.mpg;Shinzo ABE.jpg;65157;65249;91117;3260;3265;5
/net/per610a/home/mvp/mvp_db/hodost-lv/2014/2014_01_24_04_56/2014_01_24_21_54.mpg;Natsuo YAMAGUCHI.jpg;30689;31017;91121;1535;1552;17
/net/per610a/home/mvp/mvp_db/hodost-lv/2014/2014_01_24_04_56/2014_01_24_21_54.mpg;Shinzo ABE.jpg;35645;35681;91121;1783;1785;2
/net/per610a/home/mvp/mvp_db/hodost-lv/2014/2014_01_24_04_56/2014_01_24_21_54.mpg;Shinzo ABE.jpg;35753;35861;91121;1789;1794;5
/net/per610a/home/mvp/mvp_db/hodost-lv/2014/2014_01_24_04_56/2014_01_24_21_54.mpg;Shinzo ABE.jpg;36293;36413;91121;1816;1822;6
/net/per610a/home/mvp/mvp_db/hodost-lv/2014/2014_01_24_04_56/2014_01_24_21_54.mpg;Kenji Eda.jpg;85261;85685;91121;4266;4287;21
/net/per610a/home/mvp/mvp_db/hodost-lv/2014/2014_01_26_04_56/2014_01_26_10_00.mpg;Yukio HATOYAMA.jpg;78125;78225;125889;3909;3914;5
/net/per610a/home/mvp/mvp_db/hodost-lv/2014/2014_01_26_04_56/2014_01_26_10_00.mpg;Yukio HATOYAMA.jpg;78513;78581;125889;3929;3932;3
/net/per610a/home/mvp/mvp_db/hodost-lv/2014/2014_01_26_04_56/2014_01_26_10_00.mpg;Yukio HATOYAMA.jpg;79249;79305;125889;3965;3968;3
/net/per610a/home/mvp/mvp_db/hodost-lv/2014/2014_01_26_04_56/2014_01_26_10_00.mpg;Yukio HATOYAMA.jpg;79525;79933;125889;3979;4000;21
/net/per610a/home/mvp/mvp_db/hodost-lv/2014/2014_01_26_04_56/2014_01_26_10_00.mpg;Yukio HATOYAMA.jpg;81537;81993;125889;4080;4103;23
/net/per610a/home/mvp/mvp_db/hodost-lv/2014/2014_01_26_04_56/2014_01_26_10_00.mpg;Yukio HATOYAMA.jpg;87969;88069;125889;4402;4407;5
/net/per610a/home/mvp/mvp_db/hodost-lv/2014/2014_01_26_04_56/2014_01_26_10_00.mpg;Yukio HATOYAMA.jpg;88205;88601;125889;4414;4433;19
/net/per610a/home/mvp/mvp_db/hodost-lv/2014/2014_01_26_04_56/2014_01_26_10_00.mpg;Yukio HATOYAMA.jpg;91381;91437;125889;4573;4575;2
/net/per610a/home/mvp/mvp_db/hodost-lv/2014/2014_01_26_04_56/2014_01_26_10_00.mpg;Yukio HATOYAMA.jpg;94485;94533;125889;4728;4730;2
/net/per610a/home/mvp/mvp_db/hodost-lv/2014/2014_01_26_04_56/2014_01_26_10_00.mpg;Yukio HATOYAMA.jpg;95713;96021;125889;4789;4805;16
/net/per610a/home/mvp/mvp_db/hodost-lv/2014/2014_01_26_04_56/2014_01_26_10_00.mpg;Yukio HATOYAMA.jpg;96093;96437;125889;4808;4826;18
/net/per610a/home/mvp/mvp_db/hodost-lv/2014/2014_01_28_04_56/2014_01_28_21_54.mpg;Shinzo ABE.jpg;1177;1345;91125;58;67;9
/net/per610a/home/mvp/mvp_db/hodost-lv/2014/2014_01_28_04_56/2014_01_28_21_54.mpg;Shinzo ABE.jpg;6285;6477;91125;314;324;10
/net/per610a/home/mvp/mvp_db/hodost-lv/2014/2014_01_28_04_56/2014_01_28_21_54.mpg;Shinzo ABE.jpg;9141;9501;91125;457;475;18
/net/per610a/home/mvp/mvp_db/hodost-lv/2014/2014_01_28_04_56/2014_01_28_21_54.mpg;Shinzo ABE.jpg;12445;12481;91125;622;624;2
/net/per610a/home/mvp/mvp_db/hodost-lv/2014/2014_01_28_04_56/2014_01_28_21_54.mpg;Shinzo ABE.jpg;24289;24377;91125;1215;1219;4
/net/per610a/home/mvp/mvp_db/hodost-lv/2014/2014_01_28_04_56/2014_01_28_21_54.mpg;Yoshimi WATANABE.jpg;1913;2025;91125;95;101;6
/net/per610a/home/mvp/mvp_db/hodost-lv/2014/2014_01_28_04_56/2014_01_28_21_54.mpg;Yoshimi WATANABE.jpg;11625;11713;91125;581;586;5
/net/per610a/home/mvp/mvp_db/hodost-lv/2014/2014_01_28_04_56/2014_01_28_21_54.mpg;Natsuo YAMAGUCHI.jpg;10933;11565;91125;547;578;31
/net/per610a/home/mvp/mvp_db/hodost-lv/2014/2014_01_29_04_56/2014_01_29_21_54.mpg;Shinzo ABE.jpg;15349;15665;91117;768;783;15
/net/per610a/home/mvp/mvp_db/hodost-lv/2014/2014_01_29_04_56/2014_01_29_21_54.mpg;Shinzo ABE.jpg;17629;17921;91117;882;896;14
/net/per610a/home/mvp/mvp_db/hodost-lv/2014/2014_01_29_04_56/2014_01_29_21_54.mpg;Shinzo ABE.jpg;22349;22433;91117;1118;1122;4
/net/per610a/home/mvp/mvp_db/hodost-lv/2014/2014_01_29_04_56/2014_01_29_21_54.mpg;Shinzo ABE.jpg;22593;22629;91117;1130;1132;2
/net/per610a/home/mvp/mvp_db/hodost-lv/2014/2014_01_29_04_56/2014_01_29_21_54.mpg;Yoshimi WATANABE.jpg;22757;22837;91117;1138;1142;4
/net/per610a/home/mvp/mvp_db/hodost-lv/2014/2014_01_29_04_56/2014_01_29_21_54.mpg;Yoshimi WATANABE.jpg;22933;23061;91117;1147;1154;7
/net/per610a/home/mvp/mvp_db/hodost-lv/2014/2014_01_30_04_56/2014_01_30_21_54.mpg;Natsuo YAMAGUCHI.jpg;44945;44945;91121;2249;2249;0
/net/per610a/home/mvp/mvp_db/hodost-lv/2014/2014_01_30_04_56/2014_01_30_21_54.mpg;Natsuo YAMAGUCHI.jpg;48433;48501;91121;2423;2427;4
/net/per610a/home/mvp/mvp_db/hodost-lv/2014/2014_01_30_04_56/2014_01_30_21_54.mpg;Natsuo YAMAGUCHI.jpg;50653;50745;91121;2534;2539;5
/net/per610a/home/mvp/mvp_db/hodost-lv/2014/2014_02_02_04_56/2014_02_02_10_00.mpg;Yorihisa Matsuno.png;1705;1745;125881;85;87;2
/net/per610a/home/mvp/mvp_db/hodost-lv/2014/2014_02_02_04_56/2014_02_02_10_00.mpg;Yorihisa Matsuno.png;2837;3081;125881;141;154;13
/net/per610a/home/mvp/mvp_db/hodost-lv/2014/2014_02_02_04_56/2014_02_02_10_00.mpg;Shinzo ABE.jpg;121893;121941;125881;6100;6102;2
/net/per610a/home/mvp/mvp_db/hodost-lv/2014/2014_02_02_04_56/2014_02_02_10_00.mpg;Shinzo ABE.jpg;122917;123017;125881;6151;6156;5
/net/per610a/home/mvp/mvp_db/hodost-lv/2014/2014_02_03_04_56/2014_02_03_21_54.mpg;Natsuo YAMAGUCHI.jpg;39737;39877;91121;1988;1995;7
/net/per610a/home/mvp/mvp_db/hodost-lv/2014/2014_02_04_04_56/2014_02_04_21_54.mpg;Shinzo ABE.jpg;19437;20561;91117;972;1028;56
/net/per610a/home/mvp/mvp_db/hodost-lv/2014/2014_02_04_04_56/2014_02_04_21_54.mpg;Shinzo ABE.jpg;24585;24661;91117;1230;1234;4
/net/per610a/home/mvp/mvp_db/hodost-lv/2014/2014_02_04_04_56/2014_02_04_21_54.mpg;Shinzo ABE.jpg;33621;33661;91117;1682;1684;2
/net/per610a/home/mvp/mvp_db/hodost-lv/2014/2014_02_04_04_56/2014_02_04_21_54.mpg;Taro ASO.jpg;19465;19617;91117;974;981;7
/net/per610a/home/mvp/mvp_db/hodost-lv/2014/2014_02_04_04_56/2014_02_04_21_54.mpg;Taro ASO.jpg;19797;19797;91117;990;990;0
/net/per610a/home/mvp/mvp_db/hodost-lv/2014/2014_02_04_04_56/2014_02_04_21_54.mpg;Taro ASO.jpg;19861;19861;91117;993;993;0
/net/per610a/home/mvp/mvp_db/hodost-lv/2014/2014_02_04_04_56/2014_02_04_21_54.mpg;Taro ASO.jpg;20009;20281;91117;1001;1014;13
/net/per610a/home/mvp/mvp_db/hodost-lv/2014/2014_02_04_04_56/2014_02_04_21_54.mpg;Taro ASO.jpg;20357;20445;91117;1018;1023;5
/net/per610a/home/mvp/mvp_db/hodost-lv/2014/2014_02_04_04_56/2014_02_04_21_54.mpg;Taro ASO.jpg;35101;35413;91117;1756;1772;16
/net/per610a/home/mvp/mvp_db/hodost-lv/2014/2014_02_04_04_56/2014_02_04_21_54.mpg;Shinzo ABE.jpg;20905;21025;91117;1046;1052;6
/net/per610a/home/mvp/mvp_db/hodost-lv/2014/2014_02_04_04_56/2014_02_04_21_54.mpg;Shinzo ABE.jpg;21413;21685;91117;1071;1085;14
/net/per610a/home/mvp/mvp_db/hodost-lv/2014/2014_02_04_04_56/2014_02_04_21_54.mpg;Shinzo ABE.jpg;22305;22777;91117;1116;1139;23
/net/per610a/home/mvp/mvp_db/hodost-lv/2014/2014_02_04_04_56/2014_02_04_21_54.mpg;Shinzo ABE.jpg;24321;24465;91117;1217;1224;7
/net/per610a/home/mvp/mvp_db/hodost-lv/2014/2014_02_04_04_56/2014_02_04_21_54.mpg;Shinzo ABE.jpg;29713;29773;91117;1487;1490;3
/net/per610a/home/mvp/mvp_db/hodost-lv/2014/2014_02_04_04_56/2014_02_04_21_54.mpg;Shinzo ABE.jpg;47449;47649;91117;2374;2384;10
/net/per610a/home/mvp/mvp_db/hodost-lv/2014/2014_02_04_04_56/2014_02_04_21_54.mpg;Natsuo YAMAGUCHI.jpg;47257;47325;91117;2365;2368;3
/net/per610a/home/mvp/mvp_db/hodost-lv/2014/2014_02_04_04_56/2014_02_04_21_54.mpg;Natsuo YAMAGUCHI.jpg;47449;47461;91117;2374;2375;1
/net/per610a/home/mvp/mvp_db/hodost-lv/2014/2014_02_04_04_56/2014_02_04_21_54.mpg;Junichiro KOIZUMI.jpg;48505;48661;91117;2427;2435;8
/net/per610a/home/mvp/mvp_db/hodost-lv/2014/2014_02_04_04_56/2014_02_04_21_54.mpg;Shintaro ISHIHARA.jpg;49485;50069;91117;2476;2505;29
/net/per610a/home/mvp/mvp_db/hodost-lv/2014/2014_02_09_04_56/2014_02_09_10_00.mpg;Shinzo ABE.jpg;53833;53873;125885;2694;2696;2
/net/per610a/home/mvp/mvp_db/hodost-lv/2014/2014_02_09_04_56/2014_02_09_10_00.mpg;Shinzo ABE.jpg;53973;54033;125885;2701;2704;3
/net/per610a/home/mvp/mvp_db/hodost-lv/2014/2014_02_10_04_56/2014_02_10_21_54.mpg;Shinzo ABE.jpg;2173;2225;91117;108;111;3
/net/per610a/home/mvp/mvp_db/hodost-lv/2014/2014_02_10_04_56/2014_02_10_21_54.mpg;Shinzo ABE.jpg;5305;5333;91117;265;266;1
/net/per610a/home/mvp/mvp_db/hodost-lv/2014/2014_02_10_04_56/2014_02_10_21_54.mpg;Shinzo ABE.jpg;5413;5421;91117;270;271;1
/net/per610a/home/mvp/mvp_db/hodost-lv/2014/2014_02_10_04_56/2014_02_10_21_54.mpg;Shinzo ABE.jpg;18193;18245;91117;910;913;3
/net/per610a/home/mvp/mvp_db/hodost-lv/2014/2014_02_10_04_56/2014_02_10_21_54.mpg;Shinzo ABE.jpg;18573;18961;91117;929;948;19
/net/per610a/home/mvp/mvp_db/hodost-lv/2014/2014_02_10_04_56/2014_02_10_21_54.mpg;Shinzo ABE.jpg;23157;23157;91117;1158;1158;0
/net/per610a/home/mvp/mvp_db/hodost-lv/2014/2014_02_10_04_56/2014_02_10_21_54.mpg;Shinzo ABE.jpg;23229;23853;91117;1162;1193;31
/net/per610a/home/mvp/mvp_db/hodost-lv/2014/2014_02_10_04_56/2014_02_10_21_54.mpg;Shinzo ABE.jpg;26769;26917;91117;1339;1347;8
/net/per610a/home/mvp/mvp_db/hodost-lv/2014/2014_02_12_04_56/2014_02_12_21_54.mpg;Shinzo ABE.jpg;38133;38177;91117;1908;1910;2
/net/per610a/home/mvp/mvp_db/hodost-lv/2014/2014_02_12_04_56/2014_02_12_21_54.mpg;Shinzo ABE.jpg;40505;40757;91117;2027;2039;12
/net/per610a/home/mvp/mvp_db/hodost-lv/2014/2014_02_12_04_56/2014_02_12_21_54.mpg;Shinzo ABE.jpg;42693;42769;91117;2136;2140;4
/net/per610a/home/mvp/mvp_db/hodost-lv/2014/2014_02_12_04_56/2014_02_12_21_54.mpg;Shinzo ABE.jpg;43553;43565;91117;2179;2180;1
/net/per610a/home/mvp/mvp_db/hodost-lv/2014/2014_02_12_04_56/2014_02_12_21_54.mpg;Shinzo ABE.jpg;44405;44593;91117;2222;2231;9
/net/per610a/home/mvp/mvp_db/hodost-lv/2014/2014_02_13_04_56/2014_02_13_21_54.mpg;Shinzo ABE.jpg;47061;47141;91121;2355;2359;4
/net/per610a/home/mvp/mvp_db/hodost-lv/2014/2014_02_13_04_56/2014_02_13_21_54.mpg;Shinzo ABE.jpg;49533;49673;91121;2478;2485;7
/net/per610a/home/mvp/mvp_db/hodost-lv/2014/2014_02_16_04_56/2014_02_16_10_00.mpg;Shinzo ABE.jpg;120797;120937;125885;6045;6052;7
/net/per610a/home/mvp/mvp_db/hodost-lv/2014/2014_02_16_04_56/2014_02_16_10_00.mpg;Shinzo ABE.jpg;123013;123069;125885;6156;6159;3
/net/per610a/home/mvp/mvp_db/hodost-lv/2014/2014_02_16_04_56/2014_02_16_10_00.mpg;Natsuo YAMAGUCHI.jpg;120801;120933;125885;6045;6052;7
/net/per610a/home/mvp/mvp_db/hodost-lv/2014/2014_02_19_04_56/2014_02_19_21_54.mpg;Shinzo ABE.jpg;34517;34601;91117;1727;1731;4
/net/per610a/home/mvp/mvp_db/hodost-lv/2014/2014_02_19_04_56/2014_02_19_21_54.mpg;Shinzo ABE.jpg;38113;38389;91117;1907;1921;14
/net/per610a/home/mvp/mvp_db/hodost-lv/2014/2014_02_19_04_56/2014_02_19_21_54.mpg;Shinzo ABE.jpg;40305;40481;91117;2017;2025;8
/net/per610a/home/mvp/mvp_db/hodost-lv/2014/2014_02_19_04_56/2014_02_19_21_54.mpg;Shinzo ABE.jpg;40681;41081;91117;2035;2055;20
/net/per610a/home/mvp/mvp_db/hodost-lv/2014/2014_02_20_04_56/2014_02_20_21_54.mpg;Shinzo ABE.jpg;11165;11361;91121;558;568;10
/net/per610a/home/mvp/mvp_db/hodost-lv/2014/2014_02_20_04_56/2014_02_20_21_54.mpg;Shinzo ABE.jpg;13461;13661;91121;673;683;10
/net/per610a/home/mvp/mvp_db/hodost-lv/2014/2014_02_20_04_56/2014_02_20_21_54.mpg;Shinzo ABE.jpg;13873;14389;91121;694;720;26
/net/per610a/home/mvp/mvp_db/hodost-lv/2014/2014_02_20_04_56/2014_02_20_21_54.mpg;Shinzo ABE.jpg;15053;15445;91121;753;772;19
/net/per610a/home/mvp/mvp_db/hodost-lv/2014/2014_02_20_04_56/2014_02_20_21_54.mpg;Shinzo ABE.jpg;16649;16805;91121;833;840;7
/net/per610a/home/mvp/mvp_db/hodost-lv/2014/2014_02_20_04_56/2014_02_20_21_54.mpg;Shinzo ABE.jpg;21081;21321;91121;1054;1066;12
/net/per610a/home/mvp/mvp_db/hodost-lv/2014/2014_02_20_04_56/2014_02_20_21_54.mpg;Shinzo ABE.jpg;21589;21705;91121;1080;1086;6
/net/per610a/home/mvp/mvp_db/hodost-lv/2014/2014_02_23_04_56/2014_02_23_10_00.mpg;Shinzo ABE.jpg;109565;109889;125885;5483;5499;16
/net/per610a/home/mvp/mvp_db/hodost-lv/2014/2014_02_25_04_56/2014_02_25_21_54.mpg;Shinzo ABE.jpg;33305;33461;91121;1666;1674;8
/net/per610a/home/mvp/mvp_db/hodost-lv/2014/2014_02_25_04_56/2014_02_25_21_54.mpg;Natsuo YAMAGUCHI.jpg;33305;33461;91121;1666;1674;8
/net/per610a/home/mvp/mvp_db/hodost-lv/2014/2014_02_26_04_56/2014_02_26_21_54.mpg;Natsuo YAMAGUCHI.jpg;28701;28893;91117;1436;1445;9
/net/per610a/home/mvp/mvp_db/hodost-lv/2014/2014_02_27_04_56/2014_02_27_21_54.mpg;Shinzo ABE.jpg;27257;27377;91117;1364;1370;6
/net/per610a/home/mvp/mvp_db/hodost-lv/2014/2014_03_03_04_56/2014_03_03_21_54.mpg;Shinzo ABE.jpg;31349;31885;91121;1568;1595;27
/net/per610a/home/mvp/mvp_db/hodost-lv/2014/2014_03_03_04_56/2014_03_03_21_54.mpg;Shinzo ABE.jpg;40277;40817;91121;2015;2042;27
/net/per610a/home/mvp/mvp_db/hodost-lv/2014/2014_03_03_04_56/2014_03_03_21_54.mpg;Shinzo ABE.jpg;42133;42889;91121;2108;2146;38
/net/per610a/home/mvp/mvp_db/hodost-lv/2014/2014_03_03_04_56/2014_03_03_21_54.mpg;Shinzo ABE.jpg;43425;43489;91121;2173;2176;3
/net/per610a/home/mvp/mvp_db/hodost-lv/2014/2014_03_03_04_56/2014_03_03_21_54.mpg;Shinzo ABE.jpg;43757;44089;91121;2189;2206;17
/net/per610a/home/mvp/mvp_db/hodost-lv/2014/2014_03_04_04_56/2014_03_04_21_54.mpg;Toranosuke Katayama.jpg;44161;44401;91125;2209;2221;12
/net/per610a/home/mvp/mvp_db/hodost-lv/2014/2014_03_04_04_56/2014_03_04_21_54.mpg;Shinzo ABE.jpg;50993;51013;91125;2551;2552;1
/net/per610a/home/mvp/mvp_db/hodost-lv/2014/2014_03_04_04_56/2014_03_04_21_54.mpg;Shinzo ABE.jpg;51657;51757;91125;2584;2589;5
/net/per610a/home/mvp/mvp_db/hodost-lv/2014/2014_03_06_04_56/2014_03_06_21_54.mpg;Natsuo YAMAGUCHI.jpg;60281;60501;91121;3016;3027;11
/net/per610a/home/mvp/mvp_db/hodost-lv/2014/2014_03_07_04_56/2014_03_07_21_54.mpg;Shinzo ABE.jpg;26517;26861;91113;1327;1344;17
/net/per610a/home/mvp/mvp_db/hodost-lv/2014/2014_03_09_04_56/2014_03_09_10_00.mpg;Shinzo ABE.jpg;46741;46965;125881;2339;2350;11
/net/per610a/home/mvp/mvp_db/hodost-lv/2014/2014_03_09_04_56/2014_03_09_10_00.mpg;Shinzo ABE.jpg;120369;120465;125881;6024;6028;4
/net/per610a/home/mvp/mvp_db/hodost-lv/2014/2014_03_10_04_56/2014_03_10_21_54.mpg;Shinzo ABE.jpg;31565;31733;91117;1579;1588;9
/net/per610a/home/mvp/mvp_db/hodost-lv/2014/2014_03_10_04_56/2014_03_10_21_54.mpg;Shinzo ABE.jpg;33593;33689;91117;1681;1685;4
/net/per610a/home/mvp/mvp_db/hodost-lv/2014/2014_03_10_04_56/2014_03_10_21_54.mpg;Shinzo ABE.jpg;67001;67017;91117;3353;3353;0
/net/per610a/home/mvp/mvp_db/hodost-lv/2014/2014_03_10_04_56/2014_03_10_21_54.mpg;Shinzo ABE.jpg;67221;67793;91117;3364;3392;28
/net/per610a/home/mvp/mvp_db/hodost-lv/2014/2014_03_10_04_56/2014_03_10_21_54.mpg;Shinzo ABE.jpg;68009;68185;91117;3403;3412;9
/net/per610a/home/mvp/mvp_db/hodost-lv/2014/2014_03_10_04_56/2014_03_10_21_54.mpg;Shinzo ABE.jpg;71781;71805;91117;3592;3593;1
/net/per610a/home/mvp/mvp_db/hodost-lv/2014/2014_03_13_04_56/2014_03_13_21_54.mpg;Shinzo ABE.jpg;32981;33445;91121;1650;1673;23
/net/per610a/home/mvp/mvp_db/hodost-lv/2014/2014_03_13_04_56/2014_03_13_21_54.mpg;Shinzo ABE.jpg;43825;43929;91121;2193;2198;5
/net/per610a/home/mvp/mvp_db/hodost-lv/2014/2014_03_17_04_56/2014_03_17_21_54.mpg;Shinzo ABE.jpg;67193;67345;91121;3362;3370;8
/net/per610a/home/mvp/mvp_db/hodost-lv/2014/2014_03_18_04_56/2014_03_18_21_54.mpg;Shinzo ABE.jpg;10765;10889;91125;538;544;6
/net/per610a/home/mvp/mvp_db/hodost-lv/2014/2014_03_18_04_56/2014_03_18_21_54.mpg;Shinzo ABE.jpg;10953;10957;91125;548;548;0
/net/per610a/home/mvp/mvp_db/hodost-lv/2014/2014_03_19_04_56/2014_03_19_22_09.mpg;Shinzo ABE.jpg;15757;16101;91121;788;805;17
/net/per610a/home/mvp/mvp_db/hodost-lv/2014/2014_03_19_04_56/2014_03_19_22_09.mpg;Shinzo ABE.jpg;55629;56009;91121;2783;2802;19
/net/per610a/home/mvp/mvp_db/hodost-lv/2014/2014_03_20_04_56/2014_03_20_21_54.mpg;Shinzo ABE.jpg;24413;24797;91121;1221;1240;19
/net/per610a/home/mvp/mvp_db/hodost-lv/2014/2014_03_20_04_56/2014_03_20_21_54.mpg;Shinzo ABE.jpg;24929;25085;91121;1247;1255;8
/net/per610a/home/mvp/mvp_db/hodost-lv/2014/2014_03_20_04_56/2014_03_20_21_54.mpg;Shinzo ABE.jpg;25325;25389;91121;1267;1270;3
/net/per610a/home/mvp/mvp_db/hodost-lv/2014/2014_03_20_04_56/2014_03_20_21_54.mpg;Shinzo ABE.jpg;31041;31125;91121;1553;1557;4
/net/per610a/home/mvp/mvp_db/hodost-lv/2014/2014_03_20_04_56/2014_03_20_21_54.mpg;Shinzo ABE.jpg;25445;25897;91121;1273;1295;22
/net/per610a/home/mvp/mvp_db/hodost-lv/2014/2014_03_20_04_56/2014_03_20_21_54.mpg;Shinzo ABE.jpg;31161;31169;91121;1559;1559;0
/net/per610a/home/mvp/mvp_db/hodost-lv/2014/2014_03_21_04_56/2014_03_21_21_54.mpg;Shinzo ABE.jpg;42157;42185;91113;2109;2111;2
/net/per610a/home/mvp/mvp_db/hodost-lv/2014/2014_03_21_04_56/2014_03_21_21_54.mpg;Shinzo ABE.jpg;49721;49969;91113;2488;2500;12
/net/per610a/home/mvp/mvp_db/hodost-lv/2014/2014_03_21_04_56/2014_03_21_21_54.mpg;Shinzo ABE.jpg;50065;50101;91113;2505;2507;2
/net/per610a/home/mvp/mvp_db/hodost-lv/2014/2014_03_23_04_56/2014_03_23_10_00.mpg;Shinzo ABE.jpg;120321;121073;125881;6021;6059;38
/net/per610a/home/mvp/mvp_db/hodost-lv/2014/2014_03_24_04_56/2014_03_24_21_54.mpg;Shinzo ABE.jpg;2221;2341;91117;111;117;6
/net/per610a/home/mvp/mvp_db/hodost-lv/2014/2014_03_24_04_56/2014_03_24_21_54.mpg;Shinzo ABE.jpg;5817;6037;91117;291;302;11
/net/per610a/home/mvp/mvp_db/hodost-lv/2014/2014_03_24_04_56/2014_03_24_21_54.mpg;Shinzo ABE.jpg;10645;11137;91117;532;557;25
/net/per610a/home/mvp/mvp_db/hodost-lv/2014/2014_03_24_04_56/2014_03_24_21_54.mpg;Shinzo ABE.jpg;14033;14157;91117;702;708;6
/net/per610a/home/mvp/mvp_db/hodost-lv/2014/2014_03_24_04_56/2014_03_24_21_54.mpg;Shinzo ABE.jpg;14861;15029;91117;743;752;9
/net/per610a/home/mvp/mvp_db/hodost-lv/2014/2014_03_24_04_56/2014_03_24_21_54.mpg;Shinzo ABE.jpg;18545;19217;91117;928;961;33
/net/per610a/home/mvp/mvp_db/hodost-lv/2014/2014_03_26_04_56/2014_03_26_21_54.mpg;Shinzo ABE.jpg;1453;1657;91121;72;82;10
/net/per610a/home/mvp/mvp_db/hodost-lv/2014/2014_03_26_04_56/2014_03_26_21_54.mpg;Shinzo ABE.jpg;1949;1981;91121;97;99;2
/net/per610a/home/mvp/mvp_db/hodost-lv/2014/2014_03_26_04_56/2014_03_26_21_54.mpg;Shinzo ABE.jpg;8409;8485;91121;420;424;4
/net/per610a/home/mvp/mvp_db/hodost-lv/2014/2014_03_26_04_56/2014_03_26_21_54.mpg;Shinzo ABE.jpg;9621;9845;91121;481;492;11
/net/per610a/home/mvp/mvp_db/hodost-lv/2014/2014_03_26_04_56/2014_03_26_21_54.mpg;Shinzo ABE.jpg;12021;12649;91121;601;632;31
/net/per610a/home/mvp/mvp_db/hodost-lv/2014/2014_03_26_04_56/2014_03_26_21_54.mpg;Shinzo ABE.jpg;16421;16489;91121;821;825;4
/net/per610a/home/mvp/mvp_db/hodost-lv/2014/2014_03_26_04_56/2014_03_26_21_54.mpg;Shinzo ABE.jpg;18117;18549;91121;906;928;22
/net/per610a/home/mvp/mvp_db/hodost-lv/2014/2014_03_26_04_56/2014_03_26_21_54.mpg;Shinzo ABE.jpg;18697;18765;91121;935;939;4
/net/per610a/home/mvp/mvp_db/hodost-lv/2014/2014_03_26_04_56/2014_03_26_21_54.mpg;Shinzo ABE.jpg;18953;19145;91121;948;958;10
/net/per610a/home/mvp/mvp_db/hodost-lv/2014/2014_03_26_04_56/2014_03_26_21_54.mpg;Yoshimi WATANABE.jpg;21013;21397;91121;1051;1070;19
/net/per610a/home/mvp/mvp_db/hodost-lv/2014/2014_03_26_04_56/2014_03_26_21_54.mpg;Yoshimi WATANABE.jpg;24077;24781;91121;1204;1240;36
/net/per610a/home/mvp/mvp_db/hodost-lv/2014/2014_03_26_04_56/2014_03_26_21_54.mpg;Yoshimi WATANABE.jpg;24869;24977;91121;1244;1249;5
/net/per610a/home/mvp/mvp_db/hodost-lv/2014/2014_03_26_04_56/2014_03_26_21_54.mpg;Yoshimi WATANABE.jpg;22857;23193;91121;1143;1160;17
/net/per610a/home/mvp/mvp_db/hodost-lv/2014/2014_03_27_04_56/2014_03_27_21_54.mpg;Yoshimi WATANABE.jpg;37009;37473;91117;1852;1875;23
/net/per610a/home/mvp/mvp_db/hodost-lv/2014/2014_03_27_04_56/2014_03_27_21_54.mpg;Yoshimi WATANABE.jpg;37821;37941;91117;1892;1898;6
/net/per610a/home/mvp/mvp_db/hodost-lv/2014/2014_03_27_04_56/2014_03_27_21_54.mpg;Yoshimi WATANABE.jpg;39161;39265;91117;1959;1965;6
/net/per610a/home/mvp/mvp_db/hodost-lv/2014/2014_03_27_04_56/2014_03_27_21_54.mpg;Yoshimi WATANABE.jpg;37981;38573;91117;1900;1930;30
/net/per610a/home/mvp/mvp_db/hodost-lv/2014/2014_03_27_04_56/2014_03_27_21_54.mpg;Yoshimi WATANABE.jpg;42617;42933;91117;2132;2148;16
/net/per610a/home/mvp/mvp_db/hodost-lv/2014/2014_03_27_04_56/2014_03_27_21_54.mpg;Yoshimi WATANABE.jpg;43993;44433;91117;2201;2223;22
/net/per610a/home/mvp/mvp_db/hodost-lv/2014/2014_03_28_04_56/2014_03_28_21_54.mpg;Yoshimi WATANABE.jpg;4149;4217;91121;207;211;4
/net/per610a/home/mvp/mvp_db/hodost-lv/2014/2014_03_28_04_56/2014_03_28_21_54.mpg;Yoshimi WATANABE.jpg;10849;10901;91121;542;545;3
/net/per610a/home/mvp/mvp_db/hodost-lv/2014/2014_03_28_04_56/2014_03_28_21_54.mpg;Yoshimi WATANABE.jpg;12049;12189;91121;602;609;7
/net/per610a/home/mvp/mvp_db/hodost-lv/2014/2014_03_28_04_56/2014_03_28_21_54.mpg;Yoshimi WATANABE.jpg;15529;15585;91121;777;779;2
/net/per610a/home/mvp/mvp_db/hodost-lv/2014/2014_03_28_04_56/2014_03_28_21_54.mpg;Yoshimi WATANABE.jpg;17677;17821;91121;884;891;7
/net/per610a/home/mvp/mvp_db/hodost-lv/2014/2014_03_28_04_56/2014_03_28_21_54.mpg;Yoshimi WATANABE.jpg;20881;20985;91121;1044;1050;6
/net/per610a/home/mvp/mvp_db/hodost-lv/2014/2014_03_28_04_56/2014_03_28_21_54.mpg;Yoshimi WATANABE.jpg;7761;8341;91121;388;417;29
/net/per610a/home/mvp/mvp_db/hodost-lv/2014/2014_03_28_04_56/2014_03_28_21_54.mpg;Yoshimi WATANABE.jpg;9025;9065;91121;451;453;2
/net/per610a/home/mvp/mvp_db/hodost-lv/2014/2014_03_28_04_56/2014_03_28_21_54.mpg;Yoshimi WATANABE.jpg;9545;9577;91121;477;479;2
/net/per610a/home/mvp/mvp_db/hodost-lv/2014/2014_03_28_04_56/2014_03_28_21_54.mpg;Yoshimi WATANABE.jpg;11873;11957;91121;594;598;4
/net/per610a/home/mvp/mvp_db/hodost-lv/2014/2014_03_28_04_56/2014_03_28_21_54.mpg;Yoshimi WATANABE.jpg;13077;13081;91121;654;654;0
/net/per610a/home/mvp/mvp_db/hodost-lv/2014/2014_03_28_04_56/2014_03_28_21_54.mpg;Yoshimi WATANABE.jpg;20561;20797;91121;1028;1040;12
/net/per610a/home/mvp/mvp_db/hodost-lv/2014/2014_03_28_04_56/2014_03_28_21_54.mpg;Toru Hashimoto.jpg;10081;10173;91121;504;509;5
/net/per610a/home/mvp/mvp_db/hodost-lv/2014/2014_03_28_04_56/2014_03_28_21_54.mpg;Yoshimi WATANABE.jpg;14749;14793;91121;738;740;2
/net/per610a/home/mvp/mvp_db/hodost-lv/2014/2014_03_28_04_56/2014_03_28_21_54.mpg;Yoshimi WATANABE.jpg;18801;18913;91121;940;946;6
/net/per610a/home/mvp/mvp_db/hodost-lv/2014/2014_03_28_04_56/2014_03_28_21_54.mpg;Kenji Eda.jpg;16797;17537;91121;840;877;37
/net/per610a/home/mvp/mvp_db/hodost-lv/2014/2014_03_28_04_56/2014_03_28_21_54.mpg;Kenji Eda.jpg;18093;18645;91121;905;933;28
/net/per610a/home/mvp/mvp_db/hodost-lv/2014/2014_03_28_04_56/2014_03_28_21_54.mpg;Shinzo ABE.jpg;46649;47193;91121;2334;2361;27
/net/per610a/home/mvp/mvp_db/hodost-lv/2014/2014_03_28_04_56/2014_03_28_21_54.mpg;Shinzo ABE.jpg;49881;50137;91121;2496;2509;13
/net/per610a/home/mvp/mvp_db/hodost-lv/2014/2014_03_30_04_56/2014_03_30_10_00.mpg;Yoshimi WATANABE.jpg;497;593;125881;24;29;5
/net/per610a/home/mvp/mvp_db/hodost-lv/2014/2014_03_30_04_56/2014_03_30_10_00.mpg;Yoshimi WATANABE.jpg;669;793;125881;33;39;6
/net/per610a/home/mvp/mvp_db/hodost-lv/2014/2014_03_30_04_56/2014_03_30_10_00.mpg;Yoshimi WATANABE.jpg;977;1169;125881;48;58;10
/net/per610a/home/mvp/mvp_db/hodost-lv/2014/2014_03_30_04_56/2014_03_30_10_00.mpg;Yoshimi WATANABE.jpg;1441;1553;125881;72;77;5
/net/per610a/home/mvp/mvp_db/hodost-lv/2014/2014_03_30_04_56/2014_03_30_10_00.mpg;Yoshimi WATANABE.jpg;1877;2009;125881;93;100;7
/net/per610a/home/mvp/mvp_db/hodost-lv/2014/2014_03_30_04_56/2014_03_30_10_00.mpg;Yoshimi WATANABE.jpg;2853;3289;125881;142;164;22
/net/per610a/home/mvp/mvp_db/hodost-lv/2014/2014_03_30_04_56/2014_03_30_10_00.mpg;Yoshimi WATANABE.jpg;6701;6829;125881;335;341;6
/net/per610a/home/mvp/mvp_db/hodost-lv/2014/2014_03_30_04_56/2014_03_30_10_00.mpg;Yoshimi WATANABE.jpg;7013;7213;125881;350;360;10
/net/per610a/home/mvp/mvp_db/hodost-lv/2014/2014_03_30_04_56/2014_03_30_10_00.mpg;Yoshimi WATANABE.jpg;7705;8145;125881;385;407;22
/net/per610a/home/mvp/mvp_db/hodost-lv/2014/2014_03_30_04_56/2014_03_30_10_00.mpg;Yoshimi WATANABE.jpg;9601;10277;125881;480;514;34
/net/per610a/home/mvp/mvp_db/hodost-lv/2014/2014_03_30_04_56/2014_03_30_10_00.mpg;Yoshimi WATANABE.jpg;10361;10621;125881;518;531;13
/net/per610a/home/mvp/mvp_db/hodost-lv/2014/2014_03_30_04_56/2014_03_30_10_00.mpg;Yoshimi WATANABE.jpg;16181;16357;125881;809;818;9
/net/per610a/home/mvp/mvp_db/hodost-lv/2014/2014_03_30_04_56/2014_03_30_10_00.mpg;Yoshimi WATANABE.jpg;18537;18721;125881;927;936;9
/net/per610a/home/mvp/mvp_db/hodost-lv/2014/2014_03_30_04_56/2014_03_30_10_00.mpg;Yoshimi WATANABE.jpg;19157;19213;125881;958;961;3
/net/per610a/home/mvp/mvp_db/hodost-lv/2014/2014_03_30_04_56/2014_03_30_10_00.mpg;Yoshimi WATANABE.jpg;10661;10737;125881;533;537;4
/net/per610a/home/mvp/mvp_db/hodost-lv/2014/2014_03_30_04_56/2014_03_30_10_00.mpg;Yoshimi WATANABE.jpg;17221;17477;125881;861;874;13
/net/per610a/home/mvp/mvp_db/hodost-lv/2014/2014_03_30_04_56/2014_03_30_10_00.mpg;Yoshimi WATANABE.jpg;17641;17737;125881;882;887;5
/net/per610a/home/mvp/mvp_db/hodost-lv/2014/2014_03_30_04_56/2014_03_30_10_00.mpg;Yoshimi WATANABE.jpg;19457;20001;125881;973;1000;27
/net/per610a/home/mvp/mvp_db/hodost-lv/2014/2014_03_30_04_56/2014_03_30_10_00.mpg;Yoshimi WATANABE.jpg;22713;22869;125881;1136;1144;8
/net/per610a/home/mvp/mvp_db/hodost-lv/2014/2014_03_30_04_56/2014_03_30_10_00.mpg;Yoshimi WATANABE.jpg;23005;23157;125881;1151;1158;7
/net/per610a/home/mvp/mvp_db/hodost-lv/2014/2014_03_30_04_56/2014_03_30_10_00.mpg;Yoshimi WATANABE.jpg;116561;116573;125881;5833;5834;1
/net/per610a/home/mvp/mvp_db/hodost-lv/2014/2014_03_30_04_56/2014_03_30_10_00.mpg;Yoshimi WATANABE.jpg;120197;120697;125881;6015;6040;25
/net/per610a/home/mvp/mvp_db/hodost-lv/2014/2014_03_30_04_56/2014_03_30_10_00.mpg;Yoshimi WATANABE.jpg;120805;121265;125881;6045;6068;23
/net/per610a/home/mvp/mvp_db/hodost-lv/2014/2014_03_30_04_56/2014_03_30_10_00.mpg;Yoshimi WATANABE.jpg;121389;121473;125881;6075;6079;4
/net/per610a/home/mvp/mvp_db/hodost-lv/2014/2014_03_30_04_56/2014_03_30_10_00.mpg;Shinzo ABE.jpg;108493;108557;125881;5429;5432;3
/net/per610a/home/mvp/mvp_db/hodost-lv/2014/2014_03_30_04_56/2014_03_30_10_00.mpg;Shinzo ABE.jpg;116573;116573;125881;5834;5834;0
/net/per610a/home/mvp/mvp_db/hodost-lv/2014/2014_03_30_04_56/2014_03_30_10_00.mpg;Shinzo ABE.jpg;120209;120273;125881;6016;6019;3
/net/per610a/home/mvp/mvp_db/hodost-lv/2014/2014_03_30_04_56/2014_03_30_10_00.mpg;Shinzo ABE.jpg;121013;121021;125881;6056;6056;0
/net/per610a/home/mvp/mvp_db/hodost-lv/2014/2014_03_30_04_56/2014_03_30_10_00.mpg;Shinzo ABE.jpg;121389;121449;125881;6075;6078;3
/net/per610a/home/mvp/mvp_db/hodost-lv/2014/2014_03_30_04_56/2014_03_30_10_00.mpg;Natsuo YAMAGUCHI.jpg;116573;116573;125881;5834;5834;0
/net/per610a/home/mvp/mvp_db/hodost-lv/2014/2014_03_30_04_56/2014_03_30_10_00.mpg;Natsuo YAMAGUCHI.jpg;120197;120285;125881;6015;6019;4
/net/per610a/home/mvp/mvp_db/hodost-lv/2014/2014_03_30_04_56/2014_03_30_10_00.mpg;Natsuo YAMAGUCHI.jpg;120353;120353;125881;6023;6023;0
/net/per610a/home/mvp/mvp_db/hodost-lv/2014/2014_03_30_04_56/2014_03_30_10_00.mpg;Natsuo YAMAGUCHI.jpg;120581;120621;125881;6034;6036;2
/net/per610a/home/mvp/mvp_db/hodost-lv/2014/2014_03_30_04_56/2014_03_30_10_00.mpg;Natsuo YAMAGUCHI.jpg;121013;121265;125881;6056;6068;12
/net/per610a/home/mvp/mvp_db/hodost-lv/2014/2014_03_30_04_56/2014_03_30_10_00.mpg;Natsuo YAMAGUCHI.jpg;121401;121473;125881;6075;6079;4
/net/per610a/home/mvp/mvp_db/hodost-lv/2014/2014_03_30_04_56/2014_03_30_10_00.mpg;Toru Hashimoto.jpg;120709;120717;125881;6041;6041;0
/net/per610a/home/mvp/mvp_db/hodost-lv/2014/2014_03_30_04_56/2014_03_30_10_00.mpg;Toru Hashimoto.jpg;121009;121265;125881;6056;6068;12
/net/per610a/home/mvp/mvp_db/hodost-lv/2014/2014_03_30_04_56/2014_03_30_10_00.mpg;Toru Hashimoto.jpg;121389;121473;125881;6075;6079;4
/net/per610a/home/mvp/mvp_db/hodost-lv/2014/2014_03_31_04_56/2014_03_31_21_54.mpg;Yoshimi WATANABE.jpg;24697;24945;91121;1235;1248;13
/net/per610a/home/mvp/mvp_db/hodost-lv/2014/2014_03_31_04_56/2014_03_31_21_54.mpg;Taro ASO.jpg;28005;28041;91121;1401;1403;2
/net/per610a/home/mvp/mvp_db/hodost-lv/2014/2014_03_31_04_56/2014_03_31_21_54.mpg;Taro ASO.jpg;28129;28425;91121;1407;1422;15
/net/per610a/home/mvp/mvp_db/hodost-lv/2014/2014_04_01_04_56/2014_04_01_21_54.mpg;Shinzo ABE.jpg;25441;25533;91125;1273;1277;4
/net/per610a/home/mvp/mvp_db/hodost-lv/2014/2014_04_01_04_56/2014_04_01_21_54.mpg;Shinzo ABE.jpg;27537;28145;91125;1377;1408;31
/net/per610a/home/mvp/mvp_db/hodost-lv/2014/2014_04_01_04_56/2014_04_01_21_54.mpg;Shinzo ABE.jpg;46673;46749;91125;2335;2339;4
/net/per610a/home/mvp/mvp_db/hodost-lv/2014/2014_04_01_04_56/2014_04_01_21_54.mpg;Shinzo ABE.jpg;46913;47049;91125;2347;2354;7
/net/per610a/home/mvp/mvp_db/hodost-lv/2014/2014_04_01_04_56/2014_04_01_21_54.mpg;Ichiro OZAWA.jpg;51033;51037;91125;2553;2553;0
/net/per610a/home/mvp/mvp_db/hodost-lv/2014/2014_04_01_04_56/2014_04_01_21_54.mpg;Ichiro OZAWA.jpg;54489;54677;91125;2726;2736;10
/net/per610a/home/mvp/mvp_db/hodost-lv/2014/2014_04_02_04_56/2014_04_02_21_54.mpg;Shinzo ABE.jpg;25353;25569;91129;1268;1279;11
/net/per610a/home/mvp/mvp_db/hodost-lv/2014/2014_04_02_04_56/2014_04_02_21_54.mpg;Shinzo ABE.jpg;42725;42901;91129;2138;2147;9
/net/per610a/home/mvp/mvp_db/hodost-lv/2014/2014_04_02_04_56/2014_04_02_21_54.mpg;Shinzo ABE.jpg;44537;44589;91129;2229;2231;2
/net/per610a/home/mvp/mvp_db/hodost-lv/2014/2014_04_02_04_56/2014_04_02_21_54.mpg;Shinzo ABE.jpg;44661;44677;91129;2235;2236;1
/net/per610a/home/mvp/mvp_db/hodost-lv/2014/2014_04_03_04_56/2014_04_03_21_54.mpg;Yoshimi WATANABE.jpg;35937;36005;91121;1798;1801;3
/net/per610a/home/mvp/mvp_db/hodost-lv/2014/2014_04_03_04_56/2014_04_03_21_54.mpg;Yoshimi WATANABE.jpg;40785;40905;91121;2041;2047;6
/net/per610a/home/mvp/mvp_db/hodost-lv/2014/2014_04_03_04_56/2014_04_03_21_54.mpg;Yoshimi WATANABE.jpg;41009;41113;91121;2052;2057;5
/net/per610a/home/mvp/mvp_db/hodost-lv/2014/2014_04_03_04_56/2014_04_03_21_54.mpg;Keiichiro Asao.jpg;41269;41473;91121;2065;2075;10
/net/per610a/home/mvp/mvp_db/hodost-lv/2014/2014_04_03_04_56/2014_04_03_21_54.mpg;Shinzo ABE.jpg;48493;48597;91121;2426;2431;5
/net/per610a/home/mvp/mvp_db/hodost-lv/2014/2014_04_03_04_56/2014_04_03_21_54.mpg;Shinzo ABE.jpg;54681;54745;91121;2736;2739;3
/net/per610a/home/mvp/mvp_db/hodost-lv/2014/2014_04_03_04_56/2014_04_03_21_54.mpg;Natsuo YAMAGUCHI.jpg;53649;54389;91121;2684;2721;37
/net/per610a/home/mvp/mvp_db/hodost-lv/2014/2014_04_04_04_56/2014_04_04_21_54.mpg;Natsuo YAMAGUCHI.jpg;35541;35769;91125;1778;1789;11
/net/per610a/home/mvp/mvp_db/hodost-lv/2014/2014_04_04_04_56/2014_04_04_21_54.mpg;Natsuo YAMAGUCHI.jpg;36061;36225;91125;1804;1812;8
/net/per610a/home/mvp/mvp_db/hodost-lv/2014/2014_04_04_04_56/2014_04_04_21_54.mpg;Natsuo YAMAGUCHI.jpg;36565;36609;91125;1829;1831;2
/net/per610a/home/mvp/mvp_db/hodost-lv/2014/2014_04_04_04_56/2014_04_04_21_54.mpg;Shinzo ABE.jpg;47153;47217;91125;2359;2362;3
/net/per610a/home/mvp/mvp_db/hodost-lv/2014/2014_04_04_04_56/2014_04_04_21_54.mpg;Shinzo ABE.jpg;48537;48901;91125;2428;2447;19
/net/per610a/home/mvp/mvp_db/hodost-lv/2014/2014_04_06_04_56/2014_04_06_10_00.mpg;Taro ASO.jpg;19541;19761;125893;977;988;11
/net/per610a/home/mvp/mvp_db/hodost-lv/2014/2014_04_06_04_56/2014_04_06_10_00.mpg;Yoshimi WATANABE.jpg;98717;98761;125893;4940;4942;2
/net/per610a/home/mvp/mvp_db/hodost-lv/2014/2014_04_06_04_56/2014_04_06_10_00.mpg;Yoshimi WATANABE.jpg;100197;100381;125893;5014;5023;9
/net/per610a/home/mvp/mvp_db/hodost-lv/2014/2014_04_07_04_56/2014_04_07_21_54.mpg;Yoshimi WATANABE.jpg;713;1281;91125;35;64;29
/net/per610a/home/mvp/mvp_db/hodost-lv/2014/2014_04_07_04_56/2014_04_07_21_54.mpg;Yoshimi WATANABE.jpg;5257;5285;91125;263;264;1
/net/per610a/home/mvp/mvp_db/hodost-lv/2014/2014_04_07_04_56/2014_04_07_21_54.mpg;Yoshimi WATANABE.jpg;8137;10813;91125;407;541;134
/net/per610a/home/mvp/mvp_db/hodost-lv/2014/2014_04_07_04_56/2014_04_07_21_54.mpg;Yoshimi WATANABE.jpg;11125;12065;91125;556;603;47
/net/per610a/home/mvp/mvp_db/hodost-lv/2014/2014_04_07_04_56/2014_04_07_21_54.mpg;Yoshimi WATANABE.jpg;14853;14917;91125;743;746;3
/net/per610a/home/mvp/mvp_db/hodost-lv/2014/2014_04_07_04_56/2014_04_07_21_54.mpg;Yoshimi WATANABE.jpg;17889;18021;91125;895;901;6
/net/per610a/home/mvp/mvp_db/hodost-lv/2014/2014_04_07_04_56/2014_04_07_21_54.mpg;Toru Hashimoto.jpg;14437;14841;91125;722;742;20
/net/per610a/home/mvp/mvp_db/hodost-lv/2014/2014_04_07_04_56/2014_04_07_21_54.mpg;Shinzo ABE.jpg;27057;27061;91125;1353;1354;1
/net/per610a/home/mvp/mvp_db/hodost-lv/2014/2014_04_07_04_56/2014_04_07_21_54.mpg;Shinzo ABE.jpg;30205;30305;91125;1511;1516;5
/net/per610a/home/mvp/mvp_db/hodost-lv/2014/2014_04_07_04_56/2014_04_07_21_54.mpg;Shinzo ABE.jpg;34293;34317;91125;1716;1717;1
/net/per610a/home/mvp/mvp_db/hodost-lv/2014/2014_04_10_04_56/2014_04_10_22_09.mpg;Shinzo ABE.jpg;23669;23789;91121;1184;1190;6
/net/per610a/home/mvp/mvp_db/hodost-lv/2014/2014_04_10_04_56/2014_04_10_22_09.mpg;Shinzo ABE.jpg;78077;78185;91121;3907;3912;5
/net/per610a/home/mvp/mvp_db/hodost-lv/2014/2014_04_11_04_56/2014_04_11_21_54.mpg;Shinzo ABE.jpg;25601;25661;91121;1281;1284;3
/net/per610a/home/mvp/mvp_db/hodost-lv/2014/2014_04_11_04_56/2014_04_11_21_54.mpg;Shinzo ABE.jpg;85397;85457;91121;4273;4276;3
/net/per610a/home/mvp/mvp_db/hodost-lv/2014/2014_04_13_04_56/2014_04_13_10_00.mpg;Shinzo ABE.jpg;28593;28637;125881;1431;1433;2
/net/per610a/home/mvp/mvp_db/hodost-lv/2014/2014_04_13_04_56/2014_04_13_10_00.mpg;Shinzo ABE.jpg;28705;28985;125881;1436;1450;14
/net/per610a/home/mvp/mvp_db/hodost-lv/2014/2014_04_13_04_56/2014_04_13_10_00.mpg;Shinzo ABE.jpg;34361;34413;125881;1719;1722;3
/net/per610a/home/mvp/mvp_db/hodost-lv/2014/2014_04_13_04_56/2014_04_13_10_00.mpg;Shinzo ABE.jpg;34569;34653;125881;1730;1734;4
/net/per610a/home/mvp/mvp_db/hodost-lv/2014/2014_04_13_04_56/2014_04_13_10_00.mpg;Sadakazu TANIGAKI.jpg;28657;28661;125881;1434;1434;0
/net/per610a/home/mvp/mvp_db/hodost-lv/2014/2014_04_13_04_56/2014_04_13_10_00.mpg;Sadakazu TANIGAKI.jpg;34437;34509;125881;1723;1727;4
/net/per610a/home/mvp/mvp_db/hodost-lv/2014/2014_04_13_04_56/2014_04_13_10_00.mpg;Toru Hashimoto.jpg;101697;101881;125881;5089;5098;9
/net/per610a/home/mvp/mvp_db/hodost-lv/2014/2014_04_13_04_56/2014_04_13_10_00.mpg;Toru Hashimoto.jpg;103301;103505;125881;5169;5180;11
/net/per610a/home/mvp/mvp_db/hodost-lv/2014/2014_04_13_04_56/2014_04_13_10_00.mpg;Shintaro ISHIHARA.jpg;101697;101881;125881;5089;5098;9
/net/per610a/home/mvp/mvp_db/hodost-lv/2014/2014_04_13_04_56/2014_04_13_10_00.mpg;Shintaro ISHIHARA.jpg;102333;102421;125881;5121;5125;4
/net/per610a/home/mvp/mvp_db/hodost-lv/2014/2014_04_13_04_56/2014_04_13_10_00.mpg;Shintaro ISHIHARA.jpg;102953;103001;125881;5152;5154;2
/net/per610a/home/mvp/mvp_db/hodost-lv/2014/2014_04_15_04_56/2014_04_15_21_54.mpg;Shinzo ABE.jpg;29857;29885;91121;1494;1495;1
/net/per610a/home/mvp/mvp_db/hodost-lv/2014/2014_04_15_04_56/2014_04_15_21_54.mpg;Shinzo ABE.jpg;41521;41577;91121;2077;2080;3
/net/per610a/home/mvp/mvp_db/hodost-lv/2014/2014_04_17_04_56/2014_04_17_21_54.mpg;Shinzo ABE.jpg;47405;47801;91121;2372;2392;20
/net/per610a/home/mvp/mvp_db/hodost-lv/2014/2014_04_17_04_56/2014_04_17_21_54.mpg;Shinzo ABE.jpg;48009;48065;91121;2402;2405;3
/net/per610a/home/mvp/mvp_db/hodost-lv/2014/2014_04_20_04_56/2014_04_20_10_00.mpg;Toru Hashimoto.jpg;99969;100365;125881;5003;5022;19
/net/per610a/home/mvp/mvp_db/hodost-lv/2014/2014_04_22_04_56/2014_04_22_21_54.mpg;Shinzo ABE.jpg;44517;44777;91125;2227;2240;13
