video;face_name;start_frame;end_frame;total_frame;start_time;end_time;duration
/net/per610a/home/mvp/mvp_db/hodost-lv/2014/2014_01_05_04_56/2014_01_05_10_00.mpg;Shinzo ABE.jpg;1093;1181;209805;54;59;5
/net/per610a/home/mvp/mvp_db/hodost-lv/2014/2014_01_05_04_56/2014_01_05_10_00.mpg;Shinzo ABE.jpg;1257;1357;209805;62;67;5
/net/per610a/home/mvp/mvp_db/hodost-lv/2014/2014_01_05_04_56/2014_01_05_10_00.mpg;Shinzo ABE.jpg;21489;21777;209805;1075;1089;14
/net/per610a/home/mvp/mvp_db/hodost-lv/2014/2014_01_05_04_56/2014_01_05_10_00.mpg;Shinzo ABE.jpg;22729;22789;209805;1137;1140;3
/net/per610a/home/mvp/mvp_db/hodost-lv/2014/2014_01_05_04_56/2014_01_05_10_00.mpg;Shinzo ABE.jpg;39333;39365;209805;1968;1970;2
/net/per610a/home/mvp/mvp_db/hodost-lv/2014/2014_01_05_04_56/2014_01_05_10_00.mpg;Shinzo ABE.jpg;39629;39757;209805;1983;1989;6
/net/per610a/home/mvp/mvp_db/hodost-lv/2014/2014_01_05_04_56/2014_01_05_10_00.mpg;Shinzo ABE.jpg;138273;138273;209805;6920;6920;0
/net/per610a/home/mvp/mvp_db/hodost-lv/2014/2014_01_05_04_56/2014_01_05_10_00.mpg;Shinzo ABE.jpg;203917;204189;209805;10205;10218;13
/net/per610a/home/mvp/mvp_db/hodost-lv/2014/2014_01_05_04_56/2014_01_05_10_00.mpg;Shintaro ISHIHARA.jpg;1441;1557;209805;72;77;5
/net/per610a/home/mvp/mvp_db/hodost-lv/2014/2014_01_05_04_56/2014_01_05_10_00.mpg;Shintaro ISHIHARA.jpg;9317;9425;209805;466;471;5
/net/per610a/home/mvp/mvp_db/hodost-lv/2014/2014_01_05_04_56/2014_01_05_10_00.mpg;Shintaro ISHIHARA.jpg;9493;9649;209805;475;482;7
/net/per610a/home/mvp/mvp_db/hodost-lv/2014/2014_01_05_04_56/2014_01_05_10_00.mpg;Shintaro ISHIHARA.jpg;14653;14845;209805;733;742;9
/net/per610a/home/mvp/mvp_db/hodost-lv/2014/2014_01_05_04_56/2014_01_05_10_00.mpg;Shintaro ISHIHARA.jpg;14985;15033;209805;749;752;3
/net/per610a/home/mvp/mvp_db/hodost-lv/2014/2014_01_05_04_56/2014_01_05_10_00.mpg;Shintaro ISHIHARA.jpg;19293;19805;209805;965;991;26
/net/per610a/home/mvp/mvp_db/hodost-lv/2014/2014_01_05_04_56/2014_01_05_10_00.mpg;Shintaro ISHIHARA.jpg;19937;20097;209805;997;1005;8
/net/per610a/home/mvp/mvp_db/hodost-lv/2014/2014_01_05_04_56/2014_01_05_10_00.mpg;Shintaro ISHIHARA.jpg;28297;28733;209805;1416;1437;21
/net/per610a/home/mvp/mvp_db/hodost-lv/2014/2014_01_05_04_56/2014_01_05_10_00.mpg;Shintaro ISHIHARA.jpg;28929;29145;209805;1447;1458;11
/net/per610a/home/mvp/mvp_db/hodost-lv/2014/2014_01_05_04_56/2014_01_05_10_00.mpg;Shintaro ISHIHARA.jpg;29613;29613;209805;1482;1482;0
/net/per610a/home/mvp/mvp_db/hodost-lv/2014/2014_01_05_04_56/2014_01_05_10_00.mpg;Shintaro ISHIHARA.jpg;29701;30141;209805;1486;1508;22
/net/per610a/home/mvp/mvp_db/hodost-lv/2014/2014_01_05_04_56/2014_01_05_10_00.mpg;Shintaro ISHIHARA.jpg;30329;30585;209805;1517;1530;13
/net/per610a/home/mvp/mvp_db/hodost-lv/2014/2014_01_05_04_56/2014_01_05_10_00.mpg;Shintaro ISHIHARA.jpg;30769;30957;209805;1539;1549;10
/net/per610a/home/mvp/mvp_db/hodost-lv/2014/2014_01_05_04_56/2014_01_05_10_00.mpg;Shintaro ISHIHARA.jpg;31137;31401;209805;1558;1571;13
/net/per610a/home/mvp/mvp_db/hodost-lv/2014/2014_01_05_04_56/2014_01_05_10_00.mpg;Shintaro ISHIHARA.jpg;32249;32589;209805;1613;1630;17
/net/per610a/home/mvp/mvp_db/hodost-lv/2014/2014_01_05_04_56/2014_01_05_10_00.mpg;Shintaro ISHIHARA.jpg;32801;33053;209805;1641;1654;13
/net/per610a/home/mvp/mvp_db/hodost-lv/2014/2014_01_05_04_56/2014_01_05_10_00.mpg;Shintaro ISHIHARA.jpg;33117;33417;209805;1657;1672;15
/net/per610a/home/mvp/mvp_db/hodost-lv/2014/2014_01_05_04_56/2014_01_05_10_00.mpg;Shintaro ISHIHARA.jpg;33741;34093;209805;1688;1706;18
/net/per610a/home/mvp/mvp_db/hodost-lv/2014/2014_01_05_04_56/2014_01_05_10_00.mpg;Shintaro ISHIHARA.jpg;34181;34517;209805;1710;1727;17
/net/per610a/home/mvp/mvp_db/hodost-lv/2014/2014_01_05_04_56/2014_01_05_10_00.mpg;Shintaro ISHIHARA.jpg;34745;35117;209805;1738;1757;19
/net/per610a/home/mvp/mvp_db/hodost-lv/2014/2014_01_05_04_56/2014_01_05_10_00.mpg;Shintaro ISHIHARA.jpg;35221;35433;209805;1762;1773;11
/net/per610a/home/mvp/mvp_db/hodost-lv/2014/2014_01_05_04_56/2014_01_05_10_00.mpg;Shintaro ISHIHARA.jpg;35569;36161;209805;1780;1809;29
/net/per610a/home/mvp/mvp_db/hodost-lv/2014/2014_01_05_04_56/2014_01_05_10_00.mpg;Shintaro ISHIHARA.jpg;36313;36673;209805;1817;1835;18
/net/per610a/home/mvp/mvp_db/hodost-lv/2014/2014_01_05_04_56/2014_01_05_10_00.mpg;Shintaro ISHIHARA.jpg;37117;37321;209805;1857;1867;10
/net/per610a/home/mvp/mvp_db/hodost-lv/2014/2014_01_05_04_56/2014_01_05_10_00.mpg;Shintaro ISHIHARA.jpg;42425;43057;209805;2123;2154;31
/net/per610a/home/mvp/mvp_db/hodost-lv/2014/2014_01_05_04_56/2014_01_05_10_00.mpg;Shintaro ISHIHARA.jpg;43333;44365;209805;2168;2220;52
/net/per610a/home/mvp/mvp_db/hodost-lv/2014/2014_01_05_04_56/2014_01_05_10_00.mpg;Shintaro ISHIHARA.jpg;44569;44637;209805;2230;2233;3
/net/per610a/home/mvp/mvp_db/hodost-lv/2014/2014_01_05_04_56/2014_01_05_10_00.mpg;Shintaro ISHIHARA.jpg;44977;45405;209805;2250;2272;22
/net/per610a/home/mvp/mvp_db/hodost-lv/2014/2014_01_05_04_56/2014_01_05_10_00.mpg;Shintaro ISHIHARA.jpg;45581;46133;209805;2281;2308;27
/net/per610a/home/mvp/mvp_db/hodost-lv/2014/2014_01_05_04_56/2014_01_05_10_00.mpg;Shintaro ISHIHARA.jpg;46325;46765;209805;2318;2340;22
/net/per610a/home/mvp/mvp_db/hodost-lv/2014/2014_01_05_04_56/2014_01_05_10_00.mpg;Shintaro ISHIHARA.jpg;47157;47301;209805;2360;2367;7
/net/per610a/home/mvp/mvp_db/hodost-lv/2014/2014_01_05_04_56/2014_01_05_10_00.mpg;Shintaro ISHIHARA.jpg;47493;47897;209805;2376;2397;21
/net/per610a/home/mvp/mvp_db/hodost-lv/2014/2014_01_05_04_56/2014_01_05_10_00.mpg;Shintaro ISHIHARA.jpg;48221;48861;209805;2413;2445;32
/net/per610a/home/mvp/mvp_db/hodost-lv/2014/2014_01_05_04_56/2014_01_05_10_00.mpg;Shintaro ISHIHARA.jpg;49037;49549;209805;2454;2479;25
/net/per610a/home/mvp/mvp_db/hodost-lv/2014/2014_01_05_04_56/2014_01_05_10_00.mpg;Shintaro ISHIHARA.jpg;49777;50209;209805;2491;2512;21
/net/per610a/home/mvp/mvp_db/hodost-lv/2014/2014_01_05_04_56/2014_01_05_10_00.mpg;Shintaro ISHIHARA.jpg;50341;50625;209805;2519;2533;14
/net/per610a/home/mvp/mvp_db/hodost-lv/2014/2014_01_05_04_56/2014_01_05_10_00.mpg;Shintaro ISHIHARA.jpg;50845;51025;209805;2544;2553;9
/net/per610a/home/mvp/mvp_db/hodost-lv/2014/2014_01_05_04_56/2014_01_05_10_00.mpg;Shintaro ISHIHARA.jpg;51129;51757;209805;2558;2590;32
/net/per610a/home/mvp/mvp_db/hodost-lv/2014/2014_01_05_04_56/2014_01_05_10_00.mpg;Shintaro ISHIHARA.jpg;51881;52257;209805;2596;2615;19
/net/per610a/home/mvp/mvp_db/hodost-lv/2014/2014_01_05_04_56/2014_01_05_10_00.mpg;Shintaro ISHIHARA.jpg;52385;52785;209805;2621;2641;20
/net/per610a/home/mvp/mvp_db/hodost-lv/2014/2014_01_05_04_56/2014_01_05_10_00.mpg;Shintaro ISHIHARA.jpg;52873;53297;209805;2646;2667;21
/net/per610a/home/mvp/mvp_db/hodost-lv/2014/2014_01_05_04_56/2014_01_05_10_00.mpg;Shintaro ISHIHARA.jpg;53545;53865;209805;2679;2695;16
/net/per610a/home/mvp/mvp_db/hodost-lv/2014/2014_01_06_04_56/2014_01_06_21_54.mpg;Shinzo ABE.jpg;2297;2613;91121;114;130;16
/net/per610a/home/mvp/mvp_db/hodost-lv/2014/2014_01_06_04_56/2014_01_06_21_54.mpg;Shinzo ABE.jpg;12377;12429;91121;619;621;2
/net/per610a/home/mvp/mvp_db/hodost-lv/2014/2014_01_06_04_56/2014_01_06_21_54.mpg;Shinzo ABE.jpg;13501;13581;91121;675;679;4
/net/per610a/home/mvp/mvp_db/hodost-lv/2014/2014_01_06_04_56/2014_01_06_21_54.mpg;Shinzo ABE.jpg;16425;16485;91121;821;824;3
/net/per610a/home/mvp/mvp_db/hodost-lv/2014/2014_01_06_04_56/2014_01_06_21_54.mpg;Shinzo ABE.jpg;16625;17249;91121;831;863;32
/net/per610a/home/mvp/mvp_db/hodost-lv/2014/2014_01_06_04_56/2014_01_06_21_54.mpg;Shinzo ABE.jpg;19485;19577;91121;975;979;4
/net/per610a/home/mvp/mvp_db/hodost-lv/2014/2014_01_06_04_56/2014_01_06_21_54.mpg;Shinzo ABE.jpg;50469;50565;91121;2525;2530;5
/net/per610a/home/mvp/mvp_db/hodost-lv/2014/2014_01_07_04_56/2014_01_07_21_54.mpg;Shinzo ABE.jpg;26489;27181;91125;1325;1360;35
/net/per610a/home/mvp/mvp_db/hodost-lv/2014/2014_01_07_04_56/2014_01_07_21_54.mpg;Shinzo ABE.jpg;28061;28101;91125;1404;1406;2
/net/per610a/home/mvp/mvp_db/hodost-lv/2014/2014_01_07_04_56/2014_01_07_21_54.mpg;Shinzo ABE.jpg;47429;47433;91125;2373;2373;0
/net/per610a/home/mvp/mvp_db/hodost-lv/2014/2014_01_07_04_56/2014_01_07_21_54.mpg;Shinzo ABE.jpg;73957;74085;91125;3700;3707;7
/net/per610a/home/mvp/mvp_db/hodost-lv/2014/2014_01_09_04_56/2014_01_09_22_09.mpg;Shinzo ABE.jpg;72157;72281;91121;3610;3617;7
/net/per610a/home/mvp/mvp_db/hodost-lv/2014/2014_01_09_04_56/2014_01_09_22_09.mpg;Shinzo ABE.jpg;72585;72649;91121;3632;3635;3
/net/per610a/home/mvp/mvp_db/hodost-lv/2014/2014_01_09_04_56/2014_01_09_22_09.mpg;Shinzo ABE.jpg;72745;72945;91121;3640;3650;10
/net/per610a/home/mvp/mvp_db/hodost-lv/2014/2014_01_09_04_56/2014_01_09_22_09.mpg;Shinzo ABE.jpg;73673;73693;91121;3686;3687;1
/net/per610a/home/mvp/mvp_db/hodost-lv/2014/2014_01_10_04_56/2014_01_10_21_54.mpg;Junichiro KOIZUMI.jpg;36773;37169;91113;1840;1860;20
/net/per610a/home/mvp/mvp_db/hodost-lv/2014/2014_01_14_04_56/2014_01_14_21_54.mpg;Shinzo ABE.jpg;13345;14249;91117;667;713;46
/net/per610a/home/mvp/mvp_db/hodost-lv/2014/2014_01_15_04_56/2014_01_15_21_54.mpg;Shinzo ABE.jpg;11713;11749;91117;586;587;1
/net/per610a/home/mvp/mvp_db/hodost-lv/2014/2014_01_15_04_56/2014_01_15_21_54.mpg;Shinzo ABE.jpg;13269;13405;91117;664;670;6
/net/per610a/home/mvp/mvp_db/hodost-lv/2014/2014_01_15_04_56/2014_01_15_21_54.mpg;Shinzo ABE.jpg;13517;13813;91117;676;691;15
/net/per610a/home/mvp/mvp_db/hodost-lv/2014/2014_01_15_04_56/2014_01_15_21_54.mpg;Akihiro OHTA.jpg;24405;24821;91117;1221;1242;21
/net/per610a/home/mvp/mvp_db/hodost-lv/2014/2014_01_20_04_56/2014_01_20_21_54.mpg;Shinzo ABE.jpg;15125;15261;91121;756;763;7
/net/per610a/home/mvp/mvp_db/hodost-lv/2014/2014_01_20_04_56/2014_01_20_21_54.mpg;Shinzo ABE.jpg;29877;30057;91121;1495;1504;9
/net/per610a/home/mvp/mvp_db/hodost-lv/2014/2014_01_20_04_56/2014_01_20_21_54.mpg;Shinzo ABE.jpg;67925;67977;91121;3399;3401;2
/net/per610a/home/mvp/mvp_db/hodost-lv/2014/2014_01_20_04_56/2014_01_20_21_54.mpg;Shinzo ABE.jpg;68065;68261;91121;3406;3416;10
/net/per610a/home/mvp/mvp_db/hodost-lv/2014/2014_01_20_04_56/2014_01_20_21_54.mpg;Yukio HATOYAMA.jpg;27997;28149;91121;1401;1408;7
/net/per610a/home/mvp/mvp_db/hodost-lv/2014/2014_01_21_04_56/2014_01_21_21_54.mpg;Akihiro OHTA.jpg;28221;28309;91113;1412;1416;4
/net/per610a/home/mvp/mvp_db/hodost-lv/2014/2014_01_21_04_56/2014_01_21_21_54.mpg;Shinzo ABE.jpg;35541;35929;91113;1778;1798;20
/net/per610a/home/mvp/mvp_db/hodost-lv/2014/2014_01_22_04_56/2014_01_22_21_54.mpg;Yukio HATOYAMA.jpg;7901;8597;91117;395;430;35
/net/per610a/home/mvp/mvp_db/hodost-lv/2014/2014_01_23_04_56/2014_01_23_21_54.mpg;Shinzo ABE.jpg;64449;64465;91117;3225;3226;1
/net/per610a/home/mvp/mvp_db/hodost-lv/2014/2014_01_23_04_56/2014_01_23_21_54.mpg;Shinzo ABE.jpg;64685;65033;91117;3237;3254;17
/net/per610a/home/mvp/mvp_db/hodost-lv/2014/2014_01_23_04_56/2014_01_23_21_54.mpg;Shinzo ABE.jpg;65417;65489;91117;3273;3277;4
/net/per610a/home/mvp/mvp_db/hodost-lv/2014/2014_01_23_04_56/2014_01_23_21_54.mpg;Shinzo ABE.jpg;65157;65249;91117;3260;3265;5
/net/per610a/home/mvp/mvp_db/hodost-lv/2014/2014_01_24_04_56/2014_01_24_21_54.mpg;Natsuo YAMAGUCHI.jpg;30689;31017;91121;1535;1552;17
/net/per610a/home/mvp/mvp_db/hodost-lv/2014/2014_01_24_04_56/2014_01_24_21_54.mpg;Shinzo ABE.jpg;35645;35681;91121;1783;1785;2
/net/per610a/home/mvp/mvp_db/hodost-lv/2014/2014_01_24_04_56/2014_01_24_21_54.mpg;Shinzo ABE.jpg;35753;35861;91121;1789;1794;5
/net/per610a/home/mvp/mvp_db/hodost-lv/2014/2014_01_24_04_56/2014_01_24_21_54.mpg;Shinzo ABE.jpg;36293;36413;91121;1816;1822;6
/net/per610a/home/mvp/mvp_db/hodost-lv/2014/2014_01_24_04_56/2014_01_24_21_54.mpg;Kenji Eda.jpg;85261;85685;91121;4266;4287;21
/net/per610a/home/mvp/mvp_db/hodost-lv/2014/2014_01_26_04_56/2014_01_26_10_00.mpg;Yukio HATOYAMA.jpg;78125;78225;125889;3909;3914;5
/net/per610a/home/mvp/mvp_db/hodost-lv/2014/2014_01_26_04_56/2014_01_26_10_00.mpg;Yukio HATOYAMA.jpg;78513;78581;125889;3929;3932;3
/net/per610a/home/mvp/mvp_db/hodost-lv/2014/2014_01_26_04_56/2014_01_26_10_00.mpg;Yukio HATOYAMA.jpg;79249;79305;125889;3965;3968;3
/net/per610a/home/mvp/mvp_db/hodost-lv/2014/2014_01_26_04_56/2014_01_26_10_00.mpg;Yukio HATOYAMA.jpg;79525;79933;125889;3979;4000;21
/net/per610a/home/mvp/mvp_db/hodost-lv/2014/2014_01_26_04_56/2014_01_26_10_00.mpg;Yukio HATOYAMA.jpg;81537;81993;125889;4080;4103;23
/net/per610a/home/mvp/mvp_db/hodost-lv/2014/2014_01_26_04_56/2014_01_26_10_00.mpg;Yukio HATOYAMA.jpg;87969;88069;125889;4402;4407;5
/net/per610a/home/mvp/mvp_db/hodost-lv/2014/2014_01_26_04_56/2014_01_26_10_00.mpg;Yukio HATOYAMA.jpg;88205;88601;125889;4414;4433;19
/net/per610a/home/mvp/mvp_db/hodost-lv/2014/2014_01_26_04_56/2014_01_26_10_00.mpg;Yukio HATOYAMA.jpg;91381;91437;125889;4573;4575;2
/net/per610a/home/mvp/mvp_db/hodost-lv/2014/2014_01_26_04_56/2014_01_26_10_00.mpg;Yukio HATOYAMA.jpg;94485;94533;125889;4728;4730;2
/net/per610a/home/mvp/mvp_db/hodost-lv/2014/2014_01_26_04_56/2014_01_26_10_00.mpg;Yukio HATOYAMA.jpg;95713;96021;125889;4789;4805;16
/net/per610a/home/mvp/mvp_db/hodost-lv/2014/2014_01_26_04_56/2014_01_26_10_00.mpg;Yukio HATOYAMA.jpg;96093;96437;125889;4808;4826;18
/net/per610a/home/mvp/mvp_db/hodost-lv/2014/2014_01_28_04_56/2014_01_28_21_54.mpg;Shinzo ABE.jpg;1177;1345;91125;58;67;9
/net/per610a/home/mvp/mvp_db/hodost-lv/2014/2014_01_28_04_56/2014_01_28_21_54.mpg;Shinzo ABE.jpg;6285;6477;91125;314;324;10
/net/per610a/home/mvp/mvp_db/hodost-lv/2014/2014_01_28_04_56/2014_01_28_21_54.mpg;Shinzo ABE.jpg;9141;9501;91125;457;475;18
/net/per610a/home/mvp/mvp_db/hodost-lv/2014/2014_01_28_04_56/2014_01_28_21_54.mpg;Shinzo ABE.jpg;12445;12481;91125;622;624;2
/net/per610a/home/mvp/mvp_db/hodost-lv/2014/2014_01_28_04_56/2014_01_28_21_54.mpg;Shinzo ABE.jpg;24289;24377;91125;1215;1219;4
/net/per610a/home/mvp/mvp_db/hodost-lv/2014/2014_01_28_04_56/2014_01_28_21_54.mpg;Yoshimi WATANABE.jpg;1913;2025;91125;95;101;6
/net/per610a/home/mvp/mvp_db/hodost-lv/2014/2014_01_28_04_56/2014_01_28_21_54.mpg;Yoshimi WATANABE.jpg;11625;11713;91125;581;586;5
/net/per610a/home/mvp/mvp_db/hodost-lv/2014/2014_01_28_04_56/2014_01_28_21_54.mpg;Natsuo YAMAGUCHI.jpg;10933;11565;91125;547;578;31
/net/per610a/home/mvp/mvp_db/hodost-lv/2014/2014_01_29_04_56/2014_01_29_21_54.mpg;Shinzo ABE.jpg;15349;15665;91117;768;783;15
/net/per610a/home/mvp/mvp_db/hodost-lv/2014/2014_01_29_04_56/2014_01_29_21_54.mpg;Shinzo ABE.jpg;17629;17921;91117;882;896;14
/net/per610a/home/mvp/mvp_db/hodost-lv/2014/2014_01_29_04_56/2014_01_29_21_54.mpg;Shinzo ABE.jpg;22349;22433;91117;1118;1122;4
/net/per610a/home/mvp/mvp_db/hodost-lv/2014/2014_01_29_04_56/2014_01_29_21_54.mpg;Shinzo ABE.jpg;22593;22629;91117;1130;1132;2
/net/per610a/home/mvp/mvp_db/hodost-lv/2014/2014_01_29_04_56/2014_01_29_21_54.mpg;Yoshimi WATANABE.jpg;22757;22837;91117;1138;1142;4
/net/per610a/home/mvp/mvp_db/hodost-lv/2014/2014_01_29_04_56/2014_01_29_21_54.mpg;Yoshimi WATANABE.jpg;22933;23061;91117;1147;1154;7
/net/per610a/home/mvp/mvp_db/hodost-lv/2014/2014_01_30_04_56/2014_01_30_21_54.mpg;Natsuo YAMAGUCHI.jpg;44945;44945;91121;2249;2249;0
/net/per610a/home/mvp/mvp_db/hodost-lv/2014/2014_01_30_04_56/2014_01_30_21_54.mpg;Natsuo YAMAGUCHI.jpg;48433;48501;91121;2423;2427;4
/net/per610a/home/mvp/mvp_db/hodost-lv/2014/2014_01_30_04_56/2014_01_30_21_54.mpg;Natsuo YAMAGUCHI.jpg;50653;50745;91121;2534;2539;5
/net/per610a/home/mvp/mvp_db/hodost-lv/2014/2014_02_02_04_56/2014_02_02_10_00.mpg;Yorihisa Matsuno.png;1705;1745;125881;85;87;2
/net/per610a/home/mvp/mvp_db/hodost-lv/2014/2014_02_02_04_56/2014_02_02_10_00.mpg;Yorihisa Matsuno.png;2837;3081;125881;141;154;13
/net/per610a/home/mvp/mvp_db/hodost-lv/2014/2014_02_02_04_56/2014_02_02_10_00.mpg;Shinzo ABE.jpg;121893;121941;125881;6100;6102;2
/net/per610a/home/mvp/mvp_db/hodost-lv/2014/2014_02_02_04_56/2014_02_02_10_00.mpg;Shinzo ABE.jpg;122917;123017;125881;6151;6156;5
/net/per610a/home/mvp/mvp_db/hodost-lv/2014/2014_02_03_04_56/2014_02_03_21_54.mpg;Natsuo YAMAGUCHI.jpg;39737;39877;91121;1988;1995;7
/net/per610a/home/mvp/mvp_db/hodost-lv/2014/2014_02_04_04_56/2014_02_04_21_54.mpg;Shinzo ABE.jpg;19437;20561;91117;972;1028;56
/net/per610a/home/mvp/mvp_db/hodost-lv/2014/2014_02_04_04_56/2014_02_04_21_54.mpg;Shinzo ABE.jpg;24585;24661;91117;1230;1234;4
/net/per610a/home/mvp/mvp_db/hodost-lv/2014/2014_02_04_04_56/2014_02_04_21_54.mpg;Shinzo ABE.jpg;33621;33661;91117;1682;1684;2
/net/per610a/home/mvp/mvp_db/hodost-lv/2014/2014_02_04_04_56/2014_02_04_21_54.mpg;Taro ASO.jpg;19465;19617;91117;974;981;7
/net/per610a/home/mvp/mvp_db/hodost-lv/2014/2014_02_04_04_56/2014_02_04_21_54.mpg;Taro ASO.jpg;19797;19797;91117;990;990;0
/net/per610a/home/mvp/mvp_db/hodost-lv/2014/2014_02_04_04_56/2014_02_04_21_54.mpg;Taro ASO.jpg;19861;19861;91117;993;993;0
/net/per610a/home/mvp/mvp_db/hodost-lv/2014/2014_02_04_04_56/2014_02_04_21_54.mpg;Taro ASO.jpg;20009;20281;91117;1001;1014;13
/net/per610a/home/mvp/mvp_db/hodost-lv/2014/2014_02_04_04_56/2014_02_04_21_54.mpg;Taro ASO.jpg;20357;20445;91117;1018;1023;5
/net/per610a/home/mvp/mvp_db/hodost-lv/2014/2014_02_04_04_56/2014_02_04_21_54.mpg;Taro ASO.jpg;35101;35413;91117;1756;1772;16
/net/per610a/home/mvp/mvp_db/hodost-lv/2014/2014_02_04_04_56/2014_02_04_21_54.mpg;Shinzo ABE.jpg;20905;21025;91117;1046;1052;6
/net/per610a/home/mvp/mvp_db/hodost-lv/2014/2014_02_04_04_56/2014_02_04_21_54.mpg;Shinzo ABE.jpg;21413;21685;91117;1071;1085;14
/net/per610a/home/mvp/mvp_db/hodost-lv/2014/2014_02_04_04_56/2014_02_04_21_54.mpg;Shinzo ABE.jpg;22305;22777;91117;1116;1139;23
/net/per610a/home/mvp/mvp_db/hodost-lv/2014/2014_02_04_04_56/2014_02_04_21_54.mpg;Shinzo ABE.jpg;24321;24465;91117;1217;1224;7
/net/per610a/home/mvp/mvp_db/hodost-lv/2014/2014_02_04_04_56/2014_02_04_21_54.mpg;Shinzo ABE.jpg;29713;29773;91117;1487;1490;3
/net/per610a/home/mvp/mvp_db/hodost-lv/2014/2014_02_04_04_56/2014_02_04_21_54.mpg;Shinzo ABE.jpg;47449;47649;91117;2374;2384;10
/net/per610a/home/mvp/mvp_db/hodost-lv/2014/2014_02_04_04_56/2014_02_04_21_54.mpg;Natsuo YAMAGUCHI.jpg;47257;47325;91117;2365;2368;3
/net/per610a/home/mvp/mvp_db/hodost-lv/2014/2014_02_04_04_56/2014_02_04_21_54.mpg;Natsuo YAMAGUCHI.jpg;47449;47461;91117;2374;2375;1
/net/per610a/home/mvp/mvp_db/hodost-lv/2014/2014_02_04_04_56/2014_02_04_21_54.mpg;Junichiro KOIZUMI.jpg;48505;48661;91117;2427;2435;8
/net/per610a/home/mvp/mvp_db/hodost-lv/2014/2014_02_04_04_56/2014_02_04_21_54.mpg;Shintaro ISHIHARA.jpg;49485;50069;91117;2476;2505;29
/net/per610a/home/mvp/mvp_db/hodost-lv/2014/2014_02_09_04_56/2014_02_09_10_00.mpg;Shinzo ABE.jpg;53833;53873;125885;2694;2696;2
/net/per610a/home/mvp/mvp_db/hodost-lv/2014/2014_02_09_04_56/2014_02_09_10_00.mpg;Shinzo ABE.jpg;53973;54033;125885;2701;2704;3
/net/per610a/home/mvp/mvp_db/hodost-lv/2014/2014_02_10_04_56/2014_02_10_21_54.mpg;Shinzo ABE.jpg;2173;2225;91117;108;111;3
/net/per610a/home/mvp/mvp_db/hodost-lv/2014/2014_02_10_04_56/2014_02_10_21_54.mpg;Shinzo ABE.jpg;5305;5333;91117;265;266;1
/net/per610a/home/mvp/mvp_db/hodost-lv/2014/2014_02_10_04_56/2014_02_10_21_54.mpg;Shinzo ABE.jpg;5413;5421;91117;270;271;1
/net/per610a/home/mvp/mvp_db/hodost-lv/2014/2014_02_10_04_56/2014_02_10_21_54.mpg;Shinzo ABE.jpg;18193;18245;91117;910;913;3
/net/per610a/home/mvp/mvp_db/hodost-lv/2014/2014_02_10_04_56/2014_02_10_21_54.mpg;Shinzo ABE.jpg;18573;18961;91117;929;948;19
/net/per610a/home/mvp/mvp_db/hodost-lv/2014/2014_02_10_04_56/2014_02_10_21_54.mpg;Shinzo ABE.jpg;23157;23157;91117;1158;1158;0
/net/per610a/home/mvp/mvp_db/hodost-lv/2014/2014_02_10_04_56/2014_02_10_21_54.mpg;Shinzo ABE.jpg;23229;23853;91117;1162;1193;31
/net/per610a/home/mvp/mvp_db/hodost-lv/2014/2014_02_10_04_56/2014_02_10_21_54.mpg;Shinzo ABE.jpg;26769;26917;91117;1339;1347;8
/net/per610a/home/mvp/mvp_db/hodost-lv/2014/2014_02_12_04_56/2014_02_12_21_54.mpg;Shinzo ABE.jpg;38133;38177;91117;1908;1910;2
/net/per610a/home/mvp/mvp_db/hodost-lv/2014/2014_02_12_04_56/2014_02_12_21_54.mpg;Shinzo ABE.jpg;40505;40757;91117;2027;2039;12
/net/per610a/home/mvp/mvp_db/hodost-lv/2014/2014_02_12_04_56/2014_02_12_21_54.mpg;Shinzo ABE.jpg;42693;42769;91117;2136;2140;4
/net/per610a/home/mvp/mvp_db/hodost-lv/2014/2014_02_12_04_56/2014_02_12_21_54.mpg;Shinzo ABE.jpg;43553;43565;91117;2179;2180;1
/net/per610a/home/mvp/mvp_db/hodost-lv/2014/2014_02_12_04_56/2014_02_12_21_54.mpg;Shinzo ABE.jpg;44405;44593;91117;2222;2231;9
/net/per610a/home/mvp/mvp_db/hodost-lv/2014/2014_02_13_04_56/2014_02_13_21_54.mpg;Shinzo ABE.jpg;47061;47141;91121;2355;2359;4
/net/per610a/home/mvp/mvp_db/hodost-lv/2014/2014_02_13_04_56/2014_02_13_21_54.mpg;Shinzo ABE.jpg;49533;49673;91121;2478;2485;7
/net/per610a/home/mvp/mvp_db/hodost-lv/2014/2014_02_16_04_56/2014_02_16_10_00.mpg;Shinzo ABE.jpg;120797;120937;125885;6045;6052;7
/net/per610a/home/mvp/mvp_db/hodost-lv/2014/2014_02_16_04_56/2014_02_16_10_00.mpg;Shinzo ABE.jpg;123013;123069;125885;6156;6159;3
/net/per610a/home/mvp/mvp_db/hodost-lv/2014/2014_02_16_04_56/2014_02_16_10_00.mpg;Natsuo YAMAGUCHI.jpg;120801;120933;125885;6045;6052;7
/net/per610a/home/mvp/mvp_db/hodost-lv/2014/2014_02_19_04_56/2014_02_19_21_54.mpg;Shinzo ABE.jpg;34517;34601;91117;1727;1731;4
/net/per610a/home/mvp/mvp_db/hodost-lv/2014/2014_02_19_04_56/2014_02_19_21_54.mpg;Shinzo ABE.jpg;38113;38389;91117;1907;1921;14
/net/per610a/home/mvp/mvp_db/hodost-lv/2014/2014_02_19_04_56/2014_02_19_21_54.mpg;Shinzo ABE.jpg;40305;40481;91117;2017;2025;8
/net/per610a/home/mvp/mvp_db/hodost-lv/2014/2014_02_19_04_56/2014_02_19_21_54.mpg;Shinzo ABE.jpg;40681;41081;91117;2035;2055;20
/net/per610a/home/mvp/mvp_db/hodost-lv/2014/2014_02_20_04_56/2014_02_20_21_54.mpg;Shinzo ABE.jpg;11165;11361;91121;558;568;10
/net/per610a/home/mvp/mvp_db/hodost-lv/2014/2014_02_20_04_56/2014_02_20_21_54.mpg;Shinzo ABE.jpg;13461;13661;91121;673;683;10
/net/per610a/home/mvp/mvp_db/hodost-lv/2014/2014_02_20_04_56/2014_02_20_21_54.mpg;Shinzo ABE.jpg;13873;14389;91121;694;720;26
/net/per610a/home/mvp/mvp_db/hodost-lv/2014/2014_02_20_04_56/2014_02_20_21_54.mpg;Shinzo ABE.jpg;15053;15445;91121;753;772;19
/net/per610a/home/mvp/mvp_db/hodost-lv/2014/2014_02_20_04_56/2014_02_20_21_54.mpg;Shinzo ABE.jpg;16649;16805;91121;833;840;7
/net/per610a/home/mvp/mvp_db/hodost-lv/2014/2014_02_20_04_56/2014_02_20_21_54.mpg;Shinzo ABE.jpg;21081;21321;91121;1054;1066;12
/net/per610a/home/mvp/mvp_db/hodost-lv/2014/2014_02_20_04_56/2014_02_20_21_54.mpg;Shinzo ABE.jpg;21589;21705;91121;1080;1086;6
/net/per610a/home/mvp/mvp_db/hodost-lv/2014/2014_02_23_04_56/2014_02_23_10_00.mpg;Shinzo ABE.jpg;109565;109889;125885;5483;5499;16
/net/per610a/home/mvp/mvp_db/hodost-lv/2014/2014_02_25_04_56/2014_02_25_21_54.mpg;Shinzo ABE.jpg;33305;33461;91121;1666;1674;8
/net/per610a/home/mvp/mvp_db/hodost-lv/2014/2014_02_25_04_56/2014_02_25_21_54.mpg;Natsuo YAMAGUCHI.jpg;33305;33461;91121;1666;1674;8
/net/per610a/home/mvp/mvp_db/hodost-lv/2014/2014_02_26_04_56/2014_02_26_21_54.mpg;Natsuo YAMAGUCHI.jpg;28701;28893;91117;1436;1445;9
/net/per610a/home/mvp/mvp_db/hodost-lv/2014/2014_02_27_04_56/2014_02_27_21_54.mpg;Shinzo ABE.jpg;27257;27377;91117;1364;1370;6
/net/per610a/home/mvp/mvp_db/hodost-lv/2014/2014_03_03_04_56/2014_03_03_21_54.mpg;Shinzo ABE.jpg;31349;31885;91121;1568;1595;27
/net/per610a/home/mvp/mvp_db/hodost-lv/2014/2014_03_03_04_56/2014_03_03_21_54.mpg;Shinzo ABE.jpg;40277;40817;91121;2015;2042;27
/net/per610a/home/mvp/mvp_db/hodost-lv/2014/2014_03_03_04_56/2014_03_03_21_54.mpg;Shinzo ABE.jpg;42133;42889;91121;2108;2146;38
/net/per610a/home/mvp/mvp_db/hodost-lv/2014/2014_03_03_04_56/2014_03_03_21_54.mpg;Shinzo ABE.jpg;43425;43489;91121;2173;2176;3
/net/per610a/home/mvp/mvp_db/hodost-lv/2014/2014_03_03_04_56/2014_03_03_21_54.mpg;Shinzo ABE.jpg;43757;44089;91121;2189;2206;17
/net/per610a/home/mvp/mvp_db/hodost-lv/2014/2014_03_04_04_56/2014_03_04_21_54.mpg;Toranosuke Katayama.jpg;44161;44401;91125;2209;2221;12
/net/per610a/home/mvp/mvp_db/hodost-lv/2014/2014_03_04_04_56/2014_03_04_21_54.mpg;Shinzo ABE.jpg;50993;51013;91125;2551;2552;1
/net/per610a/home/mvp/mvp_db/hodost-lv/2014/2014_03_04_04_56/2014_03_04_21_54.mpg;Shinzo ABE.jpg;51657;51757;91125;2584;2589;5
/net/per610a/home/mvp/mvp_db/hodost-lv/2014/2014_03_06_04_56/2014_03_06_21_54.mpg;Natsuo YAMAGUCHI.jpg;60281;60501;91121;3016;3027;11
/net/per610a/home/mvp/mvp_db/hodost-lv/2014/2014_03_07_04_56/2014_03_07_21_54.mpg;Shinzo ABE.jpg;26517;26861;91113;1327;1344;17
/net/per610a/home/mvp/mvp_db/hodost-lv/2014/2014_03_09_04_56/2014_03_09_10_00.mpg;Shinzo ABE.jpg;46741;46965;125881;2339;2350;11
/net/per610a/home/mvp/mvp_db/hodost-lv/2014/2014_03_09_04_56/2014_03_09_10_00.mpg;Shinzo ABE.jpg;120369;120465;125881;6024;6028;4
/net/per610a/home/mvp/mvp_db/hodost-lv/2014/2014_03_10_04_56/2014_03_10_21_54.mpg;Shinzo ABE.jpg;31565;31733;91117;1579;1588;9
/net/per610a/home/mvp/mvp_db/hodost-lv/2014/2014_03_10_04_56/2014_03_10_21_54.mpg;Shinzo ABE.jpg;33593;33689;91117;1681;1685;4
/net/per610a/home/mvp/mvp_db/hodost-lv/2014/2014_03_10_04_56/2014_03_10_21_54.mpg;Shinzo ABE.jpg;67001;67017;91117;3353;3353;0
/net/per610a/home/mvp/mvp_db/hodost-lv/2014/2014_03_10_04_56/2014_03_10_21_54.mpg;Shinzo ABE.jpg;67221;67793;91117;3364;3392;28
/net/per610a/home/mvp/mvp_db/hodost-lv/2014/2014_03_10_04_56/2014_03_10_21_54.mpg;Shinzo ABE.jpg;68009;68185;91117;3403;3412;9
/net/per610a/home/mvp/mvp_db/hodost-lv/2014/2014_03_10_04_56/2014_03_10_21_54.mpg;Shinzo ABE.jpg;71781;71805;91117;3592;3593;1
/net/per610a/home/mvp/mvp_db/hodost-lv/2014/2014_03_13_04_56/2014_03_13_21_54.mpg;Shinzo ABE.jpg;32981;33445;91121;1650;1673;23
/net/per610a/home/mvp/mvp_db/hodost-lv/2014/2014_03_13_04_56/2014_03_13_21_54.mpg;Shinzo ABE.jpg;43825;43929;91121;2193;2198;5
/net/per610a/home/mvp/mvp_db/hodost-lv/2014/2014_03_17_04_56/2014_03_17_21_54.mpg;Shinzo ABE.jpg;67193;67345;91121;3362;3370;8
/net/per610a/home/mvp/mvp_db/hodost-lv/2014/2014_03_18_04_56/2014_03_18_21_54.mpg;Shinzo ABE.jpg;10765;10889;91125;538;544;6
/net/per610a/home/mvp/mvp_db/hodost-lv/2014/2014_03_18_04_56/2014_03_18_21_54.mpg;Shinzo ABE.jpg;10953;10957;91125;548;548;0
/net/per610a/home/mvp/mvp_db/hodost-lv/2014/2014_03_19_04_56/2014_03_19_22_09.mpg;Shinzo ABE.jpg;15757;16101;91121;788;805;17
/net/per610a/home/mvp/mvp_db/hodost-lv/2014/2014_03_19_04_56/2014_03_19_22_09.mpg;Shinzo ABE.jpg;55629;56009;91121;2783;2802;19
/net/per610a/home/mvp/mvp_db/hodost-lv/2014/2014_03_20_04_56/2014_03_20_21_54.mpg;Shinzo ABE.jpg;24413;24797;91121;1221;1240;19
/net/per610a/home/mvp/mvp_db/hodost-lv/2014/2014_03_20_04_56/2014_03_20_21_54.mpg;Shinzo ABE.jpg;24929;25085;91121;1247;1255;8
/net/per610a/home/mvp/mvp_db/hodost-lv/2014/2014_03_20_04_56/2014_03_20_21_54.mpg;Shinzo ABE.jpg;25325;25389;91121;1267;1270;3
/net/per610a/home/mvp/mvp_db/hodost-lv/2014/2014_03_20_04_56/2014_03_20_21_54.mpg;Shinzo ABE.jpg;31041;31125;91121;1553;1557;4
/net/per610a/home/mvp/mvp_db/hodost-lv/2014/2014_03_20_04_56/2014_03_20_21_54.mpg;Shinzo ABE.jpg;25445;25897;91121;1273;1295;22
/net/per610a/home/mvp/mvp_db/hodost-lv/2014/2014_03_20_04_56/2014_03_20_21_54.mpg;Shinzo ABE.jpg;31161;31169;91121;1559;1559;0
/net/per610a/home/mvp/mvp_db/hodost-lv/2014/2014_03_21_04_56/2014_03_21_21_54.mpg;Shinzo ABE.jpg;42157;42185;91113;2109;2111;2
/net/per610a/home/mvp/mvp_db/hodost-lv/2014/2014_03_21_04_56/2014_03_21_21_54.mpg;Shinzo ABE.jpg;49721;49969;91113;2488;2500;12
/net/per610a/home/mvp/mvp_db/hodost-lv/2014/2014_03_21_04_56/2014_03_21_21_54.mpg;Shinzo ABE.jpg;50065;50101;91113;2505;2507;2
/net/per610a/home/mvp/mvp_db/hodost-lv/2014/2014_03_23_04_56/2014_03_23_10_00.mpg;Shinzo ABE.jpg;120321;121073;125881;6021;6059;38
/net/per610a/home/mvp/mvp_db/hodost-lv/2014/2014_03_24_04_56/2014_03_24_21_54.mpg;Shinzo ABE.jpg;2221;2341;91117;111;117;6
/net/per610a/home/mvp/mvp_db/hodost-lv/2014/2014_03_24_04_56/2014_03_24_21_54.mpg;Shinzo ABE.jpg;5817;6037;91117;291;302;11
/net/per610a/home/mvp/mvp_db/hodost-lv/2014/2014_03_24_04_56/2014_03_24_21_54.mpg;Shinzo ABE.jpg;10645;11137;91117;532;557;25
/net/per610a/home/mvp/mvp_db/hodost-lv/2014/2014_03_24_04_56/2014_03_24_21_54.mpg;Shinzo ABE.jpg;14033;14157;91117;702;708;6
/net/per610a/home/mvp/mvp_db/hodost-lv/2014/2014_03_24_04_56/2014_03_24_21_54.mpg;Shinzo ABE.jpg;14861;15029;91117;743;752;9
/net/per610a/home/mvp/mvp_db/hodost-lv/2014/2014_03_24_04_56/2014_03_24_21_54.mpg;Shinzo ABE.jpg;18545;19217;91117;928;961;33
/net/per610a/home/mvp/mvp_db/hodost-lv/2014/2014_03_26_04_56/2014_03_26_21_54.mpg;Shinzo ABE.jpg;1453;1657;91121;72;82;10
/net/per610a/home/mvp/mvp_db/hodost-lv/2014/2014_03_26_04_56/2014_03_26_21_54.mpg;Shinzo ABE.jpg;1949;1981;91121;97;99;2
/net/per610a/home/mvp/mvp_db/hodost-lv/2014/2014_03_26_04_56/2014_03_26_21_54.mpg;Shinzo ABE.jpg;8409;8485;91121;420;424;4
/net/per610a/home/mvp/mvp_db/hodost-lv/2014/2014_03_26_04_56/2014_03_26_21_54.mpg;Shinzo ABE.jpg;9621;9845;91121;481;492;11
/net/per610a/home/mvp/mvp_db/hodost-lv/2014/2014_03_26_04_56/2014_03_26_21_54.mpg;Shinzo ABE.jpg;12021;12649;91121;601;632;31
/net/per610a/home/mvp/mvp_db/hodost-lv/2014/2014_03_26_04_56/2014_03_26_21_54.mpg;Shinzo ABE.jpg;16421;16489;91121;821;825;4
/net/per610a/home/mvp/mvp_db/hodost-lv/2014/2014_03_26_04_56/2014_03_26_21_54.mpg;Shinzo ABE.jpg;18117;18549;91121;906;928;22
/net/per610a/home/mvp/mvp_db/hodost-lv/2014/2014_03_26_04_56/2014_03_26_21_54.mpg;Shinzo ABE.jpg;18697;18765;91121;935;939;4
/net/per610a/home/mvp/mvp_db/hodost-lv/2014/2014_03_26_04_56/2014_03_26_21_54.mpg;Shinzo ABE.jpg;18953;19145;91121;948;958;10
/net/per610a/home/mvp/mvp_db/hodost-lv/2014/2014_03_26_04_56/2014_03_26_21_54.mpg;Yoshimi WATANABE.jpg;21013;21397;91121;1051;1070;19
/net/per610a/home/mvp/mvp_db/hodost-lv/2014/2014_03_26_04_56/2014_03_26_21_54.mpg;Yoshimi WATANABE.jpg;24077;24781;91121;1204;1240;36
/net/per610a/home/mvp/mvp_db/hodost-lv/2014/2014_03_26_04_56/2014_03_26_21_54.mpg;Yoshimi WATANABE.jpg;24869;24977;91121;1244;1249;5
/net/per610a/home/mvp/mvp_db/hodost-lv/2014/2014_03_26_04_56/2014_03_26_21_54.mpg;Yoshimi WATANABE.jpg;22857;23193;91121;1143;1160;17
/net/per610a/home/mvp/mvp_db/hodost-lv/2014/2014_03_27_04_56/2014_03_27_21_54.mpg;Yoshimi WATANABE.jpg;37009;37473;91117;1852;1875;23
/net/per610a/home/mvp/mvp_db/hodost-lv/2014/2014_03_27_04_56/2014_03_27_21_54.mpg;Yoshimi WATANABE.jpg;37821;37941;91117;1892;1898;6
/net/per610a/home/mvp/mvp_db/hodost-lv/2014/2014_03_27_04_56/2014_03_27_21_54.mpg;Yoshimi WATANABE.jpg;39161;39265;91117;1959;1965;6
/net/per610a/home/mvp/mvp_db/hodost-lv/2014/2014_03_27_04_56/2014_03_27_21_54.mpg;Yoshimi WATANABE.jpg;37981;38573;91117;1900;1930;30
/net/per610a/home/mvp/mvp_db/hodost-lv/2014/2014_03_27_04_56/2014_03_27_21_54.mpg;Yoshimi WATANABE.jpg;42617;42933;91117;2132;2148;16
/net/per610a/home/mvp/mvp_db/hodost-lv/2014/2014_03_27_04_56/2014_03_27_21_54.mpg;Yoshimi WATANABE.jpg;43993;44433;91117;2201;2223;22
/net/per610a/home/mvp/mvp_db/hodost-lv/2014/2014_03_28_04_56/2014_03_28_21_54.mpg;Yoshimi WATANABE.jpg;4149;4217;91121;207;211;4
/net/per610a/home/mvp/mvp_db/hodost-lv/2014/2014_03_28_04_56/2014_03_28_21_54.mpg;Yoshimi WATANABE.jpg;10849;10901;91121;542;545;3
/net/per610a/home/mvp/mvp_db/hodost-lv/2014/2014_03_28_04_56/2014_03_28_21_54.mpg;Yoshimi WATANABE.jpg;12049;12189;91121;602;609;7
/net/per610a/home/mvp/mvp_db/hodost-lv/2014/2014_03_28_04_56/2014_03_28_21_54.mpg;Yoshimi WATANABE.jpg;15529;15585;91121;777;779;2
/net/per610a/home/mvp/mvp_db/hodost-lv/2014/2014_03_28_04_56/2014_03_28_21_54.mpg;Yoshimi WATANABE.jpg;17677;17821;91121;884;891;7
/net/per610a/home/mvp/mvp_db/hodost-lv/2014/2014_03_28_04_56/2014_03_28_21_54.mpg;Yoshimi WATANABE.jpg;20881;20985;91121;1044;1050;6
/net/per610a/home/mvp/mvp_db/hodost-lv/2014/2014_03_28_04_56/2014_03_28_21_54.mpg;Yoshimi WATANABE.jpg;7761;8341;91121;388;417;29
/net/per610a/home/mvp/mvp_db/hodost-lv/2014/2014_03_28_04_56/2014_03_28_21_54.mpg;Yoshimi WATANABE.jpg;9025;9065;91121;451;453;2
/net/per610a/home/mvp/mvp_db/hodost-lv/2014/2014_03_28_04_56/2014_03_28_21_54.mpg;Yoshimi WATANABE.jpg;9545;9577;91121;477;479;2
/net/per610a/home/mvp/mvp_db/hodost-lv/2014/2014_03_28_04_56/2014_03_28_21_54.mpg;Yoshimi WATANABE.jpg;11873;11957;91121;594;598;4
/net/per610a/home/mvp/mvp_db/hodost-lv/2014/2014_03_28_04_56/2014_03_28_21_54.mpg;Yoshimi WATANABE.jpg;13077;13081;91121;654;654;0
/net/per610a/home/mvp/mvp_db/hodost-lv/2014/2014_03_28_04_56/2014_03_28_21_54.mpg;Yoshimi WATANABE.jpg;20561;20797;91121;1028;1040;12
/net/per610a/home/mvp/mvp_db/hodost-lv/2014/2014_03_28_04_56/2014_03_28_21_54.mpg;Toru Hashimoto.jpg;10081;10173;91121;504;509;5
/net/per610a/home/mvp/mvp_db/hodost-lv/2014/2014_03_28_04_56/2014_03_28_21_54.mpg;Yoshimi WATANABE.jpg;14749;14793;91121;738;740;2
/net/per610a/home/mvp/mvp_db/hodost-lv/2014/2014_03_28_04_56/2014_03_28_21_54.mpg;Yoshimi WATANABE.jpg;18801;18913;91121;940;946;6
/net/per610a/home/mvp/mvp_db/hodost-lv/2014/2014_03_28_04_56/2014_03_28_21_54.mpg;Kenji Eda.jpg;16797;17537;91121;840;877;37
/net/per610a/home/mvp/mvp_db/hodost-lv/2014/2014_03_28_04_56/2014_03_28_21_54.mpg;Kenji Eda.jpg;18093;18645;91121;905;933;28
/net/per610a/home/mvp/mvp_db/hodost-lv/2014/2014_03_28_04_56/2014_03_28_21_54.mpg;Shinzo ABE.jpg;46649;47193;91121;2334;2361;27
/net/per610a/home/mvp/mvp_db/hodost-lv/2014/2014_03_28_04_56/2014_03_28_21_54.mpg;Shinzo ABE.jpg;49881;50137;91121;2496;2509;13
/net/per610a/home/mvp/mvp_db/hodost-lv/2014/2014_03_30_04_56/2014_03_30_10_00.mpg;Yoshimi WATANABE.jpg;497;593;125881;24;29;5
/net/per610a/home/mvp/mvp_db/hodost-lv/2014/2014_03_30_04_56/2014_03_30_10_00.mpg;Yoshimi WATANABE.jpg;669;793;125881;33;39;6
/net/per610a/home/mvp/mvp_db/hodost-lv/2014/2014_03_30_04_56/2014_03_30_10_00.mpg;Yoshimi WATANABE.jpg;977;1169;125881;48;58;10
/net/per610a/home/mvp/mvp_db/hodost-lv/2014/2014_03_30_04_56/2014_03_30_10_00.mpg;Yoshimi WATANABE.jpg;1441;1553;125881;72;77;5
/net/per610a/home/mvp/mvp_db/hodost-lv/2014/2014_03_30_04_56/2014_03_30_10_00.mpg;Yoshimi WATANABE.jpg;1877;2009;125881;93;100;7
/net/per610a/home/mvp/mvp_db/hodost-lv/2014/2014_03_30_04_56/2014_03_30_10_00.mpg;Yoshimi WATANABE.jpg;2853;3289;125881;142;164;22
/net/per610a/home/mvp/mvp_db/hodost-lv/2014/2014_03_30_04_56/2014_03_30_10_00.mpg;Yoshimi WATANABE.jpg;6701;6829;125881;335;341;6
/net/per610a/home/mvp/mvp_db/hodost-lv/2014/2014_03_30_04_56/2014_03_30_10_00.mpg;Yoshimi WATANABE.jpg;7013;7213;125881;350;360;10
/net/per610a/home/mvp/mvp_db/hodost-lv/2014/2014_03_30_04_56/2014_03_30_10_00.mpg;Yoshimi WATANABE.jpg;7705;8145;125881;385;407;22
/net/per610a/home/mvp/mvp_db/hodost-lv/2014/2014_03_30_04_56/2014_03_30_10_00.mpg;Yoshimi WATANABE.jpg;9601;10277;125881;480;514;34
/net/per610a/home/mvp/mvp_db/hodost-lv/2014/2014_03_30_04_56/2014_03_30_10_00.mpg;Yoshimi WATANABE.jpg;10361;10621;125881;518;531;13
/net/per610a/home/mvp/mvp_db/hodost-lv/2014/2014_03_30_04_56/2014_03_30_10_00.mpg;Yoshimi WATANABE.jpg;16181;16357;125881;809;818;9
/net/per610a/home/mvp/mvp_db/hodost-lv/2014/2014_03_30_04_56/2014_03_30_10_00.mpg;Yoshimi WATANABE.jpg;18537;18721;125881;927;936;9
/net/per610a/home/mvp/mvp_db/hodost-lv/2014/2014_03_30_04_56/2014_03_30_10_00.mpg;Yoshimi WATANABE.jpg;19157;19213;125881;958;961;3
/net/per610a/home/mvp/mvp_db/hodost-lv/2014/2014_03_30_04_56/2014_03_30_10_00.mpg;Yoshimi WATANABE.jpg;10661;10737;125881;533;537;4
/net/per610a/home/mvp/mvp_db/hodost-lv/2014/2014_03_30_04_56/2014_03_30_10_00.mpg;Yoshimi WATANABE.jpg;17221;17477;125881;861;874;13
/net/per610a/home/mvp/mvp_db/hodost-lv/2014/2014_03_30_04_56/2014_03_30_10_00.mpg;Yoshimi WATANABE.jpg;17641;17737;125881;882;887;5
/net/per610a/home/mvp/mvp_db/hodost-lv/2014/2014_03_30_04_56/2014_03_30_10_00.mpg;Yoshimi WATANABE.jpg;19457;20001;125881;973;1000;27
/net/per610a/home/mvp/mvp_db/hodost-lv/2014/2014_03_30_04_56/2014_03_30_10_00.mpg;Yoshimi WATANABE.jpg;22713;22869;125881;1136;1144;8
/net/per610a/home/mvp/mvp_db/hodost-lv/2014/2014_03_30_04_56/2014_03_30_10_00.mpg;Yoshimi WATANABE.jpg;23005;23157;125881;1151;1158;7
/net/per610a/home/mvp/mvp_db/hodost-lv/2014/2014_03_30_04_56/2014_03_30_10_00.mpg;Yoshimi WATANABE.jpg;116561;116573;125881;5833;5834;1
/net/per610a/home/mvp/mvp_db/hodost-lv/2014/2014_03_30_04_56/2014_03_30_10_00.mpg;Yoshimi WATANABE.jpg;120197;120697;125881;6015;6040;25
/net/per610a/home/mvp/mvp_db/hodost-lv/2014/2014_03_30_04_56/2014_03_30_10_00.mpg;Yoshimi WATANABE.jpg;120805;121265;125881;6045;6068;23
/net/per610a/home/mvp/mvp_db/hodost-lv/2014/2014_03_30_04_56/2014_03_30_10_00.mpg;Yoshimi WATANABE.jpg;121389;121473;125881;6075;6079;4
/net/per610a/home/mvp/mvp_db/hodost-lv/2014/2014_03_30_04_56/2014_03_30_10_00.mpg;Shinzo ABE.jpg;108493;108557;125881;5429;5432;3
/net/per610a/home/mvp/mvp_db/hodost-lv/2014/2014_03_30_04_56/2014_03_30_10_00.mpg;Shinzo ABE.jpg;116573;116573;125881;5834;5834;0
/net/per610a/home/mvp/mvp_db/hodost-lv/2014/2014_03_30_04_56/2014_03_30_10_00.mpg;Shinzo ABE.jpg;120209;120273;125881;6016;6019;3
/net/per610a/home/mvp/mvp_db/hodost-lv/2014/2014_03_30_04_56/2014_03_30_10_00.mpg;Shinzo ABE.jpg;121013;121021;125881;6056;6056;0
/net/per610a/home/mvp/mvp_db/hodost-lv/2014/2014_03_30_04_56/2014_03_30_10_00.mpg;Shinzo ABE.jpg;121389;121449;125881;6075;6078;3
/net/per610a/home/mvp/mvp_db/hodost-lv/2014/2014_03_30_04_56/2014_03_30_10_00.mpg;Natsuo YAMAGUCHI.jpg;116573;116573;125881;5834;5834;0
/net/per610a/home/mvp/mvp_db/hodost-lv/2014/2014_03_30_04_56/2014_03_30_10_00.mpg;Natsuo YAMAGUCHI.jpg;120197;120285;125881;6015;6019;4
/net/per610a/home/mvp/mvp_db/hodost-lv/2014/2014_03_30_04_56/2014_03_30_10_00.mpg;Natsuo YAMAGUCHI.jpg;120353;120353;125881;6023;6023;0
/net/per610a/home/mvp/mvp_db/hodost-lv/2014/2014_03_30_04_56/2014_03_30_10_00.mpg;Natsuo YAMAGUCHI.jpg;120581;120621;125881;6034;6036;2
/net/per610a/home/mvp/mvp_db/hodost-lv/2014/2014_03_30_04_56/2014_03_30_10_00.mpg;Natsuo YAMAGUCHI.jpg;121013;121265;125881;6056;6068;12
/net/per610a/home/mvp/mvp_db/hodost-lv/2014/2014_03_30_04_56/2014_03_30_10_00.mpg;Natsuo YAMAGUCHI.jpg;121401;121473;125881;6075;6079;4
/net/per610a/home/mvp/mvp_db/hodost-lv/2014/2014_03_30_04_56/2014_03_30_10_00.mpg;Toru Hashimoto.jpg;120709;120717;125881;6041;6041;0
/net/per610a/home/mvp/mvp_db/hodost-lv/2014/2014_03_30_04_56/2014_03_30_10_00.mpg;Toru Hashimoto.jpg;121009;121265;125881;6056;6068;12
/net/per610a/home/mvp/mvp_db/hodost-lv/2014/2014_03_30_04_56/2014_03_30_10_00.mpg;Toru Hashimoto.jpg;121389;121473;125881;6075;6079;4
/net/per610a/home/mvp/mvp_db/hodost-lv/2014/2014_03_31_04_56/2014_03_31_21_54.mpg;Yoshimi WATANABE.jpg;24697;24945;91121;1235;1248;13
/net/per610a/home/mvp/mvp_db/hodost-lv/2014/2014_03_31_04_56/2014_03_31_21_54.mpg;Taro ASO.jpg;28005;28041;91121;1401;1403;2
/net/per610a/home/mvp/mvp_db/hodost-lv/2014/2014_03_31_04_56/2014_03_31_21_54.mpg;Taro ASO.jpg;28129;28425;91121;1407;1422;15
/net/per610a/home/mvp/mvp_db/hodost-lv/2014/2014_04_01_04_56/2014_04_01_21_54.mpg;Shinzo ABE.jpg;25441;25533;91125;1273;1277;4
/net/per610a/home/mvp/mvp_db/hodost-lv/2014/2014_04_01_04_56/2014_04_01_21_54.mpg;Shinzo ABE.jpg;27537;28145;91125;1377;1408;31
/net/per610a/home/mvp/mvp_db/hodost-lv/2014/2014_04_01_04_56/2014_04_01_21_54.mpg;Shinzo ABE.jpg;46673;46749;91125;2335;2339;4
/net/per610a/home/mvp/mvp_db/hodost-lv/2014/2014_04_01_04_56/2014_04_01_21_54.mpg;Shinzo ABE.jpg;46913;47049;91125;2347;2354;7
/net/per610a/home/mvp/mvp_db/hodost-lv/2014/2014_04_01_04_56/2014_04_01_21_54.mpg;Ichiro OZAWA.jpg;51033;51037;91125;2553;2553;0
/net/per610a/home/mvp/mvp_db/hodost-lv/2014/2014_04_01_04_56/2014_04_01_21_54.mpg;Ichiro OZAWA.jpg;54489;54677;91125;2726;2736;10
/net/per610a/home/mvp/mvp_db/hodost-lv/2014/2014_04_02_04_56/2014_04_02_21_54.mpg;Shinzo ABE.jpg;25353;25569;91129;1268;1279;11
/net/per610a/home/mvp/mvp_db/hodost-lv/2014/2014_04_02_04_56/2014_04_02_21_54.mpg;Shinzo ABE.jpg;42725;42901;91129;2138;2147;9
/net/per610a/home/mvp/mvp_db/hodost-lv/2014/2014_04_02_04_56/2014_04_02_21_54.mpg;Shinzo ABE.jpg;44537;44589;91129;2229;2231;2
/net/per610a/home/mvp/mvp_db/hodost-lv/2014/2014_04_02_04_56/2014_04_02_21_54.mpg;Shinzo ABE.jpg;44661;44677;91129;2235;2236;1
/net/per610a/home/mvp/mvp_db/hodost-lv/2014/2014_04_03_04_56/2014_04_03_21_54.mpg;Yoshimi WATANABE.jpg;35937;36005;91121;1798;1801;3
/net/per610a/home/mvp/mvp_db/hodost-lv/2014/2014_04_03_04_56/2014_04_03_21_54.mpg;Yoshimi WATANABE.jpg;40785;40905;91121;2041;2047;6
/net/per610a/home/mvp/mvp_db/hodost-lv/2014/2014_04_03_04_56/2014_04_03_21_54.mpg;Yoshimi WATANABE.jpg;41009;41113;91121;2052;2057;5
/net/per610a/home/mvp/mvp_db/hodost-lv/2014/2014_04_03_04_56/2014_04_03_21_54.mpg;Keiichiro Asao.jpg;41269;41473;91121;2065;2075;10
/net/per610a/home/mvp/mvp_db/hodost-lv/2014/2014_04_03_04_56/2014_04_03_21_54.mpg;Shinzo ABE.jpg;48493;48597;91121;2426;2431;5
/net/per610a/home/mvp/mvp_db/hodost-lv/2014/2014_04_03_04_56/2014_04_03_21_54.mpg;Shinzo ABE.jpg;54681;54745;91121;2736;2739;3
/net/per610a/home/mvp/mvp_db/hodost-lv/2014/2014_04_03_04_56/2014_04_03_21_54.mpg;Natsuo YAMAGUCHI.jpg;53649;54389;91121;2684;2721;37
/net/per610a/home/mvp/mvp_db/hodost-lv/2014/2014_04_04_04_56/2014_04_04_21_54.mpg;Natsuo YAMAGUCHI.jpg;35541;35769;91125;1778;1789;11
/net/per610a/home/mvp/mvp_db/hodost-lv/2014/2014_04_04_04_56/2014_04_04_21_54.mpg;Natsuo YAMAGUCHI.jpg;36061;36225;91125;1804;1812;8
/net/per610a/home/mvp/mvp_db/hodost-lv/2014/2014_04_04_04_56/2014_04_04_21_54.mpg;Natsuo YAMAGUCHI.jpg;36565;36609;91125;1829;1831;2
/net/per610a/home/mvp/mvp_db/hodost-lv/2014/2014_04_04_04_56/2014_04_04_21_54.mpg;Shinzo ABE.jpg;47153;47217;91125;2359;2362;3
/net/per610a/home/mvp/mvp_db/hodost-lv/2014/2014_04_04_04_56/2014_04_04_21_54.mpg;Shinzo ABE.jpg;48537;48901;91125;2428;2447;19
/net/per610a/home/mvp/mvp_db/hodost-lv/2014/2014_04_06_04_56/2014_04_06_10_00.mpg;Taro ASO.jpg;19541;19761;125893;977;988;11
/net/per610a/home/mvp/mvp_db/hodost-lv/2014/2014_04_06_04_56/2014_04_06_10_00.mpg;Yoshimi WATANABE.jpg;98717;98761;125893;4940;4942;2
/net/per610a/home/mvp/mvp_db/hodost-lv/2014/2014_04_06_04_56/2014_04_06_10_00.mpg;Yoshimi WATANABE.jpg;100197;100381;125893;5014;5023;9
/net/per610a/home/mvp/mvp_db/hodost-lv/2014/2014_04_07_04_56/2014_04_07_21_54.mpg;Yoshimi WATANABE.jpg;713;1281;91125;35;64;29
/net/per610a/home/mvp/mvp_db/hodost-lv/2014/2014_04_07_04_56/2014_04_07_21_54.mpg;Yoshimi WATANABE.jpg;5257;5285;91125;263;264;1
/net/per610a/home/mvp/mvp_db/hodost-lv/2014/2014_04_07_04_56/2014_04_07_21_54.mpg;Yoshimi WATANABE.jpg;8137;10813;91125;407;541;134
/net/per610a/home/mvp/mvp_db/hodost-lv/2014/2014_04_07_04_56/2014_04_07_21_54.mpg;Yoshimi WATANABE.jpg;11125;12065;91125;556;603;47
/net/per610a/home/mvp/mvp_db/hodost-lv/2014/2014_04_07_04_56/2014_04_07_21_54.mpg;Yoshimi WATANABE.jpg;14853;14917;91125;743;746;3
/net/per610a/home/mvp/mvp_db/hodost-lv/2014/2014_04_07_04_56/2014_04_07_21_54.mpg;Yoshimi WATANABE.jpg;17889;18021;91125;895;901;6
/net/per610a/home/mvp/mvp_db/hodost-lv/2014/2014_04_07_04_56/2014_04_07_21_54.mpg;Toru Hashimoto.jpg;14437;14841;91125;722;742;20
/net/per610a/home/mvp/mvp_db/hodost-lv/2014/2014_04_07_04_56/2014_04_07_21_54.mpg;Shinzo ABE.jpg;27057;27061;91125;1353;1354;1
/net/per610a/home/mvp/mvp_db/hodost-lv/2014/2014_04_07_04_56/2014_04_07_21_54.mpg;Shinzo ABE.jpg;30205;30305;91125;1511;1516;5
/net/per610a/home/mvp/mvp_db/hodost-lv/2014/2014_04_07_04_56/2014_04_07_21_54.mpg;Shinzo ABE.jpg;34293;34317;91125;1716;1717;1
/net/per610a/home/mvp/mvp_db/hodost-lv/2014/2014_04_10_04_56/2014_04_10_22_09.mpg;Shinzo ABE.jpg;23669;23789;91121;1184;1190;6
/net/per610a/home/mvp/mvp_db/hodost-lv/2014/2014_04_10_04_56/2014_04_10_22_09.mpg;Shinzo ABE.jpg;78077;78185;91121;3907;3912;5
/net/per610a/home/mvp/mvp_db/hodost-lv/2014/2014_04_11_04_56/2014_04_11_21_54.mpg;Shinzo ABE.jpg;25601;25661;91121;1281;1284;3
/net/per610a/home/mvp/mvp_db/hodost-lv/2014/2014_04_11_04_56/2014_04_11_21_54.mpg;Shinzo ABE.jpg;85397;85457;91121;4273;4276;3
/net/per610a/home/mvp/mvp_db/hodost-lv/2014/2014_04_13_04_56/2014_04_13_10_00.mpg;Shinzo ABE.jpg;28593;28637;125881;1431;1433;2
/net/per610a/home/mvp/mvp_db/hodost-lv/2014/2014_04_13_04_56/2014_04_13_10_00.mpg;Shinzo ABE.jpg;28705;28985;125881;1436;1450;14
/net/per610a/home/mvp/mvp_db/hodost-lv/2014/2014_04_13_04_56/2014_04_13_10_00.mpg;Shinzo ABE.jpg;34361;34413;125881;1719;1722;3
/net/per610a/home/mvp/mvp_db/hodost-lv/2014/2014_04_13_04_56/2014_04_13_10_00.mpg;Shinzo ABE.jpg;34569;34653;125881;1730;1734;4
/net/per610a/home/mvp/mvp_db/hodost-lv/2014/2014_04_13_04_56/2014_04_13_10_00.mpg;Sadakazu TANIGAKI.jpg;28657;28661;125881;1434;1434;0
/net/per610a/home/mvp/mvp_db/hodost-lv/2014/2014_04_13_04_56/2014_04_13_10_00.mpg;Sadakazu TANIGAKI.jpg;34437;34509;125881;1723;1727;4
/net/per610a/home/mvp/mvp_db/hodost-lv/2014/2014_04_13_04_56/2014_04_13_10_00.mpg;Toru Hashimoto.jpg;101697;101881;125881;5089;5098;9
/net/per610a/home/mvp/mvp_db/hodost-lv/2014/2014_04_13_04_56/2014_04_13_10_00.mpg;Toru Hashimoto.jpg;103301;103505;125881;5169;5180;11
/net/per610a/home/mvp/mvp_db/hodost-lv/2014/2014_04_13_04_56/2014_04_13_10_00.mpg;Shintaro ISHIHARA.jpg;101697;101881;125881;5089;5098;9
/net/per610a/home/mvp/mvp_db/hodost-lv/2014/2014_04_13_04_56/2014_04_13_10_00.mpg;Shintaro ISHIHARA.jpg;102333;102421;125881;5121;5125;4
/net/per610a/home/mvp/mvp_db/hodost-lv/2014/2014_04_13_04_56/2014_04_13_10_00.mpg;Shintaro ISHIHARA.jpg;102953;103001;125881;5152;5154;2
/net/per610a/home/mvp/mvp_db/hodost-lv/2014/2014_04_15_04_56/2014_04_15_21_54.mpg;Shinzo ABE.jpg;29857;29885;91121;1494;1495;1
/net/per610a/home/mvp/mvp_db/hodost-lv/2014/2014_04_15_04_56/2014_04_15_21_54.mpg;Shinzo ABE.jpg;41521;41577;91121;2077;2080;3
/net/per610a/home/mvp/mvp_db/hodost-lv/2014/2014_04_17_04_56/2014_04_17_21_54.mpg;Shinzo ABE.jpg;47405;47801;91121;2372;2392;20
/net/per610a/home/mvp/mvp_db/hodost-lv/2014/2014_04_17_04_56/2014_04_17_21_54.mpg;Shinzo ABE.jpg;48009;48065;91121;2402;2405;3
/net/per610a/home/mvp/mvp_db/hodost-lv/2014/2014_04_20_04_56/2014_04_20_10_00.mpg;Toru Hashimoto.jpg;99969;100365;125881;5003;5022;19
/net/per610a/home/mvp/mvp_db/hodost-lv/2014/2014_04_22_04_56/2014_04_22_21_54.mpg;Shinzo ABE.jpg;44517;44777;91125;2227;2240;13
/net/per610a/home/mvp/mvp_db/hodost-lv/2014/2014_04_23_04_56/2014_04_23_21_54.mpg;Shinzo ABE.jpg;8485;8485;91117;424;424;0
/net/per610a/home/mvp/mvp_db/hodost-lv/2014/2014_04_23_04_56/2014_04_23_21_54.mpg;Shinzo ABE.jpg;11129;11129;91117;556;556;0
/net/per610a/home/mvp/mvp_db/hodost-lv/2014/2014_04_23_04_56/2014_04_23_21_54.mpg;Shinzo ABE.jpg;15813;15817;91117;791;791;0
/net/per610a/home/mvp/mvp_db/hodost-lv/2014/2014_04_23_04_56/2014_04_23_21_54.mpg;Shinzo ABE.jpg;18445;18445;91117;923;923;0
/net/per610a/home/mvp/mvp_db/hodost-lv/2014/2014_04_23_04_56/2014_04_23_21_54.mpg;Shinzo ABE.jpg;18541;18821;91117;927;941;14
/net/per610a/home/mvp/mvp_db/hodost-lv/2014/2014_04_23_04_56/2014_04_23_21_54.mpg;Shinzo ABE.jpg;49105;49113;91117;2457;2457;0
/net/per610a/home/mvp/mvp_db/hodost-lv/2014/2014_04_23_04_56/2014_04_23_21_54.mpg;Shinzo ABE.jpg;49177;50517;91117;2461;2528;67
/net/per610a/home/mvp/mvp_db/hodost-lv/2014/2014_04_24_04_56/2014_04_24_21_54.mpg;Natsuo YAMAGUCHI.jpg;27341;27629;91121;1368;1382;14
/net/per610a/home/mvp/mvp_db/hodost-lv/2014/2014_04_24_04_56/2014_04_24_21_54.mpg;Shinzo ABE.jpg;34645;34665;91121;1733;1734;1
/net/per610a/home/mvp/mvp_db/hodost-lv/2014/2014_04_24_04_56/2014_04_24_21_54.mpg;Shinzo ABE.jpg;34733;34761;91121;1738;1739;1
/net/per610a/home/mvp/mvp_db/hodost-lv/2014/2014_04_24_04_56/2014_04_24_21_54.mpg;Shinzo ABE.jpg;35773;35785;91121;1790;1790;0
/net/per610a/home/mvp/mvp_db/hodost-lv/2014/2014_04_24_04_56/2014_04_24_21_54.mpg;Shinzo ABE.jpg;41197;41497;91121;2061;2076;15
/net/per610a/home/mvp/mvp_db/hodost-lv/2014/2014_04_25_04_56/2014_04_25_21_54.mpg;Shinzo ABE.jpg;1605;2037;91113;80;101;21
/net/per610a/home/mvp/mvp_db/hodost-lv/2014/2014_04_25_04_56/2014_04_25_21_54.mpg;Shinzo ABE.jpg;7393;7761;91113;370;388;18
/net/per610a/home/mvp/mvp_db/hodost-lv/2014/2014_04_25_04_56/2014_04_25_21_54.mpg;Shinzo ABE.jpg;10745;10793;91113;537;540;3
/net/per610a/home/mvp/mvp_db/hodost-lv/2014/2014_04_27_04_56/2014_04_27_10_00.mpg;Shinzo ABE.jpg;38837;39101;125885;1943;1956;13
/net/per610a/home/mvp/mvp_db/hodost-lv/2014/2014_04_27_04_56/2014_04_27_10_00.mpg;Shinzo ABE.jpg;98357;98473;125885;4922;4928;6
/net/per610a/home/mvp/mvp_db/hodost-lv/2014/2014_04_27_04_56/2014_04_27_10_00.mpg;Sadakazu TANIGAKI.jpg;120973;121177;125885;6054;6064;10
/net/per610a/home/mvp/mvp_db/hodost-lv/2014/2014_04_28_04_56/2014_04_28_21_54.mpg;Shinzo ABE.jpg;45793;45929;91121;2291;2298;7
/net/per610a/home/mvp/mvp_db/hodost-lv/2014/2014_04_28_04_56/2014_04_28_21_54.mpg;Shinzo ABE.jpg;46253;46309;91121;2314;2317;3
/net/per610a/home/mvp/mvp_db/hodost-lv/2014/2014_04_28_04_56/2014_04_28_21_54.mpg;Natsuo YAMAGUCHI.jpg;50597;51009;91121;2532;2552;20
/net/per610a/home/mvp/mvp_db/hodost-lv/2014/2014_05_05_04_56/2014_05_05_21_54.mpg;Junichiro KOIZUMI.jpg;6573;6901;91109;328;345;17
/net/per610a/home/mvp/mvp_db/hodost-lv/2014/2014_05_02_04_56/2014_05_02_21_54.mpg;Taro ASO.jpg;28785;28793;91101;1440;1440;0
/net/per610a/home/mvp/mvp_db/hodost-lv/2014/2014_05_02_04_56/2014_05_02_21_54.mpg;Taro ASO.jpg;29041;29161;91101;1453;1459;6
/net/per610a/home/mvp/mvp_db/hodost-lv/2014/2014_05_02_04_56/2014_05_02_21_54.mpg;Shinzo ABE.jpg;29749;29913;91101;1488;1496;8
/net/per610a/home/mvp/mvp_db/hodost-lv/2014/2014_05_02_04_56/2014_05_02_21_54.mpg;Shinzo ABE.jpg;31141;31381;91101;1558;1570;12
/net/per610a/home/mvp/mvp_db/hodost-lv/2014/2014_05_02_04_56/2014_05_02_21_54.mpg;Shinzo ABE.jpg;31877;31893;91101;1595;1596;1
/net/per610a/home/mvp/mvp_db/hodost-lv/2014/2014_05_02_04_56/2014_05_02_21_54.mpg;Shinzo ABE.jpg;38341;38381;91101;1918;1920;2
/net/per610a/home/mvp/mvp_db/hodost-lv/2014/2014_05_02_04_56/2014_05_02_21_54.mpg;Shinzo ABE.jpg;41877;41945;91101;2095;2099;4
/net/per610a/home/mvp/mvp_db/hodost-lv/2014/2014_05_02_04_56/2014_05_02_21_54.mpg;Shinzo ABE.jpg;42453;42505;91101;2124;2127;3
/net/per610a/home/mvp/mvp_db/hodost-lv/2014/2014_05_04_04_56/2014_05_04_10_00.mpg;Shinzo ABE.jpg;120901;121001;125869;6050;6055;5
/net/per610a/home/mvp/mvp_db/hodost-lv/2014/2014_05_06_04_56/2014_05_06_21_54.mpg;Shinzo ABE.jpg;48977;49073;91109;2451;2456;5
/net/per610a/home/mvp/mvp_db/hodost-lv/2014/2014_05_06_04_56/2014_05_06_21_54.mpg;Shinzo ABE.jpg;52957;53005;91109;2650;2652;2
/net/per610a/home/mvp/mvp_db/hodost-lv/2014/2014_05_06_04_56/2014_05_06_21_54.mpg;Shinzo ABE.jpg;53069;53097;91109;2656;2657;1
/net/per610a/home/mvp/mvp_db/hodost-lv/2014/2014_05_06_04_56/2014_05_06_21_54.mpg;Shinzo ABE.jpg;53309;53361;91109;2668;2670;2
/net/per610a/home/mvp/mvp_db/hodost-lv/2014/2014_05_06_04_56/2014_05_06_21_54.mpg;Shinzo ABE.jpg;54733;54821;91109;2739;2743;4
/net/per610a/home/mvp/mvp_db/hodost-lv/2014/2014_05_06_04_56/2014_05_06_21_54.mpg;Shinzo ABE.jpg;51797;51861;91109;2592;2595;3
/net/per610a/home/mvp/mvp_db/hodost-lv/2014/2014_05_06_04_56/2014_05_06_21_54.mpg;Shinzo ABE.jpg;52069;52949;91109;2606;2650;44
/net/per610a/home/mvp/mvp_db/hodost-lv/2014/2014_05_07_04_56/2014_05_07_21_54.mpg;Natsuo YAMAGUCHI.jpg;38749;39217;91101;1939;1962;23
/net/per610a/home/mvp/mvp_db/hodost-lv/2014/2014_05_09_04_56/2014_05_09_21_54.mpg;Shinzo ABE.jpg;21777;21909;91109;1089;1096;7
/net/per610a/home/mvp/mvp_db/hodost-lv/2014/2014_05_09_04_56/2014_05_09_21_54.mpg;Shinzo ABE.jpg;22057;22245;91109;1103;1113;10
/net/per610a/home/mvp/mvp_db/hodost-lv/2014/2014_05_09_04_56/2014_05_09_21_54.mpg;Shinzo ABE.jpg;32537;32605;91109;1628;1631;3
/net/per610a/home/mvp/mvp_db/hodost-lv/2014/2014_05_11_04_56/2014_05_11_10_00.mpg;Toru Hashimoto.jpg;92709;92849;125869;4639;4646;7
/net/per610a/home/mvp/mvp_db/hodost-lv/2014/2014_05_13_04_56/2014_05_13_21_54.mpg;Shinzo ABE.jpg;40609;40689;91109;2032;2036;4
/net/per610a/home/mvp/mvp_db/hodost-lv/2014/2014_05_15_04_56/2014_05_15_21_54.mpg;Shinzo ABE.jpg;2369;2425;91109;118;121;3
/net/per610a/home/mvp/mvp_db/hodost-lv/2014/2014_05_15_04_56/2014_05_15_21_54.mpg;Shinzo ABE.jpg;3857;4245;91109;193;212;19
/net/per610a/home/mvp/mvp_db/hodost-lv/2014/2014_05_15_04_56/2014_05_15_21_54.mpg;Shinzo ABE.jpg;10553;10985;91109;528;549;21
/net/per610a/home/mvp/mvp_db/hodost-lv/2014/2014_05_15_04_56/2014_05_15_21_54.mpg;Shinzo ABE.jpg;13861;14241;91109;693;712;19
/net/per610a/home/mvp/mvp_db/hodost-lv/2014/2014_05_15_04_56/2014_05_15_21_54.mpg;Shinzo ABE.jpg;14725;16449;91109;736;823;87
/net/per610a/home/mvp/mvp_db/hodost-lv/2014/2014_05_15_04_56/2014_05_15_21_54.mpg;Shinzo ABE.jpg;25989;26189;91109;1300;1310;10
/net/per610a/home/mvp/mvp_db/hodost-lv/2014/2014_05_15_04_56/2014_05_15_21_54.mpg;Shinzo ABE.jpg;50921;50941;91109;2548;2549;1
/net/per610a/home/mvp/mvp_db/hodost-lv/2014/2014_05_15_04_56/2014_05_15_21_54.mpg;Natsuo YAMAGUCHI.jpg;17777;17889;91109;889;895;6
/net/per610a/home/mvp/mvp_db/hodost-lv/2014/2014_05_15_04_56/2014_05_15_21_54.mpg;Natsuo YAMAGUCHI.jpg;18293;18653;91109;915;933;18
/net/per610a/home/mvp/mvp_db/hodost-lv/2014/2014_05_18_04_56/2014_05_18_10_00.mpg;Shinzo ABE.jpg;42293;42605;125869;2116;2132;16
/net/per610a/home/mvp/mvp_db/hodost-lv/2014/2014_05_20_04_56/2014_05_20_21_54.mpg;Natsuo YAMAGUCHI.jpg;24373;24453;91101;1219;1223;4
/net/per610a/home/mvp/mvp_db/hodost-lv/2014/2014_05_20_04_56/2014_05_20_21_54.mpg;Natsuo YAMAGUCHI.jpg;27313;27353;91101;1366;1368;2
/net/per610a/home/mvp/mvp_db/hodost-lv/2014/2014_05_20_04_56/2014_05_20_21_54.mpg;Natsuo YAMAGUCHI.jpg;28469;29101;91101;1424;1456;32
/net/per610a/home/mvp/mvp_db/hodost-lv/2014/2014_05_20_04_56/2014_05_20_21_54.mpg;Natsuo YAMAGUCHI.jpg;31505;31973;91101;1576;1600;24
/net/per610a/home/mvp/mvp_db/hodost-lv/2014/2014_05_20_04_56/2014_05_20_21_54.mpg;Natsuo YAMAGUCHI.jpg;32193;32713;91101;1611;1637;26
/net/per610a/home/mvp/mvp_db/hodost-lv/2014/2014_05_20_04_56/2014_05_20_21_54.mpg;Natsuo YAMAGUCHI.jpg;32789;32973;91101;1640;1650;10
/net/per610a/home/mvp/mvp_db/hodost-lv/2014/2014_05_20_04_56/2014_05_20_21_54.mpg;Natsuo YAMAGUCHI.jpg;33853;34093;91101;1694;1706;12
/net/per610a/home/mvp/mvp_db/hodost-lv/2014/2014_05_20_04_56/2014_05_20_21_54.mpg;Natsuo YAMAGUCHI.jpg;34165;34601;91101;1709;1731;22
/net/per610a/home/mvp/mvp_db/hodost-lv/2014/2014_05_20_04_56/2014_05_20_21_54.mpg;Natsuo YAMAGUCHI.jpg;35053;35453;91101;1754;1774;20
/net/per610a/home/mvp/mvp_db/hodost-lv/2014/2014_05_20_04_56/2014_05_20_21_54.mpg;Natsuo YAMAGUCHI.jpg;35569;36129;91101;1779;1808;29
/net/per610a/home/mvp/mvp_db/hodost-lv/2014/2014_05_20_04_56/2014_05_20_21_54.mpg;Natsuo YAMAGUCHI.jpg;36601;37949;91101;1831;1899;68
/net/per610a/home/mvp/mvp_db/hodost-lv/2014/2014_05_20_04_56/2014_05_20_21_54.mpg;Natsuo YAMAGUCHI.jpg;38157;38257;91101;1909;1914;5
/net/per610a/home/mvp/mvp_db/hodost-lv/2014/2014_05_20_04_56/2014_05_20_21_54.mpg;Natsuo YAMAGUCHI.jpg;38769;39585;91101;1940;1980;40
/net/per610a/home/mvp/mvp_db/hodost-lv/2014/2014_05_20_04_56/2014_05_20_21_54.mpg;Natsuo YAMAGUCHI.jpg;41109;41425;91101;2057;2073;16
/net/per610a/home/mvp/mvp_db/hodost-lv/2014/2014_05_20_04_56/2014_05_20_21_54.mpg;Natsuo YAMAGUCHI.jpg;41585;41701;91101;2081;2086;5
/net/per610a/home/mvp/mvp_db/hodost-lv/2014/2014_05_20_04_56/2014_05_20_21_54.mpg;Natsuo YAMAGUCHI.jpg;42269;42421;91101;2115;2122;7
/net/per610a/home/mvp/mvp_db/hodost-lv/2014/2014_05_20_04_56/2014_05_20_21_54.mpg;Natsuo YAMAGUCHI.jpg;42549;42781;91101;2129;2140;11
/net/per610a/home/mvp/mvp_db/hodost-lv/2014/2014_05_20_04_56/2014_05_20_21_54.mpg;Natsuo YAMAGUCHI.jpg;42929;43153;91101;2148;2159;11
/net/per610a/home/mvp/mvp_db/hodost-lv/2014/2014_05_20_04_56/2014_05_20_21_54.mpg;Natsuo YAMAGUCHI.jpg;43941;44401;91101;2198;2221;23
/net/per610a/home/mvp/mvp_db/hodost-lv/2014/2014_05_20_04_56/2014_05_20_21_54.mpg;Natsuo YAMAGUCHI.jpg;44533;45069;91101;2228;2255;27
/net/per610a/home/mvp/mvp_db/hodost-lv/2014/2014_05_20_04_56/2014_05_20_21_54.mpg;Natsuo YAMAGUCHI.jpg;45197;45393;91101;2261;2271;10
/net/per610a/home/mvp/mvp_db/hodost-lv/2014/2014_05_20_04_56/2014_05_20_21_54.mpg;Natsuo YAMAGUCHI.jpg;46137;46437;91101;2308;2323;15
/net/per610a/home/mvp/mvp_db/hodost-lv/2014/2014_05_20_04_56/2014_05_20_21_54.mpg;Natsuo YAMAGUCHI.jpg;46545;46877;91101;2329;2345;16
/net/per610a/home/mvp/mvp_db/hodost-lv/2014/2014_05_20_04_56/2014_05_20_21_54.mpg;Natsuo YAMAGUCHI.jpg;48005;48177;91101;2402;2410;8
/net/per610a/home/mvp/mvp_db/hodost-lv/2014/2014_05_20_04_56/2014_05_20_21_54.mpg;Natsuo YAMAGUCHI.jpg;48313;48361;91101;2417;2420;3
/net/per610a/home/mvp/mvp_db/hodost-lv/2014/2014_05_20_04_56/2014_05_20_21_54.mpg;Natsuo YAMAGUCHI.jpg;49169;49329;91101;2460;2468;8
/net/per610a/home/mvp/mvp_db/hodost-lv/2014/2014_05_20_04_56/2014_05_20_21_54.mpg;Natsuo YAMAGUCHI.jpg;49477;49581;91101;2475;2481;6
/net/per610a/home/mvp/mvp_db/hodost-lv/2014/2014_05_20_04_56/2014_05_20_21_54.mpg;Natsuo YAMAGUCHI.jpg;50433;50813;91101;2523;2542;19
/net/per610a/home/mvp/mvp_db/hodost-lv/2014/2014_05_20_04_56/2014_05_20_21_54.mpg;Natsuo YAMAGUCHI.jpg;51053;51385;91101;2554;2571;17
/net/per610a/home/mvp/mvp_db/hodost-lv/2014/2014_05_20_04_56/2014_05_20_21_54.mpg;Natsuo YAMAGUCHI.jpg;51545;51561;91101;2579;2580;1
/net/per610a/home/mvp/mvp_db/hodost-lv/2014/2014_05_21_04_56/2014_05_21_21_54.mpg;Yukio EDANO.jpg;23585;24005;91101;1180;1201;21
/net/per610a/home/mvp/mvp_db/hodost-lv/2014/2014_05_23_04_56/2014_05_23_21_54.mpg;Shinzo ABE.jpg;32273;32401;91101;1615;1621;6
/net/per610a/home/mvp/mvp_db/hodost-lv/2014/2014_05_23_04_56/2014_05_23_21_54.mpg;Shinzo ABE.jpg;35861;36049;91101;1794;1804;10
/net/per610a/home/mvp/mvp_db/hodost-lv/2014/2014_05_23_04_56/2014_05_23_21_54.mpg;Shinzo ABE.jpg;42645;42849;91101;2134;2144;10
/net/per610a/home/mvp/mvp_db/hodost-lv/2014/2014_05_23_04_56/2014_05_23_21_54.mpg;Shinzo ABE.jpg;43781;43865;91101;2190;2195;5
/net/per610a/home/mvp/mvp_db/hodost-lv/2014/2014_05_23_04_56/2014_05_23_21_54.mpg;Shinzo ABE.jpg;57141;57181;91101;2859;2861;2
/net/per610a/home/mvp/mvp_db/hodost-lv/2014/2014_05_23_04_56/2014_05_23_21_54.mpg;Shinzo ABE.jpg;59773;59789;91101;2991;2992;1
/net/per610a/home/mvp/mvp_db/hodost-lv/2014/2014_05_23_04_56/2014_05_23_21_54.mpg;Shinzo ABE.jpg;60125;60205;91101;3008;3012;4
/net/per610a/home/mvp/mvp_db/hodost-lv/2014/2014_05_25_04_56/2014_05_25_10_00.mpg;Shinzo ABE.jpg;35905;35917;125869;1796;1797;1
/net/per610a/home/mvp/mvp_db/hodost-lv/2014/2014_05_25_04_56/2014_05_25_10_00.mpg;Shinzo ABE.jpg;36049;36133;125869;1804;1808;4
/net/per610a/home/mvp/mvp_db/hodost-lv/2014/2014_05_25_04_56/2014_05_25_10_00.mpg;Shinzo ABE.jpg;38649;38661;125869;1934;1934;0
/net/per610a/home/mvp/mvp_db/hodost-lv/2014/2014_05_25_04_56/2014_05_25_10_00.mpg;Shinzo ABE.jpg;37573;38037;125869;1880;1903;23
/net/per610a/home/mvp/mvp_db/hodost-lv/2014/2014_05_25_04_56/2014_05_25_10_00.mpg;Shinzo ABE.jpg;38673;38913;125869;1935;1947;12
/net/per610a/home/mvp/mvp_db/hodost-lv/2014/2014_05_26_04_56/2014_05_26_21_54.mpg;Shinzo ABE.jpg;39433;39445;91109;1973;1974;1
/net/per610a/home/mvp/mvp_db/hodost-lv/2014/2014_05_26_04_56/2014_05_26_21_54.mpg;Shinzo ABE.jpg;42673;42877;91109;2135;2145;10
/net/per610a/home/mvp/mvp_db/hodost-lv/2014/2014_05_26_04_56/2014_05_26_21_54.mpg;Shinzo ABE.jpg;46025;46213;91109;2303;2312;9
/net/per610a/home/mvp/mvp_db/hodost-lv/2014/2014_05_26_04_56/2014_05_26_21_54.mpg;Shinzo ABE.jpg;46681;46789;91109;2336;2341;5
/net/per610a/home/mvp/mvp_db/hodost-lv/2014/2014_05_26_04_56/2014_05_26_21_54.mpg;Shinzo ABE.jpg;52281;52521;91109;2616;2628;12
/net/per610a/home/mvp/mvp_db/hodost-lv/2014/2014_05_27_04_56/2014_05_27_21_54.mpg;Shinzo ABE.jpg;35997;36029;91109;1801;1803;2
/net/per610a/home/mvp/mvp_db/hodost-lv/2014/2014_05_27_04_56/2014_05_27_21_54.mpg;Shinzo ABE.jpg;37229;37401;91109;1863;1871;8
/net/per610a/home/mvp/mvp_db/hodost-lv/2014/2014_05_27_04_56/2014_05_27_21_54.mpg;Shinzo ABE.jpg;51993;52129;91109;2602;2609;7
/net/per610a/home/mvp/mvp_db/hodost-lv/2014/2014_05_28_04_56/2014_05_28_21_54.mpg;Toru Hashimoto.jpg;14985;15017;91101;749;751;2
/net/per610a/home/mvp/mvp_db/hodost-lv/2014/2014_05_28_04_56/2014_05_28_21_54.mpg;Toru Hashimoto.jpg;15125;15129;91101;756;757;1
/net/per610a/home/mvp/mvp_db/hodost-lv/2014/2014_05_28_04_56/2014_05_28_21_54.mpg;Toru Hashimoto.jpg;15969;16021;91101;799;801;2
/net/per610a/home/mvp/mvp_db/hodost-lv/2014/2014_05_28_04_56/2014_05_28_21_54.mpg;Toru Hashimoto.jpg;17269;17817;91101;864;891;27
/net/per610a/home/mvp/mvp_db/hodost-lv/2014/2014_05_28_04_56/2014_05_28_21_54.mpg;Toru Hashimoto.jpg;21621;21653;91101;1081;1083;2
/net/per610a/home/mvp/mvp_db/hodost-lv/2014/2014_05_28_04_56/2014_05_28_21_54.mpg;Toru Hashimoto.jpg;25889;25897;91101;1295;1295;0
/net/per610a/home/mvp/mvp_db/hodost-lv/2014/2014_05_28_04_56/2014_05_28_21_54.mpg;Takeo Hiranuma.jpeg;16893;17009;91101;845;851;6
/net/per610a/home/mvp/mvp_db/hodost-lv/2014/2014_05_28_04_56/2014_05_28_21_54.mpg;Ichiro Matsui.jpeg;18437;19229;91101;922;962;40
/net/per610a/home/mvp/mvp_db/hodost-lv/2014/2014_05_28_04_56/2014_05_28_21_54.mpg;Kenji Eda.jpg;19885;20141;91101;995;1007;12
/net/per610a/home/mvp/mvp_db/hodost-lv/2014/2014_05_28_04_56/2014_05_28_21_54.mpg;Kenji Eda.jpg;22113;23585;91101;1106;1180;74
/net/per610a/home/mvp/mvp_db/hodost-lv/2014/2014_05_28_04_56/2014_05_28_21_54.mpg;Toru Hashimoto.jpg;20945;21313;91101;1048;1066;18
/net/per610a/home/mvp/mvp_db/hodost-lv/2014/2014_05_28_04_56/2014_05_28_21_54.mpg;Yorihisa Matsuno.png;21853;21945;91101;1093;1098;5
/net/per610a/home/mvp/mvp_db/hodost-lv/2014/2014_05_28_04_56/2014_05_28_21_54.mpg;Yorihisa Matsuno.png;22017;22033;91101;1101;1102;1
/net/per610a/home/mvp/mvp_db/hodost-lv/2014/2014_05_29_04_56/2014_05_29_21_54.mpg;Shinzo ABE.jpg;153;1557;91109;7;77;70
/net/per610a/home/mvp/mvp_db/hodost-lv/2014/2014_05_29_04_56/2014_05_29_21_54.mpg;Shinzo ABE.jpg;6849;7513;91109;342;376;34
/net/per610a/home/mvp/mvp_db/hodost-lv/2014/2014_05_29_04_56/2014_05_29_21_54.mpg;Shinzo ABE.jpg;10549;10689;91109;527;534;7
/net/per610a/home/mvp/mvp_db/hodost-lv/2014/2014_05_29_04_56/2014_05_29_21_54.mpg;Shinzo ABE.jpg;47437;48033;91109;2374;2404;30
/net/per610a/home/mvp/mvp_db/hodost-lv/2014/2014_05_29_04_56/2014_05_29_21_54.mpg;Yasuo FUKUDA.jpg;21845;21925;91109;1093;1097;4
/net/per610a/home/mvp/mvp_db/hodost-lv/2014/2014_05_30_04_56/2014_05_30_21_54.mpg;Shinzo ABE.jpg;8637;8697;91101;432;435;3
/net/per610a/home/mvp/mvp_db/hodost-lv/2014/2014_05_30_04_56/2014_05_30_21_54.mpg;Shinzo ABE.jpg;22637;22705;91101;1132;1136;4
/net/per610a/home/mvp/mvp_db/hodost-lv/2014/2014_05_30_04_56/2014_05_30_21_54.mpg;Shinzo ABE.jpg;24113;24129;91101;1206;1207;1
/net/per610a/home/mvp/mvp_db/hodost-lv/2014/2014_05_30_04_56/2014_05_30_21_54.mpg;Shinzo ABE.jpg;50109;50149;91101;2507;2509;2
/net/per610a/home/mvp/mvp_db/hodost-lv/2014/2014_05_30_04_56/2014_05_30_21_54.mpg;Shinzo ABE.jpg;53577;54553;91101;2681;2730;49
/net/per610a/home/mvp/mvp_db/hodost-lv/2014/2014_05_30_04_56/2014_05_30_21_54.mpg;Shinzo ABE.jpg;55077;55473;91101;2756;2776;20
/net/per610a/home/mvp/mvp_db/hodost-lv/2014/2014_05_30_04_56/2014_05_30_21_54.mpg;Ichiro OZAWA.jpg;9825;10001;91101;491;500;9
/net/per610a/home/mvp/mvp_db/hodost-lv/2014/2014_05_30_04_56/2014_05_30_21_54.mpg;Akihiro OHTA.jpg;12617;13281;91101;631;664;33
/net/per610a/home/mvp/mvp_db/hodost-lv/2014/2014_05_30_04_56/2014_05_30_21_54.mpg;Shinzo ABE.jpg;24353;24509;91101;1218;1226;8
/net/per610a/home/mvp/mvp_db/hodost-lv/2014/2014_05_30_04_56/2014_05_30_21_54.mpg;Seiji MAEHARA.jpg;84765;85441;91101;4241;4275;34
/net/per610a/home/mvp/mvp_db/hodost-lv/2014/2014_06_01_04_56/2014_06_01_10_00.mpg;Ichiro OZAWA.jpg;22741;22889;125869;1138;1145;7
/net/per610a/home/mvp/mvp_db/hodost-lv/2014/2014_06_01_04_56/2014_06_01_10_00.mpg;Junichiro KOIZUMI.jpg;36061;36241;125869;1804;1813;9
/net/per610a/home/mvp/mvp_db/hodost-lv/2014/2014_06_01_04_56/2014_06_01_10_00.mpg;Toru Hashimoto.jpg;106233;106357;125869;5316;5322;6
/net/per610a/home/mvp/mvp_db/hodost-lv/2014/2014_06_02_04_56/2014_06_02_21_54.mpg;Shinzo ABE.jpg;36941;37061;91109;1848;1854;6
/net/per610a/home/mvp/mvp_db/hodost-lv/2014/2014_06_02_04_56/2014_06_02_21_54.mpg;Shinzo ABE.jpg;40297;40373;91109;2016;2020;4
/net/per610a/home/mvp/mvp_db/hodost-lv/2014/2014_06_03_04_56/2014_06_03_21_54.mpg;Shinzo ABE.jpg;59601;60089;91101;2982;3007;25
/net/per610a/home/mvp/mvp_db/hodost-lv/2014/2014_06_04_04_56/2014_06_04_21_54.mpg;Shintaro ISHIHARA.jpg;45713;45769;91109;2287;2290;3
/net/per610a/home/mvp/mvp_db/hodost-lv/2014/2014_06_04_04_56/2014_06_04_21_54.mpg;Shintaro ISHIHARA.jpg;48269;48577;91109;2415;2431;16
/net/per610a/home/mvp/mvp_db/hodost-lv/2014/2014_06_04_04_56/2014_06_04_21_54.mpg;Shintaro ISHIHARA.jpg;48869;48921;91109;2445;2448;3
/net/per610a/home/mvp/mvp_db/hodost-lv/2014/2014_06_05_04_56/2014_06_05_21_54.mpg;Natsuo YAMAGUCHI.jpg;11513;12009;91109;576;601;25
/net/per610a/home/mvp/mvp_db/hodost-lv/2014/2014_06_05_04_56/2014_06_05_21_54.mpg;Shinzo ABE.jpg;25553;25597;91109;1278;1281;3
/net/per610a/home/mvp/mvp_db/hodost-lv/2014/2014_06_05_04_56/2014_06_05_21_54.mpg;Shinzo ABE.jpg;25817;26101;91109;1292;1306;14
/net/per610a/home/mvp/mvp_db/hodost-lv/2014/2014_06_05_04_56/2014_06_05_21_54.mpg;Shinzo ABE.jpg;29005;29457;91109;1451;1474;23
/net/per610a/home/mvp/mvp_db/hodost-lv/2014/2014_06_06_04_56/2014_06_06_21_54.mpg;Shinzo ABE.jpg;28865;28945;91109;1444;1448;4
/net/per610a/home/mvp/mvp_db/hodost-lv/2014/2014_06_06_04_56/2014_06_06_21_54.mpg;Shinzo ABE.jpg;29177;29249;91109;1459;1463;4
/net/per610a/home/mvp/mvp_db/hodost-lv/2014/2014_06_06_04_56/2014_06_06_21_54.mpg;Shinzo ABE.jpg;29449;29485;91109;1473;1475;2
/net/per610a/home/mvp/mvp_db/hodost-lv/2014/2014_06_06_04_56/2014_06_06_21_54.mpg;Shinzo ABE.jpg;40657;40693;91109;2034;2036;2
/net/per610a/home/mvp/mvp_db/hodost-lv/2014/2014_06_09_04_56/2014_06_09_21_54.mpg;Shinzo ABE.jpg;30981;31021;91109;1550;1552;2
/net/per610a/home/mvp/mvp_db/hodost-lv/2014/2014_06_09_04_56/2014_06_09_21_54.mpg;Shinzo ABE.jpg;32977;33369;91109;1650;1670;20
/net/per610a/home/mvp/mvp_db/hodost-lv/2014/2014_06_09_04_56/2014_06_09_21_54.mpg;Shinzo ABE.jpg;52981;53205;91109;2651;2662;11
/net/per610a/home/mvp/mvp_db/hodost-lv/2014/2014_06_10_04_56/2014_06_10_21_54.mpg;Shinzo ABE.jpg;32977;33017;91101;1650;1652;2
/net/per610a/home/mvp/mvp_db/hodost-lv/2014/2014_06_10_04_56/2014_06_10_21_54.mpg;Shinzo ABE.jpg;35033;35201;91101;1753;1761;8
/net/per610a/home/mvp/mvp_db/hodost-lv/2014/2014_06_10_04_56/2014_06_10_21_54.mpg;Shinzo ABE.jpg;40525;40545;91101;2028;2029;1
/net/per610a/home/mvp/mvp_db/hodost-lv/2014/2014_06_10_04_56/2014_06_10_21_54.mpg;Shinzo ABE.jpg;41817;41849;91101;2092;2094;2
/net/per610a/home/mvp/mvp_db/hodost-lv/2014/2014_06_10_04_56/2014_06_10_21_54.mpg;Shinzo ABE.jpg;42081;42249;91101;2105;2114;9
/net/per610a/home/mvp/mvp_db/hodost-lv/2014/2014_06_10_04_56/2014_06_10_21_54.mpg;Shinzo ABE.jpg;44409;44461;91101;2222;2224;2
/net/per610a/home/mvp/mvp_db/hodost-lv/2014/2014_06_10_04_56/2014_06_10_21_54.mpg;Akihiro OHTA.jpg;40681;40777;91101;2035;2040;5
/net/per610a/home/mvp/mvp_db/hodost-lv/2014/2014_06_10_04_56/2014_06_10_21_54.mpg;Taro ASO.jpg;48065;48405;91101;2405;2422;17
/net/per610a/home/mvp/mvp_db/hodost-lv/2014/2014_06_10_04_56/2014_06_10_21_54.mpg;Taro ASO.jpg;49485;49897;91101;2476;2497;21
/net/per610a/home/mvp/mvp_db/hodost-lv/2014/2014_06_10_04_56/2014_06_10_21_54.mpg;Toru Hashimoto.jpg;77733;78281;91101;3890;3917;27
/net/per610a/home/mvp/mvp_db/hodost-lv/2014/2014_06_10_04_56/2014_06_10_21_54.mpg;Toru Hashimoto.jpg;78757;78813;91101;3941;3944;3
/net/per610a/home/mvp/mvp_db/hodost-lv/2014/2014_06_10_04_56/2014_06_10_21_54.mpg;Toru Hashimoto.jpg;80437;80513;91101;4025;4029;4
/net/per610a/home/mvp/mvp_db/hodost-lv/2014/2014_06_10_04_56/2014_06_10_21_54.mpg;Toru Hashimoto.jpg;85277;85437;91101;4267;4275;8
/net/per610a/home/mvp/mvp_db/hodost-lv/2014/2014_06_13_04_56/2014_06_13_21_54.mpg;Shinzo ABE.jpg;26281;26617;91109;1315;1331;16
/net/per610a/home/mvp/mvp_db/hodost-lv/2014/2014_06_13_04_56/2014_06_13_21_54.mpg;Shinzo ABE.jpg;57129;57681;91109;2858;2886;28
/net/per610a/home/mvp/mvp_db/hodost-lv/2014/2014_06_13_04_56/2014_06_13_21_54.mpg;Shinzo ABE.jpg;59813;59877;91109;2992;2996;4
/net/per610a/home/mvp/mvp_db/hodost-lv/2014/2014_06_13_04_56/2014_06_13_21_54.mpg;Shinzo ABE.jpg;62049;62125;91109;3104;3108;4
/net/per610a/home/mvp/mvp_db/hodost-lv/2014/2014_06_13_04_56/2014_06_13_21_54.mpg;Taro ASO.jpg;59397;59765;91109;2972;2990;18
/net/per610a/home/mvp/mvp_db/hodost-lv/2014/2014_06_13_04_56/2014_06_13_21_54.mpg;Taro ASO.jpg;60417;60909;91109;3023;3047;24
/net/per610a/home/mvp/mvp_db/hodost-lv/2014/2014_06_16_04_56/2014_06_16_21_54.mpg;Shinzo ABE.jpg;33121;33173;91109;1657;1660;3
/net/per610a/home/mvp/mvp_db/hodost-lv/2014/2014_06_16_04_56/2014_06_16_21_54.mpg;Shinzo ABE.jpg;36641;36665;91109;1833;1835;2
/net/per610a/home/mvp/mvp_db/hodost-lv/2014/2014_06_16_04_56/2014_06_16_21_54.mpg;Shinzo ABE.jpg;40697;40901;91109;2036;2047;11
/net/per610a/home/mvp/mvp_db/hodost-lv/2014/2014_06_16_04_56/2014_06_16_21_54.mpg;Shinzo ABE.jpg;41013;41077;91109;2052;2055;3
/net/per610a/home/mvp/mvp_db/hodost-lv/2014/2014_06_16_04_56/2014_06_16_21_54.mpg;Shinzo ABE.jpg;40169;40353;91109;2010;2019;9
/net/per610a/home/mvp/mvp_db/hodost-lv/2014/2014_06_16_04_56/2014_06_16_21_54.mpg;Shinzo ABE.jpg;41473;41501;91109;2075;2077;2
/net/per610a/home/mvp/mvp_db/hodost-lv/2014/2014_06_16_04_56/2014_06_16_21_54.mpg;Shinzo ABE.jpg;47681;47697;91109;2386;2387;1
/net/per610a/home/mvp/mvp_db/hodost-lv/2014/2014_06_16_04_56/2014_06_16_21_54.mpg;Shinzo ABE.jpg;47817;47925;91109;2393;2398;5
/net/per610a/home/mvp/mvp_db/hodost-lv/2014/2014_06_17_04_56/2014_06_17_21_54.mpg;Shinzo ABE.jpg;36445;36493;91109;1824;1826;2
/net/per610a/home/mvp/mvp_db/hodost-lv/2014/2014_06_17_04_56/2014_06_17_21_54.mpg;Shinzo ABE.jpg;36921;36989;91109;1847;1851;4
/net/per610a/home/mvp/mvp_db/hodost-lv/2014/2014_06_18_04_56/2014_06_18_21_54.mpg;Shinzo ABE.jpg;23469;23617;91101;1174;1181;7
/net/per610a/home/mvp/mvp_db/hodost-lv/2014/2014_06_18_04_56/2014_06_18_21_54.mpg;Shinzo ABE.jpg;27017;27037;91101;1352;1353;1
/net/per610a/home/mvp/mvp_db/hodost-lv/2014/2014_06_18_04_56/2014_06_18_21_54.mpg;Shinzo ABE.jpg;31729;31741;91101;1587;1588;1
/net/per610a/home/mvp/mvp_db/hodost-lv/2014/2014_06_18_04_56/2014_06_18_21_54.mpg;Shinzo ABE.jpg;32057;32229;91101;1604;1612;8
/net/per610a/home/mvp/mvp_db/hodost-lv/2014/2014_06_18_04_56/2014_06_18_21_54.mpg;Shinzo ABE.jpg;32569;32625;91101;1629;1632;3
/net/per610a/home/mvp/mvp_db/hodost-lv/2014/2014_06_19_04_56/2014_06_19_21_54.mpg;Natsuo YAMAGUCHI.jpg;53081;53165;91101;2656;2660;4
/net/per610a/home/mvp/mvp_db/hodost-lv/2014/2014_06_19_04_56/2014_06_19_21_54.mpg;Natsuo YAMAGUCHI.jpg;56097;56449;91101;2807;2824;17
/net/per610a/home/mvp/mvp_db/hodost-lv/2014/2014_06_19_04_56/2014_06_19_21_54.mpg;Natsuo YAMAGUCHI.jpg;57313;57413;91101;2868;2873;5
/net/per610a/home/mvp/mvp_db/hodost-lv/2014/2014_06_19_04_56/2014_06_19_21_54.mpg;Natsuo YAMAGUCHI.jpg;57753;57817;91101;2890;2893;3
/net/per610a/home/mvp/mvp_db/hodost-lv/2014/2014_06_19_04_56/2014_06_19_21_54.mpg;Natsuo YAMAGUCHI.jpg;57901;58377;91101;2897;2921;24
/net/per610a/home/mvp/mvp_db/hodost-lv/2014/2014_06_19_04_56/2014_06_19_21_54.mpg;Natsuo YAMAGUCHI.jpg;59513;59621;91101;2978;2983;5
/net/per610a/home/mvp/mvp_db/hodost-lv/2014/2014_06_19_04_56/2014_06_19_21_54.mpg;Shinzo ABE.jpg;56533;56793;91101;2829;2842;13
/net/per610a/home/mvp/mvp_db/hodost-lv/2014/2014_06_19_04_56/2014_06_19_21_54.mpg;Shinzo ABE.jpg;58557;58709;91101;2930;2937;7
/net/per610a/home/mvp/mvp_db/hodost-lv/2014/2014_06_20_04_56/2014_06_20_21_54.mpg;Ichiro OZAWA.jpg;25269;25317;91169;1264;1266;2
/net/per610a/home/mvp/mvp_db/hodost-lv/2014/2014_06_20_04_56/2014_06_20_21_54.mpg;Ichiro OZAWA.jpg;25481;25597;91169;1275;1280;5
/net/per610a/home/mvp/mvp_db/hodost-lv/2014/2014_06_20_04_56/2014_06_20_21_54.mpg;Ichiro OZAWA.jpg;25797;25849;91169;1290;1293;3
/net/per610a/home/mvp/mvp_db/hodost-lv/2014/2014_06_20_04_56/2014_06_20_21_54.mpg;Ichiro OZAWA.jpg;25929;25969;91169;1297;1299;2
/net/per610a/home/mvp/mvp_db/hodost-lv/2014/2014_06_20_04_56/2014_06_20_21_54.mpg;Shinzo ABE.jpg;30113;30189;91169;1506;1510;4
/net/per610a/home/mvp/mvp_db/hodost-lv/2014/2014_06_20_04_56/2014_06_20_21_54.mpg;Shinzo ABE.jpg;32321;32997;91169;1617;1651;34
/net/per610a/home/mvp/mvp_db/hodost-lv/2014/2014_06_20_04_56/2014_06_20_21_54.mpg;Shinzo ABE.jpg;35369;35469;91169;1769;1774;5
/net/per610a/home/mvp/mvp_db/hodost-lv/2014/2014_06_20_04_56/2014_06_20_21_54.mpg;Shinzo ABE.jpg;37433;37473;91169;1873;1875;2
/net/per610a/home/mvp/mvp_db/hodost-lv/2014/2014_06_22_04_56/2014_06_22_10_00.mpg;Shinzo ABE.jpg;37509;38481;125937;1877;1925;48
/net/per610a/home/mvp/mvp_db/hodost-lv/2014/2014_06_22_04_56/2014_06_22_10_00.mpg;Shinzo ABE.jpg;122249;122353;125937;6118;6123;5
/net/per610a/home/mvp/mvp_db/hodost-lv/2014/2014_06_23_04_56/2014_06_23_21_54.mpg;Shinzo ABE.jpg;14345;14409;91169;717;721;4
/net/per610a/home/mvp/mvp_db/hodost-lv/2014/2014_06_23_04_56/2014_06_23_21_54.mpg;Shinzo ABE.jpg;26561;26605;91169;1329;1331;2
/net/per610a/home/mvp/mvp_db/hodost-lv/2014/2014_06_23_04_56/2014_06_23_21_54.mpg;Shinzo ABE.jpg;26773;27005;91169;1339;1351;12
/net/per610a/home/mvp/mvp_db/hodost-lv/2014/2014_06_23_04_56/2014_06_23_21_54.mpg;Shinzo ABE.jpg;43193;43449;91169;2161;2174;13
/net/per610a/home/mvp/mvp_db/hodost-lv/2014/2014_06_24_04_56/2014_06_24_21_54.mpg;Shinzo ABE.jpg;50965;50993;91161;2550;2551;1
/net/per610a/home/mvp/mvp_db/hodost-lv/2014/2014_06_24_04_56/2014_06_24_21_54.mpg;Shinzo ABE.jpg;53661;53937;91161;2685;2699;14
/net/per610a/home/mvp/mvp_db/hodost-lv/2014/2014_06_26_04_56/2014_06_26_21_54.mpg;Toru Hashimoto.jpg;13957;14625;91161;698;731;33
/net/per610a/home/mvp/mvp_db/hodost-lv/2014/2014_06_26_04_56/2014_06_26_21_54.mpg;Toru Hashimoto.jpg;14721;14821;91161;736;741;5
/net/per610a/home/mvp/mvp_db/hodost-lv/2014/2014_06_26_04_56/2014_06_26_21_54.mpg;Toru Hashimoto.jpg;14957;15537;91161;748;777;29
/net/per610a/home/mvp/mvp_db/hodost-lv/2014/2014_06_26_04_56/2014_06_26_21_54.mpg;Toru Hashimoto.jpg;15709;15769;91161;786;789;3
/net/per610a/home/mvp/mvp_db/hodost-lv/2014/2014_06_26_04_56/2014_06_26_21_54.mpg;Toru Hashimoto.jpg;16753;16993;91161;838;850;12
/net/per610a/home/mvp/mvp_db/hodost-lv/2014/2014_06_26_04_56/2014_06_26_21_54.mpg;Natsuo YAMAGUCHI.jpg;51837;52833;91161;2594;2643;49
/net/per610a/home/mvp/mvp_db/hodost-lv/2014/2014_06_26_04_56/2014_06_26_21_54.mpg;Shintaro ISHIHARA.jpg;52973;52989;91161;2650;2651;1
/net/per610a/home/mvp/mvp_db/hodost-lv/2014/2014_06_26_04_56/2014_06_26_21_54.mpg;Shintaro ISHIHARA.jpg;53153;53257;91161;2659;2665;6
/net/per610a/home/mvp/mvp_db/hodost-lv/2014/2014_06_26_04_56/2014_06_26_21_54.mpg;Shintaro ISHIHARA.jpg;53521;53637;91161;2678;2684;6
/net/per610a/home/mvp/mvp_db/hodost-lv/2014/2014_06_27_04_56/2014_06_27_21_54.mpg;Natsuo YAMAGUCHI.jpg;10437;11017;91169;522;551;29
/net/per610a/home/mvp/mvp_db/hodost-lv/2014/2014_06_27_04_56/2014_06_27_21_54.mpg;Shinzo ABE.jpg;26265;26497;91169;1314;1326;12
/net/per610a/home/mvp/mvp_db/hodost-lv/2014/2014_06_27_04_56/2014_06_27_21_54.mpg;Taro ASO.jpg;53189;53285;91169;2662;2666;4
/net/per610a/home/mvp/mvp_db/hodost-lv/2014/2014_06_27_04_56/2014_06_27_21_54.mpg;Taro ASO.jpg;53365;53373;91169;2670;2671;1
/net/per610a/home/mvp/mvp_db/hodost-lv/2014/2014_06_27_04_56/2014_06_27_21_54.mpg;Taro ASO.jpg;54045;54065;91169;2704;2705;1
/net/per610a/home/mvp/mvp_db/hodost-lv/2014/2014_06_27_04_56/2014_06_27_21_54.mpg;Taro ASO.jpg;55317;55569;91169;2768;2781;13
/net/per610a/home/mvp/mvp_db/hodost-lv/2014/2014_06_29_04_56/2014_06_29_10_00.mpg;Shinzo ABE.jpg;4509;4749;125937;225;237;12
/net/per610a/home/mvp/mvp_db/hodost-lv/2014/2014_06_29_04_56/2014_06_29_10_00.mpg;Shinzo ABE.jpg;4901;5041;125937;245;252;7
/net/per610a/home/mvp/mvp_db/hodost-lv/2014/2014_06_29_04_56/2014_06_29_10_00.mpg;Masashi Nakano.jpg;109821;109885;125937;5496;5499;3
/net/per610a/home/mvp/mvp_db/hodost-lv/2014/2014_06_29_04_56/2014_06_29_10_00.mpg;Masashi Nakano.jpg;111769;111785;125937;5593;5594;1
/net/per610a/home/mvp/mvp_db/hodost-lv/2014/2014_06_29_04_56/2014_06_29_10_00.mpg;Kyoko Nakayama.jpg;109821;109901;125937;5496;5500;4
/net/per610a/home/mvp/mvp_db/hodost-lv/2014/2014_06_29_04_56/2014_06_29_10_00.mpg;Kyoko Nakayama.jpg;111817;111821;125937;5596;5596;0
/net/per610a/home/mvp/mvp_db/hodost-lv/2014/2014_06_29_04_56/2014_06_29_10_00.mpg;Nariaki Nakayama.png;109997;110165;125937;5505;5513;8
/net/per610a/home/mvp/mvp_db/hodost-lv/2014/2014_06_29_04_56/2014_06_29_10_00.mpg;Nariaki Nakayama.png;111969;111993;125937;5603;5605;2
/net/per610a/home/mvp/mvp_db/hodost-lv/2014/2014_06_30_04_56/2014_06_30_21_54.mpg;Shinzo ABE.jpg;15333;15417;91169;767;771;4
/net/per610a/home/mvp/mvp_db/hodost-lv/2014/2014_06_30_04_56/2014_06_30_21_54.mpg;Shinzo ABE.jpg;33565;33721;91169;1679;1687;8
/net/per610a/home/mvp/mvp_db/hodost-lv/2014/2014_06_30_04_56/2014_06_30_21_54.mpg;Shinzo ABE.jpg;35501;35637;91169;1776;1783;7
/net/per610a/home/mvp/mvp_db/hodost-lv/2014/2014_06_30_04_56/2014_06_30_21_54.mpg;Shinzo ABE.jpg;58117;58249;91169;2908;2915;7
/net/per610a/home/mvp/mvp_db/hodost-lv/2014/2014_07_01_04_56/2014_07_01_21_54.mpg;Shinzo ABE.jpg;6817;6841;91169;341;342;1
/net/per610a/home/mvp/mvp_db/hodost-lv/2014/2014_07_01_04_56/2014_07_01_21_54.mpg;Shinzo ABE.jpg;7141;7181;91169;357;359;2
/net/per610a/home/mvp/mvp_db/hodost-lv/2014/2014_07_01_04_56/2014_07_01_21_54.mpg;Shinzo ABE.jpg;7457;7985;91169;373;399;26
/net/per610a/home/mvp/mvp_db/hodost-lv/2014/2014_07_01_04_56/2014_07_01_21_54.mpg;Shinzo ABE.jpg;8457;8613;91169;423;431;8
/net/per610a/home/mvp/mvp_db/hodost-lv/2014/2014_07_01_04_56/2014_07_01_21_54.mpg;Shinzo ABE.jpg;9781;9973;91169;489;499;10
/net/per610a/home/mvp/mvp_db/hodost-lv/2014/2014_07_01_04_56/2014_07_01_21_54.mpg;Shinzo ABE.jpg;10189;10721;91169;509;536;27
/net/per610a/home/mvp/mvp_db/hodost-lv/2014/2014_07_01_04_56/2014_07_01_21_54.mpg;Shinzo ABE.jpg;11581;12149;91169;579;608;29
/net/per610a/home/mvp/mvp_db/hodost-lv/2014/2014_07_01_04_56/2014_07_01_21_54.mpg;Shinzo ABE.jpg;14861;15029;91169;743;752;9
/net/per610a/home/mvp/mvp_db/hodost-lv/2014/2014_07_01_04_56/2014_07_01_21_54.mpg;Shinzo ABE.jpg;16689;17081;91169;835;854;19
/net/per610a/home/mvp/mvp_db/hodost-lv/2014/2014_07_01_04_56/2014_07_01_21_54.mpg;Shinzo ABE.jpg;6881;6897;91169;344;345;1
/net/per610a/home/mvp/mvp_db/hodost-lv/2014/2014_07_01_04_56/2014_07_01_21_54.mpg;Shinzo ABE.jpg;13417;13637;91169;671;682;11
/net/per610a/home/mvp/mvp_db/hodost-lv/2014/2014_07_01_04_56/2014_07_01_21_54.mpg;Shinzo ABE.jpg;15317;15517;91169;766;776;10
/net/per610a/home/mvp/mvp_db/hodost-lv/2014/2014_07_01_04_56/2014_07_01_21_54.mpg;Shinzo ABE.jpg;44657;44793;91169;2235;2241;6
/net/per610a/home/mvp/mvp_db/hodost-lv/2014/2014_07_01_04_56/2014_07_01_21_54.mpg;Shinzo ABE.jpg;8717;8813;91169;436;441;5
/net/per610a/home/mvp/mvp_db/hodost-lv/2014/2014_07_01_04_56/2014_07_01_21_54.mpg;Shinzo ABE.jpg;12341;13245;91169;617;662;45
/net/per610a/home/mvp/mvp_db/hodost-lv/2014/2014_07_01_04_56/2014_07_01_21_54.mpg;Shinzo ABE.jpg;24829;25173;91169;1242;1259;17
/net/per610a/home/mvp/mvp_db/hodost-lv/2014/2014_07_01_04_56/2014_07_01_21_54.mpg;Shinzo ABE.jpg;27797;28221;91169;1391;1412;21
/net/per610a/home/mvp/mvp_db/hodost-lv/2014/2014_07_01_04_56/2014_07_01_21_54.mpg;Shinzo ABE.jpg;34433;34541;91169;1723;1728;5
/net/per610a/home/mvp/mvp_db/hodost-lv/2014/2014_07_01_04_56/2014_07_01_21_54.mpg;Akihiro OHTA.jpg;17121;17161;91169;856;858;2
/net/per610a/home/mvp/mvp_db/hodost-lv/2014/2014_07_01_04_56/2014_07_01_21_54.mpg;Akihiro OHTA.jpg;17253;17621;91169;863;881;18
/net/per610a/home/mvp/mvp_db/hodost-lv/2014/2014_07_01_04_56/2014_07_01_21_54.mpg;Bairi Kaieda.jpg;18481;19473;91169;924;974;50
/net/per610a/home/mvp/mvp_db/hodost-lv/2014/2014_07_02_04_56/2014_07_02_21_54.mpg;Ichiro OZAWA.jpg;1529;1649;91169;76;82;6
/net/per610a/home/mvp/mvp_db/hodost-lv/2014/2014_07_02_04_56/2014_07_02_21_54.mpg;Ichiro OZAWA.jpg;1725;1937;91169;86;96;10
/net/per610a/home/mvp/mvp_db/hodost-lv/2014/2014_07_02_04_56/2014_07_02_21_54.mpg;Ichiro OZAWA.jpg;9377;9689;91169;469;484;15
/net/per610a/home/mvp/mvp_db/hodost-lv/2014/2014_07_02_04_56/2014_07_02_21_54.mpg;Shinzo ABE.jpg;36009;36129;91169;1802;1808;6
/net/per610a/home/mvp/mvp_db/hodost-lv/2014/2014_07_02_04_56/2014_07_02_21_54.mpg;Shinzo ABE.jpg;37133;37561;91169;1858;1879;21
/net/per610a/home/mvp/mvp_db/hodost-lv/2014/2014_07_02_04_56/2014_07_02_21_54.mpg;Shinzo ABE.jpg;38577;38585;91169;1930;1931;1
/net/per610a/home/mvp/mvp_db/hodost-lv/2014/2014_07_02_04_56/2014_07_02_21_54.mpg;Shinzo ABE.jpg;51929;51989;91169;2599;2602;3
/net/per610a/home/mvp/mvp_db/hodost-lv/2014/2014_07_02_04_56/2014_07_02_21_54.mpg;Shinzo ABE.jpg;42449;42545;91169;2124;2129;5
/net/per610a/home/mvp/mvp_db/hodost-lv/2014/2014_07_03_04_56/2014_07_03_21_54.mpg;Shinzo ABE.jpg;761;1025;91169;38;51;13
/net/per610a/home/mvp/mvp_db/hodost-lv/2014/2014_07_03_04_56/2014_07_03_21_54.mpg;Shinzo ABE.jpg;1229;1689;91169;61;84;23
/net/per610a/home/mvp/mvp_db/hodost-lv/2014/2014_07_03_04_56/2014_07_03_21_54.mpg;Shinzo ABE.jpg;4905;5805;91169;245;290;45
/net/per610a/home/mvp/mvp_db/hodost-lv/2014/2014_07_03_04_56/2014_07_03_21_54.mpg;Shinzo ABE.jpg;25669;25701;91169;1284;1286;2
/net/per610a/home/mvp/mvp_db/hodost-lv/2014/2014_07_04_04_56/2014_07_04_21_54.mpg;Ichiro OZAWA.jpg;8433;8621;91169;422;431;9
/net/per610a/home/mvp/mvp_db/hodost-lv/2014/2014_07_06_04_56/2014_07_06_10_00.mpg;Ichiro OZAWA.jpg;26565;26941;125929;1329;1348;19
/net/per610a/home/mvp/mvp_db/hodost-lv/2014/2014_07_06_04_56/2014_07_06_10_00.mpg;Ichiro OZAWA.jpg;29305;29549;125929;1466;1478;12
/net/per610a/home/mvp/mvp_db/hodost-lv/2014/2014_07_06_04_56/2014_07_06_10_00.mpg;Toru Hashimoto.jpg;107677;107825;125929;5388;5396;8
/net/per610a/home/mvp/mvp_db/hodost-lv/2014/2014_07_07_04_56/2014_07_07_21_54.mpg;Shinzo ABE.jpg;43741;43849;91169;2189;2194;5
/net/per610a/home/mvp/mvp_db/hodost-lv/2014/2014_07_07_04_56/2014_07_07_21_54.mpg;Shinzo ABE.jpg;45937;46541;91169;2299;2329;30
/net/per610a/home/mvp/mvp_db/hodost-lv/2014/2014_07_07_04_56/2014_07_07_21_54.mpg;Shinzo ABE.jpg;45877;45925;91169;2296;2298;2
/net/per610a/home/mvp/mvp_db/hodost-lv/2014/2014_07_07_04_56/2014_07_07_21_54.mpg;Shinzo ABE.jpg;47953;48017;91169;2400;2403;3
/net/per610a/home/mvp/mvp_db/hodost-lv/2014/2014_07_07_04_56/2014_07_07_21_54.mpg;Shinzo ABE.jpg;46661;46681;91169;2335;2336;1
/net/per610a/home/mvp/mvp_db/hodost-lv/2014/2014_07_07_04_56/2014_07_07_21_54.mpg;Shinzo ABE.jpg;47729;47861;91169;2388;2395;7
/net/per610a/home/mvp/mvp_db/hodost-lv/2014/2014_07_07_04_56/2014_07_07_21_54.mpg;Junichiro KOIZUMI.jpg;57145;58185;91169;2860;2912;52
/net/per610a/home/mvp/mvp_db/hodost-lv/2014/2014_07_08_04_56/2014_07_08_21_54.mpg;Shinzo ABE.jpg;40621;40705;91169;2033;2037;4
/net/per610a/home/mvp/mvp_db/hodost-lv/2014/2014_07_08_04_56/2014_07_08_21_54.mpg;Shinzo ABE.jpg;40845;41281;91169;2044;2066;22
/net/per610a/home/mvp/mvp_db/hodost-lv/2014/2014_07_10_04_56/2014_07_10_21_54.mpg;Ichiro OZAWA.jpg;21717;22137;91169;1086;1107;21
/net/per610a/home/mvp/mvp_db/hodost-lv/2014/2014_07_13_04_56/2014_07_13_10_00.mpg;Shinzo ABE.jpg;75333;75389;125937;3770;3773;3
/net/per610a/home/mvp/mvp_db/hodost-lv/2014/2014_07_13_04_56/2014_07_13_10_00.mpg;Shinzo ABE.jpg;93293;93853;125937;4669;4697;28
/net/per610a/home/mvp/mvp_db/hodost-lv/2014/2014_07_14_04_56/2014_07_14_21_54.mpg;Yukiko Kada.jpg;6029;6345;91169;301;317;16
/net/per610a/home/mvp/mvp_db/hodost-lv/2014/2014_07_15_04_56/2014_07_15_21_54.mpg;Shinzo ABE.jpg;22037;22113;91169;1102;1106;4
/net/per610a/home/mvp/mvp_db/hodost-lv/2014/2014_07_15_04_56/2014_07_15_21_54.mpg;Shinzo ABE.jpg;27257;27581;91169;1364;1380;16
/net/per610a/home/mvp/mvp_db/hodost-lv/2014/2014_07_15_04_56/2014_07_15_21_54.mpg;Shinzo ABE.jpg;31405;31517;91169;1571;1577;6
/net/per610a/home/mvp/mvp_db/hodost-lv/2014/2014_07_15_04_56/2014_07_15_21_54.mpg;Shinzo ABE.jpg;31609;31885;91169;1582;1595;13
/net/per610a/home/mvp/mvp_db/hodost-lv/2014/2014_07_15_04_56/2014_07_15_21_54.mpg;Shinzo ABE.jpg;32773;33065;91169;1640;1654;14
/net/per610a/home/mvp/mvp_db/hodost-lv/2014/2014_07_15_04_56/2014_07_15_21_54.mpg;Shinzo ABE.jpg;35905;36013;91169;1797;1802;5
/net/per610a/home/mvp/mvp_db/hodost-lv/2014/2014_07_16_04_56/2014_07_16_21_54.mpg;Shinzo ABE.jpg;25049;26221;91169;1253;1312;59
/net/per610a/home/mvp/mvp_db/hodost-lv/2014/2014_07_17_04_56/2014_07_17_22_09.mpg;Shinzo ABE.jpg;71933;72093;91169;3600;3608;8
/net/per610a/home/mvp/mvp_db/hodost-lv/2014/2014_07_17_04_56/2014_07_17_22_09.mpg;Shinzo ABE.jpg;73325;73337;91169;3669;3670;1
/net/per610a/home/mvp/mvp_db/hodost-lv/2014/2014_07_17_04_56/2014_07_17_22_09.mpg;Shinzo ABE.jpg;75693;75829;91169;3788;3795;7
/net/per610a/home/mvp/mvp_db/hodost-lv/2014/2014_07_17_04_56/2014_07_17_22_09.mpg;Shinzo ABE.jpg;77321;77381;91169;3869;3872;3
/net/per610a/home/mvp/mvp_db/hodost-lv/2014/2014_07_23_04_56/2014_07_23_21_54.mpg;Shinzo ABE.jpg;50441;50577;91169;2524;2531;7
/net/per610a/home/mvp/mvp_db/hodost-lv/2014/2014_07_25_04_56/2014_07_25_21_54.mpg;Shinzo ABE.jpg;30425;30729;91169;1522;1537;15
/net/per610a/home/mvp/mvp_db/hodost-lv/2014/2014_07_25_04_56/2014_07_25_21_54.mpg;Shinzo ABE.jpg;30821;30881;91169;1542;1545;3
/net/per610a/home/mvp/mvp_db/hodost-lv/2014/2014_07_25_04_56/2014_07_25_21_54.mpg;Shinzo ABE.jpg;31185;31425;91169;1560;1572;12
/net/per610a/home/mvp/mvp_db/hodost-lv/2014/2014_07_25_04_56/2014_07_25_21_54.mpg;Shinzo ABE.jpg;33809;33941;91169;1692;1698;6
/net/per610a/home/mvp/mvp_db/hodost-lv/2014/2014_07_25_04_56/2014_07_25_21_54.mpg;Shinzo ABE.jpg;46693;46989;91169;2336;2351;15
/net/per610a/home/mvp/mvp_db/hodost-lv/2014/2014_07_25_04_56/2014_07_25_21_54.mpg;Shinzo ABE.jpg;61121;61809;91169;3059;3093;34
/net/per610a/home/mvp/mvp_db/hodost-lv/2014/2014_07_25_04_56/2014_07_25_21_54.mpg;Shinzo ABE.jpg;85741;85881;91169;4291;4298;7
/net/per610a/home/mvp/mvp_db/hodost-lv/2014/2014_07_27_04_56/2014_07_27_10_00.mpg;Shinzo ABE.jpg;52337;52517;125929;2619;2628;9
/net/per610a/home/mvp/mvp_db/hodost-lv/2014/2014_07_27_04_56/2014_07_27_10_00.mpg;Shinzo ABE.jpg;53409;53569;125929;2672;2680;8
/net/per610a/home/mvp/mvp_db/hodost-lv/2014/2014_07_27_04_56/2014_07_27_10_00.mpg;Shinzo ABE.jpg;56397;56665;125929;2822;2835;13
/net/per610a/home/mvp/mvp_db/hodost-lv/2014/2014_07_29_04_56/2014_07_29_21_54.mpg;Shinzo ABE.jpg;31665;31881;91169;1584;1595;11
/net/per610a/home/mvp/mvp_db/hodost-lv/2014/2014_07_29_04_56/2014_07_29_21_54.mpg;Shinzo ABE.jpg;36681;37297;91169;1835;1866;31
/net/per610a/home/mvp/mvp_db/hodost-lv/2014/2014_07_29_04_56/2014_07_29_21_54.mpg;Shinzo ABE.jpg;32457;32569;91169;1624;1630;6
/net/per610a/home/mvp/mvp_db/hodost-lv/2014/2014_07_29_04_56/2014_07_29_21_54.mpg;Shinzo ABE.jpg;32961;33089;91169;1649;1656;7
/net/per610a/home/mvp/mvp_db/hodost-lv/2014/2014_07_31_04_56/2014_07_31_21_54.mpg;Shinzo ABE.jpg;38137;39061;91169;1908;1954;46
/net/per610a/home/mvp/mvp_db/hodost-lv/2014/2014_07_31_04_56/2014_07_31_21_54.mpg;Toru Hashimoto.jpg;52549;52641;91169;2630;2634;4
/net/per610a/home/mvp/mvp_db/hodost-lv/2014/2014_07_31_04_56/2014_07_31_21_54.mpg;Toru Hashimoto.jpg;52949;53153;91169;2650;2660;10
/net/per610a/home/mvp/mvp_db/hodost-lv/2014/2014_08_05_04_56/2014_08_05_21_54.mpg;Kazuo SHII.jpg;67325;67369;91169;3369;3371;2
/net/per610a/home/mvp/mvp_db/hodost-lv/2014/2014_08_05_04_56/2014_08_05_21_54.mpg;Kazuo SHII.jpg;67517;67613;91169;3379;3384;5
/net/per610a/home/mvp/mvp_db/hodost-lv/2014/2014_08_07_04_56/2014_08_07_21_54.mpg;Natsuo YAMAGUCHI.jpg;57165;57297;91169;2861;2867;6
/net/per610a/home/mvp/mvp_db/hodost-lv/2014/2014_08_10_04_56/2014_08_10_10_00.mpg;Taro ASO.jpg;120245;120245;125937;6018;6018;0
/net/per610a/home/mvp/mvp_db/hodost-lv/2014/2014_08_10_04_56/2014_08_10_10_00.mpg;Taro ASO.jpg;120317;120325;125937;6021;6022;1
/net/per610a/home/mvp/mvp_db/hodost-lv/2014/2014_08_10_04_56/2014_08_10_10_00.mpg;Taro ASO.jpg;120977;121077;125937;6054;6059;5
/net/per610a/home/mvp/mvp_db/hodost-lv/2014/2014_08_10_04_56/2014_08_10_10_00.mpg;Taro ASO.jpg;121345;121449;125937;6073;6078;5
/net/per610a/home/mvp/mvp_db/hodost-lv/2014/2014_08_10_04_56/2014_08_10_10_00.mpg;Taro ASO.jpg;121937;121985;125937;6102;6105;3
/net/per610a/home/mvp/mvp_db/hodost-lv/2014/2014_08_10_04_56/2014_08_10_10_00.mpg;Shinzo ABE.jpg;120253;120321;125937;6018;6021;3
/net/per610a/home/mvp/mvp_db/hodost-lv/2014/2014_08_10_04_56/2014_08_10_10_00.mpg;Shinzo ABE.jpg;120973;121061;125937;6054;6058;4
/net/per610a/home/mvp/mvp_db/hodost-lv/2014/2014_08_10_04_56/2014_08_10_10_00.mpg;Shinzo ABE.jpg;121349;121449;125937;6073;6078;5
/net/per610a/home/mvp/mvp_db/hodost-lv/2014/2014_08_11_04_56/2014_08_11_21_54.mpg;Shinzo ABE.jpg;41317;41773;91169;2067;2090;23
/net/per610a/home/mvp/mvp_db/hodost-lv/2014/2014_08_13_04_56/2014_08_13_21_54.mpg;Shinzo ABE.jpg;9821;10269;91169;491;513;22
/net/per610a/home/mvp/mvp_db/hodost-lv/2014/2014_08_13_04_56/2014_08_13_21_54.mpg;Shinzo ABE.jpg;19201;19213;91169;961;961;0
/net/per610a/home/mvp/mvp_db/hodost-lv/2014/2014_08_24_04_56/2014_08_24_10_00.mpg;Shinzo ABE.jpg;108177;108293;125937;5414;5419;5
/net/per610a/home/mvp/mvp_db/hodost-lv/2014/2014_08_25_04_56/2014_08_25_21_54.mpg;Shinzo ABE.jpg;30609;31105;91169;1531;1556;25
/net/per610a/home/mvp/mvp_db/hodost-lv/2014/2014_08_26_04_56/2014_08_26_21_54.mpg;Masashi Nakano.jpg;7821;8081;91169;391;404;13
/net/per610a/home/mvp/mvp_db/hodost-lv/2014/2014_08_26_04_56/2014_08_26_21_54.mpg;Masashi Nakano.jpg;9833;9905;91169;492;495;3
/net/per610a/home/mvp/mvp_db/hodost-lv/2014/2014_08_27_04_56/2014_08_27_21_54.mpg;Natsuo YAMAGUCHI.jpg;6921;7645;91169;346;382;36
/net/per610a/home/mvp/mvp_db/hodost-lv/2014/2014_08_27_04_56/2014_08_27_21_54.mpg;Shinzo ABE.jpg;11393;11565;91169;570;578;8
/net/per610a/home/mvp/mvp_db/hodost-lv/2014/2014_08_28_04_56/2014_08_28_21_54.mpg;Shinzo ABE.jpg;52525;52561;91169;2628;2630;2
/net/per610a/home/mvp/mvp_db/hodost-lv/2014/2014_08_28_04_56/2014_08_28_21_54.mpg;Shinzo ABE.jpg;55477;55509;91169;2776;2778;2
/net/per610a/home/mvp/mvp_db/hodost-lv/2014/2014_08_28_04_56/2014_08_28_21_54.mpg;Shinzo ABE.jpg;55605;55629;91169;2783;2784;1
/net/per610a/home/mvp/mvp_db/hodost-lv/2014/2014_08_28_04_56/2014_08_28_21_54.mpg;Shinzo ABE.jpg;55773;55925;91169;2791;2799;8
/net/per610a/home/mvp/mvp_db/hodost-lv/2014/2014_08_31_04_56/2014_08_31_10_00.mpg;Shinzo ABE.jpg;33769;33785;125929;1689;1690;1
/net/per610a/home/mvp/mvp_db/hodost-lv/2014/2014_08_31_04_56/2014_08_31_10_00.mpg;Shinzo ABE.jpg;41445;41629;125929;2074;2083;9
/net/per610a/home/mvp/mvp_db/hodost-lv/2014/2014_08_31_04_56/2014_08_31_10_00.mpg;Shinzo ABE.jpg;41765;41865;125929;2090;2095;5
/net/per610a/home/mvp/mvp_db/hodost-lv/2014/2014_08_31_04_56/2014_08_31_10_00.mpg;Shinzo ABE.jpg;43037;43161;125929;2153;2159;6
/net/per610a/home/mvp/mvp_db/hodost-lv/2014/2014_08_31_04_56/2014_08_31_10_00.mpg;Shinzo ABE.jpg;49917;49929;125929;2498;2498;0
/net/per610a/home/mvp/mvp_db/hodost-lv/2014/2014_08_31_04_56/2014_08_31_10_00.mpg;Shinzo ABE.jpg;51073;51129;125929;2555;2558;3
/net/per610a/home/mvp/mvp_db/hodost-lv/2014/2014_08_31_04_56/2014_08_31_10_00.mpg;Shinzo ABE.jpg;117233;117233;125929;5866;5866;0
/net/per610a/home/mvp/mvp_db/hodost-lv/2014/2014_08_31_04_56/2014_08_31_10_00.mpg;Shinzo ABE.jpg;120745;121005;125929;6042;6055;13
/net/per610a/home/mvp/mvp_db/hodost-lv/2014/2014_08_31_04_56/2014_08_31_10_00.mpg;Shinzo ABE.jpg;121605;121777;125929;6085;6094;9
/net/per610a/home/mvp/mvp_db/hodost-lv/2014/2014_09_01_04_56/2014_09_01_21_54.mpg;Shinzo ABE.jpg;49741;49785;91169;2489;2491;2
/net/per610a/home/mvp/mvp_db/hodost-lv/2014/2014_09_01_04_56/2014_09_01_21_54.mpg;Shinzo ABE.jpg;53401;53493;91169;2672;2677;5
/net/per610a/home/mvp/mvp_db/hodost-lv/2014/2014_09_01_04_56/2014_09_01_21_54.mpg;Ichiro OZAWA.jpg;54421;54733;91169;2723;2739;16
/net/per610a/home/mvp/mvp_db/hodost-lv/2014/2014_09_02_04_56/2014_09_02_21_54.mpg;Sadakazu TANIGAKI.jpg;1213;1301;91169;60;65;5
/net/per610a/home/mvp/mvp_db/hodost-lv/2014/2014_09_02_04_56/2014_09_02_21_54.mpg;Sadakazu TANIGAKI.jpg;6381;6437;91169;319;322;3
/net/per610a/home/mvp/mvp_db/hodost-lv/2014/2014_09_02_04_56/2014_09_02_21_54.mpg;Sadakazu TANIGAKI.jpg;6589;6685;91169;329;334;5
/net/per610a/home/mvp/mvp_db/hodost-lv/2014/2014_09_02_04_56/2014_09_02_21_54.mpg;Sadakazu TANIGAKI.jpg;13349;13549;91169;668;678;10
/net/per610a/home/mvp/mvp_db/hodost-lv/2014/2014_09_02_04_56/2014_09_02_21_54.mpg;Shinzo ABE.jpg;54505;54517;91169;2727;2728;1
/net/per610a/home/mvp/mvp_db/hodost-lv/2014/2014_09_02_04_56/2014_09_02_21_54.mpg;Shinzo ABE.jpg;54877;54893;91169;2746;2747;1
/net/per610a/home/mvp/mvp_db/hodost-lv/2014/2014_09_02_04_56/2014_09_02_21_54.mpg;Shinzo ABE.jpg;54981;55029;91169;2751;2754;3
/net/per610a/home/mvp/mvp_db/hodost-lv/2014/2014_09_02_04_56/2014_09_02_21_54.mpg;Shinzo ABE.jpg;55233;55957;91169;2764;2800;36
/net/per610a/home/mvp/mvp_db/hodost-lv/2014/2014_09_03_04_56/2014_09_03_21_54.mpg;Taro ASO.jpg;5421;5597;91169;271;280;9
/net/per610a/home/mvp/mvp_db/hodost-lv/2014/2014_09_03_04_56/2014_09_03_21_54.mpg;Sadakazu TANIGAKI.jpg;7641;7701;91169;382;385;3
/net/per610a/home/mvp/mvp_db/hodost-lv/2014/2014_09_03_04_56/2014_09_03_21_54.mpg;Sadakazu TANIGAKI.jpg;15769;15885;91169;789;795;6
/net/per610a/home/mvp/mvp_db/hodost-lv/2014/2014_09_03_04_56/2014_09_03_21_54.mpg;Sadakazu TANIGAKI.jpg;22077;22181;91169;1104;1110;6
/net/per610a/home/mvp/mvp_db/hodost-lv/2014/2014_09_03_04_56/2014_09_03_21_54.mpg;Sadakazu TANIGAKI.jpg;22257;22317;91169;1113;1116;3
/net/per610a/home/mvp/mvp_db/hodost-lv/2014/2014_09_03_04_56/2014_09_03_21_54.mpg;Sadakazu TANIGAKI.jpg;22621;22777;91169;1132;1139;7
/net/per610a/home/mvp/mvp_db/hodost-lv/2014/2014_09_03_04_56/2014_09_03_21_54.mpg;Sadakazu TANIGAKI.jpg;25493;25913;91169;1275;1296;21
/net/per610a/home/mvp/mvp_db/hodost-lv/2014/2014_09_03_04_56/2014_09_03_21_54.mpg;Sadakazu TANIGAKI.jpg;26757;26993;91169;1339;1350;11
/net/per610a/home/mvp/mvp_db/hodost-lv/2014/2014_09_03_04_56/2014_09_03_21_54.mpg;Sadakazu TANIGAKI.jpg;27213;27277;91169;1362;1365;3
/net/per610a/home/mvp/mvp_db/hodost-lv/2014/2014_09_03_04_56/2014_09_03_21_54.mpg;Shinzo ABE.jpg;15973;16661;91169;799;833;34
/net/per610a/home/mvp/mvp_db/hodost-lv/2014/2014_09_03_04_56/2014_09_03_21_54.mpg;Shinzo ABE.jpg;16665;16949;91169;834;848;14
/net/per610a/home/mvp/mvp_db/hodost-lv/2014/2014_09_03_04_56/2014_09_03_21_54.mpg;Shinzo ABE.jpg;17445;17673;91169;873;884;11
/net/per610a/home/mvp/mvp_db/hodost-lv/2014/2014_09_03_04_56/2014_09_03_21_54.mpg;Shinzo ABE.jpg;17861;17901;91169;893;895;2
/net/per610a/home/mvp/mvp_db/hodost-lv/2014/2014_09_03_04_56/2014_09_03_21_54.mpg;Seiji MAEHARA.jpg;54389;54877;91169;2722;2746;24
/net/per610a/home/mvp/mvp_db/hodost-lv/2014/2014_09_04_04_56/2014_09_04_21_54.mpg;Shinzo ABE.jpg;23889;24069;91169;1195;1204;9
/net/per610a/home/mvp/mvp_db/hodost-lv/2014/2014_09_04_04_56/2014_09_04_21_54.mpg;Shinzo ABE.jpg;28937;29073;91169;1448;1455;7
/net/per610a/home/mvp/mvp_db/hodost-lv/2014/2014_09_05_04_56/2014_09_05_21_54.mpg;Taro ASO.jpg;31117;31277;91169;1557;1565;8
/net/per610a/home/mvp/mvp_db/hodost-lv/2014/2014_09_05_04_56/2014_09_05_21_54.mpg;Taro ASO.jpg;38149;38645;91169;1908;1933;25
/net/per610a/home/mvp/mvp_db/hodost-lv/2014/2014_09_07_04_56/2014_09_07_10_00.mpg;Shinzo ABE.jpg;44669;44673;125929;2235;2235;0
/net/per610a/home/mvp/mvp_db/hodost-lv/2014/2014_09_07_04_56/2014_09_07_10_00.mpg;Shinzo ABE.jpg;52041;52261;125929;2604;2615;11
/net/per610a/home/mvp/mvp_db/hodost-lv/2014/2014_09_07_04_56/2014_09_07_10_00.mpg;Shinzo ABE.jpg;54873;54973;125929;2746;2751;5
/net/per610a/home/mvp/mvp_db/hodost-lv/2014/2014_09_07_04_56/2014_09_07_10_00.mpg;Shinzo ABE.jpg;45153;45301;125929;2259;2267;8
/net/per610a/home/mvp/mvp_db/hodost-lv/2014/2014_09_07_04_56/2014_09_07_10_00.mpg;Shinzo ABE.jpg;47201;47357;125929;2362;2369;7
/net/per610a/home/mvp/mvp_db/hodost-lv/2014/2014_09_07_04_56/2014_09_07_10_00.mpg;Sadakazu TANIGAKI.jpg;46609;46801;125929;2332;2342;10
/net/per610a/home/mvp/mvp_db/hodost-lv/2014/2014_09_07_04_56/2014_09_07_10_00.mpg;Sadakazu TANIGAKI.jpg;47289;47357;125929;2366;2369;3
/net/per610a/home/mvp/mvp_db/hodost-lv/2014/2014_09_07_04_56/2014_09_07_10_00.mpg;Sadakazu TANIGAKI.jpg;46889;47021;125929;2346;2353;7
/net/per610a/home/mvp/mvp_db/hodost-lv/2014/2014_09_08_04_56/2014_09_08_21_54.mpg;Shinzo ABE.jpg;25485;25537;91169;1275;1278;3
/net/per610a/home/mvp/mvp_db/hodost-lv/2014/2014_09_08_04_56/2014_09_08_21_54.mpg;Shinzo ABE.jpg;27529;27601;91169;1377;1381;4
/net/per610a/home/mvp/mvp_db/hodost-lv/2014/2014_09_08_04_56/2014_09_08_21_54.mpg;Shinzo ABE.jpg;27753;27853;91169;1389;1394;5
/net/per610a/home/mvp/mvp_db/hodost-lv/2014/2014_09_08_04_56/2014_09_08_21_54.mpg;Shinzo ABE.jpg;27933;28149;91169;1398;1408;10
/net/per610a/home/mvp/mvp_db/hodost-lv/2014/2014_09_08_04_56/2014_09_08_21_54.mpg;Shinzo ABE.jpg;28229;28397;91169;1412;1421;9
/net/per610a/home/mvp/mvp_db/hodost-lv/2014/2014_09_10_04_56/2014_09_10_21_54.mpg;Ichiro OZAWA.jpg;37537;37765;91169;1878;1890;12
/net/per610a/home/mvp/mvp_db/hodost-lv/2014/2014_09_10_04_56/2014_09_10_21_54.mpg;Ichiro OZAWA.jpg;37837;37865;91169;1893;1895;2
/net/per610a/home/mvp/mvp_db/hodost-lv/2014/2014_09_10_04_56/2014_09_10_21_54.mpg;Ichiro OZAWA.jpg;37965;38129;91169;1900;1908;8
/net/per610a/home/mvp/mvp_db/hodost-lv/2014/2014_09_10_04_56/2014_09_10_21_54.mpg;Ichiro OZAWA.jpg;38253;38257;91169;1914;1914;0
/net/per610a/home/mvp/mvp_db/hodost-lv/2014/2014_09_10_04_56/2014_09_10_21_54.mpg;Ichiro OZAWA.jpg;38325;38705;91169;1918;1937;19
/net/per610a/home/mvp/mvp_db/hodost-lv/2014/2014_09_14_04_56/2014_09_14_10_00.mpg;Shinzo ABE.jpg;55481;55833;125937;2776;2794;18
/net/per610a/home/mvp/mvp_db/hodost-lv/2014/2014_09_16_04_56/2014_09_16_21_54.mpg;Bairi Kaieda.jpg;56773;56789;91161;2841;2841;0
/net/per610a/home/mvp/mvp_db/hodost-lv/2014/2014_09_16_04_56/2014_09_16_21_54.mpg;Bairi Kaieda.jpg;56941;57165;91161;2849;2860;11
/net/per610a/home/mvp/mvp_db/hodost-lv/2014/2014_09_16_04_56/2014_09_16_21_54.mpg;Katsuya OKADA.jpg;57341;57421;91161;2869;2873;4
/net/per610a/home/mvp/mvp_db/hodost-lv/2014/2014_09_18_04_56/2014_09_18_21_54.mpg;Shinzo ABE.jpg;2517;2581;91169;125;129;4
/net/per610a/home/mvp/mvp_db/hodost-lv/2014/2014_09_18_04_56/2014_09_18_21_54.mpg;Shinzo ABE.jpg;16105;16349;91169;806;818;12
/net/per610a/home/mvp/mvp_db/hodost-lv/2014/2014_09_19_04_56/2014_09_19_21_54.mpg;Shinzo ABE.jpg;28877;29057;91169;1444;1453;9
/net/per610a/home/mvp/mvp_db/hodost-lv/2014/2014_09_19_04_56/2014_09_19_21_54.mpg;Shinzo ABE.jpg;29753;30825;91169;1488;1542;54
/net/per610a/home/mvp/mvp_db/hodost-lv/2014/2014_09_21_04_56/2014_09_21_10_00.mpg;Shinzo ABE.jpg;120381;120405;125937;6024;6026;2
/net/per610a/home/mvp/mvp_db/hodost-lv/2014/2014_09_21_04_56/2014_09_21_10_00.mpg;Shinzo ABE.jpg;120585;120689;125937;6035;6040;5
/net/per610a/home/mvp/mvp_db/hodost-lv/2014/2014_09_21_04_56/2014_09_21_10_00.mpg;Shinzo ABE.jpg;121025;121265;125937;6057;6069;12
/net/per610a/home/mvp/mvp_db/hodost-lv/2014/2014_09_21_04_56/2014_09_21_10_00.mpg;Shinzo ABE.jpg;121845;121929;125937;6098;6102;4
/net/per610a/home/mvp/mvp_db/hodost-lv/2014/2014_09_22_04_56/2014_09_22_21_54.mpg;Shinzo ABE.jpg;34421;34485;91169;1722;1725;3
/net/per610a/home/mvp/mvp_db/hodost-lv/2014/2014_09_22_04_56/2014_09_22_21_54.mpg;Shinzo ABE.jpg;34617;34801;91169;1732;1741;9
/net/per610a/home/mvp/mvp_db/hodost-lv/2014/2014_09_22_04_56/2014_09_22_21_54.mpg;Shinzo ABE.jpg;35337;35369;91169;1768;1770;2
/net/per610a/home/mvp/mvp_db/hodost-lv/2014/2014_09_22_04_56/2014_09_22_21_54.mpg;Shinzo ABE.jpg;48729;48885;91169;2438;2446;8
/net/per610a/home/mvp/mvp_db/hodost-lv/2014/2014_09_22_04_56/2014_09_22_21_54.mpg;Yasuo FUKUDA.jpg;47905;48421;91169;2397;2423;26
/net/per610a/home/mvp/mvp_db/hodost-lv/2014/2014_09_22_04_56/2014_09_22_21_54.mpg;Yasuo FUKUDA.jpg;50213;50837;91169;2513;2544;31
/net/per610a/home/mvp/mvp_db/hodost-lv/2014/2014_09_25_04_56/2014_09_25_21_54.mpg;Shinzo ABE.jpg;63689;63709;91169;3187;3188;1
/net/per610a/home/mvp/mvp_db/hodost-lv/2014/2014_09_25_04_56/2014_09_25_21_54.mpg;Shinzo ABE.jpg;63801;63997;91169;3193;3203;10
/net/per610a/home/mvp/mvp_db/hodost-lv/2014/2014_09_25_04_56/2014_09_25_21_54.mpg;Shinzo ABE.jpg;64669;64673;91169;3236;3236;0
/net/per610a/home/mvp/mvp_db/hodost-lv/2014/2014_09_25_04_56/2014_09_25_21_54.mpg;Shinzo ABE.jpg;64697;64805;91169;3238;3243;5
/net/per610a/home/mvp/mvp_db/hodost-lv/2014/2014_09_26_04_56/2014_09_26_21_54.mpg;Shinzo ABE.jpg;5177;6089;91169;259;304;45
/net/per610a/home/mvp/mvp_db/hodost-lv/2014/2014_09_26_04_56/2014_09_26_21_54.mpg;Shinzo ABE.jpg;6205;6653;91169;310;332;22
/net/per610a/home/mvp/mvp_db/hodost-lv/2014/2014_09_26_04_56/2014_09_26_21_54.mpg;Shinzo ABE.jpg;6833;6913;91169;341;345;4
/net/per610a/home/mvp/mvp_db/hodost-lv/2014/2014_09_26_04_56/2014_09_26_21_54.mpg;Shinzo ABE.jpg;7025;7181;91169;351;359;8
/net/per610a/home/mvp/mvp_db/hodost-lv/2014/2014_09_26_04_56/2014_09_26_21_54.mpg;Shinzo ABE.jpg;7945;8593;91169;397;430;33
/net/per610a/home/mvp/mvp_db/hodost-lv/2014/2014_09_26_04_56/2014_09_26_21_54.mpg;Shinzo ABE.jpg;8781;8845;91169;439;442;3
/net/per610a/home/mvp/mvp_db/hodost-lv/2014/2014_09_26_04_56/2014_09_26_21_54.mpg;Shinzo ABE.jpg;41209;41321;91169;2062;2068;6
/net/per610a/home/mvp/mvp_db/hodost-lv/2014/2014_09_26_04_56/2014_09_26_21_54.mpg;Shinzo ABE.jpg;42913;43081;91169;2147;2156;9
/net/per610a/home/mvp/mvp_db/hodost-lv/2014/2014_09_29_04_56/2014_09_29_21_54.mpg;Shinzo ABE.jpg;70441;70677;91169;3525;3537;12
/net/per610a/home/mvp/mvp_db/hodost-lv/2014/2014_09_30_04_56/2014_09_30_21_54.mpg;Shinzo ABE.jpg;30433;30697;91169;1523;1536;13
/net/per610a/home/mvp/mvp_db/hodost-lv/2014/2014_09_30_04_56/2014_09_30_21_54.mpg;Shinzo ABE.jpg;30877;31889;91169;1545;1596;51
/net/per610a/home/mvp/mvp_db/hodost-lv/2014/2014_09_30_04_56/2014_09_30_21_54.mpg;Shinzo ABE.jpg;32001;32361;91169;1601;1619;18
/net/per610a/home/mvp/mvp_db/hodost-lv/2014/2014_09_30_04_56/2014_09_30_21_54.mpg;Shinzo ABE.jpg;32533;32681;91169;1628;1635;7
/net/per610a/home/mvp/mvp_db/hodost-lv/2014/2014_09_30_04_56/2014_09_30_21_54.mpg;Shinzo ABE.jpg;35917;36125;91169;1797;1808;11
/net/per610a/home/mvp/mvp_db/hodost-lv/2014/2014_10_01_04_56/2014_10_01_21_54.mpg;Kazuo SHII.jpg;37201;37621;91169;1861;1882;21
/net/per610a/home/mvp/mvp_db/hodost-lv/2014/2014_10_02_04_56/2014_10_02_21_54.mpg;Natsuo YAMAGUCHI.jpg;48677;49125;91169;2436;2458;22
/net/per610a/home/mvp/mvp_db/hodost-lv/2014/2014_10_07_04_56/2014_10_07_21_54.mpg;Shinzo ABE.jpg;48049;48317;91169;2404;2418;14
/net/per610a/home/mvp/mvp_db/hodost-lv/2014/2014_10_07_04_56/2014_10_07_21_54.mpg;Shinzo ABE.jpg;54433;54481;91169;2724;2726;2
/net/per610a/home/mvp/mvp_db/hodost-lv/2014/2014_10_08_04_56/2014_10_08_21_54.mpg;Shinzo ABE.jpg;40829;41469;91169;2043;2075;32
/net/per610a/home/mvp/mvp_db/hodost-lv/2014/2014_10_08_04_56/2014_10_08_21_54.mpg;Shinzo ABE.jpg;46341;46357;91169;2319;2320;1
/net/per610a/home/mvp/mvp_db/hodost-lv/2014/2014_10_09_04_56/2014_10_09_22_09.mpg;Toranosuke Katayama.jpg;33249;33313;91169;1664;1667;3
/net/per610a/home/mvp/mvp_db/hodost-lv/2014/2014_10_09_04_56/2014_10_09_22_09.mpg;Toranosuke Katayama.jpg;33429;33465;91169;1673;1674;1
/net/per610a/home/mvp/mvp_db/hodost-lv/2014/2014_10_14_04_56/2014_10_14_21_54.mpg;Shinzo ABE.jpg;35669;35841;91161;1784;1793;9
/net/per610a/home/mvp/mvp_db/hodost-lv/2014/2014_10_14_04_56/2014_10_14_21_54.mpg;Shinzo ABE.jpg;44137;44293;91161;2208;2216;8
/net/per610a/home/mvp/mvp_db/hodost-lv/2014/2014_10_14_04_56/2014_10_14_21_54.mpg;Shinzo ABE.jpg;44401;44541;91161;2221;2228;7
/net/per610a/home/mvp/mvp_db/hodost-lv/2014/2014_10_16_04_56/2014_10_16_22_09.mpg;Kenji Eda.jpg;12573;13009;91161;629;651;22
/net/per610a/home/mvp/mvp_db/hodost-lv/2014/2014_10_16_04_56/2014_10_16_22_09.mpg;Shinzo ABE.jpg;39285;39301;91161;1965;1966;1
/net/per610a/home/mvp/mvp_db/hodost-lv/2014/2014_10_16_04_56/2014_10_16_22_09.mpg;Shinzo ABE.jpg;39705;39785;91161;1986;1990;4
/net/per610a/home/mvp/mvp_db/hodost-lv/2014/2014_10_16_04_56/2014_10_16_22_09.mpg;Shinzo ABE.jpg;68993;69233;91161;3452;3464;12
/net/per610a/home/mvp/mvp_db/hodost-lv/2014/2014_10_16_04_56/2014_10_16_22_09.mpg;Takeo Hiranuma.jpeg;40369;40389;91161;2020;2021;1
/net/per610a/home/mvp/mvp_db/hodost-lv/2014/2014_10_16_04_56/2014_10_16_22_09.mpg;Takeo Hiranuma.jpeg;40661;40797;91161;2034;2041;7
/net/per610a/home/mvp/mvp_db/hodost-lv/2014/2014_10_16_04_56/2014_10_16_22_09.mpg;Takeo Hiranuma.jpeg;40977;41133;91161;2050;2058;8
/net/per610a/home/mvp/mvp_db/hodost-lv/2014/2014_10_16_04_56/2014_10_16_22_09.mpg;Takeo Hiranuma.jpeg;41265;41489;91161;2065;2076;11
/net/per610a/home/mvp/mvp_db/hodost-lv/2014/2014_10_17_04_56/2014_10_17_21_54.mpg;Shinzo ABE.jpg;47393;47549;91169;2371;2379;8
/net/per610a/home/mvp/mvp_db/hodost-lv/2014/2014_10_19_04_56/2014_10_19_10_00.mpg;Shinzo ABE.jpg;14961;15157;125937;748;758;10
/net/per610a/home/mvp/mvp_db/hodost-lv/2014/2014_10_19_04_56/2014_10_19_10_00.mpg;Shinzo ABE.jpg;40333;40457;125937;2018;2024;6
/net/per610a/home/mvp/mvp_db/hodost-lv/2014/2014_10_19_04_56/2014_10_19_10_00.mpg;Yukiko Kada.jpg;40333;40457;125937;2018;2024;6
/net/per610a/home/mvp/mvp_db/hodost-lv/2014/2014_10_20_04_56/2014_10_20_21_54.mpg;Shinzo ABE.jpg;28541;28897;91169;1428;1446;18
/net/per610a/home/mvp/mvp_db/hodost-lv/2014/2014_10_20_04_56/2014_10_20_21_54.mpg;Shinzo ABE.jpg;28909;28977;91169;1446;1450;4
/net/per610a/home/mvp/mvp_db/hodost-lv/2014/2014_10_20_04_56/2014_10_20_21_54.mpg;Shinzo ABE.jpg;49741;50001;91169;2489;2502;13
/net/per610a/home/mvp/mvp_db/hodost-lv/2014/2014_10_20_04_56/2014_10_20_21_54.mpg;Shinzo ABE.jpg;58953;59009;91169;2950;2953;3
/net/per610a/home/mvp/mvp_db/hodost-lv/2014/2014_10_20_04_56/2014_10_20_21_54.mpg;Sadakazu TANIGAKI.jpg;29129;29601;91169;1457;1481;24
/net/per610a/home/mvp/mvp_db/hodost-lv/2014/2014_10_20_04_56/2014_10_20_21_54.mpg;Kyoko Nakayama.jpg;54753;54829;91169;2740;2744;4
/net/per610a/home/mvp/mvp_db/hodost-lv/2014/2014_10_20_04_56/2014_10_20_21_54.mpg;Kyoko Nakayama.jpg;57601;57741;91169;2882;2889;7
/net/per610a/home/mvp/mvp_db/hodost-lv/2014/2014_10_20_04_56/2014_10_20_21_54.mpg;Kyoko Nakayama.jpg;58237;58341;91169;2914;2919;5
/net/per610a/home/mvp/mvp_db/hodost-lv/2014/2014_10_21_04_56/2014_10_21_21_54.mpg;Natsuo YAMAGUCHI.jpg;35673;36153;91161;1785;1809;24
/net/per610a/home/mvp/mvp_db/hodost-lv/2014/2014_10_22_04_56/2014_10_22_21_54.mpg;Shinzo ABE.jpg;14917;15149;91169;746;758;12
/net/per610a/home/mvp/mvp_db/hodost-lv/2014/2014_10_22_04_56/2014_10_22_21_54.mpg;Shinzo ABE.jpg;20561;20829;91169;1029;1042;13
/net/per610a/home/mvp/mvp_db/hodost-lv/2014/2014_10_22_04_56/2014_10_22_21_54.mpg;Shinzo ABE.jpg;36633;36701;91169;1833;1836;3
/net/per610a/home/mvp/mvp_db/hodost-lv/2014/2014_10_22_04_56/2014_10_22_21_54.mpg;Shinzo ABE.jpg;42609;42705;91169;2132;2137;5
/net/per610a/home/mvp/mvp_db/hodost-lv/2014/2014_10_23_04_56/2014_10_23_21_54.mpg;Yukio HATOYAMA.jpg;69593;69633;91169;3483;3485;2
/net/per610a/home/mvp/mvp_db/hodost-lv/2014/2014_10_23_04_56/2014_10_23_21_54.mpg;Yukio HATOYAMA.jpg;70405;70733;91169;3523;3540;17
/net/per610a/home/mvp/mvp_db/hodost-lv/2014/2014_10_26_04_56/2014_10_26_10_00.mpg;Shinzo ABE.jpg;47717;47893;125937;2388;2396;8
/net/per610a/home/mvp/mvp_db/hodost-lv/2014/2014_10_26_04_56/2014_10_26_10_00.mpg;Ichiro OZAWA.jpg;120061;120733;125937;6008;6042;34
/net/per610a/home/mvp/mvp_db/hodost-lv/2014/2014_10_27_04_56/2014_10_27_21_54.mpg;Kenji Eda.jpg;57057;57141;91169;2855;2859;4
/net/per610a/home/mvp/mvp_db/hodost-lv/2014/2014_10_27_04_56/2014_10_27_21_54.mpg;Kenji Eda.jpg;59945;60173;91169;3000;3011;11
/net/per610a/home/mvp/mvp_db/hodost-lv/2014/2014_10_27_04_56/2014_10_27_21_54.mpg;Sadakazu TANIGAKI.jpg;58769;59125;91169;2941;2959;18
/net/per610a/home/mvp/mvp_db/hodost-lv/2014/2014_10_28_04_56/2014_10_28_21_45.mpg;Shinzo ABE.jpg;33165;33245;101961;1659;1663;4
/net/per610a/home/mvp/mvp_db/hodost-lv/2014/2014_10_29_04_56/2014_10_29_21_54.mpg;Shinzo ABE.jpg;32381;32541;91169;1620;1628;8
/net/per610a/home/mvp/mvp_db/hodost-lv/2014/2014_10_29_04_56/2014_10_29_21_54.mpg;Shinzo ABE.jpg;34997;35153;91169;1751;1759;8
/net/per610a/home/mvp/mvp_db/hodost-lv/2014/2014_10_29_04_56/2014_10_29_21_54.mpg;Shinzo ABE.jpg;35357;35373;91169;1769;1770;1
/net/per610a/home/mvp/mvp_db/hodost-lv/2014/2014_10_29_04_56/2014_10_29_21_54.mpg;Sadakazu TANIGAKI.jpg;33229;34149;91169;1663;1709;46
/net/per610a/home/mvp/mvp_db/hodost-lv/2014/2014_10_30_04_56/2014_10_30_21_54.mpg;Kenji Eda.jpg;10329;10713;91169;516;536;20
/net/per610a/home/mvp/mvp_db/hodost-lv/2014/2014_10_30_04_56/2014_10_30_21_54.mpg;Yasuo FUKUDA.jpg;11905;12057;91169;595;603;8
/net/per610a/home/mvp/mvp_db/hodost-lv/2014/2014_10_30_04_56/2014_10_30_21_54.mpg;Shinzo ABE.jpg;17613;17717;91169;881;886;5
/net/per610a/home/mvp/mvp_db/hodost-lv/2014/2014_10_30_04_56/2014_10_30_21_54.mpg;Shinzo ABE.jpg;17841;20237;91169;892;1012;120
/net/per610a/home/mvp/mvp_db/hodost-lv/2014/2014_10_30_04_56/2014_10_30_21_54.mpg;Shinzo ABE.jpg;21717;21837;91169;1086;1092;6
/net/per610a/home/mvp/mvp_db/hodost-lv/2014/2014_10_31_04_56/2014_10_31_21_54.mpg;Shinzo ABE.jpg;20097;20261;91169;1005;1013;8
/net/per610a/home/mvp/mvp_db/hodost-lv/2014/2014_10_31_04_56/2014_10_31_21_54.mpg;Kenji Eda.jpg;50797;51345;91169;2541;2569;28
/net/per610a/home/mvp/mvp_db/hodost-lv/2014/2014_11_04_04_56/2014_11_04_21_54.mpg;Shinzo ABE.jpg;2429;2497;91169;121;124;3
/net/per610a/home/mvp/mvp_db/hodost-lv/2014/2014_11_04_04_56/2014_11_04_21_54.mpg;Shinzo ABE.jpg;10845;10993;91169;542;550;8
/net/per610a/home/mvp/mvp_db/hodost-lv/2014/2014_11_04_04_56/2014_11_04_21_54.mpg;Shinzo ABE.jpg;11233;11969;91169;562;599;37
/net/per610a/home/mvp/mvp_db/hodost-lv/2014/2014_11_04_04_56/2014_11_04_21_54.mpg;Shinzo ABE.jpg;12281;12425;91169;614;621;7
/net/per610a/home/mvp/mvp_db/hodost-lv/2014/2014_11_04_04_56/2014_11_04_21_54.mpg;Shinzo ABE.jpg;12653;13353;91169;633;668;35
/net/per610a/home/mvp/mvp_db/hodost-lv/2014/2014_11_04_04_56/2014_11_04_21_54.mpg;Shinzo ABE.jpg;13589;13961;91169;680;698;18
/net/per610a/home/mvp/mvp_db/hodost-lv/2014/2014_11_04_04_56/2014_11_04_21_54.mpg;Shinzo ABE.jpg;19885;19997;91169;995;1000;5
/net/per610a/home/mvp/mvp_db/hodost-lv/2014/2014_11_04_04_56/2014_11_04_21_54.mpg;Shinzo ABE.jpg;22517;22645;91169;1126;1133;7
/net/per610a/home/mvp/mvp_db/hodost-lv/2014/2014_11_05_04_56/2014_11_05_21_54.mpg;Shinzo ABE.jpg;53533;53701;91169;2679;2687;8
/net/per610a/home/mvp/mvp_db/hodost-lv/2014/2014_11_06_04_56/2014_11_06_21_54.mpg;Shinzo ABE.jpg;1417;1433;91169;70;71;1
/net/per610a/home/mvp/mvp_db/hodost-lv/2014/2014_11_06_04_56/2014_11_06_21_54.mpg;Shinzo ABE.jpg;9237;9409;91169;462;470;8
/net/per610a/home/mvp/mvp_db/hodost-lv/2014/2014_11_06_04_56/2014_11_06_21_54.mpg;Shinzo ABE.jpg;11285;11389;91169;564;570;6
/net/per610a/home/mvp/mvp_db/hodost-lv/2014/2014_11_07_04_56/2014_11_07_21_54.mpg;Shinzo ABE.jpg;16817;16993;91169;841;850;9
/net/per610a/home/mvp/mvp_db/hodost-lv/2014/2014_11_07_04_56/2014_11_07_21_54.mpg;Shinzo ABE.jpg;19133;19241;91169;957;963;6
/net/per610a/home/mvp/mvp_db/hodost-lv/2014/2014_11_07_04_56/2014_11_07_21_54.mpg;Shinzo ABE.jpg;41689;41781;91169;2086;2091;5
/net/per610a/home/mvp/mvp_db/hodost-lv/2014/2014_11_07_04_56/2014_11_07_21_54.mpg;Sadakazu TANIGAKI.jpg;43169;43661;91169;2160;2185;25
/net/per610a/home/mvp/mvp_db/hodost-lv/2014/2014_11_10_04_56/2014_11_10_21_54.mpg;Shinzo ABE.jpg;1857;1981;91169;92;99;7
/net/per610a/home/mvp/mvp_db/hodost-lv/2014/2014_11_10_04_56/2014_11_10_21_54.mpg;Shinzo ABE.jpg;2249;2337;91169;112;116;4
/net/per610a/home/mvp/mvp_db/hodost-lv/2014/2014_11_10_04_56/2014_11_10_21_54.mpg;Shinzo ABE.jpg;6117;6257;91169;306;313;7
/net/per610a/home/mvp/mvp_db/hodost-lv/2014/2014_11_10_04_56/2014_11_10_21_54.mpg;Shinzo ABE.jpg;6369;6385;91169;318;319;1
/net/per610a/home/mvp/mvp_db/hodost-lv/2014/2014_11_10_04_56/2014_11_10_21_54.mpg;Shinzo ABE.jpg;6953;6977;91169;347;349;2
/net/per610a/home/mvp/mvp_db/hodost-lv/2014/2014_11_10_04_56/2014_11_10_21_54.mpg;Shinzo ABE.jpg;8085;8089;91169;404;404;0
/net/per610a/home/mvp/mvp_db/hodost-lv/2014/2014_11_10_04_56/2014_11_10_21_54.mpg;Shinzo ABE.jpg;8181;8889;91169;409;444;35
/net/per610a/home/mvp/mvp_db/hodost-lv/2014/2014_11_10_04_56/2014_11_10_21_54.mpg;Shinzo ABE.jpg;11477;11777;91169;574;589;15
/net/per610a/home/mvp/mvp_db/hodost-lv/2014/2014_11_10_04_56/2014_11_10_21_54.mpg;Shinzo ABE.jpg;39457;39529;91169;1974;1978;4
/net/per610a/home/mvp/mvp_db/hodost-lv/2014/2014_11_10_04_56/2014_11_10_21_54.mpg;Shinzo ABE.jpg;40309;40533;91169;2017;2028;11
/net/per610a/home/mvp/mvp_db/hodost-lv/2014/2014_11_10_04_56/2014_11_10_21_54.mpg;Shinzo ABE.jpg;42597;43433;91169;2131;2173;42
/net/per610a/home/mvp/mvp_db/hodost-lv/2014/2014_11_10_04_56/2014_11_10_21_54.mpg;Shinzo ABE.jpg;8969;9009;91169;448;450;2
/net/per610a/home/mvp/mvp_db/hodost-lv/2014/2014_11_10_04_56/2014_11_10_21_54.mpg;Shinzo ABE.jpg;10301;10305;91169;515;515;0
/net/per610a/home/mvp/mvp_db/hodost-lv/2014/2014_11_10_04_56/2014_11_10_21_54.mpg;Shinzo ABE.jpg;10797;10969;91169;540;548;8
/net/per610a/home/mvp/mvp_db/hodost-lv/2014/2014_11_10_04_56/2014_11_10_21_54.mpg;Shinzo ABE.jpg;23453;23457;91169;1173;1174;1
/net/per610a/home/mvp/mvp_db/hodost-lv/2014/2014_11_10_04_56/2014_11_10_21_54.mpg;Shinzo ABE.jpg;32341;32425;91169;1618;1622;4
/net/per610a/home/mvp/mvp_db/hodost-lv/2014/2014_11_10_04_56/2014_11_10_21_54.mpg;Shinzo ABE.jpg;39217;39237;91169;1962;1963;1
/net/per610a/home/mvp/mvp_db/hodost-lv/2014/2014_11_10_04_56/2014_11_10_21_54.mpg;Shinzo ABE.jpg;41893;41913;91169;2096;2097;1
/net/per610a/home/mvp/mvp_db/hodost-lv/2014/2014_11_10_04_56/2014_11_10_21_54.mpg;Shinzo ABE.jpg;41985;42297;91169;2101;2116;15
/net/per610a/home/mvp/mvp_db/hodost-lv/2014/2014_11_10_04_56/2014_11_10_21_54.mpg;Taro ASO.jpg;41661;41757;91169;2085;2089;4
/net/per610a/home/mvp/mvp_db/hodost-lv/2014/2014_11_11_04_56/2014_11_11_21_54.mpg;Shinzo ABE.jpg;1597;1845;91161;79;92;13
/net/per610a/home/mvp/mvp_db/hodost-lv/2014/2014_11_11_04_56/2014_11_11_21_54.mpg;Shinzo ABE.jpg;5865;6049;91161;293;302;9
/net/per610a/home/mvp/mvp_db/hodost-lv/2014/2014_11_11_04_56/2014_11_11_21_54.mpg;Shinzo ABE.jpg;7529;7561;91161;376;378;2
/net/per610a/home/mvp/mvp_db/hodost-lv/2014/2014_11_11_04_56/2014_11_11_21_54.mpg;Shinzo ABE.jpg;8761;8961;91161;438;448;10
/net/per610a/home/mvp/mvp_db/hodost-lv/2014/2014_11_11_04_56/2014_11_11_21_54.mpg;Shinzo ABE.jpg;9049;9621;91161;452;481;29
/net/per610a/home/mvp/mvp_db/hodost-lv/2014/2014_11_11_04_56/2014_11_11_21_54.mpg;Shinzo ABE.jpg;18077;18189;91161;904;910;6
/net/per610a/home/mvp/mvp_db/hodost-lv/2014/2014_11_11_04_56/2014_11_11_21_54.mpg;Shinzo ABE.jpg;23977;24025;91161;1199;1202;3
/net/per610a/home/mvp/mvp_db/hodost-lv/2014/2014_11_11_04_56/2014_11_11_21_54.mpg;Shinzo ABE.jpg;6133;6217;91161;306;311;5
/net/per610a/home/mvp/mvp_db/hodost-lv/2014/2014_11_11_04_56/2014_11_11_21_54.mpg;Natsuo YAMAGUCHI.jpg;6373;6769;91161;318;338;20
/net/per610a/home/mvp/mvp_db/hodost-lv/2014/2014_11_11_04_56/2014_11_11_21_54.mpg;Natsuo YAMAGUCHI.jpg;7145;7305;91161;357;365;8
/net/per610a/home/mvp/mvp_db/hodost-lv/2014/2014_11_11_04_56/2014_11_11_21_54.mpg;Yukio EDANO.jpg;8569;8733;91161;428;437;9
/net/per610a/home/mvp/mvp_db/hodost-lv/2014/2014_11_12_04_56/2014_11_12_21_54.mpg;Katsuya OKADA.jpg;4725;4997;91169;236;250;14
/net/per610a/home/mvp/mvp_db/hodost-lv/2014/2014_11_12_04_56/2014_11_12_21_54.mpg;Katsuya OKADA.jpg;7893;8669;91169;395;433;38
/net/per610a/home/mvp/mvp_db/hodost-lv/2014/2014_11_12_04_56/2014_11_12_21_54.mpg;Shinzo ABE.jpg;5041;5197;91169;252;260;8
/net/per610a/home/mvp/mvp_db/hodost-lv/2014/2014_11_12_04_56/2014_11_12_21_54.mpg;Toru Hashimoto.jpg;6761;7009;91169;338;350;12
/net/per610a/home/mvp/mvp_db/hodost-lv/2014/2014_11_13_04_56/2014_11_13_21_54.mpg;Sadakazu TANIGAKI.jpg;21933;22213;91161;1097;1111;14
/net/per610a/home/mvp/mvp_db/hodost-lv/2014/2014_11_13_04_56/2014_11_13_21_54.mpg;Yukio EDANO.jpg;22345;23085;91161;1118;1155;37
/net/per610a/home/mvp/mvp_db/hodost-lv/2014/2014_11_13_04_56/2014_11_13_21_54.mpg;Yukio EDANO.jpg;25153;25773;91161;1258;1289;31
/net/per610a/home/mvp/mvp_db/hodost-lv/2014/2014_11_14_04_56/2014_11_14_21_54.mpg;Yoshihiko Noda.jpg;20097;20829;91169;1005;1042;37
/net/per610a/home/mvp/mvp_db/hodost-lv/2014/2014_11_14_04_56/2014_11_14_21_54.mpg;Yoshihiko Noda.jpg;21041;21077;91169;1053;1054;1
/net/per610a/home/mvp/mvp_db/hodost-lv/2014/2014_11_14_04_56/2014_11_14_21_54.mpg;Yoshihiko Noda.jpg;21153;21437;91169;1058;1072;14
/net/per610a/home/mvp/mvp_db/hodost-lv/2014/2014_11_14_04_56/2014_11_14_21_54.mpg;Yoshihiko Noda.jpg;21561;22197;91169;1079;1110;31
/net/per610a/home/mvp/mvp_db/hodost-lv/2014/2014_11_14_04_56/2014_11_14_21_54.mpg;Taro ASO.jpg;20117;20773;91169;1006;1039;33
/net/per610a/home/mvp/mvp_db/hodost-lv/2014/2014_11_14_04_56/2014_11_14_21_54.mpg;Taro ASO.jpg;23453;23457;91169;1173;1174;1
/net/per610a/home/mvp/mvp_db/hodost-lv/2014/2014_11_14_04_56/2014_11_14_21_54.mpg;Taro ASO.jpg;23805;24489;91169;1191;1225;34
/net/per610a/home/mvp/mvp_db/hodost-lv/2014/2014_11_14_04_56/2014_11_14_21_54.mpg;Shinzo ABE.jpg;40689;40733;91169;2036;2038;2
/net/per610a/home/mvp/mvp_db/hodost-lv/2014/2014_11_14_04_56/2014_11_14_21_54.mpg;Shinzo ABE.jpg;40849;40901;91169;2044;2047;3
/net/per610a/home/mvp/mvp_db/hodost-lv/2014/2014_11_16_04_56/2014_11_16_10_00.mpg;Shinzo ABE.jpg;42065;42153;125937;2105;2109;4
/net/per610a/home/mvp/mvp_db/hodost-lv/2014/2014_11_16_04_56/2014_11_16_10_00.mpg;Shinzo ABE.jpg;42293;42325;125937;2116;2118;2
/net/per610a/home/mvp/mvp_db/hodost-lv/2014/2014_11_16_04_56/2014_11_16_10_00.mpg;Shinzo ABE.jpg;50673;50709;125937;2536;2537;1
/net/per610a/home/mvp/mvp_db/hodost-lv/2014/2014_11_16_04_56/2014_11_16_10_00.mpg;Shinzo ABE.jpg;50981;51053;125937;2551;2555;4
/net/per610a/home/mvp/mvp_db/hodost-lv/2014/2014_11_16_04_56/2014_11_16_10_00.mpg;Shinzo ABE.jpg;52477;52653;125937;2626;2635;9
/net/per610a/home/mvp/mvp_db/hodost-lv/2014/2014_11_16_04_56/2014_11_16_10_00.mpg;Shinzo ABE.jpg;116569;116621;125937;5834;5836;2
/net/per610a/home/mvp/mvp_db/hodost-lv/2014/2014_11_16_04_56/2014_11_16_10_00.mpg;Shinzo ABE.jpg;120013;120017;125937;6006;6006;0
/net/per610a/home/mvp/mvp_db/hodost-lv/2014/2014_11_16_04_56/2014_11_16_10_00.mpg;Shinzo ABE.jpg;120089;120249;125937;6010;6018;8
/net/per610a/home/mvp/mvp_db/hodost-lv/2014/2014_11_16_04_56/2014_11_16_10_00.mpg;Shinzo ABE.jpg;120525;120601;125937;6032;6035;3
/net/per610a/home/mvp/mvp_db/hodost-lv/2014/2014_11_16_04_56/2014_11_16_10_00.mpg;Shinzo ABE.jpg;121213;121217;125937;6066;6066;0
/net/per610a/home/mvp/mvp_db/hodost-lv/2014/2014_11_16_04_56/2014_11_16_10_00.mpg;Shinzo ABE.jpg;121613;121725;125937;6086;6092;6
/net/per610a/home/mvp/mvp_db/hodost-lv/2014/2014_11_16_04_56/2014_11_16_10_00.mpg;Ichiro OZAWA.jpg;49765;50049;125937;2490;2504;14
/net/per610a/home/mvp/mvp_db/hodost-lv/2014/2014_11_17_04_56/2014_11_17_21_54.mpg;Shinzo ABE.jpg;1585;1841;91169;79;92;13
/net/per610a/home/mvp/mvp_db/hodost-lv/2014/2014_11_17_04_56/2014_11_17_21_54.mpg;Shinzo ABE.jpg;2449;2449;91169;122;122;0
/net/per610a/home/mvp/mvp_db/hodost-lv/2014/2014_11_17_04_56/2014_11_17_21_54.mpg;Shinzo ABE.jpg;5009;5149;91169;250;257;7
/net/per610a/home/mvp/mvp_db/hodost-lv/2014/2014_11_17_04_56/2014_11_17_21_54.mpg;Shinzo ABE.jpg;5401;5469;91169;270;273;3
/net/per610a/home/mvp/mvp_db/hodost-lv/2014/2014_11_17_04_56/2014_11_17_21_54.mpg;Shinzo ABE.jpg;5805;6977;91169;290;349;59
/net/per610a/home/mvp/mvp_db/hodost-lv/2014/2014_11_17_04_56/2014_11_17_21_54.mpg;Shinzo ABE.jpg;14165;14505;91169;708;725;17
/net/per610a/home/mvp/mvp_db/hodost-lv/2014/2014_11_17_04_56/2014_11_17_21_54.mpg;Shinzo ABE.jpg;17081;17121;91169;854;856;2
/net/per610a/home/mvp/mvp_db/hodost-lv/2014/2014_11_17_04_56/2014_11_17_21_54.mpg;Shinzo ABE.jpg;17945;18341;91169;898;917;19
/net/per610a/home/mvp/mvp_db/hodost-lv/2014/2014_11_17_04_56/2014_11_17_21_54.mpg;Ichiro Matsui.jpeg;21225;21465;91169;1062;1074;12
/net/per610a/home/mvp/mvp_db/hodost-lv/2014/2014_11_17_04_56/2014_11_17_21_54.mpg;Toru Hashimoto.jpg;21501;21721;91169;1076;1087;11
/net/per610a/home/mvp/mvp_db/hodost-lv/2014/2014_11_18_04_56/2014_11_18_21_54.mpg;Shinzo ABE.jpg;34561;36589;91169;1729;1830;101
/net/per610a/home/mvp/mvp_db/hodost-lv/2014/2014_11_18_04_56/2014_11_18_21_54.mpg;Shinzo ABE.jpg;36673;36733;91169;1835;1838;3
/net/per610a/home/mvp/mvp_db/hodost-lv/2014/2014_11_18_04_56/2014_11_18_21_54.mpg;Shinzo ABE.jpg;38157;38361;91169;1909;1919;10
/net/per610a/home/mvp/mvp_db/hodost-lv/2014/2014_11_18_04_56/2014_11_18_21_54.mpg;Shinzo ABE.jpg;39081;39193;91169;1955;1961;6
/net/per610a/home/mvp/mvp_db/hodost-lv/2014/2014_11_18_04_56/2014_11_18_21_54.mpg;Shinzo ABE.jpg;39285;39293;91169;1965;1966;1
/net/per610a/home/mvp/mvp_db/hodost-lv/2014/2014_11_18_04_56/2014_11_18_21_54.mpg;Shinzo ABE.jpg;43397;43445;91169;2171;2173;2
/net/per610a/home/mvp/mvp_db/hodost-lv/2014/2014_11_18_04_56/2014_11_18_21_54.mpg;Shinzo ABE.jpg;47865;49037;91169;2395;2453;58
/net/per610a/home/mvp/mvp_db/hodost-lv/2014/2014_11_18_04_56/2014_11_18_21_54.mpg;Bairi Kaieda.jpg;39941;43081;91169;1998;2155;157
/net/per610a/home/mvp/mvp_db/hodost-lv/2014/2014_11_18_04_56/2014_11_18_21_54.mpg;Bairi Kaieda.jpg;47505;47597;91169;2377;2381;4
/net/per610a/home/mvp/mvp_db/hodost-lv/2014/2014_11_18_04_56/2014_11_18_21_54.mpg;Natsuo YAMAGUCHI.jpg;43397;43473;91169;2171;2175;4
/net/per610a/home/mvp/mvp_db/hodost-lv/2014/2014_11_18_04_56/2014_11_18_21_54.mpg;Natsuo YAMAGUCHI.jpg;43545;43545;91169;2178;2178;0
/net/per610a/home/mvp/mvp_db/hodost-lv/2014/2014_11_18_04_56/2014_11_18_21_54.mpg;Natsuo YAMAGUCHI.jpg;43613;43813;91169;2182;2192;10
/net/per610a/home/mvp/mvp_db/hodost-lv/2014/2014_11_19_04_56/2014_11_19_21_54.mpg;Yoshimi WATANABE.jpg;15357;15437;91169;768;772;4
/net/per610a/home/mvp/mvp_db/hodost-lv/2014/2014_11_19_04_56/2014_11_19_21_54.mpg;Yoshimi WATANABE.jpg;16081;16273;91169;804;814;10
/net/per610a/home/mvp/mvp_db/hodost-lv/2014/2014_11_19_04_56/2014_11_19_21_54.mpg;Keiichiro Asao.jpg;16509;16933;91169;826;847;21
/net/per610a/home/mvp/mvp_db/hodost-lv/2014/2014_11_19_04_56/2014_11_19_21_54.mpg;Shinzo ABE.jpg;20801;21313;91169;1041;1066;25
/net/per610a/home/mvp/mvp_db/hodost-lv/2014/2014_11_19_04_56/2014_11_19_21_54.mpg;Shinzo ABE.jpg;26673;27341;91169;1334;1368;34
/net/per610a/home/mvp/mvp_db/hodost-lv/2014/2014_11_19_04_56/2014_11_19_21_54.mpg;Shinzo ABE.jpg;23029;23077;91169;1152;1155;3
/net/per610a/home/mvp/mvp_db/hodost-lv/2014/2014_11_19_04_56/2014_11_19_21_54.mpg;Shinzo ABE.jpg;23333;25009;91169;1167;1251;84
/net/per610a/home/mvp/mvp_db/hodost-lv/2014/2014_11_19_04_56/2014_11_19_21_54.mpg;Shinzo ABE.jpg;26141;26589;91169;1308;1330;22
/net/per610a/home/mvp/mvp_db/hodost-lv/2014/2014_11_20_04_56/2014_11_20_21_54.mpg;Bairi Kaieda.jpg;30889;31005;91161;1545;1551;6
/net/per610a/home/mvp/mvp_db/hodost-lv/2014/2014_11_20_04_56/2014_11_20_21_54.mpg;Bairi Kaieda.jpg;31945;32217;91161;1598;1612;14
/net/per610a/home/mvp/mvp_db/hodost-lv/2014/2014_11_20_04_56/2014_11_20_21_54.mpg;Yukio EDANO.jpg;32353;32761;91161;1619;1639;20
/net/per610a/home/mvp/mvp_db/hodost-lv/2014/2014_11_20_04_56/2014_11_20_21_54.mpg;Ichiro OZAWA.jpg;32845;33113;91161;1643;1657;14
/net/per610a/home/mvp/mvp_db/hodost-lv/2014/2014_11_21_04_56/2014_11_21_21_54.mpg;Shinzo ABE.jpg;1625;1809;91177;81;90;9
/net/per610a/home/mvp/mvp_db/hodost-lv/2014/2014_11_21_04_56/2014_11_21_21_54.mpg;Shinzo ABE.jpg;6481;6549;91177;324;327;3
/net/per610a/home/mvp/mvp_db/hodost-lv/2014/2014_11_21_04_56/2014_11_21_21_54.mpg;Shinzo ABE.jpg;17617;17837;91177;881;892;11
/net/per610a/home/mvp/mvp_db/hodost-lv/2014/2014_11_21_04_56/2014_11_21_21_54.mpg;Shinzo ABE.jpg;17909;17973;91177;896;899;3
/net/per610a/home/mvp/mvp_db/hodost-lv/2014/2014_11_21_04_56/2014_11_21_21_54.mpg;Shinzo ABE.jpg;18789;18869;91177;940;944;4
/net/per610a/home/mvp/mvp_db/hodost-lv/2014/2014_11_21_04_56/2014_11_21_21_54.mpg;Shinzo ABE.jpg;7529;7537;91177;376;377;1
/net/per610a/home/mvp/mvp_db/hodost-lv/2014/2014_11_21_04_56/2014_11_21_21_54.mpg;Shinzo ABE.jpg;7601;8097;91177;380;405;25
/net/per610a/home/mvp/mvp_db/hodost-lv/2014/2014_11_21_04_56/2014_11_21_21_54.mpg;Natsuo YAMAGUCHI.jpg;8133;8221;91177;407;411;4
/net/per610a/home/mvp/mvp_db/hodost-lv/2014/2014_11_21_04_56/2014_11_21_21_54.mpg;Natsuo YAMAGUCHI.jpg;8349;8637;91177;417;432;15
/net/per610a/home/mvp/mvp_db/hodost-lv/2014/2014_11_21_04_56/2014_11_21_21_54.mpg;Taro ASO.jpg;8961;10169;91177;448;508;60
/net/per610a/home/mvp/mvp_db/hodost-lv/2014/2014_11_21_04_56/2014_11_21_21_54.mpg;Bairi Kaieda.jpg;10177;13285;91177;509;664;155
/net/per610a/home/mvp/mvp_db/hodost-lv/2014/2014_11_25_04_56/2014_11_25_21_54.mpg;Toranosuke Katayama.jpg;32445;32581;91169;1623;1630;7
/net/per610a/home/mvp/mvp_db/hodost-lv/2014/2014_11_25_04_56/2014_11_25_21_54.mpg;Takeo Hiranuma.jpeg;32625;33017;91169;1632;1652;20
/net/per610a/home/mvp/mvp_db/hodost-lv/2014/2014_11_26_04_56/2014_11_26_21_54.mpg;Natsuo YAMAGUCHI.jpg;39521;39901;91169;1978;1997;19
/net/per610a/home/mvp/mvp_db/hodost-lv/2014/2014_11_26_04_56/2014_11_26_21_54.mpg;Kazuo SHII.jpg;41973;42081;91169;2100;2106;6
/net/per610a/home/mvp/mvp_db/hodost-lv/2014/2014_11_26_04_56/2014_11_26_21_54.mpg;Kazuo SHII.jpg;42293;42429;91169;2116;2123;7
/net/per610a/home/mvp/mvp_db/hodost-lv/2014/2014_11_26_04_56/2014_11_26_21_54.mpg;Ichiro OZAWA.jpg;42693;43165;91169;2136;2160;24
/net/per610a/home/mvp/mvp_db/hodost-lv/2014/2014_11_26_04_56/2014_11_26_21_54.mpg;Shinzo ABE.jpg;84057;84221;91169;4207;4215;8
/net/per610a/home/mvp/mvp_db/hodost-lv/2014/2014_11_27_04_56/2014_11_27_21_54.mpg;Natsuo YAMAGUCHI.jpg;49305;49577;91169;2467;2481;14
/net/per610a/home/mvp/mvp_db/hodost-lv/2014/2014_11_27_04_56/2014_11_27_21_54.mpg;Natsuo YAMAGUCHI.jpg;49801;49905;91169;2492;2497;5
/net/per610a/home/mvp/mvp_db/hodost-lv/2014/2014_11_27_04_56/2014_11_27_21_54.mpg;Tadatomo Yoshida.jpg;49973;50253;91169;2501;2515;14
/net/per610a/home/mvp/mvp_db/hodost-lv/2014/2014_11_27_04_56/2014_11_27_21_54.mpg;Masashi Nakano.jpg;60469;61141;91169;3026;3060;34
/net/per610a/home/mvp/mvp_db/hodost-lv/2014/2014_11_28_04_56/2014_11_28_21_54.mpg;Natsuo YAMAGUCHI.jpg;31965;32589;91169;1599;1630;31
/net/per610a/home/mvp/mvp_db/hodost-lv/2014/2014_11_28_04_56/2014_11_28_21_54.mpg;Toru Hashimoto.jpg;33837;34041;91169;1693;1703;10
/net/per610a/home/mvp/mvp_db/hodost-lv/2014/2014_11_28_04_56/2014_11_28_21_54.mpg;Taro ASO.jpg;34133;34553;91169;1707;1728;21
/net/per610a/home/mvp/mvp_db/hodost-lv/2014/2014_11_30_04_56/2014_11_30_10_00.mpg;Shinzo ABE.jpg;116645;117393;125929;5837;5874;37
/net/per610a/home/mvp/mvp_db/hodost-lv/2014/2014_12_01_04_56/2014_12_01_21_54.mpg;Bairi Kaieda.jpg;31433;34409;91169;1573;1722;149
/net/per610a/home/mvp/mvp_db/hodost-lv/2014/2014_12_01_04_56/2014_12_01_21_54.mpg;Kazuo SHII.jpg;34445;37201;91169;1723;1861;138
/net/per610a/home/mvp/mvp_db/hodost-lv/2014/2014_12_01_04_56/2014_12_01_21_54.mpg;Shinzo ABE.jpg;37749;38809;91169;1889;1942;53
/net/per610a/home/mvp/mvp_db/hodost-lv/2014/2014_12_01_04_56/2014_12_01_21_54.mpg;Shinzo ABE.jpg;54957;54989;91169;2750;2752;2
/net/per610a/home/mvp/mvp_db/hodost-lv/2014/2014_12_01_04_56/2014_12_01_21_54.mpg;Natsuo YAMAGUCHI.jpg;40493;40693;91169;2026;2036;10
/net/per610a/home/mvp/mvp_db/hodost-lv/2014/2014_12_01_04_56/2014_12_01_21_54.mpg;Natsuo YAMAGUCHI.jpg;40789;41445;91169;2041;2074;33
/net/per610a/home/mvp/mvp_db/hodost-lv/2014/2014_12_01_04_56/2014_12_01_21_54.mpg;Natsuo YAMAGUCHI.jpg;41573;41809;91169;2080;2092;12
/net/per610a/home/mvp/mvp_db/hodost-lv/2014/2014_12_01_04_56/2014_12_01_21_54.mpg;Natsuo YAMAGUCHI.jpg;41893;43121;91169;2096;2158;62
/net/per610a/home/mvp/mvp_db/hodost-lv/2014/2014_12_02_04_56/2014_12_02_21_54.mpg;Shinzo ABE.jpg;1261;1457;91169;63;72;9
/net/per610a/home/mvp/mvp_db/hodost-lv/2014/2014_12_02_04_56/2014_12_02_21_54.mpg;Shinzo ABE.jpg;4541;4605;91169;227;230;3
/net/per610a/home/mvp/mvp_db/hodost-lv/2014/2014_12_02_04_56/2014_12_02_21_54.mpg;Bairi Kaieda.jpg;5641;6637;91169;282;332;50
/net/per610a/home/mvp/mvp_db/hodost-lv/2014/2014_12_02_04_56/2014_12_02_21_54.mpg;Natsuo YAMAGUCHI.jpg;8449;8613;91169;422;431;9
/net/per610a/home/mvp/mvp_db/hodost-lv/2014/2014_12_02_04_56/2014_12_02_21_54.mpg;Natsuo YAMAGUCHI.jpg;22133;22609;91169;1107;1131;24
/net/per610a/home/mvp/mvp_db/hodost-lv/2014/2014_12_02_04_56/2014_12_02_21_54.mpg;Kazuo SHII.jpg;9765;10521;91169;488;526;38
/net/per610a/home/mvp/mvp_db/hodost-lv/2014/2014_12_02_04_56/2014_12_02_21_54.mpg;Ichiro OZAWA.jpg;10681;11197;91169;534;560;26
/net/per610a/home/mvp/mvp_db/hodost-lv/2014/2014_12_03_04_56/2014_12_03_21_54.mpg;Shinzo ABE.jpg;1837;2773;91169;91;138;47
/net/per610a/home/mvp/mvp_db/hodost-lv/2014/2014_12_03_04_56/2014_12_03_21_54.mpg;Shinzo ABE.jpg;3441;3445;91169;172;172;0
/net/per610a/home/mvp/mvp_db/hodost-lv/2014/2014_12_03_04_56/2014_12_03_21_54.mpg;Shinzo ABE.jpg;3509;3921;91169;175;196;21
/net/per610a/home/mvp/mvp_db/hodost-lv/2014/2014_12_03_04_56/2014_12_03_21_54.mpg;Shinzo ABE.jpg;3985;3985;91169;199;199;0
/net/per610a/home/mvp/mvp_db/hodost-lv/2014/2014_12_03_04_56/2014_12_03_21_54.mpg;Shinzo ABE.jpg;4073;4073;91169;203;203;0
/net/per610a/home/mvp/mvp_db/hodost-lv/2014/2014_12_03_04_56/2014_12_03_21_54.mpg;Shinzo ABE.jpg;13317;13453;91169;666;673;7
/net/per610a/home/mvp/mvp_db/hodost-lv/2014/2014_12_03_04_56/2014_12_03_21_54.mpg;Shinzo ABE.jpg;16233;16449;91169;812;823;11
/net/per610a/home/mvp/mvp_db/hodost-lv/2014/2014_12_03_04_56/2014_12_03_21_54.mpg;Shinzo ABE.jpg;16617;16709;91169;831;836;5
/net/per610a/home/mvp/mvp_db/hodost-lv/2014/2014_12_03_04_56/2014_12_03_21_54.mpg;Shinzo ABE.jpg;16861;17941;91169;843;897;54
/net/per610a/home/mvp/mvp_db/hodost-lv/2014/2014_12_03_04_56/2014_12_03_21_54.mpg;Shinzo ABE.jpg;26529;26657;91169;1327;1334;7
/net/per610a/home/mvp/mvp_db/hodost-lv/2014/2014_12_03_04_56/2014_12_03_21_54.mpg;Shinzo ABE.jpg;27257;28029;91169;1364;1402;38
/net/per610a/home/mvp/mvp_db/hodost-lv/2014/2014_12_03_04_56/2014_12_03_21_54.mpg;Shinzo ABE.jpg;28181;28589;91169;1410;1430;20
/net/per610a/home/mvp/mvp_db/hodost-lv/2014/2014_12_03_04_56/2014_12_03_21_54.mpg;Shinzo ABE.jpg;28657;28857;91169;1434;1444;10
/net/per610a/home/mvp/mvp_db/hodost-lv/2014/2014_12_03_04_56/2014_12_03_21_54.mpg;Shinzo ABE.jpg;28949;29401;91169;1448;1471;23
/net/per610a/home/mvp/mvp_db/hodost-lv/2014/2014_12_03_04_56/2014_12_03_21_54.mpg;Shinzo ABE.jpg;29537;29741;91169;1478;1488;10
/net/per610a/home/mvp/mvp_db/hodost-lv/2014/2014_12_03_04_56/2014_12_03_21_54.mpg;Shinzo ABE.jpg;31777;32165;91169;1590;1609;19
/net/per610a/home/mvp/mvp_db/hodost-lv/2014/2014_12_03_04_56/2014_12_03_21_54.mpg;Shinzo ABE.jpg;33117;33745;91169;1657;1688;31
/net/per610a/home/mvp/mvp_db/hodost-lv/2014/2014_12_03_04_56/2014_12_03_21_54.mpg;Shinzo ABE.jpg;33849;34581;91169;1694;1730;36
/net/per610a/home/mvp/mvp_db/hodost-lv/2014/2014_12_03_04_56/2014_12_03_21_54.mpg;Shinzo ABE.jpg;34649;35077;91169;1734;1755;21
/net/per610a/home/mvp/mvp_db/hodost-lv/2014/2014_12_03_04_56/2014_12_03_21_54.mpg;Shinzo ABE.jpg;36597;36745;91169;1831;1839;8
/net/per610a/home/mvp/mvp_db/hodost-lv/2014/2014_12_03_04_56/2014_12_03_21_54.mpg;Shinzo ABE.jpg;49509;50121;91169;2477;2508;31
/net/per610a/home/mvp/mvp_db/hodost-lv/2014/2014_12_03_04_56/2014_12_03_21_54.mpg;Shinzo ABE.jpg;50813;51065;91169;2543;2555;12
/net/per610a/home/mvp/mvp_db/hodost-lv/2014/2014_12_03_04_56/2014_12_03_21_54.mpg;Shinzo ABE.jpg;59841;59893;91169;2995;2997;2
/net/per610a/home/mvp/mvp_db/hodost-lv/2014/2014_12_03_04_56/2014_12_03_21_54.mpg;Shinzo ABE.jpg;60745;61685;91169;3040;3087;47
/net/per610a/home/mvp/mvp_db/hodost-lv/2014/2014_12_03_04_56/2014_12_03_21_54.mpg;Shinzo ABE.jpg;62185;63269;91169;3112;3166;54
/net/per610a/home/mvp/mvp_db/hodost-lv/2014/2014_12_03_04_56/2014_12_03_21_54.mpg;Shinzo ABE.jpg;63377;63901;91169;3172;3198;26
/net/per610a/home/mvp/mvp_db/hodost-lv/2014/2014_12_03_04_56/2014_12_03_21_54.mpg;Shinzo ABE.jpg;64013;64265;91169;3203;3216;13
/net/per610a/home/mvp/mvp_db/hodost-lv/2014/2014_12_03_04_56/2014_12_03_21_54.mpg;Shinzo ABE.jpg;64373;64517;91169;3221;3229;8
/net/per610a/home/mvp/mvp_db/hodost-lv/2014/2014_12_03_04_56/2014_12_03_21_54.mpg;Shinzo ABE.jpg;64625;64793;91169;3234;3242;8
/net/per610a/home/mvp/mvp_db/hodost-lv/2014/2014_12_03_04_56/2014_12_03_21_54.mpg;Shinzo ABE.jpg;64933;65121;91169;3249;3259;10
/net/per610a/home/mvp/mvp_db/hodost-lv/2014/2014_12_03_04_56/2014_12_03_21_54.mpg;Shinzo ABE.jpg;66473;66901;91169;3326;3348;22
/net/per610a/home/mvp/mvp_db/hodost-lv/2014/2014_12_03_04_56/2014_12_03_21_54.mpg;Shinzo ABE.jpg;68053;68657;91169;3406;3436;30
/net/per610a/home/mvp/mvp_db/hodost-lv/2014/2014_12_03_04_56/2014_12_03_21_54.mpg;Shinzo ABE.jpg;68757;69017;91169;3441;3454;13
/net/per610a/home/mvp/mvp_db/hodost-lv/2014/2014_12_03_04_56/2014_12_03_21_54.mpg;Shinzo ABE.jpg;69369;70253;91169;3471;3516;45
/net/per610a/home/mvp/mvp_db/hodost-lv/2014/2014_12_03_04_56/2014_12_03_21_54.mpg;Shinzo ABE.jpg;71901;72165;91169;3598;3611;13
/net/per610a/home/mvp/mvp_db/hodost-lv/2014/2014_12_03_04_56/2014_12_03_21_54.mpg;Kazuo SHII.jpg;4725;5105;91169;236;255;19
/net/per610a/home/mvp/mvp_db/hodost-lv/2014/2014_12_03_04_56/2014_12_03_21_54.mpg;Kazuo SHII.jpg;5173;5573;91169;258;278;20
/net/per610a/home/mvp/mvp_db/hodost-lv/2014/2014_12_03_04_56/2014_12_03_21_54.mpg;Kazuo SHII.jpg;5661;5769;91169;283;288;5
/net/per610a/home/mvp/mvp_db/hodost-lv/2014/2014_12_03_04_56/2014_12_03_21_54.mpg;Kazuo SHII.jpg;29833;30029;91169;1493;1502;9
/net/per610a/home/mvp/mvp_db/hodost-lv/2014/2014_12_03_04_56/2014_12_03_21_54.mpg;Kazuo SHII.jpg;30133;30313;91169;1508;1517;9
/net/per610a/home/mvp/mvp_db/hodost-lv/2014/2014_12_03_04_56/2014_12_03_21_54.mpg;Kazuo SHII.jpg;30457;30625;91169;1524;1532;8
/net/per610a/home/mvp/mvp_db/hodost-lv/2014/2014_12_03_04_56/2014_12_03_21_54.mpg;Kazuo SHII.jpg;31649;31937;91169;1584;1598;14
/net/per610a/home/mvp/mvp_db/hodost-lv/2014/2014_12_03_04_56/2014_12_03_21_54.mpg;Kazuo SHII.jpg;39541;39921;91169;1979;1998;19
/net/per610a/home/mvp/mvp_db/hodost-lv/2014/2014_12_03_04_56/2014_12_03_21_54.mpg;Kazuo SHII.jpg;65469;65581;91169;3276;3282;6
/net/per610a/home/mvp/mvp_db/hodost-lv/2014/2014_12_03_04_56/2014_12_03_21_54.mpg;Kazuo SHII.jpg;65721;66901;91169;3289;3348;59
/net/per610a/home/mvp/mvp_db/hodost-lv/2014/2014_12_03_04_56/2014_12_03_21_54.mpg;Kazuo SHII.jpg;67065;67329;91169;3356;3369;13
/net/per610a/home/mvp/mvp_db/hodost-lv/2014/2014_12_03_04_56/2014_12_03_21_54.mpg;Toru Hashimoto.jpg;5965;6301;91169;298;315;17
/net/per610a/home/mvp/mvp_db/hodost-lv/2014/2014_12_03_04_56/2014_12_03_21_54.mpg;Toru Hashimoto.jpg;6497;6597;91169;325;330;5
/net/per610a/home/mvp/mvp_db/hodost-lv/2014/2014_12_03_04_56/2014_12_03_21_54.mpg;Toru Hashimoto.jpg;6893;7157;91169;344;358;14
/net/per610a/home/mvp/mvp_db/hodost-lv/2014/2014_12_03_04_56/2014_12_03_21_54.mpg;Toru Hashimoto.jpg;18153;18409;91169;908;921;13
/net/per610a/home/mvp/mvp_db/hodost-lv/2014/2014_12_03_04_56/2014_12_03_21_54.mpg;Toru Hashimoto.jpg;18585;18933;91169;930;947;17
/net/per610a/home/mvp/mvp_db/hodost-lv/2014/2014_12_03_04_56/2014_12_03_21_54.mpg;Toru Hashimoto.jpg;23573;23809;91169;1179;1191;12
/net/per610a/home/mvp/mvp_db/hodost-lv/2014/2014_12_03_04_56/2014_12_03_21_54.mpg;Toru Hashimoto.jpg;24109;24621;91169;1206;1232;26
/net/per610a/home/mvp/mvp_db/hodost-lv/2014/2014_12_03_04_56/2014_12_03_21_54.mpg;Toru Hashimoto.jpg;24721;25149;91169;1237;1258;21
/net/per610a/home/mvp/mvp_db/hodost-lv/2014/2014_12_03_04_56/2014_12_03_21_54.mpg;Toru Hashimoto.jpg;35909;37105;91169;1797;1857;60
/net/per610a/home/mvp/mvp_db/hodost-lv/2014/2014_12_03_04_56/2014_12_03_21_54.mpg;Toru Hashimoto.jpg;39541;39921;91169;1979;1998;19
/net/per610a/home/mvp/mvp_db/hodost-lv/2014/2014_12_03_04_56/2014_12_03_21_54.mpg;Toru Hashimoto.jpg;52825;53397;91169;2643;2672;29
/net/per610a/home/mvp/mvp_db/hodost-lv/2014/2014_12_03_04_56/2014_12_03_21_54.mpg;Toru Hashimoto.jpg;53653;53721;91169;2685;2688;3
/net/per610a/home/mvp/mvp_db/hodost-lv/2014/2014_12_03_04_56/2014_12_03_21_54.mpg;Toru Hashimoto.jpg;71201;71349;91169;3563;3571;8
/net/per610a/home/mvp/mvp_db/hodost-lv/2014/2014_12_03_04_56/2014_12_03_21_54.mpg;Toru Hashimoto.jpg;71517;71897;91169;3579;3598;19
/net/per610a/home/mvp/mvp_db/hodost-lv/2014/2014_12_03_04_56/2014_12_03_21_54.mpg;Ichiro OZAWA.jpg;8661;8921;91169;433;446;13
/net/per610a/home/mvp/mvp_db/hodost-lv/2014/2014_12_03_04_56/2014_12_03_21_54.mpg;Ichiro OZAWA.jpg;9037;9377;91169;452;469;17
/net/per610a/home/mvp/mvp_db/hodost-lv/2014/2014_12_03_04_56/2014_12_03_21_54.mpg;Ichiro OZAWA.jpg;9513;10621;91169;476;531;55
/net/per610a/home/mvp/mvp_db/hodost-lv/2014/2014_12_03_04_56/2014_12_03_21_54.mpg;Ichiro OZAWA.jpg;17945;18089;91169;898;905;7
/net/per610a/home/mvp/mvp_db/hodost-lv/2014/2014_12_03_04_56/2014_12_03_21_54.mpg;Ichiro OZAWA.jpg;45745;48673;91169;2289;2436;147
/net/per610a/home/mvp/mvp_db/hodost-lv/2014/2014_12_03_04_56/2014_12_03_21_54.mpg;Ichiro OZAWA.jpg;48785;49373;91169;2441;2471;30
/net/per610a/home/mvp/mvp_db/hodost-lv/2014/2014_12_03_04_56/2014_12_03_21_54.mpg;Natsuo YAMAGUCHI.jpg;14493;15193;91169;725;760;35
/net/per610a/home/mvp/mvp_db/hodost-lv/2014/2014_12_03_04_56/2014_12_03_21_54.mpg;Natsuo YAMAGUCHI.jpg;15289;16173;91169;765;809;44
/net/per610a/home/mvp/mvp_db/hodost-lv/2014/2014_12_03_04_56/2014_12_03_21_54.mpg;Natsuo YAMAGUCHI.jpg;19153;19317;91169;958;966;8
/net/per610a/home/mvp/mvp_db/hodost-lv/2014/2014_12_03_04_56/2014_12_03_21_54.mpg;Natsuo YAMAGUCHI.jpg;19457;19841;91169;973;993;20
/net/per610a/home/mvp/mvp_db/hodost-lv/2014/2014_12_03_04_56/2014_12_03_21_54.mpg;Natsuo YAMAGUCHI.jpg;25345;25529;91169;1268;1277;9
/net/per610a/home/mvp/mvp_db/hodost-lv/2014/2014_12_03_04_56/2014_12_03_21_54.mpg;Natsuo YAMAGUCHI.jpg;53725;53913;91169;2688;2698;10
/net/per610a/home/mvp/mvp_db/hodost-lv/2014/2014_12_03_04_56/2014_12_03_21_54.mpg;Natsuo YAMAGUCHI.jpg;60249;60329;91169;3015;3019;4
/net/per610a/home/mvp/mvp_db/hodost-lv/2014/2014_12_03_04_56/2014_12_03_21_54.mpg;Natsuo YAMAGUCHI.jpg;60745;61685;91169;3040;3087;47
/net/per610a/home/mvp/mvp_db/hodost-lv/2014/2014_12_03_04_56/2014_12_03_21_54.mpg;Natsuo YAMAGUCHI.jpg;62185;62705;91169;3112;3138;26
/net/per610a/home/mvp/mvp_db/hodost-lv/2014/2014_12_03_04_56/2014_12_03_21_54.mpg;Natsuo YAMAGUCHI.jpg;67441;67617;91169;3375;3384;9
/net/per610a/home/mvp/mvp_db/hodost-lv/2014/2014_12_03_04_56/2014_12_03_21_54.mpg;Natsuo YAMAGUCHI.jpg;67737;67933;91169;3390;3400;10
/net/per610a/home/mvp/mvp_db/hodost-lv/2014/2014_12_04_04_56/2014_12_04_21_54.mpg;Shinzo ABE.jpg;36541;36685;91169;1828;1836;8
/net/per610a/home/mvp/mvp_db/hodost-lv/2014/2014_12_04_04_56/2014_12_04_21_54.mpg;Taro ASO.jpg;39109;39281;91169;1957;1966;9
/net/per610a/home/mvp/mvp_db/hodost-lv/2014/2014_12_05_04_56/2014_12_05_21_54.mpg;Toru Hashimoto.jpg;40177;40429;91169;2010;2023;13
/net/per610a/home/mvp/mvp_db/hodost-lv/2014/2014_12_08_04_56/2014_12_08_21_54.mpg;Taro ASO.jpg;38049;38189;91169;1904;1911;7
/net/per610a/home/mvp/mvp_db/hodost-lv/2014/2014_12_08_04_56/2014_12_08_21_54.mpg;Taro ASO.jpg;38485;39009;91169;1926;1952;26
/net/per610a/home/mvp/mvp_db/hodost-lv/2014/2014_12_08_04_56/2014_12_08_21_54.mpg;Taro ASO.jpg;39393;39809;91169;1971;1992;21
/net/per610a/home/mvp/mvp_db/hodost-lv/2014/2014_12_08_04_56/2014_12_08_21_54.mpg;Ichiro OZAWA.jpg;39665;39773;91169;1985;1990;5
/net/per610a/home/mvp/mvp_db/hodost-lv/2014/2014_12_08_04_56/2014_12_08_21_54.mpg;Ichiro OZAWA.jpg;43261;43677;91169;2165;2186;21
/net/per610a/home/mvp/mvp_db/hodost-lv/2014/2014_12_08_04_56/2014_12_08_21_54.mpg;Ichiro OZAWA.jpg;43929;44373;91169;2198;2220;22
/net/per610a/home/mvp/mvp_db/hodost-lv/2014/2014_12_08_04_56/2014_12_08_21_54.mpg;Yukio EDANO.jpg;47729;47981;91169;2388;2401;13
/net/per610a/home/mvp/mvp_db/hodost-lv/2014/2014_12_08_04_56/2014_12_08_21_54.mpg;Shinzo ABE.jpg;89873;89909;91169;4498;4499;1
/net/per610a/home/mvp/mvp_db/hodost-lv/2014/2014_12_08_04_56/2014_12_08_21_54.mpg;Shinzo ABE.jpg;90873;90981;91169;4548;4553;5
/net/per610a/home/mvp/mvp_db/hodost-lv/2014/2014_12_08_04_56/2014_12_08_21_54.mpg;Shinzo ABE.jpg;91145;91165;91169;4561;4562;1
/net/per610a/home/mvp/mvp_db/hodost-lv/2014/2014_12_09_04_56/2014_12_09_21_54.mpg;Bairi Kaieda.jpg;19333;20665;91169;967;1034;67
/net/per610a/home/mvp/mvp_db/hodost-lv/2014/2014_12_09_04_56/2014_12_09_21_54.mpg;Shinzo ABE.jpg;45785;45905;91169;2291;2297;6
/net/per610a/home/mvp/mvp_db/hodost-lv/2014/2014_12_09_04_56/2014_12_09_21_54.mpg;Shinzo ABE.jpg;50429;50493;91169;2523;2527;4
/net/per610a/home/mvp/mvp_db/hodost-lv/2014/2014_12_10_04_56/2014_12_10_21_54.mpg;Shinzo ABE.jpg;14605;14701;91169;730;735;5
/net/per610a/home/mvp/mvp_db/hodost-lv/2014/2014_12_10_04_56/2014_12_10_21_54.mpg;Shinzo ABE.jpg;15733;16021;91169;787;801;14
/net/per610a/home/mvp/mvp_db/hodost-lv/2014/2014_12_10_04_56/2014_12_10_21_54.mpg;Shinzo ABE.jpg;19241;19289;91169;963;965;2
/net/per610a/home/mvp/mvp_db/hodost-lv/2014/2014_12_11_04_56/2014_12_11_21_54.mpg;Naoto KAN.jpg;21673;21957;91169;1084;1098;14
/net/per610a/home/mvp/mvp_db/hodost-lv/2014/2014_12_11_04_56/2014_12_11_21_54.mpg;Yoshimi WATANABE.jpg;24613;24753;91169;1231;1238;7
/net/per610a/home/mvp/mvp_db/hodost-lv/2014/2014_12_11_04_56/2014_12_11_21_54.mpg;Yoshimi WATANABE.jpg;25685;25937;91169;1285;1298;13
/net/per610a/home/mvp/mvp_db/hodost-lv/2014/2014_12_12_04_56/2014_12_12_21_54.mpg;Shinzo ABE.jpg;9209;9981;91169;460;499;39
/net/per610a/home/mvp/mvp_db/hodost-lv/2014/2014_12_12_04_56/2014_12_12_21_54.mpg;Kazuo SHII.jpg;14093;14737;91169;705;737;32
/net/per610a/home/mvp/mvp_db/hodost-lv/2014/2014_12_12_04_56/2014_12_12_21_54.mpg;Ichiro OZAWA.jpg;15225;15593;91169;762;780;18
/net/per610a/home/mvp/mvp_db/hodost-lv/2014/2014_12_15_04_56/2014_12_15_21_54.mpg;Bairi Kaieda.jpg;1557;1637;91169;77;81;4
/net/per610a/home/mvp/mvp_db/hodost-lv/2014/2014_12_15_04_56/2014_12_15_21_54.mpg;Bairi Kaieda.jpg;10477;10489;91169;524;524;0
/net/per610a/home/mvp/mvp_db/hodost-lv/2014/2014_12_15_04_56/2014_12_15_21_54.mpg;Bairi Kaieda.jpg;10993;11317;91169;550;566;16
/net/per610a/home/mvp/mvp_db/hodost-lv/2014/2014_12_15_04_56/2014_12_15_21_54.mpg;Seiji MAEHARA.jpg;11897;13473;91169;595;674;79
/net/per610a/home/mvp/mvp_db/hodost-lv/2014/2014_12_15_04_56/2014_12_15_21_54.mpg;Yoshimi WATANABE.jpg;13609;14149;91169;681;708;27
/net/per610a/home/mvp/mvp_db/hodost-lv/2014/2014_12_15_04_56/2014_12_15_21_54.mpg;Yoshimi WATANABE.jpg;14673;14913;91169;734;746;12
/net/per610a/home/mvp/mvp_db/hodost-lv/2014/2014_12_15_04_56/2014_12_15_21_54.mpg;Kazuo SHII.jpg;15017;15269;91169;751;764;13
/net/per610a/home/mvp/mvp_db/hodost-lv/2014/2014_12_15_04_56/2014_12_15_21_54.mpg;Shinzo ABE.jpg;19769;19769;91169;989;989;0
/net/per610a/home/mvp/mvp_db/hodost-lv/2014/2014_12_15_04_56/2014_12_15_21_54.mpg;Shinzo ABE.jpg;25149;25149;91169;1258;1258;0
/net/per610a/home/mvp/mvp_db/hodost-lv/2014/2014_12_15_04_56/2014_12_15_21_54.mpg;Shinzo ABE.jpg;35581;35837;91169;1780;1793;13
/net/per610a/home/mvp/mvp_db/hodost-lv/2014/2014_12_16_04_56/2014_12_16_21_54.mpg;Shinzo ABE.jpg;31457;31461;91169;1574;1574;0
/net/per610a/home/mvp/mvp_db/hodost-lv/2014/2014_12_16_04_56/2014_12_16_21_54.mpg;Shinzo ABE.jpg;31637;31797;91169;1583;1591;8
/net/per610a/home/mvp/mvp_db/hodost-lv/2014/2014_12_16_04_56/2014_12_16_21_54.mpg;Shinzo ABE.jpg;34133;34309;91169;1708;1717;9
/net/per610a/home/mvp/mvp_db/hodost-lv/2014/2014_12_16_04_56/2014_12_16_21_54.mpg;Shintaro ISHIHARA.jpg;42145;42249;91169;2109;2114;5
/net/per610a/home/mvp/mvp_db/hodost-lv/2014/2014_12_16_04_56/2014_12_16_21_54.mpg;Shintaro ISHIHARA.jpg;47585;48065;91169;2381;2405;24
/net/per610a/home/mvp/mvp_db/hodost-lv/2014/2014_12_16_04_56/2014_12_16_21_54.mpg;Shintaro ISHIHARA.jpg;48149;49229;91169;2409;2463;54
/net/per610a/home/mvp/mvp_db/hodost-lv/2014/2014_12_16_04_56/2014_12_16_21_54.mpg;Shintaro ISHIHARA.jpg;49325;49901;91169;2468;2497;29
/net/per610a/home/mvp/mvp_db/hodost-lv/2014/2014_12_19_04_56/2014_12_19_21_54.mpg;Seiji MAEHARA.jpg;37045;37341;91169;1854;1868;14
/net/per610a/home/mvp/mvp_db/hodost-lv/2014/2014_12_21_04_56/2014_12_21_10_00.mpg;Yoshimi WATANABE.jpg;7457;7541;125929;373;377;4
/net/per610a/home/mvp/mvp_db/hodost-lv/2014/2014_12_21_04_56/2014_12_21_10_00.mpg;Yoshimi WATANABE.jpg;7717;8033;125929;386;402;16
/net/per610a/home/mvp/mvp_db/hodost-lv/2014/2014_12_21_04_56/2014_12_21_10_00.mpg;Yoshimi WATANABE.jpg;8421;8557;125929;421;428;7
/net/per610a/home/mvp/mvp_db/hodost-lv/2014/2014_12_24_04_56/2014_12_24_21_54.mpg;Katsuya OKADA.jpg;16653;16965;91169;833;849;16
/net/per610a/home/mvp/mvp_db/hodost-lv/2014/2014_12_24_04_56/2014_12_24_21_54.mpg;Renho.jpg;17201;17505;91169;860;876;16
/net/per610a/home/mvp/mvp_db/hodost-lv/2014/2014_12_24_04_56/2014_12_24_21_54.mpg;Shinzo ABE.jpg;41289;41377;91169;2066;2070;4
/net/per610a/home/mvp/mvp_db/hodost-lv/2014/2014_12_24_04_56/2014_12_24_21_54.mpg;Shinzo ABE.jpg;42705;42785;91169;2137;2141;4
/net/per610a/home/mvp/mvp_db/hodost-lv/2014/2014_12_28_04_56/2014_12_28_16_00.mpg;Shinzo ABE.jpg;138925;139013;143921;6952;6957;5
/net/per610a/home/mvp/mvp_db/hodost-lv/2015/2015_01_05_04_56/2015_01_05_21_54.mpg;Shinzo ABE.jpg;2501;2513;91169;125;125;0
/net/per610a/home/mvp/mvp_db/hodost-lv/2015/2015_01_05_04_56/2015_01_05_21_54.mpg;Shinzo ABE.jpg;10697;10809;91169;535;540;5
/net/per610a/home/mvp/mvp_db/hodost-lv/2015/2015_01_05_04_56/2015_01_05_21_54.mpg;Shinzo ABE.jpg;14845;15249;91169;742;763;21
/net/per610a/home/mvp/mvp_db/hodost-lv/2015/2015_01_05_04_56/2015_01_05_21_54.mpg;Shinzo ABE.jpg;15377;15577;91169;769;779;10
/net/per610a/home/mvp/mvp_db/hodost-lv/2015/2015_01_05_04_56/2015_01_05_21_54.mpg;Shinzo ABE.jpg;11113;11213;91169;556;561;5
/net/per610a/home/mvp/mvp_db/hodost-lv/2015/2015_01_05_04_56/2015_01_05_21_54.mpg;Shinzo ABE.jpg;15661;16261;91169;783;813;30
/net/per610a/home/mvp/mvp_db/hodost-lv/2015/2015_01_05_04_56/2015_01_05_21_54.mpg;Shinzo ABE.jpg;16689;17129;91169;835;857;22
/net/per610a/home/mvp/mvp_db/hodost-lv/2015/2015_01_05_04_56/2015_01_05_21_54.mpg;Yukio EDANO.jpg;13965;14081;91169;698;704;6
/net/per610a/home/mvp/mvp_db/hodost-lv/2015/2015_01_05_04_56/2015_01_05_21_54.mpg;Yukio EDANO.jpg;21269;21449;91169;1064;1073;9
/net/per610a/home/mvp/mvp_db/hodost-lv/2015/2015_01_06_04_56/2015_01_06_21_54.mpg;Shinzo ABE.jpg;29565;29713;91169;1479;1487;8
/net/per610a/home/mvp/mvp_db/hodost-lv/2015/2015_01_11_04_56/2015_01_11_10_00.mpg;Katsuya OKADA.jpg;118521;118773;125929;5931;5943;12
/net/per610a/home/mvp/mvp_db/hodost-lv/2015/2015_01_11_04_56/2015_01_11_10_00.mpg;Katsuya OKADA.jpg;121065;121177;125929;6058;6064;6
/net/per610a/home/mvp/mvp_db/hodost-lv/2015/2015_01_12_04_56/2015_01_12_21_54.mpg;Shinzo ABE.jpg;34213;34377;91169;1712;1720;8
/net/per610a/home/mvp/mvp_db/hodost-lv/2015/2015_01_12_04_56/2015_01_12_21_54.mpg;Shinzo ABE.jpg;41153;41277;91169;2059;2065;6
/net/per610a/home/mvp/mvp_db/hodost-lv/2015/2015_01_12_04_56/2015_01_12_21_54.mpg;Shinzo ABE.jpg;41365;41525;91169;2070;2078;8
/net/per610a/home/mvp/mvp_db/hodost-lv/2015/2015_01_13_04_56/2015_01_13_21_54.mpg;Katsuya OKADA.jpg;59165;60057;91169;2960;3005;45
/net/per610a/home/mvp/mvp_db/hodost-lv/2015/2015_01_14_04_56/2015_01_14_21_54.mpg;Shinzo ABE.jpg;17549;17825;91169;878;892;14
/net/per610a/home/mvp/mvp_db/hodost-lv/2015/2015_01_14_04_56/2015_01_14_21_54.mpg;Shinzo ABE.jpg;41521;41669;91169;2078;2085;7
/net/per610a/home/mvp/mvp_db/hodost-lv/2015/2015_01_14_04_56/2015_01_14_21_54.mpg;Taro ASO.jpg;29845;29957;91169;1493;1499;6
/net/per610a/home/mvp/mvp_db/hodost-lv/2015/2015_01_14_04_56/2015_01_14_21_54.mpg;Yoshimi WATANABE.jpg;47489;47553;91169;2376;2380;4
/net/per610a/home/mvp/mvp_db/hodost-lv/2015/2015_01_14_04_56/2015_01_14_21_54.mpg;Yoshimi WATANABE.jpg;50397;50413;91169;2522;2523;1
/net/per610a/home/mvp/mvp_db/hodost-lv/2015/2015_01_14_04_56/2015_01_14_21_54.mpg;Yoshimi WATANABE.jpg;51377;51613;91169;2571;2583;12
/net/per610a/home/mvp/mvp_db/hodost-lv/2015/2015_01_16_04_56/2015_01_16_21_54.mpg;Katsuya OKADA.jpg;21453;21585;91169;1073;1080;7
/net/per610a/home/mvp/mvp_db/hodost-lv/2015/2015_01_16_04_56/2015_01_16_21_54.mpg;Katsuya OKADA.jpg;23285;23889;91169;1165;1195;30
/net/per610a/home/mvp/mvp_db/hodost-lv/2015/2015_01_16_04_56/2015_01_16_21_54.mpg;Katsuya OKADA.jpg;25029;25221;91169;1252;1262;10
/net/per610a/home/mvp/mvp_db/hodost-lv/2015/2015_01_16_04_56/2015_01_16_21_54.mpg;Katsuya OKADA.jpg;30273;30433;91169;1515;1523;8
/net/per610a/home/mvp/mvp_db/hodost-lv/2015/2015_01_16_04_56/2015_01_16_21_54.mpg;Katsuya OKADA.jpg;30653;31409;91169;1534;1572;38
/net/per610a/home/mvp/mvp_db/hodost-lv/2015/2015_01_16_04_56/2015_01_16_21_54.mpg;Katsuya OKADA.jpg;31897;32421;91169;1596;1622;26
/net/per610a/home/mvp/mvp_db/hodost-lv/2015/2015_01_16_04_56/2015_01_16_21_54.mpg;Katsuya OKADA.jpg;32793;33305;91169;1641;1666;25
/net/per610a/home/mvp/mvp_db/hodost-lv/2015/2015_01_16_04_56/2015_01_16_21_54.mpg;Katsuya OKADA.jpg;34389;34721;91169;1721;1737;16
/net/per610a/home/mvp/mvp_db/hodost-lv/2015/2015_01_16_04_56/2015_01_16_21_54.mpg;Katsuya OKADA.jpg;37177;38029;91169;1860;1903;43
/net/per610a/home/mvp/mvp_db/hodost-lv/2015/2015_01_16_04_56/2015_01_16_21_54.mpg;Katsuya OKADA.jpg;40109;40281;91169;2007;2016;9
/net/per610a/home/mvp/mvp_db/hodost-lv/2015/2015_01_16_04_56/2015_01_16_21_54.mpg;Katsuya OKADA.jpg;40677;41325;91169;2035;2068;33
/net/per610a/home/mvp/mvp_db/hodost-lv/2015/2015_01_16_04_56/2015_01_16_21_54.mpg;Katsuya OKADA.jpg;43025;43373;91169;2153;2170;17
/net/per610a/home/mvp/mvp_db/hodost-lv/2015/2015_01_16_04_56/2015_01_16_21_54.mpg;Katsuya OKADA.jpg;43677;43741;91169;2186;2189;3
/net/per610a/home/mvp/mvp_db/hodost-lv/2015/2015_01_16_04_56/2015_01_16_21_54.mpg;Katsuya OKADA.jpg;46969;47257;91169;2350;2365;15
/net/per610a/home/mvp/mvp_db/hodost-lv/2015/2015_01_16_04_56/2015_01_16_21_54.mpg;Katsuya OKADA.jpg;47485;48941;91169;2376;2449;73
/net/per610a/home/mvp/mvp_db/hodost-lv/2015/2015_01_16_04_56/2015_01_16_21_54.mpg;Katsuya OKADA.jpg;49361;50733;91169;2470;2539;69
/net/per610a/home/mvp/mvp_db/hodost-lv/2015/2015_01_16_04_56/2015_01_16_21_54.mpg;Katsuya OKADA.jpg;51825;53001;91169;2593;2652;59
/net/per610a/home/mvp/mvp_db/hodost-lv/2015/2015_01_16_04_56/2015_01_16_21_54.mpg;Katsuya OKADA.jpg;53093;54081;91169;2657;2706;49
/net/per610a/home/mvp/mvp_db/hodost-lv/2015/2015_01_16_04_56/2015_01_16_21_54.mpg;Katsuya OKADA.jpg;57253;58341;91169;2865;2919;54
/net/per610a/home/mvp/mvp_db/hodost-lv/2015/2015_01_19_04_56/2015_01_19_21_54.mpg;Katsuya OKADA.jpg;32497;32505;91169;1626;1626;0
/net/per610a/home/mvp/mvp_db/hodost-lv/2015/2015_01_19_04_56/2015_01_19_21_54.mpg;Katsuya OKADA.jpg;32809;33085;91169;1642;1655;13
/net/per610a/home/mvp/mvp_db/hodost-lv/2015/2015_01_19_04_56/2015_01_19_21_54.mpg;Katsuya OKADA.jpg;34025;34197;91169;1702;1711;9
/net/per610a/home/mvp/mvp_db/hodost-lv/2015/2015_01_19_04_56/2015_01_19_21_54.mpg;Katsuya OKADA.jpg;34341;34749;91169;1718;1739;21
/net/per610a/home/mvp/mvp_db/hodost-lv/2015/2015_01_19_04_56/2015_01_19_21_54.mpg;Katsuya OKADA.jpg;35933;36213;91169;1798;1812;14
/net/per610a/home/mvp/mvp_db/hodost-lv/2015/2015_01_19_04_56/2015_01_19_21_54.mpg;Shinzo ABE.jpg;36237;36289;91169;1813;1816;3
/net/per610a/home/mvp/mvp_db/hodost-lv/2015/2015_01_19_04_56/2015_01_19_21_54.mpg;Shinzo ABE.jpg;48173;48309;91169;2411;2417;6
/net/per610a/home/mvp/mvp_db/hodost-lv/2015/2015_01_19_04_56/2015_01_19_21_54.mpg;Shinzo ABE.jpg;47941;48073;91169;2399;2406;7
/net/per610a/home/mvp/mvp_db/hodost-lv/2015/2015_01_20_04_56/2015_01_20_21_54.mpg;Shinzo ABE.jpg;7985;8197;91161;399;410;11
/net/per610a/home/mvp/mvp_db/hodost-lv/2015/2015_01_20_04_56/2015_01_20_21_54.mpg;Shinzo ABE.jpg;8353;9325;91161;418;466;48
/net/per610a/home/mvp/mvp_db/hodost-lv/2015/2015_01_20_04_56/2015_01_20_21_54.mpg;Shinzo ABE.jpg;10685;11169;91161;534;558;24
/net/per610a/home/mvp/mvp_db/hodost-lv/2015/2015_01_20_04_56/2015_01_20_21_54.mpg;Shinzo ABE.jpg;11529;11961;91161;576;598;22
/net/per610a/home/mvp/mvp_db/hodost-lv/2015/2015_01_20_04_56/2015_01_20_21_54.mpg;Shinzo ABE.jpg;12301;12929;91161;615;647;32
/net/per610a/home/mvp/mvp_db/hodost-lv/2015/2015_01_20_04_56/2015_01_20_21_54.mpg;Shinzo ABE.jpg;30525;31069;91161;1527;1554;27
/net/per610a/home/mvp/mvp_db/hodost-lv/2015/2015_01_20_04_56/2015_01_20_21_54.mpg;Shinzo ABE.jpg;33089;33105;91161;1655;1656;1
/net/per610a/home/mvp/mvp_db/hodost-lv/2015/2015_01_20_04_56/2015_01_20_21_54.mpg;Shinzo ABE.jpg;33185;33189;91161;1660;1660;0
/net/per610a/home/mvp/mvp_db/hodost-lv/2015/2015_01_20_04_56/2015_01_20_21_54.mpg;Shinzo ABE.jpg;33961;34217;91161;1699;1712;13
/net/per610a/home/mvp/mvp_db/hodost-lv/2015/2015_01_20_04_56/2015_01_20_21_54.mpg;Shinzo ABE.jpg;34497;34597;91161;1726;1731;5
/net/per610a/home/mvp/mvp_db/hodost-lv/2015/2015_01_21_04_56/2015_01_21_21_54.mpg;Sadakazu TANIGAKI.jpg;29361;29417;91169;1469;1472;3
/net/per610a/home/mvp/mvp_db/hodost-lv/2015/2015_01_21_04_56/2015_01_21_21_54.mpg;Sadakazu TANIGAKI.jpg;29533;29553;91169;1478;1479;1
/net/per610a/home/mvp/mvp_db/hodost-lv/2015/2015_01_23_04_56/2015_01_23_22_14.mpg;Shinzo ABE.jpg;8113;9649;91169;406;482;76
/net/per610a/home/mvp/mvp_db/hodost-lv/2015/2015_01_23_04_56/2015_01_23_22_14.mpg;Shinzo ABE.jpg;15749;16005;91169;788;801;13
/net/per610a/home/mvp/mvp_db/hodost-lv/2015/2015_01_23_04_56/2015_01_23_22_14.mpg;Shinzo ABE.jpg;33673;33753;91169;1685;1689;4
/net/per610a/home/mvp/mvp_db/hodost-lv/2015/2015_01_23_04_56/2015_01_23_22_14.mpg;Shinzo ABE.jpg;46913;47053;91169;2347;2354;7
/net/per610a/home/mvp/mvp_db/hodost-lv/2015/2015_01_23_04_56/2015_01_23_22_14.mpg;Shinzo ABE.jpg;47141;47921;91169;2359;2398;39
/net/per610a/home/mvp/mvp_db/hodost-lv/2015/2015_01_23_04_56/2015_01_23_22_14.mpg;Shinzo ABE.jpg;52613;52765;91169;2633;2640;7
/net/per610a/home/mvp/mvp_db/hodost-lv/2015/2015_01_23_04_56/2015_01_23_22_14.mpg;Shinzo ABE.jpg;52849;52981;91169;2645;2651;6
/net/per610a/home/mvp/mvp_db/hodost-lv/2015/2015_01_23_04_56/2015_01_23_22_14.mpg;Taro ASO.jpg;14929;15697;91169;747;785;38
/net/per610a/home/mvp/mvp_db/hodost-lv/2015/2015_01_26_04_56/2015_01_26_21_54.mpg;Shinzo ABE.jpg;16221;16273;91169;811;814;3
/net/per610a/home/mvp/mvp_db/hodost-lv/2015/2015_01_26_04_56/2015_01_26_21_54.mpg;Shinzo ABE.jpg;20073;20089;91169;1004;1005;1
/net/per610a/home/mvp/mvp_db/hodost-lv/2015/2015_01_26_04_56/2015_01_26_21_54.mpg;Shinzo ABE.jpg;22681;22769;91169;1135;1139;4
/net/per610a/home/mvp/mvp_db/hodost-lv/2015/2015_01_26_04_56/2015_01_26_21_54.mpg;Shinzo ABE.jpg;34597;34745;91169;1731;1738;7
/net/per610a/home/mvp/mvp_db/hodost-lv/2015/2015_01_26_04_56/2015_01_26_21_54.mpg;Shinzo ABE.jpg;37113;37261;91169;1857;1864;7
/net/per610a/home/mvp/mvp_db/hodost-lv/2015/2015_01_26_04_56/2015_01_26_21_54.mpg;Shinzo ABE.jpg;37449;37705;91169;1874;1887;13
/net/per610a/home/mvp/mvp_db/hodost-lv/2015/2015_01_26_04_56/2015_01_26_21_54.mpg;Shinzo ABE.jpg;40833;40925;91169;2043;2048;5
/net/per610a/home/mvp/mvp_db/hodost-lv/2015/2015_01_26_04_56/2015_01_26_21_54.mpg;Shinzo ABE.jpg;41061;41073;91169;2055;2055;0
/net/per610a/home/mvp/mvp_db/hodost-lv/2015/2015_01_26_04_56/2015_01_26_21_54.mpg;Shinzo ABE.jpg;41425;41601;91169;2073;2082;9
/net/per610a/home/mvp/mvp_db/hodost-lv/2015/2015_01_26_04_56/2015_01_26_21_54.mpg;Katsuya OKADA.jpg;42953;44761;91169;2149;2240;91
/net/per610a/home/mvp/mvp_db/hodost-lv/2015/2015_01_27_04_56/2015_01_27_21_54.mpg;Shinzo ABE.jpg;9049;9921;91169;452;496;44
/net/per610a/home/mvp/mvp_db/hodost-lv/2015/2015_01_27_04_56/2015_01_27_21_54.mpg;Shinzo ABE.jpg;17157;17397;91169;858;870;12
/net/per610a/home/mvp/mvp_db/hodost-lv/2015/2015_01_27_04_56/2015_01_27_21_54.mpg;Shinzo ABE.jpg;18301;18341;91169;915;917;2
/net/per610a/home/mvp/mvp_db/hodost-lv/2015/2015_01_27_04_56/2015_01_27_21_54.mpg;Shinzo ABE.jpg;19713;20461;91169;986;1024;38
/net/per610a/home/mvp/mvp_db/hodost-lv/2015/2015_01_27_04_56/2015_01_27_21_54.mpg;Shinzo ABE.jpg;22837;22901;91169;1142;1146;4
/net/per610a/home/mvp/mvp_db/hodost-lv/2015/2015_01_27_04_56/2015_01_27_21_54.mpg;Shinzo ABE.jpg;23225;23261;91169;1162;1164;2
/net/per610a/home/mvp/mvp_db/hodost-lv/2015/2015_01_27_04_56/2015_01_27_21_54.mpg;Sadakazu TANIGAKI.jpg;17589;18233;91169;880;912;32
/net/per610a/home/mvp/mvp_db/hodost-lv/2015/2015_01_27_04_56/2015_01_27_21_54.mpg;Shinzo ABE.jpg;31181;31325;91169;1560;1567;7
/net/per610a/home/mvp/mvp_db/hodost-lv/2015/2015_01_27_04_56/2015_01_27_21_54.mpg;Shinzo ABE.jpg;55581;55817;91169;2781;2793;12
/net/per610a/home/mvp/mvp_db/hodost-lv/2015/2015_01_27_04_56/2015_01_27_21_54.mpg;Shinzo ABE.jpg;61493;61705;91169;3077;3088;11
/net/per610a/home/mvp/mvp_db/hodost-lv/2015/2015_01_27_04_56/2015_01_27_21_54.mpg;Seiji MAEHARA.jpg;69145;69729;91169;3460;3489;29
/net/per610a/home/mvp/mvp_db/hodost-lv/2015/2015_01_27_04_56/2015_01_27_21_54.mpg;Seiji MAEHARA.jpg;70213;70661;91169;3514;3536;22
/net/per610a/home/mvp/mvp_db/hodost-lv/2015/2015_01_29_04_56/2015_01_29_21_54.mpg;Shinzo ABE.jpg;22073;22213;91161;1104;1111;7
/net/per610a/home/mvp/mvp_db/hodost-lv/2015/2015_01_30_04_56/2015_01_30_21_54.mpg;Shinzo ABE.jpg;39321;39433;91169;1968;1973;5
/net/per610a/home/mvp/mvp_db/hodost-lv/2015/2015_01_30_04_56/2015_01_30_21_54.mpg;Shinzo ABE.jpg;39505;39637;91169;1977;1983;6
/net/per610a/home/mvp/mvp_db/hodost-lv/2015/2015_01_30_04_56/2015_01_30_21_54.mpg;Shinzo ABE.jpg;39769;39837;91169;1990;1993;3
/net/per610a/home/mvp/mvp_db/hodost-lv/2015/2015_02_01_04_56/2015_02_01_09_00.mpg;Shinzo ABE.jpg;96353;96389;197865;4822;4824;2
/net/per610a/home/mvp/mvp_db/hodost-lv/2015/2015_02_01_04_56/2015_02_01_09_00.mpg;Shinzo ABE.jpg;96529;96705;197865;4831;4840;9
/net/per610a/home/mvp/mvp_db/hodost-lv/2015/2015_02_01_04_56/2015_02_01_09_00.mpg;Shinzo ABE.jpg;168265;169197;197865;8421;8468;47
/net/per610a/home/mvp/mvp_db/hodost-lv/2015/2015_02_01_04_56/2015_02_01_09_00.mpg;Shinzo ABE.jpg;175621;176145;197865;8789;8815;26
/net/per610a/home/mvp/mvp_db/hodost-lv/2015/2015_02_02_04_56/2015_02_02_21_54.mpg;Natsuo YAMAGUCHI.jpg;72845;72877;91169;3645;3647;2
/net/per610a/home/mvp/mvp_db/hodost-lv/2015/2015_02_02_04_56/2015_02_02_21_54.mpg;Natsuo YAMAGUCHI.jpg;73565;73761;91169;3681;3691;10
/net/per610a/home/mvp/mvp_db/hodost-lv/2015/2015_02_03_04_56/2015_02_03_21_54.mpg;Shinzo ABE.jpg;13821;14277;91169;691;714;23
/net/per610a/home/mvp/mvp_db/hodost-lv/2015/2015_02_03_04_56/2015_02_03_21_54.mpg;Shinzo ABE.jpg;25637;25717;91169;1283;1287;4
/net/per610a/home/mvp/mvp_db/hodost-lv/2015/2015_02_03_04_56/2015_02_03_21_54.mpg;Shinzo ABE.jpg;26861;27581;91169;1344;1380;36
/net/per610a/home/mvp/mvp_db/hodost-lv/2015/2015_02_03_04_56/2015_02_03_21_54.mpg;Shinzo ABE.jpg;28205;28573;91169;1411;1430;19
/net/per610a/home/mvp/mvp_db/hodost-lv/2015/2015_02_03_04_56/2015_02_03_21_54.mpg;Shinzo ABE.jpg;29541;29777;91169;1478;1490;12
/net/per610a/home/mvp/mvp_db/hodost-lv/2015/2015_02_03_04_56/2015_02_03_21_54.mpg;Shinzo ABE.jpg;30421;30433;91169;1522;1523;1
/net/per610a/home/mvp/mvp_db/hodost-lv/2015/2015_02_03_04_56/2015_02_03_21_54.mpg;Shinzo ABE.jpg;47829;47961;91169;2393;2400;7
/net/per610a/home/mvp/mvp_db/hodost-lv/2015/2015_02_05_04_56/2015_02_05_21_54.mpg;Shinzo ABE.jpg;41041;41105;91169;2054;2057;3
/net/per610a/home/mvp/mvp_db/hodost-lv/2015/2015_02_05_04_56/2015_02_05_21_54.mpg;Shinzo ABE.jpg;44041;44741;91169;2204;2239;35
/net/per610a/home/mvp/mvp_db/hodost-lv/2015/2015_02_05_04_56/2015_02_05_21_54.mpg;Shinzo ABE.jpg;47197;47249;91169;2362;2364;2
/net/per610a/home/mvp/mvp_db/hodost-lv/2015/2015_02_08_04_56/2015_02_08_10_00.mpg;Shinzo ABE.jpg;22253;22553;125937;1113;1128;15
/net/per610a/home/mvp/mvp_db/hodost-lv/2015/2015_02_08_04_56/2015_02_08_10_00.mpg;Shinzo ABE.jpg;22781;22853;125937;1140;1143;3
/net/per610a/home/mvp/mvp_db/hodost-lv/2015/2015_02_08_04_56/2015_02_08_10_00.mpg;Shinzo ABE.jpg;30985;31085;125937;1550;1555;5
/net/per610a/home/mvp/mvp_db/hodost-lv/2015/2015_02_08_04_56/2015_02_08_10_00.mpg;Shinzo ABE.jpg;31281;31321;125937;1565;1567;2
/net/per610a/home/mvp/mvp_db/hodost-lv/2015/2015_02_08_04_56/2015_02_08_10_00.mpg;Shinzo ABE.jpg;31469;31697;125937;1574;1586;12
/net/per610a/home/mvp/mvp_db/hodost-lv/2015/2015_02_08_04_56/2015_02_08_10_00.mpg;Shinzo ABE.jpg;116069;116093;125937;5809;5810;1
/net/per610a/home/mvp/mvp_db/hodost-lv/2015/2015_02_08_04_56/2015_02_08_10_00.mpg;Shinzo ABE.jpg;120661;120873;125937;6038;6049;11
/net/per610a/home/mvp/mvp_db/hodost-lv/2015/2015_02_08_04_56/2015_02_08_10_00.mpg;Seiji Mataichi.jpg;34265;34789;125937;1714;1741;27
/net/per610a/home/mvp/mvp_db/hodost-lv/2015/2015_02_09_04_56/2015_02_09_21_54.mpg;Shinzo ABE.jpg;54921;55297;91169;2748;2767;19
/net/per610a/home/mvp/mvp_db/hodost-lv/2015/2015_02_09_04_56/2015_02_09_21_54.mpg;Shinzo ABE.jpg;55525;55641;91169;2779;2784;5
/net/per610a/home/mvp/mvp_db/hodost-lv/2015/2015_02_10_04_56/2015_02_10_21_54.mpg;Shinzo ABE.jpg;22405;22561;91169;1121;1129;8
/net/per610a/home/mvp/mvp_db/hodost-lv/2015/2015_02_10_04_56/2015_02_10_21_54.mpg;Shinzo ABE.jpg;23189;23217;91169;1160;1162;2
/net/per610a/home/mvp/mvp_db/hodost-lv/2015/2015_02_12_04_56/2015_02_12_21_54.mpg;Katsuya OKADA.jpg;33641;34501;91169;1683;1726;43
/net/per610a/home/mvp/mvp_db/hodost-lv/2015/2015_02_12_04_56/2015_02_12_21_54.mpg;Shinzo ABE.jpg;35337;35509;91169;1768;1777;9
/net/per610a/home/mvp/mvp_db/hodost-lv/2015/2015_02_16_04_56/2015_02_16_21_54.mpg;Shinzo ABE.jpg;4605;4653;91169;230;232;2
/net/per610a/home/mvp/mvp_db/hodost-lv/2015/2015_02_16_04_56/2015_02_16_21_54.mpg;Shinzo ABE.jpg;8605;8641;91169;430;432;2
/net/per610a/home/mvp/mvp_db/hodost-lv/2015/2015_02_16_04_56/2015_02_16_21_54.mpg;Natsuo YAMAGUCHI.jpg;57249;57261;91169;2865;2865;0
/net/per610a/home/mvp/mvp_db/hodost-lv/2015/2015_02_16_04_56/2015_02_16_21_54.mpg;Natsuo YAMAGUCHI.jpg;60181;60429;91169;3012;3024;12
/net/per610a/home/mvp/mvp_db/hodost-lv/2015/2015_02_17_04_56/2015_02_17_21_54.mpg;Shinzo ABE.jpg;37305;37429;91169;1867;1873;6
/net/per610a/home/mvp/mvp_db/hodost-lv/2015/2015_02_18_04_56/2015_02_18_21_54.mpg;Kohei Otsuka.jpg;8325;8501;91161;416;425;9
/net/per610a/home/mvp/mvp_db/hodost-lv/2015/2015_02_18_04_56/2015_02_18_21_54.mpg;Shinzo ABE.jpg;68221;68313;91161;3414;3418;4
/net/per610a/home/mvp/mvp_db/hodost-lv/2015/2015_02_18_04_56/2015_02_18_21_54.mpg;Shinzo ABE.jpg;68437;68649;91161;3424;3435;11
/net/per610a/home/mvp/mvp_db/hodost-lv/2015/2015_02_19_04_56/2015_02_19_21_54.mpg;Shinzo ABE.jpg;27377;27441;91169;1370;1373;3
/net/per610a/home/mvp/mvp_db/hodost-lv/2015/2015_02_19_04_56/2015_02_19_21_54.mpg;Shinzo ABE.jpg;31249;31397;91169;1564;1571;7
/net/per610a/home/mvp/mvp_db/hodost-lv/2015/2015_02_19_04_56/2015_02_19_21_54.mpg;Shinzo ABE.jpg;32789;33325;91169;1641;1667;26
/net/per610a/home/mvp/mvp_db/hodost-lv/2015/2015_02_19_04_56/2015_02_19_21_54.mpg;Shinzo ABE.jpg;33533;33561;91169;1678;1679;1
/net/per610a/home/mvp/mvp_db/hodost-lv/2015/2015_02_19_04_56/2015_02_19_21_54.mpg;Shinzo ABE.jpg;34565;34577;91169;1729;1730;1
/net/per610a/home/mvp/mvp_db/hodost-lv/2015/2015_02_23_04_56/2015_02_23_21_54.mpg;Shinzo ABE.jpg;1709;1841;91169;85;92;7
/net/per610a/home/mvp/mvp_db/hodost-lv/2015/2015_02_23_04_56/2015_02_23_21_54.mpg;Shinzo ABE.jpg;6481;7145;91169;324;357;33
/net/per610a/home/mvp/mvp_db/hodost-lv/2015/2015_02_23_04_56/2015_02_23_21_54.mpg;Shinzo ABE.jpg;21249;21341;91169;1063;1068;5
/net/per610a/home/mvp/mvp_db/hodost-lv/2015/2015_02_23_04_56/2015_02_23_21_54.mpg;Shinzo ABE.jpg;10621;10817;91169;531;541;10
/net/per610a/home/mvp/mvp_db/hodost-lv/2015/2015_02_23_04_56/2015_02_23_21_54.mpg;Shinzo ABE.jpg;11041;11097;91169;552;555;3
/net/per610a/home/mvp/mvp_db/hodost-lv/2015/2015_02_23_04_56/2015_02_23_21_54.mpg;Shinzo ABE.jpg;11209;11533;91169;561;577;16
/net/per610a/home/mvp/mvp_db/hodost-lv/2015/2015_02_23_04_56/2015_02_23_21_54.mpg;Shinzo ABE.jpg;12393;12553;91169;620;628;8
/net/per610a/home/mvp/mvp_db/hodost-lv/2015/2015_02_23_04_56/2015_02_23_21_54.mpg;Shinzo ABE.jpg;13157;13193;91169;658;660;2
/net/per610a/home/mvp/mvp_db/hodost-lv/2015/2015_02_23_04_56/2015_02_23_21_54.mpg;Sadakazu TANIGAKI.jpg;13373;14061;91169;669;703;34
/net/per610a/home/mvp/mvp_db/hodost-lv/2015/2015_02_25_04_56/2015_02_25_21_54.mpg;Shinzo ABE.jpg;14557;14801;91169;728;740;12
/net/per610a/home/mvp/mvp_db/hodost-lv/2015/2015_02_25_04_56/2015_02_25_21_54.mpg;Shinzo ABE.jpg;14945;15697;91169;747;785;38
/net/per610a/home/mvp/mvp_db/hodost-lv/2015/2015_02_25_04_56/2015_02_25_21_54.mpg;Shinzo ABE.jpg;16025;16377;91169;802;819;17
/net/per610a/home/mvp/mvp_db/hodost-lv/2015/2015_02_25_04_56/2015_02_25_21_54.mpg;Shinzo ABE.jpg;16513;16957;91169;826;848;22
/net/per610a/home/mvp/mvp_db/hodost-lv/2015/2015_02_25_04_56/2015_02_25_21_54.mpg;Shinzo ABE.jpg;80937;80949;91169;4050;4051;1
/net/per610a/home/mvp/mvp_db/hodost-lv/2015/2015_02_25_04_56/2015_02_25_21_54.mpg;Natsuo YAMAGUCHI.jpg;73745;74045;91169;3690;3705;15
/net/per610a/home/mvp/mvp_db/hodost-lv/2015/2015_03_03_04_56/2015_03_03_21_54.mpg;Shinzo ABE.jpg;19917;19945;91161;996;998;2
/net/per610a/home/mvp/mvp_db/hodost-lv/2015/2015_03_03_04_56/2015_03_03_21_54.mpg;Shinzo ABE.jpg;78173;78221;91161;3912;3914;2
/net/per610a/home/mvp/mvp_db/hodost-lv/2015/2015_03_03_04_56/2015_03_03_21_54.mpg;Shinzo ABE.jpg;79449;79501;91161;3975;3978;3
/net/per610a/home/mvp/mvp_db/hodost-lv/2015/2015_03_03_04_56/2015_03_03_21_54.mpg;Shinzo ABE.jpg;84753;84901;91161;4241;4248;7
/net/per610a/home/mvp/mvp_db/hodost-lv/2015/2015_03_03_04_56/2015_03_03_21_54.mpg;Yukio EDANO.jpg;20605;20721;91161;1031;1036;5
/net/per610a/home/mvp/mvp_db/hodost-lv/2015/2015_03_05_04_56/2015_03_05_22_09.mpg;Shinzo ABE.jpg;55241;55409;91169;2764;2773;9
/net/per610a/home/mvp/mvp_db/hodost-lv/2015/2015_03_05_04_56/2015_03_05_22_09.mpg;Shinzo ABE.jpg;57625;57689;91169;2884;2887;3
/net/per610a/home/mvp/mvp_db/hodost-lv/2015/2015_03_06_04_56/2015_03_06_21_54.mpg;Shinzo ABE.jpg;17185;17277;91169;860;864;4
/net/per610a/home/mvp/mvp_db/hodost-lv/2015/2015_03_06_04_56/2015_03_06_21_54.mpg;Shinzo ABE.jpg;18573;18697;91169;929;935;6
/net/per610a/home/mvp/mvp_db/hodost-lv/2015/2015_03_08_04_56/2015_03_08_10_00.mpg;Shinzo ABE.jpg;8073;8301;125937;404;415;11
/net/per610a/home/mvp/mvp_db/hodost-lv/2015/2015_03_09_04_56/2015_03_09_21_54.mpg;Shinzo ABE.jpg;19469;19849;91169;974;993;19
/net/per610a/home/mvp/mvp_db/hodost-lv/2015/2015_03_09_04_56/2015_03_09_21_54.mpg;Shinzo ABE.jpg;21081;21093;91169;1055;1055;0
/net/per610a/home/mvp/mvp_db/hodost-lv/2015/2015_03_09_04_56/2015_03_09_21_54.mpg;Shinzo ABE.jpg;26169;26201;91169;1309;1311;2
/net/per610a/home/mvp/mvp_db/hodost-lv/2015/2015_03_09_04_56/2015_03_09_21_54.mpg;Shinzo ABE.jpg;30565;30793;91169;1529;1541;12
/net/per610a/home/mvp/mvp_db/hodost-lv/2015/2015_03_10_04_56/2015_03_10_21_54.mpg;Shinzo ABE.jpg;58405;58477;91169;2923;2926;3
/net/per610a/home/mvp/mvp_db/hodost-lv/2015/2015_03_10_04_56/2015_03_10_21_54.mpg;Shinzo ABE.jpg;59289;59401;91169;2967;2973;6
/net/per610a/home/mvp/mvp_db/hodost-lv/2015/2015_03_11_04_56/2015_03_11_21_54.mpg;Shinzo ABE.jpg;31833;31937;91169;1593;1598;5
/net/per610a/home/mvp/mvp_db/hodost-lv/2015/2015_03_12_04_56/2015_03_12_21_54.mpg;Shinzo ABE.jpg;20125;20369;91169;1007;1019;12
/net/per610a/home/mvp/mvp_db/hodost-lv/2015/2015_03_12_04_56/2015_03_12_21_54.mpg;Shinzo ABE.jpg;24165;24373;91169;1209;1219;10
/net/per610a/home/mvp/mvp_db/hodost-lv/2015/2015_03_13_04_56/2015_03_13_21_54.mpg;Yukio HATOYAMA.jpg;36677;36777;91169;1835;1840;5
/net/per610a/home/mvp/mvp_db/hodost-lv/2015/2015_03_15_04_56/2015_03_15_10_00.mpg;Shinzo ABE.jpg;44837;45397;125929;2243;2271;28
/net/per610a/home/mvp/mvp_db/hodost-lv/2015/2015_03_15_04_56/2015_03_15_10_00.mpg;Shinzo ABE.jpg;46297;46313;125929;2316;2317;1
/net/per610a/home/mvp/mvp_db/hodost-lv/2015/2015_03_15_04_56/2015_03_15_10_00.mpg;Junichiro KOIZUMI.jpg;122069;122177;125929;6108;6114;6
/net/per610a/home/mvp/mvp_db/hodost-lv/2015/2015_03_16_04_56/2015_03_16_21_54.mpg;Shinzo ABE.jpg;46009;46453;91169;2302;2324;22
/net/per610a/home/mvp/mvp_db/hodost-lv/2015/2015_03_16_04_56/2015_03_16_21_54.mpg;Shinzo ABE.jpg;46817;47189;91169;2343;2361;18
/net/per610a/home/mvp/mvp_db/hodost-lv/2015/2015_03_16_04_56/2015_03_16_21_54.mpg;Shinzo ABE.jpg;46461;46793;91169;2325;2341;16
/net/per610a/home/mvp/mvp_db/hodost-lv/2015/2015_03_16_04_56/2015_03_16_21_54.mpg;Shinzo ABE.jpg;49277;49597;91169;2466;2482;16
/net/per610a/home/mvp/mvp_db/hodost-lv/2015/2015_03_17_04_56/2015_03_17_21_54.mpg;Sadakazu TANIGAKI.jpg;12685;12989;91169;634;650;16
/net/per610a/home/mvp/mvp_db/hodost-lv/2015/2015_03_17_04_56/2015_03_17_21_54.mpg;Sadakazu TANIGAKI.jpg;14041;14117;91169;702;706;4
/net/per610a/home/mvp/mvp_db/hodost-lv/2015/2015_03_17_04_56/2015_03_17_21_54.mpg;Shinzo ABE.jpg;37305;37405;91169;1867;1872;5
/net/per610a/home/mvp/mvp_db/hodost-lv/2015/2015_03_19_04_56/2015_03_19_21_54.mpg;Ichiro OZAWA.jpg;60329;60453;91169;3019;3025;6
/net/per610a/home/mvp/mvp_db/hodost-lv/2015/2015_03_20_04_56/2015_03_20_21_54.mpg;Shinzo ABE.jpg;39309;39353;91169;1966;1969;3
/net/per610a/home/mvp/mvp_db/hodost-lv/2015/2015_03_20_04_56/2015_03_20_21_54.mpg;Shinzo ABE.jpg;52109;52249;91169;2607;2614;7
/net/per610a/home/mvp/mvp_db/hodost-lv/2015/2015_03_23_04_56/2015_03_23_21_54.mpg;Sadakazu TANIGAKI.jpg;48633;48657;91161;2433;2434;1
/net/per610a/home/mvp/mvp_db/hodost-lv/2015/2015_03_23_04_56/2015_03_23_21_54.mpg;Sadakazu TANIGAKI.jpg;48965;49049;91161;2450;2454;4
/net/per610a/home/mvp/mvp_db/hodost-lv/2015/2015_03_26_04_56/2015_03_26_21_54.mpg;Ichiro OZAWA.jpg;27425;27513;91169;1372;1377;5
/net/per610a/home/mvp/mvp_db/hodost-lv/2015/2015_03_26_04_56/2015_03_26_21_54.mpg;Ichiro OZAWA.jpg;27737;27845;91169;1388;1393;5
/net/per610a/home/mvp/mvp_db/hodost-lv/2015/2015_03_26_04_56/2015_03_26_21_54.mpg;Shinzo ABE.jpg;29193;29353;91169;1461;1469;8
/net/per610a/home/mvp/mvp_db/hodost-lv/2015/2015_03_26_04_56/2015_03_26_21_54.mpg;Shinzo ABE.jpg;41365;41429;91169;2070;2073;3
/net/per610a/home/mvp/mvp_db/hodost-lv/2015/2015_03_26_04_56/2015_03_26_21_54.mpg;Shinzo ABE.jpg;41661;41965;91169;2085;2100;15
/net/per610a/home/mvp/mvp_db/hodost-lv/2015/2015_03_27_04_56/2015_03_27_21_54.mpg;Yukio EDANO.jpg;39613;39873;91161;1982;1995;13
/net/per610a/home/mvp/mvp_db/hodost-lv/2015/2015_03_29_04_56/2015_03_29_10_00.mpg;Shinzo ABE.jpg;38745;38765;125937;1939;1940;1
/net/per610a/home/mvp/mvp_db/hodost-lv/2015/2015_03_29_04_56/2015_03_29_10_00.mpg;Shinzo ABE.jpg;39029;39037;125937;1953;1953;0
/net/per610a/home/mvp/mvp_db/hodost-lv/2015/2015_03_29_04_56/2015_03_29_10_00.mpg;Shinzo ABE.jpg;39145;39209;125937;1959;1962;3
/net/per610a/home/mvp/mvp_db/hodost-lv/2015/2015_03_30_04_56/2015_03_30_21_54.mpg;Takeo Hiranuma.jpeg;2961;3085;91169;148;154;6
/net/per610a/home/mvp/mvp_db/hodost-lv/2015/2015_03_30_04_56/2015_03_30_21_54.mpg;Takeo Hiranuma.jpeg;7741;8117;91169;387;406;19
/net/per610a/home/mvp/mvp_db/hodost-lv/2015/2015_03_30_04_56/2015_03_30_21_54.mpg;Takeo Hiranuma.jpeg;10365;10837;91169;518;542;24
/net/per610a/home/mvp/mvp_db/hodost-lv/2015/2015_03_30_04_56/2015_03_30_21_54.mpg;Takeo Hiranuma.jpeg;31909;32877;91169;1597;1645;48
/net/per610a/home/mvp/mvp_db/hodost-lv/2015/2015_03_30_04_56/2015_03_30_21_54.mpg;Shinzo ABE.jpg;47481;47593;91169;2376;2382;6
/net/per610a/home/mvp/mvp_db/hodost-lv/2015/2015_03_30_04_56/2015_03_30_21_54.mpg;Shinzo ABE.jpg;85797;85929;91169;4294;4300;6
/net/per610a/home/mvp/mvp_db/hodost-lv/2015/2015_03_31_04_56/2015_03_31_21_54.mpg;Shinzo ABE.jpg;36617;36641;91169;1832;1833;1
/net/per610a/home/mvp/mvp_db/hodost-lv/2015/2015_03_31_04_56/2015_03_31_21_54.mpg;Shinzo ABE.jpg;85289;85397;91169;4268;4274;6
/net/per610a/home/mvp/mvp_db/hodost-lv/2015/2015_04_02_04_56/2015_04_02_21_54.mpg;Shinzo ABE.jpg;5877;6045;91169;294;302;8
/net/per610a/home/mvp/mvp_db/hodost-lv/2015/2015_04_03_04_56/2015_04_03_21_54.mpg;Shinzo ABE.jpg;15585;15769;91169;780;789;9
/net/per610a/home/mvp/mvp_db/hodost-lv/2015/2015_04_03_04_56/2015_04_03_21_54.mpg;Shinzo ABE.jpg;40053;40365;91169;2004;2020;16
/net/per610a/home/mvp/mvp_db/hodost-lv/2015/2015_04_03_04_56/2015_04_03_21_54.mpg;Shinzo ABE.jpg;42961;42969;91169;2150;2150;0
/net/per610a/home/mvp/mvp_db/hodost-lv/2015/2015_04_03_04_56/2015_04_03_21_54.mpg;Shinzo ABE.jpg;43065;43689;91169;2155;2186;31
/net/per610a/home/mvp/mvp_db/hodost-lv/2015/2015_04_08_04_56/2015_04_08_21_54.mpg;Shinzo ABE.jpg;55137;55577;91169;2759;2781;22
/net/per610a/home/mvp/mvp_db/hodost-lv/2015/2015_04_08_04_56/2015_04_08_21_54.mpg;Shinzo ABE.jpg;55749;56033;91169;2790;2804;14
/net/per610a/home/mvp/mvp_db/hodost-lv/2015/2015_04_09_04_56/2015_04_09_21_54.mpg;Shinzo ABE.jpg;46373;46553;91169;2320;2329;9
/net/per610a/home/mvp/mvp_db/hodost-lv/2015/2015_04_09_04_56/2015_04_09_21_54.mpg;Shinzo ABE.jpg;58929;59225;91169;2949;2964;15
/net/per610a/home/mvp/mvp_db/hodost-lv/2015/2015_04_10_04_56/2015_04_10_21_54.mpg;Taro ASO.jpg;23593;23821;91169;1180;1192;12
/net/per610a/home/mvp/mvp_db/hodost-lv/2015/2015_04_13_04_56/2015_04_13_21_54.mpg;Shinzo ABE.jpg;24925;25373;91169;1247;1269;22
/net/per610a/home/mvp/mvp_db/hodost-lv/2015/2015_04_13_04_56/2015_04_13_21_54.mpg;Ichiro Matsui.jpeg;26877;27469;91169;1345;1374;29
/net/per610a/home/mvp/mvp_db/hodost-lv/2015/2015_04_15_04_56/2015_04_15_21_54.mpg;Taro ASO.jpg;52569;52777;91169;2631;2641;10
/net/per610a/home/mvp/mvp_db/hodost-lv/2015/2015_04_17_04_56/2015_04_17_21_54.mpg;Junichiro KOIZUMI.jpg;15133;15845;91169;757;793;36
/net/per610a/home/mvp/mvp_db/hodost-lv/2015/2015_04_19_04_56/2015_04_19_16_30.mpg;Shinzo ABE.jpg;11185;11293;107949;559;565;6
/net/per610a/home/mvp/mvp_db/hodost-lv/2015/2015_04_19_04_56/2015_04_19_16_30.mpg;Shinzo ABE.jpg;11393;11533;107949;570;577;7
/net/per610a/home/mvp/mvp_db/hodost-lv/2015/2015_04_19_04_56/2015_04_19_16_30.mpg;Sadakazu TANIGAKI.jpg;29801;29809;107949;1491;1491;0
/net/per610a/home/mvp/mvp_db/hodost-lv/2015/2015_04_19_04_56/2015_04_19_16_30.mpg;Sadakazu TANIGAKI.jpg;30165;30269;107949;1509;1514;5
/net/per610a/home/mvp/mvp_db/hodost-lv/2015/2015_04_19_04_56/2015_04_19_16_30.mpg;Sadakazu TANIGAKI.jpg;34733;34925;107949;1738;1747;9
/net/per610a/home/mvp/mvp_db/hodost-lv/2015/2015_04_19_04_56/2015_04_19_16_30.mpg;Sadakazu TANIGAKI.jpg;35421;35517;107949;1772;1777;5
/net/per610a/home/mvp/mvp_db/hodost-lv/2015/2015_04_19_04_56/2015_04_19_16_30.mpg;Sadakazu TANIGAKI.jpg;35877;35965;107949;1795;1799;4
/net/per610a/home/mvp/mvp_db/hodost-lv/2015/2015_04_20_04_56/2015_04_20_21_54.mpg;Shinzo ABE.jpg;31733;31909;91169;1588;1597;9
/net/per610a/home/mvp/mvp_db/hodost-lv/2015/2015_04_21_04_56/2015_04_21_21_54.mpg;Shinzo ABE.jpg;34593;34717;91169;1731;1737;6
/net/per610a/home/mvp/mvp_db/hodost-lv/2015/2015_04_21_04_56/2015_04_21_21_54.mpg;Shinzo ABE.jpg;34889;35241;91169;1746;1763;17
/net/per610a/home/mvp/mvp_db/hodost-lv/2015/2015_04_21_04_56/2015_04_21_21_54.mpg;Shinzo ABE.jpg;36581;36669;91169;1830;1835;5
/net/per610a/home/mvp/mvp_db/hodost-lv/2015/2015_04_22_04_56/2015_04_22_21_54.mpg;Shinzo ABE.jpg;16737;16745;91169;837;838;1
/net/per610a/home/mvp/mvp_db/hodost-lv/2015/2015_04_22_04_56/2015_04_22_21_54.mpg;Shinzo ABE.jpg;19469;20241;91169;974;1013;39
/net/per610a/home/mvp/mvp_db/hodost-lv/2015/2015_04_22_04_56/2015_04_22_21_54.mpg;Shinzo ABE.jpg;21417;21489;91169;1071;1075;4
/net/per610a/home/mvp/mvp_db/hodost-lv/2015/2015_04_22_04_56/2015_04_22_21_54.mpg;Shinzo ABE.jpg;22213;22281;91169;1111;1115;4
/net/per610a/home/mvp/mvp_db/hodost-lv/2015/2015_04_22_04_56/2015_04_22_21_54.mpg;Shinzo ABE.jpg;22969;22973;91169;1149;1149;0
/net/per610a/home/mvp/mvp_db/hodost-lv/2015/2015_04_22_04_56/2015_04_22_21_54.mpg;Shinzo ABE.jpg;16961;17009;91169;848;851;3
/net/per610a/home/mvp/mvp_db/hodost-lv/2015/2015_04_22_04_56/2015_04_22_21_54.mpg;Shinzo ABE.jpg;20549;20553;91169;1028;1028;0
/net/per610a/home/mvp/mvp_db/hodost-lv/2015/2015_04_22_04_56/2015_04_22_21_54.mpg;Shinzo ABE.jpg;30485;30553;91169;1525;1529;4
/net/per610a/home/mvp/mvp_db/hodost-lv/2015/2015_04_22_04_56/2015_04_22_21_54.mpg;Shinzo ABE.jpg;22993;23229;91169;1150;1162;12
/net/per610a/home/mvp/mvp_db/hodost-lv/2015/2015_04_22_04_56/2015_04_22_21_54.mpg;Shinzo ABE.jpg;24553;24605;91169;1228;1231;3
/net/per610a/home/mvp/mvp_db/hodost-lv/2015/2015_04_22_04_56/2015_04_22_21_54.mpg;Shinzo ABE.jpg;30745;31065;91169;1538;1554;16
/net/per610a/home/mvp/mvp_db/hodost-lv/2015/2015_04_23_04_56/2015_04_23_21_54.mpg;Shinzo ABE.jpg;31021;31065;91169;1552;1554;2
/net/per610a/home/mvp/mvp_db/hodost-lv/2015/2015_04_23_04_56/2015_04_23_21_54.mpg;Shinzo ABE.jpg;31205;31309;91169;1561;1567;6
/net/per610a/home/mvp/mvp_db/hodost-lv/2015/2015_04_24_04_56/2015_04_24_21_54.mpg;Taro ASO.jpg;53937;54865;91169;2698;2745;47
/net/per610a/home/mvp/mvp_db/hodost-lv/2015/2015_04_26_04_56/2015_04_26_16_30.mpg;Shinzo ABE.jpg;34077;34125;107949;1705;1707;2
/net/per610a/home/mvp/mvp_db/hodost-lv/2015/2015_04_26_04_56/2015_04_26_16_30.mpg;Shinzo ABE.jpg;36941;37029;107949;1848;1853;5
/net/per610a/home/mvp/mvp_db/hodost-lv/2015/2015_04_26_04_56/2015_04_26_16_30.mpg;Shinzo ABE.jpg;43529;43529;107949;2178;2178;0
/net/per610a/home/mvp/mvp_db/hodost-lv/2015/2015_04_26_04_56/2015_04_26_16_30.mpg;Shinzo ABE.jpg;88321;88645;107949;4419;4435;16
/net/per610a/home/mvp/mvp_db/hodost-lv/2015/2015_04_26_04_56/2015_04_26_16_30.mpg;Shinzo ABE.jpg;97781;97833;107949;4893;4895;2
/net/per610a/home/mvp/mvp_db/hodost-lv/2015/2015_04_27_04_56/2015_04_27_21_54.mpg;Natsuo YAMAGUCHI.jpg;27497;27809;91169;1376;1391;15
/net/per610a/home/mvp/mvp_db/hodost-lv/2015/2015_04_27_04_56/2015_04_27_21_54.mpg;Ichiro OZAWA.jpg;40449;40589;91169;2024;2031;7
/net/per610a/home/mvp/mvp_db/hodost-lv/2015/2015_04_28_04_56/2015_04_28_21_54.mpg;Shinzo ABE.jpg;31633;32145;91169;1583;1608;25
/net/per610a/home/mvp/mvp_db/hodost-lv/2015/2015_04_29_04_56/2015_04_29_21_54.mpg;Shinzo ABE.jpg;9269;9281;91169;463;464;1
/net/per610a/home/mvp/mvp_db/hodost-lv/2015/2015_04_29_04_56/2015_04_29_21_54.mpg;Shinzo ABE.jpg;12673;12825;91169;634;641;7
/net/per610a/home/mvp/mvp_db/hodost-lv/2015/2015_04_29_04_56/2015_04_29_21_54.mpg;Shinzo ABE.jpg;13149;13253;91169;658;663;5
/net/per610a/home/mvp/mvp_db/hodost-lv/2015/2015_04_29_04_56/2015_04_29_21_54.mpg;Shinzo ABE.jpg;13421;13433;91169;671;672;1
/net/per610a/home/mvp/mvp_db/hodost-lv/2015/2015_04_29_04_56/2015_04_29_21_54.mpg;Shinzo ABE.jpg;17609;17785;91169;881;890;9
/net/per610a/home/mvp/mvp_db/hodost-lv/2015/2015_04_30_04_56/2015_04_30_21_54.mpg;Shinzo ABE.jpg;18605;18621;91169;931;931;0
/net/per610a/home/mvp/mvp_db/hodost-lv/2015/2015_04_30_04_56/2015_04_30_21_54.mpg;Shinzo ABE.jpg;21949;22069;91169;1098;1104;6
/net/per610a/home/mvp/mvp_db/hodost-lv/2015/2015_04_30_04_56/2015_04_30_21_54.mpg;Shinzo ABE.jpg;24481;24889;91169;1225;1245;20
/net/per610a/home/mvp/mvp_db/hodost-lv/2015/2015_04_30_04_56/2015_04_30_21_54.mpg;Shinzo ABE.jpg;30085;30133;91169;1505;1508;3
/net/per610a/home/mvp/mvp_db/hodost-lv/2015/2015_05_01_04_56/2015_05_01_21_54.mpg;Shinzo ABE.jpg;45153;45337;91169;2259;2268;9
/net/per610a/home/mvp/mvp_db/hodost-lv/2015/2015_05_01_04_56/2015_05_01_21_54.mpg;Shinzo ABE.jpg;45489;45509;91169;2276;2277;1
/net/per610a/home/mvp/mvp_db/hodost-lv/2015/2015_05_03_04_56/2015_05_03_16_30.mpg;Shinzo ABE.jpg;13981;14109;107961;699;706;7
/net/per610a/home/mvp/mvp_db/hodost-lv/2015/2015_05_03_04_56/2015_05_03_16_30.mpg;Shinzo ABE.jpg;14661;14713;107961;733;736;3
/net/per610a/home/mvp/mvp_db/hodost-lv/2015/2015_05_03_04_56/2015_05_03_16_30.mpg;Shinzo ABE.jpg;14849;14917;107961;743;746;3
/net/per610a/home/mvp/mvp_db/hodost-lv/2015/2015_05_03_04_56/2015_05_03_16_30.mpg;Shinzo ABE.jpg;15437;15481;107961;772;774;2
/net/per610a/home/mvp/mvp_db/hodost-lv/2015/2015_05_03_04_56/2015_05_03_16_30.mpg;Shinzo ABE.jpg;17353;17537;107961;868;877;9
/net/per610a/home/mvp/mvp_db/hodost-lv/2015/2015_05_03_04_56/2015_05_03_16_30.mpg;Kazuo SHII.jpg;87385;87513;107961;4373;4379;6
/net/per610a/home/mvp/mvp_db/hodost-lv/2015/2015_05_05_04_56/2015_05_05_21_54.mpg;Shinzo ABE.jpg;1953;2197;91169;97;109;12
/net/per610a/home/mvp/mvp_db/hodost-lv/2015/2015_05_05_04_56/2015_05_05_21_54.mpg;Shinzo ABE.jpg;13409;14045;91169;671;702;31
/net/per610a/home/mvp/mvp_db/hodost-lv/2015/2015_05_05_04_56/2015_05_05_21_54.mpg;Shinzo ABE.jpg;14381;14805;91169;719;740;21
/net/per610a/home/mvp/mvp_db/hodost-lv/2015/2015_05_07_04_56/2015_05_07_21_54.mpg;Shinzo ABE.jpg;23805;23905;91169;1191;1196;5
/net/per610a/home/mvp/mvp_db/hodost-lv/2015/2015_05_07_04_56/2015_05_07_21_54.mpg;Shinzo ABE.jpg;25033;25073;91169;1252;1254;2
/net/per610a/home/mvp/mvp_db/hodost-lv/2015/2015_05_11_04_56/2015_05_11_21_54.mpg;Kohei Otsuka.jpg;77873;77941;91169;3897;3900;3
/net/per610a/home/mvp/mvp_db/hodost-lv/2015/2015_05_11_04_56/2015_05_11_21_54.mpg;Kohei Otsuka.jpg;79897;79905;91169;3998;3999;1
/net/per610a/home/mvp/mvp_db/hodost-lv/2015/2015_05_11_04_56/2015_05_11_21_54.mpg;Kohei Otsuka.jpg;82125;82153;91169;4110;4111;1
/net/per610a/home/mvp/mvp_db/hodost-lv/2015/2015_05_11_04_56/2015_05_11_21_54.mpg;Kohei Otsuka.jpg;84429;84477;91169;4225;4228;3
/net/per610a/home/mvp/mvp_db/hodost-lv/2015/2015_05_11_04_56/2015_05_11_21_54.mpg;Kohei Otsuka.jpg;84797;84925;91169;4244;4250;6
/net/per610a/home/mvp/mvp_db/hodost-lv/2015/2015_05_12_04_56/2015_05_12_21_54.mpg;Shinzo ABE.jpg;50673;50749;91161;2535;2539;4
/net/per610a/home/mvp/mvp_db/hodost-lv/2015/2015_05_14_04_56/2015_05_14_21_54.mpg;Shinzo ABE.jpg;1997;2037;91169;99;101;2
/net/per610a/home/mvp/mvp_db/hodost-lv/2015/2015_05_14_04_56/2015_05_14_21_54.mpg;Shinzo ABE.jpg;3853;5433;91169;192;271;79
/net/per610a/home/mvp/mvp_db/hodost-lv/2015/2015_05_14_04_56/2015_05_14_21_54.mpg;Shinzo ABE.jpg;6293;6297;91169;314;315;1
/net/per610a/home/mvp/mvp_db/hodost-lv/2015/2015_05_14_04_56/2015_05_14_21_54.mpg;Shinzo ABE.jpg;6445;7105;91169;322;355;33
/net/per610a/home/mvp/mvp_db/hodost-lv/2015/2015_05_14_04_56/2015_05_14_21_54.mpg;Shinzo ABE.jpg;7337;7989;91169;367;399;32
/net/per610a/home/mvp/mvp_db/hodost-lv/2015/2015_05_14_04_56/2015_05_14_21_54.mpg;Shinzo ABE.jpg;9541;9653;91169;477;483;6
/net/per610a/home/mvp/mvp_db/hodost-lv/2015/2015_05_14_04_56/2015_05_14_21_54.mpg;Shinzo ABE.jpg;9773;10413;91169;489;521;32
/net/per610a/home/mvp/mvp_db/hodost-lv/2015/2015_05_14_04_56/2015_05_14_21_54.mpg;Shinzo ABE.jpg;22841;22893;91169;1143;1145;2
/net/per610a/home/mvp/mvp_db/hodost-lv/2015/2015_05_14_04_56/2015_05_14_21_54.mpg;Shinzo ABE.jpg;23041;23337;91169;1153;1168;15
/net/per610a/home/mvp/mvp_db/hodost-lv/2015/2015_05_14_04_56/2015_05_14_21_54.mpg;Katsuya OKADA.jpg;8117;9389;91169;406;469;63
/net/per610a/home/mvp/mvp_db/hodost-lv/2015/2015_05_14_04_56/2015_05_14_21_54.mpg;Shinzo ABE.jpg;14697;14821;91169;735;741;6
/net/per610a/home/mvp/mvp_db/hodost-lv/2015/2015_05_15_04_56/2015_05_15_21_54.mpg;Shinzo ABE.jpg;15229;15349;91169;762;768;6
/net/per610a/home/mvp/mvp_db/hodost-lv/2015/2015_05_15_04_56/2015_05_15_21_54.mpg;Toru Hashimoto.jpg;35913;36253;91169;1797;1814;17
/net/per610a/home/mvp/mvp_db/hodost-lv/2015/2015_05_15_04_56/2015_05_15_21_54.mpg;Toru Hashimoto.jpg;40669;40773;91169;2035;2040;5
/net/per610a/home/mvp/mvp_db/hodost-lv/2015/2015_05_15_04_56/2015_05_15_21_54.mpg;Toru Hashimoto.jpg;37577;37877;91169;1880;1895;15
/net/per610a/home/mvp/mvp_db/hodost-lv/2015/2015_05_15_04_56/2015_05_15_21_54.mpg;Toru Hashimoto.jpg;41069;41141;91169;2055;2058;3
/net/per610a/home/mvp/mvp_db/hodost-lv/2015/2015_05_18_04_56/2015_05_18_21_54.mpg;Toranosuke Katayama.jpg;17109;17421;91169;856;871;15
/net/per610a/home/mvp/mvp_db/hodost-lv/2015/2015_05_18_04_56/2015_05_18_21_54.mpg;Toranosuke Katayama.jpg;17677;17745;91169;884;888;4
/net/per610a/home/mvp/mvp_db/hodost-lv/2015/2015_05_18_04_56/2015_05_18_21_54.mpg;Shinzo ABE.jpg;19341;19393;91169;968;970;2
/net/per610a/home/mvp/mvp_db/hodost-lv/2015/2015_05_18_04_56/2015_05_18_21_54.mpg;Shinzo ABE.jpg;19517;19673;91169;976;984;8
/net/per610a/home/mvp/mvp_db/hodost-lv/2015/2015_05_18_04_56/2015_05_18_21_54.mpg;Natsuo YAMAGUCHI.jpg;20737;21089;91169;1037;1055;18
/net/per610a/home/mvp/mvp_db/hodost-lv/2015/2015_05_19_04_56/2015_05_19_21_54.mpg;Ichiro OZAWA.jpg;32693;33105;91169;1636;1656;20
/net/per610a/home/mvp/mvp_db/hodost-lv/2015/2015_05_19_04_56/2015_05_19_21_54.mpg;Yorihisa Matsuno.png;39201;39221;91169;1962;1963;1
/net/per610a/home/mvp/mvp_db/hodost-lv/2015/2015_05_19_04_56/2015_05_19_21_54.mpg;Yorihisa Matsuno.png;39285;39493;91169;1966;1976;10
/net/per610a/home/mvp/mvp_db/hodost-lv/2015/2015_05_19_04_56/2015_05_19_21_54.mpg;Yorihisa Matsuno.png;39517;39625;91169;1977;1983;6
/net/per610a/home/mvp/mvp_db/hodost-lv/2015/2015_05_20_04_56/2015_05_20_21_54.mpg;Natsuo YAMAGUCHI.jpg;70553;70993;91169;3531;3553;22
/net/per610a/home/mvp/mvp_db/hodost-lv/2015/2015_05_21_04_56/2015_05_21_21_54.mpg;Shinzo ABE.jpg;36257;36441;91161;1814;1823;9
/net/per610a/home/mvp/mvp_db/hodost-lv/2015/2015_05_21_04_56/2015_05_21_21_54.mpg;Shinzo ABE.jpg;36785;36877;91161;1840;1845;5
/net/per610a/home/mvp/mvp_db/hodost-lv/2015/2015_05_24_04_56/2015_05_24_16_30.mpg;Shinzo ABE.jpg;31389;31505;107961;1570;1576;6
/net/per610a/home/mvp/mvp_db/hodost-lv/2015/2015_05_24_04_56/2015_05_24_16_30.mpg;Shinzo ABE.jpg;32425;32489;107961;1622;1625;3
/net/per610a/home/mvp/mvp_db/hodost-lv/2015/2015_05_24_04_56/2015_05_24_16_30.mpg;Shinzo ABE.jpg;33173;33181;107961;1660;1660;0
/net/per610a/home/mvp/mvp_db/hodost-lv/2015/2015_05_24_04_56/2015_05_24_16_30.mpg;Shinzo ABE.jpg;33257;33269;107961;1664;1664;0
/net/per610a/home/mvp/mvp_db/hodost-lv/2015/2015_05_24_04_56/2015_05_24_16_30.mpg;Toru Hashimoto.jpg;57669;57833;107961;2886;2894;8
/net/per610a/home/mvp/mvp_db/hodost-lv/2015/2015_05_24_04_56/2015_05_24_16_30.mpg;Toru Hashimoto.jpg;59441;59497;107961;2974;2977;3
/net/per610a/home/mvp/mvp_db/hodost-lv/2015/2015_05_25_04_56/2015_05_25_21_54.mpg;Yukio EDANO.jpg;59385;59889;91169;2972;2997;25
/net/per610a/home/mvp/mvp_db/hodost-lv/2015/2015_05_25_04_56/2015_05_25_21_54.mpg;Yukio EDANO.jpg;60117;60137;91169;3008;3009;1
/net/per610a/home/mvp/mvp_db/hodost-lv/2015/2015_05_26_04_56/2015_05_26_21_54.mpg;Shintaro ISHIHARA.jpg;30485;30581;91169;1525;1530;5
/net/per610a/home/mvp/mvp_db/hodost-lv/2015/2015_05_26_04_56/2015_05_26_21_54.mpg;Akihiro OHTA.jpg;45029;45193;91169;2253;2261;8
/net/per610a/home/mvp/mvp_db/hodost-lv/2015/2015_05_28_04_56/2015_05_28_21_54.mpg;Shinzo ABE.jpg;14637;14721;91169;732;736;4
/net/per610a/home/mvp/mvp_db/hodost-lv/2015/2015_05_28_04_56/2015_05_28_21_54.mpg;Shinzo ABE.jpg;14885;14941;91169;744;747;3
/net/per610a/home/mvp/mvp_db/hodost-lv/2015/2015_05_28_04_56/2015_05_28_21_54.mpg;Shinzo ABE.jpg;15281;15341;91169;764;767;3
/net/per610a/home/mvp/mvp_db/hodost-lv/2015/2015_05_28_04_56/2015_05_28_21_54.mpg;Shinzo ABE.jpg;15869;16285;91169;794;815;21
/net/per610a/home/mvp/mvp_db/hodost-lv/2015/2015_05_28_04_56/2015_05_28_21_54.mpg;Shinzo ABE.jpg;17181;17493;91169;859;875;16
/net/per610a/home/mvp/mvp_db/hodost-lv/2015/2015_05_28_04_56/2015_05_28_21_54.mpg;Shinzo ABE.jpg;17645;17709;91169;883;886;3
/net/per610a/home/mvp/mvp_db/hodost-lv/2015/2015_05_28_04_56/2015_05_28_21_54.mpg;Shinzo ABE.jpg;19081;19189;91169;955;960;5
/net/per610a/home/mvp/mvp_db/hodost-lv/2015/2015_05_31_04_56/2015_05_31_16_30.mpg;Shinzo ABE.jpg;43809;44209;107949;2192;2212;20
/net/per610a/home/mvp/mvp_db/hodost-lv/2015/2015_05_31_04_56/2015_05_31_16_30.mpg;Shinzo ABE.jpg;44905;45053;107949;2247;2254;7
/net/per610a/home/mvp/mvp_db/hodost-lv/2015/2015_05_31_04_56/2015_05_31_16_30.mpg;Shinzo ABE.jpg;45153;45165;107949;2259;2260;1
/net/per610a/home/mvp/mvp_db/hodost-lv/2015/2015_05_31_04_56/2015_05_31_16_30.mpg;Shinzo ABE.jpg;45245;45261;107949;2264;2264;0
/net/per610a/home/mvp/mvp_db/hodost-lv/2015/2015_05_31_04_56/2015_05_31_16_30.mpg;Shinzo ABE.jpg;45757;45941;107949;2289;2298;9
/net/per610a/home/mvp/mvp_db/hodost-lv/2015/2015_05_31_04_56/2015_05_31_16_30.mpg;Shinzo ABE.jpg;47185;47265;107949;2361;2365;4
/net/per610a/home/mvp/mvp_db/hodost-lv/2015/2015_05_31_04_56/2015_05_31_16_30.mpg;Shinzo ABE.jpg;48065;48109;107949;2405;2407;2
/net/per610a/home/mvp/mvp_db/hodost-lv/2015/2015_05_31_04_56/2015_05_31_16_30.mpg;Shinzo ABE.jpg;97829;98069;107949;4895;4907;12
/net/per610a/home/mvp/mvp_db/hodost-lv/2015/2015_06_01_04_56/2015_06_01_21_54.mpg;Shinzo ABE.jpg;16237;16501;91169;812;825;13
/net/per610a/home/mvp/mvp_db/hodost-lv/2015/2015_06_01_04_56/2015_06_01_21_54.mpg;Shinzo ABE.jpg;16773;16813;91169;839;841;2
/net/per610a/home/mvp/mvp_db/hodost-lv/2015/2015_06_01_04_56/2015_06_01_21_54.mpg;Shinzo ABE.jpg;39833;39849;91169;1993;1994;1
/net/per610a/home/mvp/mvp_db/hodost-lv/2015/2015_06_01_04_56/2015_06_01_21_54.mpg;Shinzo ABE.jpg;43257;43369;91169;2165;2170;5
/net/per610a/home/mvp/mvp_db/hodost-lv/2015/2015_06_03_04_56/2015_06_03_21_54.mpg;Yuichiro Tamaki.png;8393;8545;91169;420;427;7
/net/per610a/home/mvp/mvp_db/hodost-lv/2015/2015_06_03_04_56/2015_06_03_21_54.mpg;Yuichiro Tamaki.png;9313;9489;91169;466;474;8
/net/per610a/home/mvp/mvp_db/hodost-lv/2015/2015_06_03_04_56/2015_06_03_21_54.mpg;Yuichiro Tamaki.png;10833;10933;91169;542;547;5
/net/per610a/home/mvp/mvp_db/hodost-lv/2015/2015_06_03_04_56/2015_06_03_21_54.mpg;Yuichiro Tamaki.png;16053;16149;91169;803;808;5
/net/per610a/home/mvp/mvp_db/hodost-lv/2015/2015_06_03_04_56/2015_06_03_21_54.mpg;Yuichiro Tamaki.png;16361;16489;91169;818;825;7
/net/per610a/home/mvp/mvp_db/hodost-lv/2015/2015_06_05_04_56/2015_06_05_21_54.mpg;Shinzo ABE.jpg;85513;85717;91169;4278;4289;11
/net/per610a/home/mvp/mvp_db/hodost-lv/2015/2015_06_07_04_56/2015_06_07_16_30.mpg;Shinzo ABE.jpg;13493;13541;107949;675;677;2
/net/per610a/home/mvp/mvp_db/hodost-lv/2015/2015_06_07_04_56/2015_06_07_16_30.mpg;Shinzo ABE.jpg;75937;76053;107949;3800;3805;5
/net/per610a/home/mvp/mvp_db/hodost-lv/2015/2015_06_07_04_56/2015_06_07_16_30.mpg;Shinzo ABE.jpg;76153;76261;107949;3810;3816;6
/net/per610a/home/mvp/mvp_db/hodost-lv/2015/2015_06_08_04_56/2015_06_08_21_54.mpg;Shinzo ABE.jpg;43961;44273;91169;2200;2215;15
/net/per610a/home/mvp/mvp_db/hodost-lv/2015/2015_06_09_04_56/2015_06_09_21_54.mpg;Shinzo ABE.jpg;36353;36693;91161;1819;1836;17
/net/per610a/home/mvp/mvp_db/hodost-lv/2015/2015_06_09_04_56/2015_06_09_21_54.mpg;Shinzo ABE.jpg;40697;40745;91161;2036;2039;3
/net/per610a/home/mvp/mvp_db/hodost-lv/2015/2015_06_12_04_56/2015_06_12_21_54.mpg;Shinzo ABE.jpg;1877;1885;91169;93;94;1
/net/per610a/home/mvp/mvp_db/hodost-lv/2015/2015_06_12_04_56/2015_06_12_21_54.mpg;Shinzo ABE.jpg;2445;2577;91169;122;128;6
/net/per610a/home/mvp/mvp_db/hodost-lv/2015/2015_06_12_04_56/2015_06_12_21_54.mpg;Shinzo ABE.jpg;10013;10245;91169;501;512;11
/net/per610a/home/mvp/mvp_db/hodost-lv/2015/2015_06_12_04_56/2015_06_12_21_54.mpg;Shinzo ABE.jpg;1977;1977;91169;98;98;0
/net/per610a/home/mvp/mvp_db/hodost-lv/2015/2015_06_12_04_56/2015_06_12_21_54.mpg;Shinzo ABE.jpg;10253;10257;91169;513;513;0
/net/per610a/home/mvp/mvp_db/hodost-lv/2015/2015_06_12_04_56/2015_06_12_21_54.mpg;Shinzo ABE.jpg;11989;12141;91169;599;607;8
/net/per610a/home/mvp/mvp_db/hodost-lv/2015/2015_06_12_04_56/2015_06_12_21_54.mpg;Shinzo ABE.jpg;37633;37833;91169;1883;1893;10
/net/per610a/home/mvp/mvp_db/hodost-lv/2015/2015_06_12_04_56/2015_06_12_21_54.mpg;Sadakazu TANIGAKI.jpg;14293;14533;91169;715;727;12
/net/per610a/home/mvp/mvp_db/hodost-lv/2015/2015_06_12_04_56/2015_06_12_21_54.mpg;Shizuka KAMEI.jpg;18909;19409;91169;946;971;25
/net/per610a/home/mvp/mvp_db/hodost-lv/2015/2015_06_12_04_56/2015_06_12_21_54.mpg;Shizuka KAMEI.jpg;19605;20729;91169;981;1037;56
/net/per610a/home/mvp/mvp_db/hodost-lv/2015/2015_06_14_04_56/2015_06_14_16_30.mpg;Toru Hashimoto.jpg;88285;88413;107949;4417;4424;7
/net/per610a/home/mvp/mvp_db/hodost-lv/2015/2015_06_14_04_56/2015_06_14_16_30.mpg;Toru Hashimoto.jpg;89381;89577;107949;4472;4482;10
/net/per610a/home/mvp/mvp_db/hodost-lv/2015/2015_06_15_04_56/2015_06_15_21_54.mpg;Sadakazu TANIGAKI.jpg;27505;27669;91169;1376;1384;8
/net/per610a/home/mvp/mvp_db/hodost-lv/2015/2015_06_16_04_56/2015_06_16_21_37.mpg;Masashi Nakano.jpg;67369;67417;111549;3371;3374;3
/net/per610a/home/mvp/mvp_db/hodost-lv/2015/2015_06_16_04_56/2015_06_16_21_37.mpg;Masashi Nakano.jpg;70301;70593;111549;3518;3533;15
/net/per610a/home/mvp/mvp_db/hodost-lv/2015/2015_06_16_04_56/2015_06_16_21_37.mpg;Masashi Nakano.jpg;70725;70857;111549;3539;3546;7
/net/per610a/home/mvp/mvp_db/hodost-lv/2015/2015_06_16_04_56/2015_06_16_21_37.mpg;Masashi Nakano.jpg;71101;71661;111549;3558;3586;28
/net/per610a/home/mvp/mvp_db/hodost-lv/2015/2015_06_17_04_56/2015_06_17_21_54.mpg;Shinzo ABE.jpg;15937;16573;91169;797;829;32
/net/per610a/home/mvp/mvp_db/hodost-lv/2015/2015_06_17_04_56/2015_06_17_21_54.mpg;Shinzo ABE.jpg;16941;17213;91169;847;861;14
/net/per610a/home/mvp/mvp_db/hodost-lv/2015/2015_06_17_04_56/2015_06_17_21_54.mpg;Shinzo ABE.jpg;17581;17617;91169;879;881;2
/net/per610a/home/mvp/mvp_db/hodost-lv/2015/2015_06_17_04_56/2015_06_17_21_54.mpg;Shinzo ABE.jpg;17697;17709;91169;885;886;1
/net/per610a/home/mvp/mvp_db/hodost-lv/2015/2015_06_17_04_56/2015_06_17_21_54.mpg;Shinzo ABE.jpg;17841;18017;91169;892;901;9
/net/per610a/home/mvp/mvp_db/hodost-lv/2015/2015_06_17_04_56/2015_06_17_21_54.mpg;Shinzo ABE.jpg;18121;18337;91169;906;917;11
/net/per610a/home/mvp/mvp_db/hodost-lv/2015/2015_06_17_04_56/2015_06_17_21_54.mpg;Shinzo ABE.jpg;18573;18649;91169;929;933;4
/net/per610a/home/mvp/mvp_db/hodost-lv/2015/2015_06_17_04_56/2015_06_17_21_54.mpg;Shinzo ABE.jpg;19193;19277;91169;960;964;4
/net/per610a/home/mvp/mvp_db/hodost-lv/2015/2015_06_17_04_56/2015_06_17_21_54.mpg;Shinzo ABE.jpg;19377;19581;91169;969;980;11
/net/per610a/home/mvp/mvp_db/hodost-lv/2015/2015_06_17_04_56/2015_06_17_21_54.mpg;Shinzo ABE.jpg;19701;19781;91169;986;990;4
/net/per610a/home/mvp/mvp_db/hodost-lv/2015/2015_06_17_04_56/2015_06_17_21_54.mpg;Shinzo ABE.jpg;20633;20757;91169;1032;1038;6
/net/per610a/home/mvp/mvp_db/hodost-lv/2015/2015_06_17_04_56/2015_06_17_21_54.mpg;Shinzo ABE.jpg;20981;20981;91169;1050;1050;0
/net/per610a/home/mvp/mvp_db/hodost-lv/2015/2015_06_17_04_56/2015_06_17_21_54.mpg;Shinzo ABE.jpg;22045;22177;91169;1103;1109;6
/net/per610a/home/mvp/mvp_db/hodost-lv/2015/2015_06_17_04_56/2015_06_17_21_54.mpg;Shinzo ABE.jpg;23101;23257;91169;1156;1164;8
/net/per610a/home/mvp/mvp_db/hodost-lv/2015/2015_06_17_04_56/2015_06_17_21_54.mpg;Shinzo ABE.jpg;23969;23981;91169;1199;1200;1
/net/per610a/home/mvp/mvp_db/hodost-lv/2015/2015_06_19_04_56/2015_06_19_21_54.mpg;Shinzo ABE.jpg;21957;22101;91169;1098;1105;7
/net/per610a/home/mvp/mvp_db/hodost-lv/2015/2015_06_19_04_56/2015_06_19_21_54.mpg;Shinzo ABE.jpg;23825;23921;91169;1192;1196;4
/net/per610a/home/mvp/mvp_db/hodost-lv/2015/2015_06_19_04_56/2015_06_19_21_54.mpg;Shinzo ABE.jpg;40781;40825;91169;2040;2042;2
/net/per610a/home/mvp/mvp_db/hodost-lv/2015/2015_06_21_04_56/2015_06_21_16_30.mpg;Masashi Nakano.jpg;53845;53957;107949;2694;2700;6
/net/per610a/home/mvp/mvp_db/hodost-lv/2015/2015_06_21_04_56/2015_06_21_16_30.mpg;Masashi Nakano.jpg;54837;54857;107949;2744;2745;1
/net/per610a/home/mvp/mvp_db/hodost-lv/2015/2015_06_21_04_56/2015_06_21_16_30.mpg;Masashi Nakano.jpg;55401;55425;107949;2772;2773;1
/net/per610a/home/mvp/mvp_db/hodost-lv/2015/2015_06_22_04_56/2015_06_22_21_54.mpg;Shinzo ABE.jpg;15353;15453;91169;768;773;5
/net/per610a/home/mvp/mvp_db/hodost-lv/2015/2015_06_22_04_56/2015_06_22_21_54.mpg;Shinzo ABE.jpg;15925;15977;91169;797;799;2
/net/per610a/home/mvp/mvp_db/hodost-lv/2015/2015_06_22_04_56/2015_06_22_21_54.mpg;Shinzo ABE.jpg;16365;16769;91169;819;839;20
/net/per610a/home/mvp/mvp_db/hodost-lv/2015/2015_06_22_04_56/2015_06_22_21_54.mpg;Shinzo ABE.jpg;23141;23229;91169;1158;1162;4
/net/per610a/home/mvp/mvp_db/hodost-lv/2015/2015_06_22_04_56/2015_06_22_21_54.mpg;Shinzo ABE.jpg;25233;25261;91169;1262;1264;2
/net/per610a/home/mvp/mvp_db/hodost-lv/2015/2015_06_22_04_56/2015_06_22_21_54.mpg;Shinzo ABE.jpg;27965;28037;91169;1399;1403;4
/net/per610a/home/mvp/mvp_db/hodost-lv/2015/2015_06_22_04_56/2015_06_22_21_54.mpg;Shinzo ABE.jpg;28449;28749;91169;1423;1438;15
/net/per610a/home/mvp/mvp_db/hodost-lv/2015/2015_06_22_04_56/2015_06_22_21_54.mpg;Yorihisa Matsuno.png;29661;30193;91169;1484;1511;27
/net/per610a/home/mvp/mvp_db/hodost-lv/2015/2015_06_22_04_56/2015_06_22_21_54.mpg;Natsuo YAMAGUCHI.jpg;69557;69597;91169;3481;3483;2
/net/per610a/home/mvp/mvp_db/hodost-lv/2015/2015_06_22_04_56/2015_06_22_21_54.mpg;Natsuo YAMAGUCHI.jpg;69801;70029;91169;3493;3504;11
/net/per610a/home/mvp/mvp_db/hodost-lv/2015/2015_06_23_04_56/2015_06_23_21_54.mpg;Shinzo ABE.jpg;16349;16889;91169;818;845;27
/net/per610a/home/mvp/mvp_db/hodost-lv/2015/2015_06_23_04_56/2015_06_23_21_54.mpg;Shinzo ABE.jpg;63901;64025;91169;3198;3204;6
/net/per610a/home/mvp/mvp_db/hodost-lv/2015/2015_06_23_04_56/2015_06_23_21_54.mpg;Shinzo ABE.jpg;64157;64193;91169;3211;3212;1
/net/per610a/home/mvp/mvp_db/hodost-lv/2015/2015_06_24_04_56/2015_06_24_21_54.mpg;Shinzo ABE.jpg;47585;47789;91169;2381;2391;10
/net/per610a/home/mvp/mvp_db/hodost-lv/2015/2015_06_25_04_56/2015_06_25_21_54.mpg;Shinzo ABE.jpg;47241;47309;91169;2364;2367;3
/net/per610a/home/mvp/mvp_db/hodost-lv/2015/2015_06_25_04_56/2015_06_25_21_54.mpg;Shinzo ABE.jpg;52033;52201;91169;2604;2612;8
/net/per610a/home/mvp/mvp_db/hodost-lv/2015/2015_06_26_04_56/2015_06_26_21_54.mpg;Shinzo ABE.jpg;19913;20061;91169;996;1004;8
/net/per610a/home/mvp/mvp_db/hodost-lv/2015/2015_06_26_04_56/2015_06_26_21_54.mpg;Shinzo ABE.jpg;24321;24393;91169;1217;1220;3
/net/per610a/home/mvp/mvp_db/hodost-lv/2015/2015_06_30_04_56/2015_06_30_21_54.mpg;Shinzo ABE.jpg;16565;16649;91169;829;833;4
/net/per610a/home/mvp/mvp_db/hodost-lv/2015/2015_06_30_04_56/2015_06_30_21_54.mpg;Shinzo ABE.jpg;42413;42537;91169;2122;2128;6
/net/per610a/home/mvp/mvp_db/hodost-lv/2015/2015_06_28_04_56/2015_06_28_16_30.mpg;Sadakazu TANIGAKI.jpg;9277;9337;107961;464;467;3
/net/per610a/home/mvp/mvp_db/hodost-lv/2015/2015_06_28_04_56/2015_06_28_16_30.mpg;Sadakazu TANIGAKI.jpg;14057;14113;107961;703;706;3
/net/per610a/home/mvp/mvp_db/hodost-lv/2015/2015_07_01_04_56/2015_07_01_21_54.mpg;Shinzo ABE.jpg;27969;28257;91169;1399;1414;15
/net/per610a/home/mvp/mvp_db/hodost-lv/2015/2015_07_02_04_56/2015_07_02_21_54.mpg;Kenji Eda.jpg;41201;41445;91169;2062;2074;12
/net/per610a/home/mvp/mvp_db/hodost-lv/2015/2015_07_03_04_56/2015_07_03_21_54.mpg;Shinzo ABE.jpg;2093;2189;91169;104;109;5
/net/per610a/home/mvp/mvp_db/hodost-lv/2015/2015_07_03_04_56/2015_07_03_21_54.mpg;Shinzo ABE.jpg;12485;12901;91169;624;645;21
/net/per610a/home/mvp/mvp_db/hodost-lv/2015/2015_07_03_04_56/2015_07_03_21_54.mpg;Shinzo ABE.jpg;25637;25725;91169;1283;1287;4
/net/per610a/home/mvp/mvp_db/hodost-lv/2015/2015_07_03_04_56/2015_07_03_21_54.mpg;Shinzo ABE.jpg;27657;27821;91169;1384;1392;8
/net/per610a/home/mvp/mvp_db/hodost-lv/2015/2015_07_06_04_56/2015_07_06_21_54.mpg;Shinzo ABE.jpg;42057;42137;91169;2104;2108;4
/net/per610a/home/mvp/mvp_db/hodost-lv/2015/2015_07_07_04_56/2015_07_07_21_54.mpg;Toranosuke Katayama.jpg;51541;51621;91169;2579;2583;4
/net/per610a/home/mvp/mvp_db/hodost-lv/2015/2015_07_07_04_56/2015_07_07_21_54.mpg;Yorihisa Matsuno.png;51861;51961;91169;2595;2600;5
/net/per610a/home/mvp/mvp_db/hodost-lv/2015/2015_07_08_04_56/2015_07_08_21_54.mpg;Shinzo ABE.jpg;50673;50829;91169;2536;2543;7
/net/per610a/home/mvp/mvp_db/hodost-lv/2015/2015_07_08_04_56/2015_07_08_21_54.mpg;Shinzo ABE.jpg;52981;53017;91169;2651;2653;2
/net/per610a/home/mvp/mvp_db/hodost-lv/2015/2015_07_08_04_56/2015_07_08_21_54.mpg;Shinzo ABE.jpg;55397;55409;91169;2772;2773;1
/net/per610a/home/mvp/mvp_db/hodost-lv/2015/2015_07_10_04_56/2015_07_10_21_54.mpg;Shinzo ABE.jpg;15181;15257;91169;759;763;4
/net/per610a/home/mvp/mvp_db/hodost-lv/2015/2015_07_10_04_56/2015_07_10_21_54.mpg;Shinzo ABE.jpg;15821;16037;91169;791;802;11
/net/per610a/home/mvp/mvp_db/hodost-lv/2015/2015_07_10_04_56/2015_07_10_21_54.mpg;Shinzo ABE.jpg;18233;18293;91169;912;915;3
/net/per610a/home/mvp/mvp_db/hodost-lv/2015/2015_07_10_04_56/2015_07_10_21_54.mpg;Shinzo ABE.jpg;20173;20237;91169;1009;1012;3
/net/per610a/home/mvp/mvp_db/hodost-lv/2015/2015_07_10_04_56/2015_07_10_21_54.mpg;Shinzo ABE.jpg;24605;24669;91169;1231;1234;3
/net/per610a/home/mvp/mvp_db/hodost-lv/2015/2015_07_12_04_56/2015_07_12_16_30.mpg;Shinzo ABE.jpg;28361;28789;107949;1419;1440;21
/net/per610a/home/mvp/mvp_db/hodost-lv/2015/2015_07_12_04_56/2015_07_12_16_30.mpg;Shinzo ABE.jpg;28929;29169;107949;1447;1459;12
/net/per610a/home/mvp/mvp_db/hodost-lv/2015/2015_07_12_04_56/2015_07_12_16_30.mpg;Shinzo ABE.jpg;31637;31733;107949;1583;1587;4
/net/per610a/home/mvp/mvp_db/hodost-lv/2015/2015_07_12_04_56/2015_07_12_16_30.mpg;Shinzo ABE.jpg;31809;31881;107949;1591;1595;4
/net/per610a/home/mvp/mvp_db/hodost-lv/2015/2015_07_14_04_56/2015_07_14_21_54.mpg;Shinzo ABE.jpg;12817;12921;91161;641;646;5
/net/per610a/home/mvp/mvp_db/hodost-lv/2015/2015_07_14_04_56/2015_07_14_21_54.mpg;Shinzo ABE.jpg;13069;13237;91161;654;662;8
/net/per610a/home/mvp/mvp_db/hodost-lv/2015/2015_07_14_04_56/2015_07_14_21_54.mpg;Shinzo ABE.jpg;13473;13549;91161;674;678;4
/net/per610a/home/mvp/mvp_db/hodost-lv/2015/2015_07_14_04_56/2015_07_14_21_54.mpg;Shinzo ABE.jpg;13685;13701;91161;684;685;1
/net/per610a/home/mvp/mvp_db/hodost-lv/2015/2015_07_14_04_56/2015_07_14_21_54.mpg;Shinzo ABE.jpg;14437;14449;91161;722;723;1
/net/per610a/home/mvp/mvp_db/hodost-lv/2015/2015_07_14_04_56/2015_07_14_21_54.mpg;Ichiro OZAWA.jpg;43197;43857;91161;2161;2194;33
/net/per610a/home/mvp/mvp_db/hodost-lv/2015/2015_07_15_04_56/2015_07_15_22_24.mpg;Shinzo ABE.jpg;13177;13253;91169;659;663;4
/net/per610a/home/mvp/mvp_db/hodost-lv/2015/2015_07_15_04_56/2015_07_15_22_24.mpg;Shinzo ABE.jpg;45769;45865;91169;2290;2295;5
/net/per610a/home/mvp/mvp_db/hodost-lv/2015/2015_07_15_04_56/2015_07_15_22_24.mpg;Shinzo ABE.jpg;16165;16177;91169;809;809;0
/net/per610a/home/mvp/mvp_db/hodost-lv/2015/2015_07_15_04_56/2015_07_15_22_24.mpg;Shinzo ABE.jpg;16293;16293;91169;815;815;0
/net/per610a/home/mvp/mvp_db/hodost-lv/2015/2015_07_15_04_56/2015_07_15_22_24.mpg;Shinzo ABE.jpg;16801;17209;91169;840;861;21
/net/per610a/home/mvp/mvp_db/hodost-lv/2015/2015_07_15_04_56/2015_07_15_22_24.mpg;Shinzo ABE.jpg;17597;18077;91169;880;904;24
/net/per610a/home/mvp/mvp_db/hodost-lv/2015/2015_07_15_04_56/2015_07_15_22_24.mpg;Shinzo ABE.jpg;33021;33293;91169;1652;1666;14
/net/per610a/home/mvp/mvp_db/hodost-lv/2015/2015_07_15_04_56/2015_07_15_22_24.mpg;Shinzo ABE.jpg;32909;33013;91169;1647;1652;5
/net/per610a/home/mvp/mvp_db/hodost-lv/2015/2015_07_16_04_56/2015_07_16_21_54.mpg;Shinzo ABE.jpg;7713;8797;91161;385;440;55
/net/per610a/home/mvp/mvp_db/hodost-lv/2015/2015_07_16_04_56/2015_07_16_21_54.mpg;Shinzo ABE.jpg;9193;9697;91161;460;485;25
/net/per610a/home/mvp/mvp_db/hodost-lv/2015/2015_07_16_04_56/2015_07_16_21_54.mpg;Shinzo ABE.jpg;11497;12129;91161;575;606;31
/net/per610a/home/mvp/mvp_db/hodost-lv/2015/2015_07_16_04_56/2015_07_16_21_54.mpg;Shinzo ABE.jpg;18761;18765;91161;938;939;1
/net/per610a/home/mvp/mvp_db/hodost-lv/2015/2015_07_16_04_56/2015_07_16_21_54.mpg;Shinzo ABE.jpg;69629;69733;91161;3484;3489;5
/net/per610a/home/mvp/mvp_db/hodost-lv/2015/2015_07_19_04_56/2015_07_19_16_30.mpg;Shinzo ABE.jpg;6873;6953;107949;343;347;4
/net/per610a/home/mvp/mvp_db/hodost-lv/2015/2015_07_19_04_56/2015_07_19_16_30.mpg;Shinzo ABE.jpg;15781;15865;107949;789;793;4
/net/per610a/home/mvp/mvp_db/hodost-lv/2015/2015_07_19_04_56/2015_07_19_16_30.mpg;Shinzo ABE.jpg;18201;18229;107949;910;912;2
/net/per610a/home/mvp/mvp_db/hodost-lv/2015/2015_07_19_04_56/2015_07_19_16_30.mpg;Shinzo ABE.jpg;10269;10505;107949;513;525;12
/net/per610a/home/mvp/mvp_db/hodost-lv/2015/2015_07_19_04_56/2015_07_19_16_30.mpg;Shinzo ABE.jpg;16977;17077;107949;849;854;5
/net/per610a/home/mvp/mvp_db/hodost-lv/2015/2015_07_19_04_56/2015_07_19_16_30.mpg;Shinzo ABE.jpg;17229;17525;107949;862;876;14
/net/per610a/home/mvp/mvp_db/hodost-lv/2015/2015_07_19_04_56/2015_07_19_16_30.mpg;Shinzo ABE.jpg;17669;17837;107949;884;892;8
/net/per610a/home/mvp/mvp_db/hodost-lv/2015/2015_07_19_04_56/2015_07_19_16_30.mpg;Shinzo ABE.jpg;18497;18621;107949;925;931;6
/net/per610a/home/mvp/mvp_db/hodost-lv/2015/2015_07_19_04_56/2015_07_19_16_30.mpg;Sadakazu TANIGAKI.jpg;14153;14585;107949;708;729;21
/net/per610a/home/mvp/mvp_db/hodost-lv/2015/2015_07_20_04_56/2015_07_20_21_54.mpg;Shinzo ABE.jpg;26877;26993;91169;1345;1350;5
/net/per610a/home/mvp/mvp_db/hodost-lv/2015/2015_07_20_04_56/2015_07_20_21_54.mpg;Shinzo ABE.jpg;41405;41521;91169;2072;2078;6
/net/per610a/home/mvp/mvp_db/hodost-lv/2015/2015_07_20_04_56/2015_07_20_21_54.mpg;Shinzo ABE.jpg;27177;27453;91169;1360;1374;14
/net/per610a/home/mvp/mvp_db/hodost-lv/2015/2015_07_21_04_56/2015_07_21_21_54.mpg;Shinzo ABE.jpg;45609;45657;91169;2282;2285;3
/net/per610a/home/mvp/mvp_db/hodost-lv/2015/2015_07_21_04_56/2015_07_21_21_54.mpg;Shinzo ABE.jpg;53177;53281;91169;2661;2666;5
/net/per610a/home/mvp/mvp_db/hodost-lv/2015/2015_07_24_04_56/2015_07_24_21_54.mpg;Natsuo YAMAGUCHI.jpg;16809;17369;91169;841;869;28
/net/per610a/home/mvp/mvp_db/hodost-lv/2015/2015_07_24_04_56/2015_07_24_21_54.mpg;Natsuo YAMAGUCHI.jpg;22121;22461;91169;1106;1123;17
/net/per610a/home/mvp/mvp_db/hodost-lv/2015/2015_07_26_04_56/2015_07_26_16_30.mpg;Shinzo ABE.jpg;61985;62377;107949;3101;3121;20
/net/per610a/home/mvp/mvp_db/hodost-lv/2015/2015_07_26_04_56/2015_07_26_16_30.mpg;Shinzo ABE.jpg;62737;63125;107949;3139;3158;19
/net/per610a/home/mvp/mvp_db/hodost-lv/2015/2015_07_27_04_56/2015_07_27_21_54.mpg;Shinzo ABE.jpg;26005;26157;91169;1301;1309;8
/net/per610a/home/mvp/mvp_db/hodost-lv/2015/2015_07_27_04_56/2015_07_27_21_54.mpg;Kohei Otsuka.jpg;72549;72605;91169;3631;3633;2
/net/per610a/home/mvp/mvp_db/hodost-lv/2015/2015_07_27_04_56/2015_07_27_21_54.mpg;Kohei Otsuka.jpg;85153;85233;91169;4261;4265;4
/net/per610a/home/mvp/mvp_db/hodost-lv/2015/2015_07_27_04_56/2015_07_27_21_54.mpg;Kohei Otsuka.jpg;85777;85889;91169;4293;4298;5
/net/per610a/home/mvp/mvp_db/hodost-lv/2015/2015_07_28_04_56/2015_07_28_21_54.mpg;Shinzo ABE.jpg;28573;29245;91169;1430;1463;33
/net/per610a/home/mvp/mvp_db/hodost-lv/2015/2015_07_28_04_56/2015_07_28_21_54.mpg;Natsuo YAMAGUCHI.jpg;51245;51429;91169;2564;2574;10
/net/per610a/home/mvp/mvp_db/hodost-lv/2015/2015_07_29_04_56/2015_07_29_21_54.mpg;Shinzo ABE.jpg;24813;24813;91169;1241;1241;0
/net/per610a/home/mvp/mvp_db/hodost-lv/2015/2015_07_29_04_56/2015_07_29_21_54.mpg;Shinzo ABE.jpg;24881;25841;91169;1245;1293;48
/net/per610a/home/mvp/mvp_db/hodost-lv/2015/2015_07_29_04_56/2015_07_29_21_54.mpg;Shinzo ABE.jpg;26669;26761;91169;1334;1339;5
/net/per610a/home/mvp/mvp_db/hodost-lv/2015/2015_07_29_04_56/2015_07_29_21_54.mpg;Shinzo ABE.jpg;26833;27397;91169;1342;1371;29
/net/per610a/home/mvp/mvp_db/hodost-lv/2015/2015_07_29_04_56/2015_07_29_21_54.mpg;Shinzo ABE.jpg;27637;27845;91169;1383;1393;10
/net/per610a/home/mvp/mvp_db/hodost-lv/2015/2015_07_29_04_56/2015_07_29_21_54.mpg;Shinzo ABE.jpg;27937;28313;91169;1398;1417;19
/net/per610a/home/mvp/mvp_db/hodost-lv/2015/2015_07_30_04_56/2015_07_30_21_54.mpg;Shinzo ABE.jpg;28029;28177;91169;1402;1410;8
/net/per610a/home/mvp/mvp_db/hodost-lv/2015/2015_07_30_04_56/2015_07_30_21_54.mpg;Shinzo ABE.jpg;28601;28697;91169;1431;1436;5
/net/per610a/home/mvp/mvp_db/hodost-lv/2015/2015_07_30_04_56/2015_07_30_21_54.mpg;Shinzo ABE.jpg;29061;29309;91169;1454;1466;12
/net/per610a/home/mvp/mvp_db/hodost-lv/2015/2015_07_30_04_56/2015_07_30_21_54.mpg;Shinzo ABE.jpg;29709;29781;91169;1486;1490;4
/net/per610a/home/mvp/mvp_db/hodost-lv/2015/2015_07_30_04_56/2015_07_30_21_54.mpg;Shinzo ABE.jpg;30605;30745;91169;1531;1538;7
/net/per610a/home/mvp/mvp_db/hodost-lv/2015/2015_07_30_04_56/2015_07_30_21_54.mpg;Shinzo ABE.jpg;32753;33001;91169;1639;1651;12
/net/per610a/home/mvp/mvp_db/hodost-lv/2015/2015_07_31_04_56/2015_07_31_21_54.mpg;Shinzo ABE.jpg;30485;30565;91169;1525;1529;4
/net/per610a/home/mvp/mvp_db/hodost-lv/2015/2015_07_31_04_56/2015_07_31_21_54.mpg;Shinzo ABE.jpg;34889;34961;91169;1745;1749;4
/net/per610a/home/mvp/mvp_db/hodost-lv/2015/2015_08_02_04_56/2015_08_02_16_30.mpg;Shinzo ABE.jpg;54797;54925;107961;2742;2748;6
/net/per610a/home/mvp/mvp_db/hodost-lv/2015/2015_08_03_04_56/2015_08_03_21_54.mpg;Yukio EDANO.jpg;1677;1849;91169;83;92;9
/net/per610a/home/mvp/mvp_db/hodost-lv/2015/2015_08_03_04_56/2015_08_03_21_54.mpg;Shinzo ABE.jpg;14029;14121;91169;702;706;4
/net/per610a/home/mvp/mvp_db/hodost-lv/2015/2015_08_06_04_56/2015_08_06_21_54.mpg;Shinzo ABE.jpg;9861;10561;91169;493;528;35
/net/per610a/home/mvp/mvp_db/hodost-lv/2015/2015_08_06_04_56/2015_08_06_21_54.mpg;Shinzo ABE.jpg;50929;50989;91169;2548;2551;3
/net/per610a/home/mvp/mvp_db/hodost-lv/2015/2015_08_06_04_56/2015_08_06_21_54.mpg;Shinzo ABE.jpg;51117;51477;91169;2558;2576;18
/net/per610a/home/mvp/mvp_db/hodost-lv/2015/2015_08_06_04_56/2015_08_06_21_54.mpg;Shinzo ABE.jpg;10877;11137;91169;544;557;13
/net/per610a/home/mvp/mvp_db/hodost-lv/2015/2015_08_06_04_56/2015_08_06_21_54.mpg;Shinzo ABE.jpg;46541;46601;91169;2329;2332;3
/net/per610a/home/mvp/mvp_db/hodost-lv/2015/2015_08_06_04_56/2015_08_06_21_54.mpg;Shinzo ABE.jpg;50005;50025;91169;2502;2503;1
/net/per610a/home/mvp/mvp_db/hodost-lv/2015/2015_08_06_04_56/2015_08_06_21_54.mpg;Renho.jpg;11701;12213;91169;585;611;26
/net/per610a/home/mvp/mvp_db/hodost-lv/2015/2015_08_07_04_56/2015_08_07_21_54.mpg;Shinzo ABE.jpg;17289;17441;91169;865;872;7
/net/per610a/home/mvp/mvp_db/hodost-lv/2015/2015_08_07_04_56/2015_08_07_21_54.mpg;Shinzo ABE.jpg;17553;17633;91169;878;882;4
/net/per610a/home/mvp/mvp_db/hodost-lv/2015/2015_08_07_04_56/2015_08_07_21_54.mpg;Shinzo ABE.jpg;17953;17997;91169;898;900;2
/net/per610a/home/mvp/mvp_db/hodost-lv/2015/2015_08_07_04_56/2015_08_07_21_54.mpg;Shinzo ABE.jpg;23673;23821;91169;1184;1191;7
/net/per610a/home/mvp/mvp_db/hodost-lv/2015/2015_08_07_04_56/2015_08_07_21_54.mpg;Shinzo ABE.jpg;25313;25345;91169;1266;1268;2
/net/per610a/home/mvp/mvp_db/hodost-lv/2015/2015_08_07_04_56/2015_08_07_21_54.mpg;Shinzo ABE.jpg;26225;26317;91169;1312;1316;4
/net/per610a/home/mvp/mvp_db/hodost-lv/2015/2015_08_07_04_56/2015_08_07_21_54.mpg;Shinzo ABE.jpg;26469;26509;91169;1324;1326;2
/net/per610a/home/mvp/mvp_db/hodost-lv/2015/2015_08_07_04_56/2015_08_07_21_54.mpg;Shinzo ABE.jpg;26637;26689;91169;1332;1335;3
/net/per610a/home/mvp/mvp_db/hodost-lv/2015/2015_08_07_04_56/2015_08_07_21_54.mpg;Shinzo ABE.jpg;27269;27349;91169;1364;1368;4
/net/per610a/home/mvp/mvp_db/hodost-lv/2015/2015_08_07_04_56/2015_08_07_21_54.mpg;Shinzo ABE.jpg;27497;27589;91169;1375;1380;5
/net/per610a/home/mvp/mvp_db/hodost-lv/2015/2015_08_07_04_56/2015_08_07_21_54.mpg;Shinzo ABE.jpg;27661;27813;91169;1384;1391;7
/net/per610a/home/mvp/mvp_db/hodost-lv/2015/2015_08_07_04_56/2015_08_07_21_54.mpg;Shinzo ABE.jpg;28537;28589;91169;1427;1430;3
/net/per610a/home/mvp/mvp_db/hodost-lv/2015/2015_08_07_04_56/2015_08_07_21_54.mpg;Shinzo ABE.jpg;28985;29117;91169;1450;1456;6
/net/per610a/home/mvp/mvp_db/hodost-lv/2015/2015_08_09_04_56/2015_08_09_16_30.mpg;Shinzo ABE.jpg;4117;4501;107949;206;225;19
/net/per610a/home/mvp/mvp_db/hodost-lv/2015/2015_08_09_04_56/2015_08_09_16_30.mpg;Shinzo ABE.jpg;89137;89549;107949;4460;4481;21
/net/per610a/home/mvp/mvp_db/hodost-lv/2015/2015_08_09_04_56/2015_08_09_16_30.mpg;Shinzo ABE.jpg;104137;104301;107949;5211;5219;8
/net/per610a/home/mvp/mvp_db/hodost-lv/2015/2015_08_10_04_56/2015_08_10_21_54.mpg;Ichiro OZAWA.jpg;28921;29105;91169;1447;1456;9
/net/per610a/home/mvp/mvp_db/hodost-lv/2015/2015_08_10_04_56/2015_08_10_21_54.mpg;Renho.jpg;41397;41493;91169;2071;2076;5
/net/per610a/home/mvp/mvp_db/hodost-lv/2015/2015_08_10_04_56/2015_08_10_21_54.mpg;Renho.jpg;41581;41613;91169;2081;2082;1
/net/per610a/home/mvp/mvp_db/hodost-lv/2015/2015_08_10_04_56/2015_08_10_21_54.mpg;Renho.jpg;41881;41957;91169;2096;2099;3
/net/per610a/home/mvp/mvp_db/hodost-lv/2015/2015_08_10_04_56/2015_08_10_21_54.mpg;Junichiro KOIZUMI.jpg;52409;52561;91169;2623;2630;7
/net/per610a/home/mvp/mvp_db/hodost-lv/2015/2015_08_10_04_56/2015_08_10_21_54.mpg;Shinzo ABE.jpg;52713;52797;91169;2638;2642;4
/net/per610a/home/mvp/mvp_db/hodost-lv/2015/2015_08_11_04_56/2015_08_11_21_54.mpg;Shinzo ABE.jpg;8069;8357;91169;403;418;15
/net/per610a/home/mvp/mvp_db/hodost-lv/2015/2015_08_11_04_56/2015_08_11_21_54.mpg;Shinzo ABE.jpg;34633;34705;91169;1733;1736;3
/net/per610a/home/mvp/mvp_db/hodost-lv/2015/2015_08_14_04_56/2015_08_14_21_54.mpg;Shinzo ABE.jpg;2405;2441;91169;120;122;2
/net/per610a/home/mvp/mvp_db/hodost-lv/2015/2015_08_14_04_56/2015_08_14_21_54.mpg;Shinzo ABE.jpg;11881;11933;91169;594;597;3
/net/per610a/home/mvp/mvp_db/hodost-lv/2015/2015_08_14_04_56/2015_08_14_21_54.mpg;Natsuo YAMAGUCHI.jpg;14501;15085;91169;725;754;29
/net/per610a/home/mvp/mvp_db/hodost-lv/2015/2015_08_16_04_56/2015_08_16_16_30.mpg;Shinzo ABE.jpg;23761;24105;107949;1189;1206;17
/net/per610a/home/mvp/mvp_db/hodost-lv/2015/2015_08_16_04_56/2015_08_16_16_30.mpg;Shinzo ABE.jpg;25249;25409;107949;1263;1271;8
/net/per610a/home/mvp/mvp_db/hodost-lv/2015/2015_08_16_04_56/2015_08_16_16_30.mpg;Shinzo ABE.jpg;55593;55705;107949;2781;2787;6
/net/per610a/home/mvp/mvp_db/hodost-lv/2015/2015_08_18_04_56/2015_08_18_21_54.mpg;Shinzo ABE.jpg;46873;46949;91169;2345;2349;4
/net/per610a/home/mvp/mvp_db/hodost-lv/2015/2015_08_18_04_56/2015_08_18_21_54.mpg;Shinzo ABE.jpg;48009;48097;91169;2402;2407;5
/net/per610a/home/mvp/mvp_db/hodost-lv/2015/2015_08_18_04_56/2015_08_18_21_54.mpg;Shinzo ABE.jpg;49953;50401;91169;2500;2522;22
/net/per610a/home/mvp/mvp_db/hodost-lv/2015/2015_08_18_04_56/2015_08_18_21_54.mpg;Shinzo ABE.jpg;50549;51077;91169;2529;2556;27
/net/per610a/home/mvp/mvp_db/hodost-lv/2015/2015_08_20_04_56/2015_08_20_21_54.mpg;Shinzo ABE.jpg;24397;24481;91169;1221;1225;4
/net/per610a/home/mvp/mvp_db/hodost-lv/2015/2015_08_23_04_56/2015_08_23_16_30.mpg;Shinzo ABE.jpg;16553;16861;107961;828;843;15
/net/per610a/home/mvp/mvp_db/hodost-lv/2015/2015_08_23_04_56/2015_08_23_16_30.mpg;Shinzo ABE.jpg;18421;18553;107961;921;928;7
/net/per610a/home/mvp/mvp_db/hodost-lv/2015/2015_08_23_04_56/2015_08_23_16_30.mpg;Shinzo ABE.jpg;18617;18673;107961;931;934;3
/net/per610a/home/mvp/mvp_db/hodost-lv/2015/2015_08_25_04_56/2015_08_25_21_54.mpg;Taro ASO.jpg;24753;25321;91169;1238;1267;29
/net/per610a/home/mvp/mvp_db/hodost-lv/2015/2015_08_25_04_56/2015_08_25_21_54.mpg;Shinzo ABE.jpg;43185;43665;91169;2161;2185;24
/net/per610a/home/mvp/mvp_db/hodost-lv/2015/2015_08_25_04_56/2015_08_25_21_54.mpg;Kenji Eda.jpg;55769;55925;91169;2791;2799;8
/net/per610a/home/mvp/mvp_db/hodost-lv/2015/2015_08_27_04_56/2015_08_27_21_54.mpg;Toru Hashimoto.jpg;537;605;91169;26;30;4
/net/per610a/home/mvp/mvp_db/hodost-lv/2015/2015_08_27_04_56/2015_08_27_21_54.mpg;Toru Hashimoto.jpg;669;1045;91169;33;52;19
/net/per610a/home/mvp/mvp_db/hodost-lv/2015/2015_08_27_04_56/2015_08_27_21_54.mpg;Toru Hashimoto.jpg;5085;5225;91169;254;261;7
/net/per610a/home/mvp/mvp_db/hodost-lv/2015/2015_08_27_04_56/2015_08_27_21_54.mpg;Toru Hashimoto.jpg;5321;6025;91169;266;301;35
/net/per610a/home/mvp/mvp_db/hodost-lv/2015/2015_08_27_04_56/2015_08_27_21_54.mpg;Toru Hashimoto.jpg;6137;6281;91169;307;314;7
/net/per610a/home/mvp/mvp_db/hodost-lv/2015/2015_08_27_04_56/2015_08_27_21_54.mpg;Toru Hashimoto.jpg;7993;8429;91169;400;421;21
/net/per610a/home/mvp/mvp_db/hodost-lv/2015/2015_08_27_04_56/2015_08_27_21_54.mpg;Toru Hashimoto.jpg;8529;8617;91169;426;431;5
/net/per610a/home/mvp/mvp_db/hodost-lv/2015/2015_08_27_04_56/2015_08_27_21_54.mpg;Toru Hashimoto.jpg;9861;10169;91169;493;508;15
/net/per610a/home/mvp/mvp_db/hodost-lv/2015/2015_08_27_04_56/2015_08_27_21_54.mpg;Yorihisa Matsuno.png;1945;2141;91169;97;107;10
/net/per610a/home/mvp/mvp_db/hodost-lv/2015/2015_08_28_04_56/2015_08_28_21_54.mpg;Shinzo ABE.jpg;26005;26249;91169;1301;1313;12
/net/per610a/home/mvp/mvp_db/hodost-lv/2015/2015_08_28_04_56/2015_08_28_21_54.mpg;Masashi Nakano.jpg;26973;27277;91169;1349;1365;16
/net/per610a/home/mvp/mvp_db/hodost-lv/2015/2015_08_28_04_56/2015_08_28_21_54.mpg;Masashi Nakano.jpg;28313;28625;91169;1417;1432;15
/net/per610a/home/mvp/mvp_db/hodost-lv/2015/2015_08_28_04_56/2015_08_28_21_54.mpg;Sadakazu TANIGAKI.jpg;38005;38601;91169;1902;1931;29
/net/per610a/home/mvp/mvp_db/hodost-lv/2015/2015_08_28_04_56/2015_08_28_21_54.mpg;Toru Hashimoto.jpg;59253;59309;91169;2965;2968;3
/net/per610a/home/mvp/mvp_db/hodost-lv/2015/2015_08_28_04_56/2015_08_28_21_54.mpg;Toru Hashimoto.jpg;59437;59625;91169;2974;2984;10
/net/per610a/home/mvp/mvp_db/hodost-lv/2015/2015_08_30_04_56/2015_08_30_16_30.mpg;Toru Hashimoto.jpg;52233;52477;107949;2613;2626;13
/net/per610a/home/mvp/mvp_db/hodost-lv/2015/2015_08_30_04_56/2015_08_30_16_30.mpg;Toru Hashimoto.jpg;53101;53769;107949;2657;2690;33
/net/per610a/home/mvp/mvp_db/hodost-lv/2015/2015_08_31_04_56/2015_08_31_21_54.mpg;Shinzo ABE.jpg;37709;37721;91169;1887;1887;0
/net/per610a/home/mvp/mvp_db/hodost-lv/2015/2015_08_31_04_56/2015_08_31_21_54.mpg;Shinzo ABE.jpg;37829;37961;91169;1893;1899;6
/net/per610a/home/mvp/mvp_db/hodost-lv/2015/2015_09_01_04_56/2015_09_01_21_54.mpg;Sadakazu TANIGAKI.jpg;55653;55705;91169;2785;2788;3
/net/per610a/home/mvp/mvp_db/hodost-lv/2015/2015_09_01_04_56/2015_09_01_21_54.mpg;Sadakazu TANIGAKI.jpg;58685;59017;91169;2937;2953;16
/net/per610a/home/mvp/mvp_db/hodost-lv/2015/2015_09_04_04_56/2015_09_04_21_54.mpg;Sadakazu TANIGAKI.jpg;52693;52945;91169;2636;2649;13
/net/per610a/home/mvp/mvp_db/hodost-lv/2015/2015_09_08_04_56/2015_09_08_21_54.mpg;Shinzo ABE.jpg;22309;22873;91169;1116;1144;28
/net/per610a/home/mvp/mvp_db/hodost-lv/2015/2015_09_08_04_56/2015_09_08_21_54.mpg;Shinzo ABE.jpg;24353;24869;91169;1218;1244;26
/net/per610a/home/mvp/mvp_db/hodost-lv/2015/2015_09_08_04_56/2015_09_08_21_54.mpg;Shinzo ABE.jpg;31321;31397;91169;1567;1571;4
/net/per610a/home/mvp/mvp_db/hodost-lv/2015/2015_09_08_04_56/2015_09_08_21_54.mpg;Shinzo ABE.jpg;32225;32529;91169;1612;1628;16
/net/per610a/home/mvp/mvp_db/hodost-lv/2015/2015_09_08_04_56/2015_09_08_21_54.mpg;Shinzo ABE.jpg;32625;32661;91169;1632;1634;2
/net/per610a/home/mvp/mvp_db/hodost-lv/2015/2015_09_10_04_56/2015_09_10_21_54.mpg;Natsuo YAMAGUCHI.jpg;72241;73177;91161;3615;3662;47
/net/per610a/home/mvp/mvp_db/hodost-lv/2015/2015_09_11_04_56/2015_09_11_21_54.mpg;Shinzo ABE.jpg;64041;64085;91169;3204;3206;2
/net/per610a/home/mvp/mvp_db/hodost-lv/2015/2015_09_11_04_56/2015_09_11_21_54.mpg;Shinzo ABE.jpg;64233;64417;91169;3214;3223;9
/net/per610a/home/mvp/mvp_db/hodost-lv/2015/2015_09_13_04_56/2015_09_13_16_00.mpg;Shinzo ABE.jpg;139513;139737;143909;6981;6993;12
/net/per610a/home/mvp/mvp_db/hodost-lv/2015/2015_09_14_04_56/2015_09_14_21_54.mpg;Shinzo ABE.jpg;36337;36409;91161;1818;1822;4
/net/per610a/home/mvp/mvp_db/hodost-lv/2015/2015_09_14_04_56/2015_09_14_21_54.mpg;Shinzo ABE.jpg;36697;36817;91161;1836;1842;6
/net/per610a/home/mvp/mvp_db/hodost-lv/2015/2015_09_15_04_56/2015_09_15_21_54.mpg;Shinzo ABE.jpg;29681;29745;91161;1485;1488;3
/net/per610a/home/mvp/mvp_db/hodost-lv/2015/2015_09_15_04_56/2015_09_15_21_54.mpg;Shinzo ABE.jpg;30645;30673;91161;1533;1534;1
/net/per610a/home/mvp/mvp_db/hodost-lv/2015/2015_09_17_04_56/2015_09_17_21_54.mpg;Shinzo ABE.jpg;7805;7833;91169;390;392;2
/net/per610a/home/mvp/mvp_db/hodost-lv/2015/2015_09_17_04_56/2015_09_17_21_54.mpg;Shinzo ABE.jpg;21337;21349;91169;1067;1068;1
/net/per610a/home/mvp/mvp_db/hodost-lv/2015/2015_09_17_04_56/2015_09_17_21_54.mpg;Shinzo ABE.jpg;53177;53281;91169;2661;2666;5
/net/per610a/home/mvp/mvp_db/hodost-lv/2015/2015_09_18_04_56/2015_09_18_21_54.mpg;Shinzo ABE.jpg;10177;10197;91169;509;510;1
/net/per610a/home/mvp/mvp_db/hodost-lv/2015/2015_09_18_04_56/2015_09_18_21_54.mpg;Shinzo ABE.jpg;35929;36129;91169;1798;1808;10
/net/per610a/home/mvp/mvp_db/hodost-lv/2015/2015_09_18_04_56/2015_09_18_21_54.mpg;Shinzo ABE.jpg;36477;36745;91169;1825;1839;14
/net/per610a/home/mvp/mvp_db/hodost-lv/2015/2015_09_18_04_56/2015_09_18_21_54.mpg;Shinzo ABE.jpg;37277;37421;91169;1865;1872;7
/net/per610a/home/mvp/mvp_db/hodost-lv/2015/2015_09_18_04_56/2015_09_18_21_54.mpg;Shinzo ABE.jpg;37889;38253;91169;1896;1914;18
/net/per610a/home/mvp/mvp_db/hodost-lv/2015/2015_09_18_04_56/2015_09_18_21_54.mpg;Shinzo ABE.jpg;37429;37509;91169;1873;1877;4
/net/per610a/home/mvp/mvp_db/hodost-lv/2015/2015_09_21_04_56/2015_09_21_21_54.mpg;Shinzo ABE.jpg;7285;7441;91169;364;372;8
/net/per610a/home/mvp/mvp_db/hodost-lv/2015/2015_09_21_04_56/2015_09_21_21_54.mpg;Shinzo ABE.jpg;12361;13365;91169;618;668;50
/net/per610a/home/mvp/mvp_db/hodost-lv/2015/2015_09_21_04_56/2015_09_21_21_54.mpg;Kazuo SHII.jpg;8553;9113;91169;428;456;28
/net/per610a/home/mvp/mvp_db/hodost-lv/2015/2015_09_22_04_56/2015_09_22_21_54.mpg;Shinzo ABE.jpg;45349;45457;91169;2269;2275;6
/net/per610a/home/mvp/mvp_db/hodost-lv/2015/2015_09_23_04_56/2015_09_23_21_54.mpg;Shintaro ISHIHARA.jpg;10821;10997;91169;541;550;9
/net/per610a/home/mvp/mvp_db/hodost-lv/2015/2015_09_23_04_56/2015_09_23_21_54.mpg;Shinzo ABE.jpg;36237;36353;91169;1813;1819;6
/net/per610a/home/mvp/mvp_db/hodost-lv/2015/2015_09_25_04_56/2015_09_25_21_54.mpg;Yorihisa Matsuno.png;18461;18513;91169;923;926;3
/net/per610a/home/mvp/mvp_db/hodost-lv/2015/2015_09_25_04_56/2015_09_25_21_54.mpg;Yorihisa Matsuno.png;18721;18777;91169;936;939;3
/net/per610a/home/mvp/mvp_db/hodost-lv/2015/2015_09_25_04_56/2015_09_25_21_54.mpg;Kazuo SHII.jpg;18973;19073;91169;949;954;5
/net/per610a/home/mvp/mvp_db/hodost-lv/2015/2015_09_27_04_56/2015_09_27_16_30.mpg;Shinzo ABE.jpg;63001;63193;107949;3152;3162;10
/net/per610a/home/mvp/mvp_db/hodost-lv/2015/2015_09_28_04_56/2015_09_28_21_54.mpg;Shinzo ABE.jpg;26241;26325;91169;1313;1317;4
/net/per610a/home/mvp/mvp_db/hodost-lv/2015/2015_09_28_04_56/2015_09_28_21_54.mpg;Shinzo ABE.jpg;58117;58173;91169;2908;2911;3
/net/per610a/home/mvp/mvp_db/hodost-lv/2015/2015_09_28_04_56/2015_09_28_21_54.mpg;Shinzo ABE.jpg;58937;58981;91169;2949;2951;2
/net/per610a/home/mvp/mvp_db/hodost-lv/2015/2015_09_29_04_56/2015_09_29_21_54.mpg;Shinzo ABE.jpg;27841;27905;91169;1393;1396;3
/net/per610a/home/mvp/mvp_db/hodost-lv/2015/2015_09_29_04_56/2015_09_29_21_54.mpg;Shinzo ABE.jpg;28113;28153;91169;1407;1409;2
/net/per610a/home/mvp/mvp_db/hodost-lv/2015/2015_09_29_04_56/2015_09_29_21_54.mpg;Shinzo ABE.jpg;28353;28505;91169;1419;1426;7
/net/per610a/home/mvp/mvp_db/hodost-lv/2015/2015_09_29_04_56/2015_09_29_21_54.mpg;Shinzo ABE.jpg;29881;29953;91169;1495;1499;4
/net/per610a/home/mvp/mvp_db/hodost-lv/2015/2015_09_29_04_56/2015_09_29_21_54.mpg;Shinzo ABE.jpg;34745;34809;91169;1738;1742;4
/net/per610a/home/mvp/mvp_db/hodost-lv/2015/2015_09_30_04_56/2015_09_30_21_54.mpg;Shinzo ABE.jpg;24825;25865;91161;1242;1294;52
/net/per610a/home/mvp/mvp_db/hodost-lv/2015/2015_09_30_04_56/2015_09_30_21_54.mpg;Shinzo ABE.jpg;42705;42829;91161;2137;2143;6
/net/per610a/home/mvp/mvp_db/hodost-lv/2015/2015_09_30_04_56/2015_09_30_21_54.mpg;Shinzo ABE.jpg;43153;43369;91161;2159;2170;11
/net/per610a/home/mvp/mvp_db/hodost-lv/2015/2015_09_30_04_56/2015_09_30_21_54.mpg;Shinzo ABE.jpg;44253;45305;91161;2214;2267;53
/net/per610a/home/mvp/mvp_db/hodost-lv/2015/2015_09_30_04_56/2015_09_30_21_54.mpg;Shinzo ABE.jpg;45569;45585;91161;2280;2281;1
/net/per610a/home/mvp/mvp_db/hodost-lv/2015/2015_09_30_04_56/2015_09_30_21_54.mpg;Shinzo ABE.jpg;51413;52089;91161;2572;2606;34
/net/per610a/home/mvp/mvp_db/hodost-lv/2015/2015_10_01_04_56/2015_10_01_21_54.mpg;Toranosuke Katayama.jpg;57153;57253;91169;2860;2865;5
/net/per610a/home/mvp/mvp_db/hodost-lv/2015/2015_10_02_04_56/2015_10_02_21_54.mpg;Shinzo ABE.jpg;25521;25697;91169;1277;1286;9
/net/per610a/home/mvp/mvp_db/hodost-lv/2015/2015_10_02_04_56/2015_10_02_21_54.mpg;Shinzo ABE.jpg;37469;37693;91169;1875;1886;11
/net/per610a/home/mvp/mvp_db/hodost-lv/2015/2015_10_05_04_56/2015_10_05_21_54.mpg;Shinzo ABE.jpg;25241;25637;91169;1263;1283;20
/net/per610a/home/mvp/mvp_db/hodost-lv/2015/2015_10_05_04_56/2015_10_05_21_54.mpg;Shinzo ABE.jpg;31957;32221;91169;1599;1612;13
/net/per610a/home/mvp/mvp_db/hodost-lv/2015/2015_10_07_04_56/2015_10_07_21_54.mpg;Shinzo ABE.jpg;27945;28025;91169;1398;1402;4
/net/per610a/home/mvp/mvp_db/hodost-lv/2015/2015_10_07_04_56/2015_10_07_21_54.mpg;Shinzo ABE.jpg;32601;32689;91169;1631;1636;5
/net/per610a/home/mvp/mvp_db/hodost-lv/2015/2015_10_07_04_56/2015_10_07_21_54.mpg;Shinzo ABE.jpg;28861;28997;91169;1444;1451;7
/net/per610a/home/mvp/mvp_db/hodost-lv/2015/2015_10_07_04_56/2015_10_07_21_54.mpg;Shinzo ABE.jpg;31673;31837;91169;1585;1593;8
/net/per610a/home/mvp/mvp_db/hodost-lv/2015/2015_10_07_04_56/2015_10_07_21_54.mpg;Shinzo ABE.jpg;32049;32125;91169;1604;1607;3
/net/per610a/home/mvp/mvp_db/hodost-lv/2015/2015_10_09_04_56/2015_10_09_21_54.mpg;Shinzo ABE.jpg;27857;27953;91169;1393;1398;5
/net/per610a/home/mvp/mvp_db/hodost-lv/2015/2015_10_11_04_56/2015_10_11_16_30.mpg;Shinzo ABE.jpg;15029;15121;107949;752;756;4
/net/per610a/home/mvp/mvp_db/hodost-lv/2015/2015_10_11_04_56/2015_10_11_16_30.mpg;Shinzo ABE.jpg;15337;15337;107949;767;767;0
/net/per610a/home/mvp/mvp_db/hodost-lv/2015/2015_10_11_04_56/2015_10_11_16_30.mpg;Shinzo ABE.jpg;79405;79481;107949;3973;3977;4
/net/per610a/home/mvp/mvp_db/hodost-lv/2015/2015_10_11_04_56/2015_10_11_16_30.mpg;Shinzo ABE.jpg;57521;57617;107949;2878;2883;5
/net/per610a/home/mvp/mvp_db/hodost-lv/2015/2015_10_13_04_56/2015_10_13_21_54.mpg;Sadakazu TANIGAKI.jpg;42325;42709;91169;2118;2137;19
/net/per610a/home/mvp/mvp_db/hodost-lv/2015/2015_10_13_04_56/2015_10_13_21_54.mpg;Shinzo ABE.jpg;48765;48885;91169;2440;2446;6
/net/per610a/home/mvp/mvp_db/hodost-lv/2015/2015_10_14_04_56/2015_10_14_22_09.mpg;Shinzo ABE.jpg;26457;26577;91169;1324;1330;6
/net/per610a/home/mvp/mvp_db/hodost-lv/2015/2015_10_14_04_56/2015_10_14_22_09.mpg;Shinzo ABE.jpg;31161;31225;91169;1559;1562;3
/net/per610a/home/mvp/mvp_db/hodost-lv/2015/2015_10_14_04_56/2015_10_14_22_09.mpg;Shinzo ABE.jpg;40105;40133;91169;2007;2008;1
/net/per610a/home/mvp/mvp_db/hodost-lv/2015/2015_10_15_04_56/2015_10_15_21_54.mpg;Shinzo ABE.jpg;18521;18917;91169;926;946;20
/net/per610a/home/mvp/mvp_db/hodost-lv/2015/2015_10_15_04_56/2015_10_15_21_54.mpg;Shinzo ABE.jpg;42749;42869;91169;2139;2145;6
/net/per610a/home/mvp/mvp_db/hodost-lv/2015/2015_10_15_04_56/2015_10_15_21_54.mpg;Taro ASO.jpg;41593;41761;91169;2081;2090;9
/net/per610a/home/mvp/mvp_db/hodost-lv/2015/2015_10_15_04_56/2015_10_15_21_54.mpg;Shinzo ABE.jpg;42533;42713;91169;2128;2137;9
/net/per610a/home/mvp/mvp_db/hodost-lv/2015/2015_10_15_04_56/2015_10_15_21_54.mpg;Natsuo YAMAGUCHI.jpg;42749;42901;91169;2139;2147;8
/net/per610a/home/mvp/mvp_db/hodost-lv/2015/2015_10_15_04_56/2015_10_15_21_54.mpg;Natsuo YAMAGUCHI.jpg;56337;56417;91169;2819;2823;4
/net/per610a/home/mvp/mvp_db/hodost-lv/2015/2015_10_15_04_56/2015_10_15_21_54.mpg;Natsuo YAMAGUCHI.jpg;85369;85865;91169;4272;4297;25
/net/per610a/home/mvp/mvp_db/hodost-lv/2015/2015_10_15_04_56/2015_10_15_21_54.mpg;Yorihisa Matsuno.png;55617;55737;91169;2783;2789;6
/net/per610a/home/mvp/mvp_db/hodost-lv/2015/2015_10_15_04_56/2015_10_15_21_54.mpg;Yorihisa Matsuno.png;55897;56017;91169;2797;2803;6
/net/per610a/home/mvp/mvp_db/hodost-lv/2015/2015_10_15_04_56/2015_10_15_21_54.mpg;Toru Hashimoto.jpg;56497;57341;91169;2827;2869;42
/net/per610a/home/mvp/mvp_db/hodost-lv/2015/2015_10_16_04_56/2015_10_16_21_54.mpg;Renho.jpg;51161;51433;91169;2560;2574;14
/net/per610a/home/mvp/mvp_db/hodost-lv/2015/2015_10_20_04_56/2015_10_20_21_54.mpg;Shinzo ABE.jpg;30745;30925;91169;1538;1547;9
/net/per610a/home/mvp/mvp_db/hodost-lv/2015/2015_10_20_04_56/2015_10_20_21_54.mpg;Shinzo ABE.jpg;31029;31429;91169;1552;1573;21
/net/per610a/home/mvp/mvp_db/hodost-lv/2015/2015_10_20_04_56/2015_10_20_21_54.mpg;Kyoko Nakayama.jpg;42497;42645;91169;2126;2134;8
/net/per610a/home/mvp/mvp_db/hodost-lv/2015/2015_10_22_04_56/2015_10_22_22_09.mpg;Toru Hashimoto.jpg;73493;73733;91169;3678;3690;12
/net/per610a/home/mvp/mvp_db/hodost-lv/2015/2015_10_23_04_56/2015_10_23_21_54.mpg;Shinzo ABE.jpg;36329;36373;91169;1817;1820;3
/net/per610a/home/mvp/mvp_db/hodost-lv/2015/2015_10_23_04_56/2015_10_23_21_54.mpg;Shinzo ABE.jpg;40665;40765;91169;2034;2039;5
/net/per610a/home/mvp/mvp_db/hodost-lv/2015/2015_10_25_04_56/2015_10_25_16_30.mpg;Yorihisa Matsuno.png;89449;89657;107949;4476;4486;10
/net/per610a/home/mvp/mvp_db/hodost-lv/2015/2015_10_25_04_56/2015_10_25_16_30.mpg;Shinzo ABE.jpg;98681;98737;107949;4938;4941;3
/net/per610a/home/mvp/mvp_db/hodost-lv/2015/2015_10_25_04_56/2015_10_25_16_30.mpg;Shinzo ABE.jpg;98865;99049;107949;4947;4956;9
/net/per610a/home/mvp/mvp_db/hodost-lv/2015/2015_10_27_04_56/2015_10_27_21_54.mpg;Shinzo ABE.jpg;15401;16089;91169;770;805;35
/net/per610a/home/mvp/mvp_db/hodost-lv/2015/2015_10_29_04_56/2015_10_29_21_54.mpg;Shinzo ABE.jpg;4721;4881;91169;236;244;8
/net/per610a/home/mvp/mvp_db/hodost-lv/2015/2015_10_29_04_56/2015_10_29_21_54.mpg;Shinzo ABE.jpg;7337;7549;91169;367;377;10
/net/per610a/home/mvp/mvp_db/hodost-lv/2015/2015_11_01_04_56/2015_11_01_17_25.mpg;Shinzo ABE.jpg;4905;5097;42021;245;255;10
/net/per610a/home/mvp/mvp_db/hodost-lv/2015/2015_11_01_04_56/2015_11_01_17_25.mpg;Shinzo ABE.jpg;6993;7057;42021;349;353;4
/net/per610a/home/mvp/mvp_db/hodost-lv/2015/2015_11_01_04_56/2015_11_01_17_25.mpg;Shinzo ABE.jpg;7529;7745;42021;376;387;11
/net/per610a/home/mvp/mvp_db/hodost-lv/2015/2015_11_02_04_56/2015_11_02_21_54.mpg;Shinzo ABE.jpg;25497;25513;91169;1276;1276;0
/net/per610a/home/mvp/mvp_db/hodost-lv/2015/2015_11_02_04_56/2015_11_02_21_54.mpg;Shinzo ABE.jpg;27913;27993;91169;1397;1401;4
/net/per610a/home/mvp/mvp_db/hodost-lv/2015/2015_11_02_04_56/2015_11_02_21_54.mpg;Shinzo ABE.jpg;28357;28453;91169;1419;1424;5
/net/per610a/home/mvp/mvp_db/hodost-lv/2015/2015_11_02_04_56/2015_11_02_21_54.mpg;Shinzo ABE.jpg;28517;28577;91169;1427;1430;3
/net/per610a/home/mvp/mvp_db/hodost-lv/2015/2015_11_03_04_56/2015_11_03_21_54.mpg;Natsuo YAMAGUCHI.jpg;76869;77241;91169;3847;3865;18
/net/per610a/home/mvp/mvp_db/hodost-lv/2015/2015_11_03_04_56/2015_11_03_21_54.mpg;Natsuo YAMAGUCHI.jpg;78437;78673;91169;3925;3937;12
/net/per610a/home/mvp/mvp_db/hodost-lv/2015/2015_11_03_04_56/2015_11_03_21_54.mpg;Natsuo YAMAGUCHI.jpg;80397;80457;91169;4023;4026;3
/net/per610a/home/mvp/mvp_db/hodost-lv/2015/2015_11_03_04_56/2015_11_03_21_54.mpg;Natsuo YAMAGUCHI.jpg;81309;81465;91169;4069;4077;8
/net/per610a/home/mvp/mvp_db/hodost-lv/2015/2015_11_03_04_56/2015_11_03_21_54.mpg;Natsuo YAMAGUCHI.jpg;82313;82473;91169;4119;4127;8
/net/per610a/home/mvp/mvp_db/hodost-lv/2015/2015_11_03_04_56/2015_11_03_21_54.mpg;Natsuo YAMAGUCHI.jpg;83693;83813;91169;4188;4194;6
/net/per610a/home/mvp/mvp_db/hodost-lv/2015/2015_11_08_04_56/2015_11_08_16_30.mpg;Shinzo ABE.jpg;89325;89657;107961;4470;4486;16
/net/per610a/home/mvp/mvp_db/hodost-lv/2015/2015_11_08_04_56/2015_11_08_16_30.mpg;Shinzo ABE.jpg;89765;89817;107961;4492;4494;2
/net/per610a/home/mvp/mvp_db/hodost-lv/2015/2015_11_09_04_56/2015_11_09_21_54.mpg;Sadakazu TANIGAKI.jpg;60193;61109;91169;3012;3058;46
/net/per610a/home/mvp/mvp_db/hodost-lv/2015/2015_11_09_04_56/2015_11_09_21_54.mpg;Natsuo YAMAGUCHI.jpg;67777;68021;91169;3392;3404;12
/net/per610a/home/mvp/mvp_db/hodost-lv/2015/2015_11_12_04_56/2015_11_12_21_54.mpg;Seiji MAEHARA.jpg;11081;11433;91169;554;572;18
/net/per610a/home/mvp/mvp_db/hodost-lv/2015/2015_11_12_04_56/2015_11_12_21_54.mpg;Kazuo SHII.jpg;12313;12673;91169;616;634;18
/net/per610a/home/mvp/mvp_db/hodost-lv/2015/2015_11_12_04_56/2015_11_12_21_54.mpg;Yorihisa Matsuno.png;13513;14953;91169;676;748;72
/net/per610a/home/mvp/mvp_db/hodost-lv/2015/2015_11_12_04_56/2015_11_12_21_54.mpg;Shinzo ABE.jpg;41077;41385;91169;2055;2071;16
/net/per610a/home/mvp/mvp_db/hodost-lv/2015/2015_11_18_04_56/2015_11_18_21_54.mpg;Shinzo ABE.jpg;45177;45261;91169;2261;2265;4
/net/per610a/home/mvp/mvp_db/hodost-lv/2015/2015_11_18_04_56/2015_11_18_21_54.mpg;Natsuo YAMAGUCHI.jpg;46753;46885;91169;2339;2346;7
/net/per610a/home/mvp/mvp_db/hodost-lv/2015/2015_11_20_04_56/2015_11_20_21_54.mpg;Taro ASO.jpg;52461;52573;91169;2625;2630;5
/net/per610a/home/mvp/mvp_db/hodost-lv/2015/2015_11_23_04_56/2015_11_23_21_54.mpg;Toru Hashimoto.jpg;30161;30213;91169;1509;1512;3
/net/per610a/home/mvp/mvp_db/hodost-lv/2015/2015_11_23_04_56/2015_11_23_21_54.mpg;Toru Hashimoto.jpg;30301;30401;91169;1516;1521;5
/net/per610a/home/mvp/mvp_db/hodost-lv/2015/2015_11_23_04_56/2015_11_23_21_54.mpg;Shinzo ABE.jpg;30217;30309;91169;1512;1516;4
/net/per610a/home/mvp/mvp_db/hodost-lv/2015/2015_11_23_04_56/2015_11_23_21_54.mpg;Toru Hashimoto.jpg;31193;31641;91169;1561;1583;22
/net/per610a/home/mvp/mvp_db/hodost-lv/2015/2015_11_24_04_56/2015_11_24_21_54.mpg;Sadakazu TANIGAKI.jpg;34909;35429;91169;1747;1773;26
/net/per610a/home/mvp/mvp_db/hodost-lv/2015/2015_11_25_04_56/2015_11_25_21_54.mpg;Natsuo YAMAGUCHI.jpg;52417;52949;91169;2623;2650;27
/net/per610a/home/mvp/mvp_db/hodost-lv/2015/2015_11_25_04_56/2015_11_25_21_54.mpg;Shinzo ABE.jpg;53345;53709;91169;2669;2688;19
/net/per610a/home/mvp/mvp_db/hodost-lv/2015/2015_11_25_04_56/2015_11_25_21_54.mpg;Shinzo ABE.jpg;55401;55505;91169;2772;2778;6
/net/per610a/home/mvp/mvp_db/hodost-lv/2015/2015_11_26_04_56/2015_11_26_21_54.mpg;Shinzo ABE.jpg;19741;19877;91161;987;994;7
/net/per610a/home/mvp/mvp_db/hodost-lv/2015/2015_11_26_04_56/2015_11_26_21_54.mpg;Shinzo ABE.jpg;20361;20481;91161;1018;1024;6
/net/per610a/home/mvp/mvp_db/hodost-lv/2015/2015_11_26_04_56/2015_11_26_21_54.mpg;Shinzo ABE.jpg;22421;22757;91161;1122;1138;16
/net/per610a/home/mvp/mvp_db/hodost-lv/2015/2015_11_26_04_56/2015_11_26_21_54.mpg;Shinzo ABE.jpg;28029;28165;91161;1402;1409;7
/net/per610a/home/mvp/mvp_db/hodost-lv/2015/2015_11_26_04_56/2015_11_26_21_54.mpg;Ichiro OZAWA.jpg;24041;24221;91161;1203;1212;9
/net/per610a/home/mvp/mvp_db/hodost-lv/2015/2015_11_29_04_56/2015_11_29_16_30.mpg;Shinzo ABE.jpg;5925;5941;107949;296;297;1
/net/per610a/home/mvp/mvp_db/hodost-lv/2015/2015_11_29_04_56/2015_11_29_16_30.mpg;Shinzo ABE.jpg;6105;6213;107949;305;310;5
/net/per610a/home/mvp/mvp_db/hodost-lv/2015/2015_11_29_04_56/2015_11_29_16_30.mpg;Shinzo ABE.jpg;6777;6913;107949;339;345;6
/net/per610a/home/mvp/mvp_db/hodost-lv/2015/2015_11_29_04_56/2015_11_29_16_30.mpg;Shinzo ABE.jpg;7525;7597;107949;376;380;4
/net/per610a/home/mvp/mvp_db/hodost-lv/2015/2015_11_29_04_56/2015_11_29_16_30.mpg;Shinzo ABE.jpg;15517;15609;107949;776;781;5
/net/per610a/home/mvp/mvp_db/hodost-lv/2015/2015_11_29_04_56/2015_11_29_16_30.mpg;Shinzo ABE.jpg;16117;16209;107949;806;811;5
/net/per610a/home/mvp/mvp_db/hodost-lv/2015/2015_11_29_04_56/2015_11_29_16_30.mpg;Shinzo ABE.jpg;88737;88833;107949;4440;4445;5
/net/per610a/home/mvp/mvp_db/hodost-lv/2015/2015_11_29_04_56/2015_11_29_16_30.mpg;Shinzo ABE.jpg;7365;7465;107949;368;373;5
/net/per610a/home/mvp/mvp_db/hodost-lv/2015/2015_11_29_04_56/2015_11_29_16_30.mpg;Shinzo ABE.jpg;56249;56441;107949;2814;2824;10
/net/per610a/home/mvp/mvp_db/hodost-lv/2015/2015_11_29_04_56/2015_11_29_16_30.mpg;Shinzo ABE.jpg;56733;56925;107949;2839;2848;9
/net/per610a/home/mvp/mvp_db/hodost-lv/2015/2015_11_29_04_56/2015_11_29_16_30.mpg;Shinzo ABE.jpg;57161;57433;107949;2860;2874;14
/net/per610a/home/mvp/mvp_db/hodost-lv/2015/2015_12_06_04_56/2015_12_06_16_30.mpg;Yorihisa Matsuno.png;88461;88809;107957;4427;4444;17
/net/per610a/home/mvp/mvp_db/hodost-lv/2015/2015_12_06_04_56/2015_12_06_16_30.mpg;Shinzo ABE.jpg;90013;90277;107957;4504;4518;14
/net/per610a/home/mvp/mvp_db/hodost-lv/2015/2015_12_07_04_56/2015_12_07_21_54.mpg;Yorihisa Matsuno.png;35173;35193;91169;1760;1761;1
/net/per610a/home/mvp/mvp_db/hodost-lv/2015/2015_12_07_04_56/2015_12_07_21_54.mpg;Yorihisa Matsuno.png;36469;36473;91169;1825;1825;0
/net/per610a/home/mvp/mvp_db/hodost-lv/2015/2015_12_07_04_56/2015_12_07_21_54.mpg;Yorihisa Matsuno.png;39333;39385;91169;1968;1971;3
/net/per610a/home/mvp/mvp_db/hodost-lv/2015/2015_12_07_04_56/2015_12_07_21_54.mpg;Shinzo ABE.jpg;40617;41005;91169;2032;2052;20
/net/per610a/home/mvp/mvp_db/hodost-lv/2015/2015_12_07_04_56/2015_12_07_21_54.mpg;Natsuo YAMAGUCHI.jpg;41281;41725;91169;2066;2088;22
/net/per610a/home/mvp/mvp_db/hodost-lv/2015/2015_12_08_04_56/2015_12_08_21_54.mpg;Shinzo ABE.jpg;21809;22221;91169;1091;1112;21
/net/per610a/home/mvp/mvp_db/hodost-lv/2015/2015_12_08_04_56/2015_12_08_21_54.mpg;Shinzo ABE.jpg;22321;22505;91169;1117;1126;9
/net/per610a/home/mvp/mvp_db/hodost-lv/2015/2015_12_08_04_56/2015_12_08_21_54.mpg;Taro ASO.jpg;23489;23737;91169;1175;1188;13
/net/per610a/home/mvp/mvp_db/hodost-lv/2015/2015_12_08_04_56/2015_12_08_21_54.mpg;Shinzo ABE.jpg;23761;23933;91169;1189;1197;8
/net/per610a/home/mvp/mvp_db/hodost-lv/2015/2015_12_08_04_56/2015_12_08_21_54.mpg;Shinzo ABE.jpg;24237;24265;91169;1213;1214;1
/net/per610a/home/mvp/mvp_db/hodost-lv/2015/2015_12_09_04_56/2015_12_09_21_54.mpg;Natsuo YAMAGUCHI.jpg;15629;15661;91169;782;783;1
/net/per610a/home/mvp/mvp_db/hodost-lv/2015/2015_12_09_04_56/2015_12_09_21_54.mpg;Natsuo YAMAGUCHI.jpg;15725;15733;91169;787;787;0
/net/per610a/home/mvp/mvp_db/hodost-lv/2015/2015_12_09_04_56/2015_12_09_21_54.mpg;Natsuo YAMAGUCHI.jpg;17281;18473;91169;864;924;60
/net/per610a/home/mvp/mvp_db/hodost-lv/2015/2015_12_09_04_56/2015_12_09_21_54.mpg;Shinzo ABE.jpg;15909;15957;91169;796;798;2
/net/per610a/home/mvp/mvp_db/hodost-lv/2015/2015_12_09_04_56/2015_12_09_21_54.mpg;Shinzo ABE.jpg;16653;17241;91169;833;862;29
/net/per610a/home/mvp/mvp_db/hodost-lv/2015/2015_12_10_04_56/2015_12_10_21_54.mpg;Natsuo YAMAGUCHI.jpg;2189;2465;91161;109;123;14
/net/per610a/home/mvp/mvp_db/hodost-lv/2015/2015_12_10_04_56/2015_12_10_21_54.mpg;Natsuo YAMAGUCHI.jpg;7413;7553;91161;370;377;7
/net/per610a/home/mvp/mvp_db/hodost-lv/2015/2015_12_10_04_56/2015_12_10_21_54.mpg;Natsuo YAMAGUCHI.jpg;9765;9797;91161;488;490;2
/net/per610a/home/mvp/mvp_db/hodost-lv/2015/2015_12_10_04_56/2015_12_10_21_54.mpg;Natsuo YAMAGUCHI.jpg;9861;9869;91161;493;493;0
/net/per610a/home/mvp/mvp_db/hodost-lv/2015/2015_12_10_04_56/2015_12_10_21_54.mpg;Shinzo ABE.jpg;2645;2721;91161;132;136;4
/net/per610a/home/mvp/mvp_db/hodost-lv/2015/2015_12_10_04_56/2015_12_10_21_54.mpg;Shinzo ABE.jpg;5337;5433;91161;267;271;4
/net/per610a/home/mvp/mvp_db/hodost-lv/2015/2015_12_10_04_56/2015_12_10_21_54.mpg;Shinzo ABE.jpg;9793;9869;91161;490;493;3
/net/per610a/home/mvp/mvp_db/hodost-lv/2015/2015_12_10_04_56/2015_12_10_21_54.mpg;Sadakazu TANIGAKI.jpg;6805;7145;91161;340;357;17
/net/per610a/home/mvp/mvp_db/hodost-lv/2015/2015_12_11_04_56/2015_12_11_21_54.mpg;Taro ASO.jpg;4353;4705;91169;217;235;18
/net/per610a/home/mvp/mvp_db/hodost-lv/2015/2015_12_11_04_56/2015_12_11_21_54.mpg;Taro ASO.jpg;7413;7641;91169;371;382;11
/net/per610a/home/mvp/mvp_db/hodost-lv/2015/2015_12_11_04_56/2015_12_11_21_54.mpg;Shinzo ABE.jpg;5409;5445;91169;270;272;2
/net/per610a/home/mvp/mvp_db/hodost-lv/2015/2015_12_11_04_56/2015_12_11_21_54.mpg;Shinzo ABE.jpg;7193;7205;91169;360;360;0
/net/per610a/home/mvp/mvp_db/hodost-lv/2015/2015_12_11_04_56/2015_12_11_21_54.mpg;Shinzo ABE.jpg;14985;15117;91169;749;756;7
/net/per610a/home/mvp/mvp_db/hodost-lv/2015/2015_12_11_04_56/2015_12_11_21_54.mpg;Sadakazu TANIGAKI.jpg;5617;5889;91169;281;294;13
/net/per610a/home/mvp/mvp_db/hodost-lv/2015/2015_12_13_04_56/2015_12_13_16_30.mpg;Sadakazu TANIGAKI.jpg;25993;25997;107949;1300;1300;0
/net/per610a/home/mvp/mvp_db/hodost-lv/2015/2015_12_13_04_56/2015_12_13_16_30.mpg;Sadakazu TANIGAKI.jpg;26277;26325;107949;1314;1317;3
/net/per610a/home/mvp/mvp_db/hodost-lv/2015/2015_12_13_04_56/2015_12_13_16_30.mpg;Sadakazu TANIGAKI.jpg;28649;28785;107949;1433;1440;7
/net/per610a/home/mvp/mvp_db/hodost-lv/2015/2015_12_13_04_56/2015_12_13_16_30.mpg;Taro ASO.jpg;26717;27437;107949;1336;1373;37
/net/per610a/home/mvp/mvp_db/hodost-lv/2015/2015_12_14_04_56/2015_12_14_21_54.mpg;Shinzo ABE.jpg;34665;34873;91169;1734;1745;11
/net/per610a/home/mvp/mvp_db/hodost-lv/2015/2015_12_16_04_56/2015_12_16_21_54.mpg;Shinzo ABE.jpg;41209;41341;91169;2062;2069;7
/net/per610a/home/mvp/mvp_db/hodost-lv/2015/2015_12_16_04_56/2015_12_16_21_54.mpg;Shinzo ABE.jpg;48133;48621;91169;2409;2433;24
/net/per610a/home/mvp/mvp_db/hodost-lv/2015/2015_12_16_04_56/2015_12_16_21_54.mpg;Shinzo ABE.jpg;53821;53837;91169;2693;2694;1
/net/per610a/home/mvp/mvp_db/hodost-lv/2015/2015_12_16_04_56/2015_12_16_21_54.mpg;Shinzo ABE.jpg;54033;54429;91169;2704;2724;20
/net/per610a/home/mvp/mvp_db/hodost-lv/2015/2015_12_17_04_56/2015_12_17_21_54.mpg;Shinzo ABE.jpg;9469;9489;91169;473;474;1
/net/per610a/home/mvp/mvp_db/hodost-lv/2015/2015_12_17_04_56/2015_12_17_21_54.mpg;Shinzo ABE.jpg;12597;12813;91169;630;641;11
/net/per610a/home/mvp/mvp_db/hodost-lv/2015/2015_12_18_04_56/2015_12_18_21_54.mpg;Toru Hashimoto.jpg;34229;34381;91169;1713;1720;7
/net/per610a/home/mvp/mvp_db/hodost-lv/2015/2015_12_18_04_56/2015_12_18_21_54.mpg;Toru Hashimoto.jpg;34449;34977;91169;1724;1750;26
/net/per610a/home/mvp/mvp_db/hodost-lv/2015/2015_12_18_04_56/2015_12_18_21_54.mpg;Toru Hashimoto.jpg;35653;36669;91169;1784;1835;51
/net/per610a/home/mvp/mvp_db/hodost-lv/2015/2015_12_18_04_56/2015_12_18_21_54.mpg;Toru Hashimoto.jpg;35065;35565;91169;1755;1780;25
/net/per610a/home/mvp/mvp_db/hodost-lv/2015/2015_12_18_04_56/2015_12_18_21_54.mpg;Toru Hashimoto.jpg;36729;37405;91169;1838;1872;34
/net/per610a/home/mvp/mvp_db/hodost-lv/2015/2015_12_22_04_56/2015_12_22_21_54.mpg;Shinzo ABE.jpg;38629;39133;91169;1933;1958;25
/net/per610a/home/mvp/mvp_db/hodost-lv/2016/2016_01_04_04_56/2016_01_04_21_54.mpg;Shinzo ABE.jpg;4265;4453;91169;213;222;9
/net/per610a/home/mvp/mvp_db/hodost-lv/2016/2016_01_04_04_56/2016_01_04_21_54.mpg;Shinzo ABE.jpg;16689;16765;91169;835;839;4
/net/per610a/home/mvp/mvp_db/hodost-lv/2016/2016_01_04_04_56/2016_01_04_21_54.mpg;Shinzo ABE.jpg;16965;17145;91169;849;858;9
/net/per610a/home/mvp/mvp_db/hodost-lv/2016/2016_01_04_04_56/2016_01_04_21_54.mpg;Shinzo ABE.jpg;20261;20793;91169;1014;1040;26
/net/per610a/home/mvp/mvp_db/hodost-lv/2016/2016_01_04_04_56/2016_01_04_21_54.mpg;Shinzo ABE.jpg;21561;21573;91169;1079;1079;0
/net/per610a/home/mvp/mvp_db/hodost-lv/2016/2016_01_04_04_56/2016_01_04_21_54.mpg;Kazuo SHII.jpg;19853;19977;91169;993;999;6
/net/per610a/home/mvp/mvp_db/hodost-lv/2016/2016_01_06_04_56/2016_01_06_21_54.mpg;Bairi Kaieda.jpg;67961;68065;91169;3401;3406;5
/net/per610a/home/mvp/mvp_db/hodost-lv/2016/2016_01_08_04_56/2016_01_08_21_54.mpg;Shinzo ABE.jpg;6081;6097;91161;304;305;1
/net/per610a/home/mvp/mvp_db/hodost-lv/2016/2016_01_08_04_56/2016_01_08_21_54.mpg;Shinzo ABE.jpg;10449;10645;91161;522;532;10
/net/per610a/home/mvp/mvp_db/hodost-lv/2016/2016_01_08_04_56/2016_01_08_21_54.mpg;Shinzo ABE.jpg;10885;10969;91161;544;548;4
/net/per610a/home/mvp/mvp_db/hodost-lv/2016/2016_01_08_04_56/2016_01_08_21_54.mpg;Shinzo ABE.jpg;11033;11261;91161;552;563;11
/net/per610a/home/mvp/mvp_db/hodost-lv/2016/2016_01_08_04_56/2016_01_08_21_54.mpg;Shinzo ABE.jpg;13629;13633;91161;682;682;0
/net/per610a/home/mvp/mvp_db/hodost-lv/2016/2016_01_08_04_56/2016_01_08_21_54.mpg;Shinzo ABE.jpg;13753;13757;91161;688;688;0
/net/per610a/home/mvp/mvp_db/hodost-lv/2016/2016_01_08_04_56/2016_01_08_21_54.mpg;Shinzo ABE.jpg;20465;20505;91161;1024;1026;2
/net/per610a/home/mvp/mvp_db/hodost-lv/2016/2016_01_08_04_56/2016_01_08_21_54.mpg;Taro ASO.jpg;28937;29425;91161;1448;1472;24
/net/per610a/home/mvp/mvp_db/hodost-lv/2016/2016_01_08_04_56/2016_01_08_21_54.mpg;Taro ASO.jpg;30069;30317;91161;1504;1517;13
/net/per610a/home/mvp/mvp_db/hodost-lv/2016/2016_01_12_04_56/2016_01_12_21_54.mpg;Shinzo ABE.jpg;46613;46857;91169;2332;2345;13
/net/per610a/home/mvp/mvp_db/hodost-lv/2016/2016_01_12_04_56/2016_01_12_21_54.mpg;Shinzo ABE.jpg;48941;48989;91169;2449;2451;2
/net/per610a/home/mvp/mvp_db/hodost-lv/2016/2016_01_12_04_56/2016_01_12_21_54.mpg;Shinzo ABE.jpg;50005;50193;91169;2502;2512;10
/net/per610a/home/mvp/mvp_db/hodost-lv/2016/2016_01_12_04_56/2016_01_12_21_54.mpg;Shinzo ABE.jpg;51001;51113;91169;2552;2558;6
/net/per610a/home/mvp/mvp_db/hodost-lv/2016/2016_01_12_04_56/2016_01_12_21_54.mpg;Shinzo ABE.jpg;51185;51409;91169;2561;2573;12
/net/per610a/home/mvp/mvp_db/hodost-lv/2016/2016_01_12_04_56/2016_01_12_21_54.mpg;Shinzo ABE.jpg;51745;51837;91169;2589;2594;5
/net/per610a/home/mvp/mvp_db/hodost-lv/2016/2016_01_12_04_56/2016_01_12_21_54.mpg;Shinzo ABE.jpg;51441;51577;91169;2574;2581;7
/net/per610a/home/mvp/mvp_db/hodost-lv/2016/2016_01_12_04_56/2016_01_12_21_54.mpg;Shinzo ABE.jpg;51961;51977;91169;2600;2601;1
/net/per610a/home/mvp/mvp_db/hodost-lv/2016/2016_01_13_04_56/2016_01_13_21_54.mpg;Shinzo ABE.jpg;15793;15929;37221;790;796;6
/net/per610a/home/mvp/mvp_db/hodost-lv/2016/2016_01_13_04_56/2016_01_13_21_54.mpg;Shinzo ABE.jpg;16417;16569;37221;821;828;7
/net/per610a/home/mvp/mvp_db/hodost-lv/2016/2016_01_13_04_56/2016_01_13_21_54.mpg;Shinzo ABE.jpg;16649;16681;37221;832;834;2
/net/per610a/home/mvp/mvp_db/hodost-lv/2016/2016_01_13_04_56/2016_01_13_21_54.mpg;Shinzo ABE.jpg;16781;17017;37221;839;851;12
/net/per610a/home/mvp/mvp_db/hodost-lv/2016/2016_01_13_04_56/2016_01_13_21_54.mpg;Shinzo ABE.jpg;17845;17993;37221;892;900;8
/net/per610a/home/mvp/mvp_db/hodost-lv/2016/2016_01_13_04_56/2016_01_13_21_54.mpg;Shinzo ABE.jpg;20589;20669;37221;1029;1033;4
/net/per610a/home/mvp/mvp_db/hodost-lv/2016/2016_01_13_04_56/2016_01_13_21_54.mpg;Shinzo ABE.jpg;24637;24661;37221;1232;1233;1
/net/per610a/home/mvp/mvp_db/hodost-lv/2016/2016_01_13_04_56/2016_01_13_21_54.mpg;Shinzo ABE.jpg;17317;17733;37221;866;887;21
/net/per610a/home/mvp/mvp_db/hodost-lv/2016/2016_01_13_04_56/2016_01_13_21_54.mpg;Shinzo ABE.jpg;18421;18425;37221;921;921;0
/net/per610a/home/mvp/mvp_db/hodost-lv/2016/2016_01_14_04_56/2016_01_14_22_09.mpg;Shinzo ABE.jpg;34157;34185;91169;1709;1710;1
/net/per610a/home/mvp/mvp_db/hodost-lv/2016/2016_01_14_04_56/2016_01_14_22_09.mpg;Shinzo ABE.jpg;36833;36937;91169;1843;1848;5
/net/per610a/home/mvp/mvp_db/hodost-lv/2016/2016_01_14_04_56/2016_01_14_22_09.mpg;Sadakazu TANIGAKI.jpg;35469;35573;91169;1775;1780;5
/net/per610a/home/mvp/mvp_db/hodost-lv/2016/2016_01_18_04_56/2016_01_18_21_54.mpg;Shinzo ABE.jpg;43413;43693;91169;2172;2186;14
/net/per610a/home/mvp/mvp_db/hodost-lv/2016/2016_01_18_04_56/2016_01_18_21_54.mpg;Shinzo ABE.jpg;44241;44497;91169;2214;2227;13
/net/per610a/home/mvp/mvp_db/hodost-lv/2016/2016_01_24_04_56/2016_01_24_16_30.mpg;Shinzo ABE.jpg;19849;19925;107961;993;997;4
/net/per610a/home/mvp/mvp_db/hodost-lv/2016/2016_01_26_04_56/2016_01_26_21_54.mpg;Shinzo ABE.jpg;16717;16985;37221;836;849;13
/net/per610a/home/mvp/mvp_db/hodost-lv/2016/2016_01_28_04_56/2016_01_28_21_54.mpg;Taro ASO.jpg;20085;20177;91169;1005;1009;4
/net/per610a/home/mvp/mvp_db/hodost-lv/2016/2016_01_28_04_56/2016_01_28_21_54.mpg;Taro ASO.jpg;33761;33805;91169;1689;1691;2
/net/per610a/home/mvp/mvp_db/hodost-lv/2016/2016_01_29_04_56/2016_01_29_21_54.mpg;Taro ASO.jpg;19785;20157;91169;990;1008;18
/net/per610a/home/mvp/mvp_db/hodost-lv/2016/2016_01_31_04_56/2016_01_31_16_30.mpg;Yorihisa Matsuno.png;53869;53993;107949;2695;2701;6
/net/per610a/home/mvp/mvp_db/hodost-lv/2016/2016_02_03_04_56/2016_02_03_21_54.mpg;Shinzo ABE.jpg;21989;22045;91169;1100;1103;3
/net/per610a/home/mvp/mvp_db/hodost-lv/2016/2016_02_03_04_56/2016_02_03_21_54.mpg;Shinzo ABE.jpg;25845;26157;91169;1293;1309;16
/net/per610a/home/mvp/mvp_db/hodost-lv/2016/2016_02_03_04_56/2016_02_03_21_54.mpg;Shinzo ABE.jpg;26405;26405;91169;1321;1321;0
/net/per610a/home/mvp/mvp_db/hodost-lv/2016/2016_02_03_04_56/2016_02_03_21_54.mpg;Shinzo ABE.jpg;27977;28161;91169;1400;1409;9
/net/per610a/home/mvp/mvp_db/hodost-lv/2016/2016_02_03_04_56/2016_02_03_21_54.mpg;Shinzo ABE.jpg;28245;28249;91169;1413;1413;0
/net/per610a/home/mvp/mvp_db/hodost-lv/2016/2016_02_03_04_56/2016_02_03_21_54.mpg;Shinzo ABE.jpg;29861;30061;91169;1494;1504;10
/net/per610a/home/mvp/mvp_db/hodost-lv/2016/2016_02_03_04_56/2016_02_03_21_54.mpg;Shinzo ABE.jpg;30165;30257;91169;1509;1514;5
/net/per610a/home/mvp/mvp_db/hodost-lv/2016/2016_02_04_04_56/2016_02_04_21_54.mpg;Shinzo ABE.jpg;30989;31265;91161;1550;1564;14
/net/per610a/home/mvp/mvp_db/hodost-lv/2016/2016_02_04_04_56/2016_02_04_21_54.mpg;Shinzo ABE.jpg;31609;31645;91161;1581;1583;2
/net/per610a/home/mvp/mvp_db/hodost-lv/2016/2016_02_04_04_56/2016_02_04_21_54.mpg;Shinzo ABE.jpg;32837;32837;91161;1643;1643;0
/net/per610a/home/mvp/mvp_db/hodost-lv/2016/2016_02_04_04_56/2016_02_04_21_54.mpg;Shinzo ABE.jpg;32925;32929;91161;1647;1647;0
/net/per610a/home/mvp/mvp_db/hodost-lv/2016/2016_02_05_04_56/2016_02_05_21_54.mpg;Shinzo ABE.jpg;36481;36613;91169;1825;1832;7
/net/per610a/home/mvp/mvp_db/hodost-lv/2016/2016_02_05_04_56/2016_02_05_21_54.mpg;Shinzo ABE.jpg;36677;36745;91169;1835;1838;3
/net/per610a/home/mvp/mvp_db/hodost-lv/2016/2016_02_05_04_56/2016_02_05_21_54.mpg;Shinzo ABE.jpg;36877;36993;91169;1845;1851;6
/net/per610a/home/mvp/mvp_db/hodost-lv/2016/2016_02_05_04_56/2016_02_05_21_54.mpg;Natsuo YAMAGUCHI.jpg;37949;38029;91169;1898;1902;4
/net/per610a/home/mvp/mvp_db/hodost-lv/2016/2016_02_07_04_56/2016_02_07_16_30.mpg;Shinzo ABE.jpg;4425;5129;107949;221;256;35
/net/per610a/home/mvp/mvp_db/hodost-lv/2016/2016_02_08_04_56/2016_02_08_21_54.mpg;Shinzo ABE.jpg;32205;32697;91169;1611;1636;25
/net/per610a/home/mvp/mvp_db/hodost-lv/2016/2016_02_09_04_56/2016_02_09_21_54.mpg;Taro ASO.jpg;7149;7833;91169;357;392;35
/net/per610a/home/mvp/mvp_db/hodost-lv/2016/2016_02_09_04_56/2016_02_09_21_54.mpg;Shinzo ABE.jpg;45057;45117;91169;2255;2258;3
/net/per610a/home/mvp/mvp_db/hodost-lv/2016/2016_02_09_04_56/2016_02_09_21_54.mpg;Shinzo ABE.jpg;45441;45821;91169;2274;2293;19
/net/per610a/home/mvp/mvp_db/hodost-lv/2016/2016_02_09_04_56/2016_02_09_21_54.mpg;Natsuo YAMAGUCHI.jpg;45933;46577;91169;2298;2331;33
/net/per610a/home/mvp/mvp_db/hodost-lv/2016/2016_02_10_04_56/2016_02_10_21_54.mpg;Shinzo ABE.jpg;7813;7941;91169;391;397;6
/net/per610a/home/mvp/mvp_db/hodost-lv/2016/2016_02_10_04_56/2016_02_10_21_54.mpg;Shinzo ABE.jpg;8557;8625;91169;428;431;3
/net/per610a/home/mvp/mvp_db/hodost-lv/2016/2016_02_10_04_56/2016_02_10_21_54.mpg;Shinzo ABE.jpg;8729;8873;91169;436;444;8
/net/per610a/home/mvp/mvp_db/hodost-lv/2016/2016_02_10_04_56/2016_02_10_21_54.mpg;Shinzo ABE.jpg;22185;22185;91169;1110;1110;0
/net/per610a/home/mvp/mvp_db/hodost-lv/2016/2016_02_10_04_56/2016_02_10_21_54.mpg;Shinzo ABE.jpg;23033;23033;91169;1152;1152;0
/net/per610a/home/mvp/mvp_db/hodost-lv/2016/2016_02_10_04_56/2016_02_10_21_54.mpg;Shinzo ABE.jpg;23141;23169;91169;1158;1159;1
/net/per610a/home/mvp/mvp_db/hodost-lv/2016/2016_02_10_04_56/2016_02_10_21_54.mpg;Shinzo ABE.jpg;23717;23717;91169;1187;1187;0
/net/per610a/home/mvp/mvp_db/hodost-lv/2016/2016_02_10_04_56/2016_02_10_21_54.mpg;Shinzo ABE.jpg;27037;27045;91169;1353;1353;0
/net/per610a/home/mvp/mvp_db/hodost-lv/2016/2016_02_10_04_56/2016_02_10_21_54.mpg;Shinzo ABE.jpg;48121;48545;91169;2408;2429;21
/net/per610a/home/mvp/mvp_db/hodost-lv/2016/2016_02_10_04_56/2016_02_10_21_54.mpg;Shinzo ABE.jpg;55269;55421;91169;2766;2773;7
/net/per610a/home/mvp/mvp_db/hodost-lv/2016/2016_02_15_04_56/2016_02_15_21_54.mpg;Shinzo ABE.jpg;11985;12245;91169;599;612;13
/net/per610a/home/mvp/mvp_db/hodost-lv/2016/2016_02_15_04_56/2016_02_15_21_54.mpg;Shinzo ABE.jpg;16777;16813;91169;839;841;2
/net/per610a/home/mvp/mvp_db/hodost-lv/2016/2016_02_15_04_56/2016_02_15_21_54.mpg;Shinzo ABE.jpg;16921;17057;91169;846;853;7
/net/per610a/home/mvp/mvp_db/hodost-lv/2016/2016_02_15_04_56/2016_02_15_21_54.mpg;Shinzo ABE.jpg;17317;17429;91169;866;872;6
/net/per610a/home/mvp/mvp_db/hodost-lv/2016/2016_02_15_04_56/2016_02_15_21_54.mpg;Shinzo ABE.jpg;18493;18673;91169;925;934;9
/net/per610a/home/mvp/mvp_db/hodost-lv/2016/2016_02_15_04_56/2016_02_15_21_54.mpg;Shinzo ABE.jpg;19433;19749;91169;972;988;16
/net/per610a/home/mvp/mvp_db/hodost-lv/2016/2016_02_15_04_56/2016_02_15_21_54.mpg;Shinzo ABE.jpg;30413;30681;91169;1522;1535;13
/net/per610a/home/mvp/mvp_db/hodost-lv/2016/2016_02_19_04_56/2016_02_19_21_54.mpg;Katsuya OKADA.jpg;19217;19305;91169;961;966;5
/net/per610a/home/mvp/mvp_db/hodost-lv/2016/2016_02_19_04_56/2016_02_19_21_54.mpg;Yoshihiko Noda.jpg;25781;25941;91169;1290;1298;8
/net/per610a/home/mvp/mvp_db/hodost-lv/2016/2016_02_19_04_56/2016_02_19_21_54.mpg;Shinzo ABE.jpg;25981;26037;91169;1300;1302;2
/net/per610a/home/mvp/mvp_db/hodost-lv/2016/2016_02_21_04_56/2016_02_21_16_30.mpg;Shinzo ABE.jpg;22761;22937;107949;1139;1147;8
/net/per610a/home/mvp/mvp_db/hodost-lv/2016/2016_02_22_04_56/2016_02_22_21_54.mpg;Sadakazu TANIGAKI.jpg;2177;2345;91161;108;117;9
/net/per610a/home/mvp/mvp_db/hodost-lv/2016/2016_02_22_04_56/2016_02_22_21_54.mpg;Sadakazu TANIGAKI.jpg;7929;8053;91161;396;402;6
/net/per610a/home/mvp/mvp_db/hodost-lv/2016/2016_02_22_04_56/2016_02_22_21_54.mpg;Sadakazu TANIGAKI.jpg;10609;10633;91161;530;532;2
/net/per610a/home/mvp/mvp_db/hodost-lv/2016/2016_02_22_04_56/2016_02_22_21_54.mpg;Shinzo ABE.jpg;11473;11605;91161;574;580;6
/net/per610a/home/mvp/mvp_db/hodost-lv/2016/2016_02_22_04_56/2016_02_22_21_54.mpg;Shinzo ABE.jpg;21125;21265;91161;1057;1064;7
/net/per610a/home/mvp/mvp_db/hodost-lv/2016/2016_02_23_04_56/2016_02_23_21_54.mpg;Kenji Eda.jpg;45093;45253;91169;2256;2264;8
/net/per610a/home/mvp/mvp_db/hodost-lv/2016/2016_02_23_04_56/2016_02_23_21_54.mpg;Kazuo SHII.jpg;46981;47425;91169;2351;2373;22
/net/per610a/home/mvp/mvp_db/hodost-lv/2016/2016_02_24_04_56/2016_02_24_21_54.mpg;Shinzo ABE.jpg;35297;35337;91169;1766;1768;2
/net/per610a/home/mvp/mvp_db/hodost-lv/2016/2016_02_24_04_56/2016_02_24_21_54.mpg;Shinzo ABE.jpg;36801;36877;91169;1841;1845;4
/net/per610a/home/mvp/mvp_db/hodost-lv/2016/2016_02_24_04_56/2016_02_24_21_54.mpg;Shinzo ABE.jpg;36993;37241;91169;1851;1863;12
/net/per610a/home/mvp/mvp_db/hodost-lv/2016/2016_02_25_04_56/2016_02_25_21_54.mpg;Shinzo ABE.jpg;67565;67989;91169;3381;3402;21
/net/per610a/home/mvp/mvp_db/hodost-lv/2016/2016_02_25_04_56/2016_02_25_21_54.mpg;Shinzo ABE.jpg;84345;84529;91169;4221;4230;9
/net/per610a/home/mvp/mvp_db/hodost-lv/2016/2016_02_26_04_56/2016_02_26_21_54.mpg;Taro ASO.jpg;63125;63301;91169;3158;3167;9
/net/per610a/home/mvp/mvp_db/hodost-lv/2016/2016_02_28_04_56/2016_02_28_16_30.mpg;Shinzo ABE.jpg;87969;88077;107949;4402;4407;5
/net/per610a/home/mvp/mvp_db/hodost-lv/2016/2016_02_28_04_56/2016_02_28_16_30.mpg;Shinzo ABE.jpg;88181;88269;107949;4412;4417;5
/net/per610a/home/mvp/mvp_db/hodost-lv/2016/2016_02_29_04_56/2016_02_29_21_54.mpg;Shinzo ABE.jpg;43885;43897;91169;2196;2197;1
/net/per610a/home/mvp/mvp_db/hodost-lv/2016/2016_02_29_04_56/2016_02_29_21_54.mpg;Shinzo ABE.jpg;45613;45613;91169;2282;2282;0
/net/per610a/home/mvp/mvp_db/hodost-lv/2016/2016_02_29_04_56/2016_02_29_21_54.mpg;Shinzo ABE.jpg;45889;46225;91169;2296;2313;17
/net/per610a/home/mvp/mvp_db/hodost-lv/2016/2016_03_01_04_56/2016_03_01_21_54.mpg;Shinzo ABE.jpg;21625;22209;91169;1082;1111;29
/net/per610a/home/mvp/mvp_db/hodost-lv/2016/2016_03_01_04_56/2016_03_01_21_54.mpg;Shinzo ABE.jpg;22385;23305;91169;1120;1166;46
/net/per610a/home/mvp/mvp_db/hodost-lv/2016/2016_03_01_04_56/2016_03_01_21_54.mpg;Shinzo ABE.jpg;24085;24509;91169;1205;1226;21
/net/per610a/home/mvp/mvp_db/hodost-lv/2016/2016_03_01_04_56/2016_03_01_21_54.mpg;Shinzo ABE.jpg;24729;24753;91169;1237;1238;1
/net/per610a/home/mvp/mvp_db/hodost-lv/2016/2016_03_01_04_56/2016_03_01_21_54.mpg;Shinzo ABE.jpg;24821;24973;91169;1242;1249;7
/net/per610a/home/mvp/mvp_db/hodost-lv/2016/2016_03_01_04_56/2016_03_01_21_54.mpg;Shinzo ABE.jpg;26325;26545;91169;1317;1328;11
/net/per610a/home/mvp/mvp_db/hodost-lv/2016/2016_03_01_04_56/2016_03_01_21_54.mpg;Shinzo ABE.jpg;25721;25805;91169;1287;1291;4
/net/per610a/home/mvp/mvp_db/hodost-lv/2016/2016_03_01_04_56/2016_03_01_21_54.mpg;Shinzo ABE.jpg;25869;25921;91169;1294;1297;3
/net/per610a/home/mvp/mvp_db/hodost-lv/2016/2016_03_01_04_56/2016_03_01_21_54.mpg;Shinzo ABE.jpg;26001;26261;91169;1301;1314;13
/net/per610a/home/mvp/mvp_db/hodost-lv/2016/2016_03_03_04_56/2016_03_03_21_54.mpg;Shinzo ABE.jpg;15013;15045;91169;751;753;2
/net/per610a/home/mvp/mvp_db/hodost-lv/2016/2016_03_03_04_56/2016_03_03_21_54.mpg;Shinzo ABE.jpg;15109;15109;91169;756;756;0
/net/per610a/home/mvp/mvp_db/hodost-lv/2016/2016_03_03_04_56/2016_03_03_21_54.mpg;Shinzo ABE.jpg;15181;15181;91169;759;759;0
/net/per610a/home/mvp/mvp_db/hodost-lv/2016/2016_03_03_04_56/2016_03_03_21_54.mpg;Shinzo ABE.jpg;15661;15813;91169;783;791;8
/net/per610a/home/mvp/mvp_db/hodost-lv/2016/2016_03_03_04_56/2016_03_03_21_54.mpg;Shinzo ABE.jpg;17409;17589;91169;871;880;9
/net/per610a/home/mvp/mvp_db/hodost-lv/2016/2016_03_03_04_56/2016_03_03_21_54.mpg;Shinzo ABE.jpg;15905;16041;91169;796;802;6
/net/per610a/home/mvp/mvp_db/hodost-lv/2016/2016_03_04_04_56/2016_03_04_21_54.mpg;Shinzo ABE.jpg;1101;1237;91169;55;61;6
/net/per610a/home/mvp/mvp_db/hodost-lv/2016/2016_03_04_04_56/2016_03_04_21_54.mpg;Shinzo ABE.jpg;1657;1837;91169;82;91;9
/net/per610a/home/mvp/mvp_db/hodost-lv/2016/2016_03_04_04_56/2016_03_04_21_54.mpg;Shinzo ABE.jpg;2273;2449;91169;113;122;9
/net/per610a/home/mvp/mvp_db/hodost-lv/2016/2016_03_04_04_56/2016_03_04_21_54.mpg;Shinzo ABE.jpg;5093;5365;91169;254;268;14
/net/per610a/home/mvp/mvp_db/hodost-lv/2016/2016_03_04_04_56/2016_03_04_21_54.mpg;Shinzo ABE.jpg;5445;5621;91169;272;281;9
/net/per610a/home/mvp/mvp_db/hodost-lv/2016/2016_03_04_04_56/2016_03_04_21_54.mpg;Shinzo ABE.jpg;8513;8905;91169;426;445;19
/net/per610a/home/mvp/mvp_db/hodost-lv/2016/2016_03_04_04_56/2016_03_04_21_54.mpg;Shinzo ABE.jpg;9717;10181;91169;486;509;23
/net/per610a/home/mvp/mvp_db/hodost-lv/2016/2016_03_04_04_56/2016_03_04_21_54.mpg;Shinzo ABE.jpg;13321;13513;91169;666;676;10
/net/per610a/home/mvp/mvp_db/hodost-lv/2016/2016_03_04_04_56/2016_03_04_21_54.mpg;Shinzo ABE.jpg;16417;16629;91169;821;832;11
/net/per610a/home/mvp/mvp_db/hodost-lv/2016/2016_03_04_04_56/2016_03_04_21_54.mpg;Shinzo ABE.jpg;16753;16941;91169;838;847;9
/net/per610a/home/mvp/mvp_db/hodost-lv/2016/2016_03_04_04_56/2016_03_04_21_54.mpg;Shinzo ABE.jpg;34837;35141;91169;1743;1758;15
/net/per610a/home/mvp/mvp_db/hodost-lv/2016/2016_03_04_04_56/2016_03_04_21_54.mpg;Yukio EDANO.jpg;33133;33177;91169;1658;1660;2
/net/per610a/home/mvp/mvp_db/hodost-lv/2016/2016_03_04_04_56/2016_03_04_21_54.mpg;Yukio EDANO.jpg;33341;33385;91169;1668;1670;2
/net/per610a/home/mvp/mvp_db/hodost-lv/2016/2016_03_06_04_56/2016_03_06_16_00.mpg;Shinzo ABE.jpg;65313;65445;143909;3268;3275;7
/net/per610a/home/mvp/mvp_db/hodost-lv/2016/2016_03_06_04_56/2016_03_06_16_00.mpg;Shinzo ABE.jpg;65713;65849;143909;3288;3295;7
/net/per610a/home/mvp/mvp_db/hodost-lv/2016/2016_03_06_04_56/2016_03_06_16_00.mpg;Shinzo ABE.jpg;66317;66449;143909;3318;3325;7
/net/per610a/home/mvp/mvp_db/hodost-lv/2016/2016_03_06_04_56/2016_03_06_16_00.mpg;Shinzo ABE.jpg;66717;66853;143909;3338;3345;7
/net/per610a/home/mvp/mvp_db/hodost-lv/2016/2016_03_07_04_56/2016_03_07_21_54.mpg;Shinzo ABE.jpg;39621;39673;91169;1983;1985;2
/net/per610a/home/mvp/mvp_db/hodost-lv/2016/2016_03_07_04_56/2016_03_07_21_54.mpg;Shinzo ABE.jpg;43209;43373;91169;2162;2170;8
/net/per610a/home/mvp/mvp_db/hodost-lv/2016/2016_03_07_04_56/2016_03_07_21_54.mpg;Shinzo ABE.jpg;45753;45801;91169;2289;2292;3
/net/per610a/home/mvp/mvp_db/hodost-lv/2016/2016_03_07_04_56/2016_03_07_21_54.mpg;Shinzo ABE.jpg;45921;45921;91169;2298;2298;0
/net/per610a/home/mvp/mvp_db/hodost-lv/2016/2016_03_07_04_56/2016_03_07_21_54.mpg;Shinzo ABE.jpg;53229;53321;91169;2664;2668;4
/net/per610a/home/mvp/mvp_db/hodost-lv/2016/2016_03_07_04_56/2016_03_07_21_54.mpg;Shinzo ABE.jpg;47457;47557;91169;2375;2380;5
/net/per610a/home/mvp/mvp_db/hodost-lv/2016/2016_03_07_04_56/2016_03_07_21_54.mpg;Shinzo ABE.jpg;47885;47949;91169;2396;2399;3
/net/per610a/home/mvp/mvp_db/hodost-lv/2016/2016_03_07_04_56/2016_03_07_21_54.mpg;Shinzo ABE.jpg;48013;48221;91169;2403;2413;10
/net/per610a/home/mvp/mvp_db/hodost-lv/2016/2016_03_10_04_56/2016_03_10_21_54.mpg;Shinzo ABE.jpg;13869;14021;91161;694;701;7
/net/per610a/home/mvp/mvp_db/hodost-lv/2016/2016_03_10_04_56/2016_03_10_21_54.mpg;Kenji Eda.jpg;64965;65013;91161;3251;3253;2
/net/per610a/home/mvp/mvp_db/hodost-lv/2016/2016_03_10_04_56/2016_03_10_21_54.mpg;Kenji Eda.jpg;68389;68497;91161;3422;3427;5
/net/per610a/home/mvp/mvp_db/hodost-lv/2016/2016_03_10_04_56/2016_03_10_21_54.mpg;Yukio EDANO.jpg;67885;68017;91161;3397;3403;6
/net/per610a/home/mvp/mvp_db/hodost-lv/2016/2016_03_13_04_56/2016_03_13_16_30.mpg;Shinzo ABE.jpg;65777;65881;107961;3291;3297;6
/net/per610a/home/mvp/mvp_db/hodost-lv/2016/2016_03_13_04_56/2016_03_13_16_30.mpg;Shinzo ABE.jpg;88249;88493;107961;4416;4428;12
/net/per610a/home/mvp/mvp_db/hodost-lv/2016/2016_03_13_04_56/2016_03_13_16_30.mpg;Shinzo ABE.jpg;88901;89089;107961;4449;4458;9
/net/per610a/home/mvp/mvp_db/hodost-lv/2016/2016_03_16_04_56/2016_03_16_22_09.mpg;Shinzo ABE.jpg;39469;39589;91161;1975;1981;6
/net/per610a/home/mvp/mvp_db/hodost-lv/2016/2016_03_20_04_56/2016_03_20_16_30.mpg;Yorihisa Matsuno.png;53657;54109;107949;2685;2707;22
/net/per610a/home/mvp/mvp_db/hodost-lv/2016/2016_03_23_04_56/2016_03_23_21_54.mpg;Shinzo ABE.jpg;49925;50021;91169;2498;2503;5
/net/per610a/home/mvp/mvp_db/hodost-lv/2016/2016_03_23_04_56/2016_03_23_21_54.mpg;Shinzo ABE.jpg;62281;62397;91169;3117;3122;5
/net/per610a/home/mvp/mvp_db/hodost-lv/2016/2016_03_24_04_56/2016_03_24_21_54.mpg;Shinzo ABE.jpg;34465;34465;91169;1724;1724;0
/net/per610a/home/mvp/mvp_db/hodost-lv/2016/2016_03_24_04_56/2016_03_24_21_54.mpg;Shinzo ABE.jpg;34529;34889;91169;1728;1746;18
/net/per610a/home/mvp/mvp_db/hodost-lv/2016/2016_03_24_04_56/2016_03_24_21_54.mpg;Kenji Eda.jpg;54957;55201;91169;2750;2762;12
/net/per610a/home/mvp/mvp_db/hodost-lv/2016/2016_03_25_04_56/2016_03_25_21_54.mpg;Shinzo ABE.jpg;18677;18677;91169;934;934;0
/net/per610a/home/mvp/mvp_db/hodost-lv/2016/2016_03_25_04_56/2016_03_25_21_54.mpg;Shinzo ABE.jpg;19041;19065;91169;953;954;1
/net/per610a/home/mvp/mvp_db/hodost-lv/2016/2016_03_25_04_56/2016_03_25_21_54.mpg;Shinzo ABE.jpg;19133;19133;91169;957;957;0
/net/per610a/home/mvp/mvp_db/hodost-lv/2016/2016_03_25_04_56/2016_03_25_21_54.mpg;Shinzo ABE.jpg;19293;19597;91169;965;980;15
/net/per610a/home/mvp/mvp_db/hodost-lv/2016/2016_03_25_04_56/2016_03_25_21_54.mpg;Shinzo ABE.jpg;19753;20001;91169;988;1001;13
/net/per610a/home/mvp/mvp_db/hodost-lv/2016/2016_03_25_04_56/2016_03_25_21_54.mpg;Shinzo ABE.jpg;20733;20773;91169;1037;1039;2
/net/per610a/home/mvp/mvp_db/hodost-lv/2016/2016_03_27_04_56/2016_03_27_16_30.mpg;Sadakazu TANIGAKI.jpg;53601;53797;107949;2682;2692;10
/net/per610a/home/mvp/mvp_db/hodost-lv/2016/2016_03_29_04_56/2016_03_29_21_35.mpg;Junichiro KOIZUMI.jpg;34293;34477;113949;1716;1725;9
/net/per610a/home/mvp/mvp_db/hodost-lv/2016/2016_03_30_04_56/2016_03_30_21_54.mpg;Natsuo YAMAGUCHI.jpg;57465;57481;91169;2876;2876;0
/net/per610a/home/mvp/mvp_db/hodost-lv/2016/2016_03_30_04_56/2016_03_30_21_54.mpg;Natsuo YAMAGUCHI.jpg;57749;57869;91169;2890;2896;6
/net/per610a/home/mvp/mvp_db/hodost-lv/2016/2016_03_30_04_56/2016_03_30_21_54.mpg;Natsuo YAMAGUCHI.jpg;58025;58377;91169;2904;2921;17
/net/per610a/home/mvp/mvp_db/hodost-lv/2016/2016_03_31_04_56/2016_03_31_21_54.mpg;Shinzo ABE.jpg;20573;20841;91169;1029;1043;14
/net/per610a/home/mvp/mvp_db/hodost-lv/2016/2016_03_31_04_56/2016_03_31_21_54.mpg;Shinzo ABE.jpg;21297;21785;91169;1065;1090;25
/net/per610a/home/mvp/mvp_db/hodost-lv/2016/2016_03_31_04_56/2016_03_31_21_54.mpg;Shinzo ABE.jpg;24141;24241;91169;1208;1213;5
/net/per610a/home/mvp/mvp_db/hodost-lv/2016/2016_04_11_04_56/2016_04_11_21_54.mpg;Shinzo ABE.jpg;33821;33945;91169;1692;1698;6
/net/per610a/home/mvp/mvp_db/hodost-lv/2016/2016_04_12_04_56/2016_04_12_21_54.mpg;Shinzo ABE.jpg;41153;41173;91169;2059;2060;1
/net/per610a/home/mvp/mvp_db/hodost-lv/2016/2016_04_12_04_56/2016_04_12_21_54.mpg;Shinzo ABE.jpg;41269;41537;91169;2065;2078;13
/net/per610a/home/mvp/mvp_db/hodost-lv/2016/2016_04_13_04_56/2016_04_13_21_54.mpg;Shinzo ABE.jpg;24061;24293;91169;1204;1215;11
/net/per610a/home/mvp/mvp_db/hodost-lv/2016/2016_04_13_04_56/2016_04_13_21_54.mpg;Shinzo ABE.jpg;53157;53297;91169;2660;2667;7
/net/per610a/home/mvp/mvp_db/hodost-lv/2016/2016_04_14_04_56/2016_04_14_21_54.mpg;Shinzo ABE.jpg;61617;61625;91169;3083;3084;1
/net/per610a/home/mvp/mvp_db/hodost-lv/2016/2016_04_14_04_56/2016_04_14_21_54.mpg;Shinzo ABE.jpg;61753;61933;91169;3090;3099;9
/net/per610a/home/mvp/mvp_db/hodost-lv/2016/2016_04_14_04_56/2016_04_14_21_54.mpg;Shinzo ABE.jpg;74153;74157;91169;3711;3711;0
/net/per610a/home/mvp/mvp_db/hodost-lv/2016/2016_04_19_04_56/2016_04_19_21_54.mpg;Sadakazu TANIGAKI.jpg;55433;55785;91169;2773;2791;18
/net/per610a/home/mvp/mvp_db/hodost-lv/2016/2016_04_25_04_56/2016_04_25_21_54.mpg;Yukio EDANO.jpg;32485;32665;91169;1625;1634;9
/net/per610a/home/mvp/mvp_db/hodost-lv/2016/2016_04_26_04_56/2016_04_26_21_54.mpg;Shinzo ABE.jpg;30921;30965;91169;1547;1549;2
/net/per610a/home/mvp/mvp_db/hodost-lv/2016/2016_04_26_04_56/2016_04_26_21_54.mpg;Shinzo ABE.jpg;32121;32189;91169;1607;1611;4
/net/per610a/home/mvp/mvp_db/hodost-lv/2016/2016_04_26_04_56/2016_04_26_21_54.mpg;Shinzo ABE.jpg;33185;33257;91169;1660;1664;4
/net/per610a/home/mvp/mvp_db/hodost-lv/2016/2016_04_26_04_56/2016_04_26_21_54.mpg;Shinzo ABE.jpg;33329;33369;91169;1668;1670;2
/net/per610a/home/mvp/mvp_db/hodost-lv/2016/2016_04_26_04_56/2016_04_26_21_54.mpg;Shinzo ABE.jpg;33657;33661;91169;1684;1684;0
/net/per610a/home/mvp/mvp_db/hodost-lv/2016/2016_04_26_04_56/2016_04_26_21_54.mpg;Shinzo ABE.jpg;55729;55853;91169;2789;2795;6
/net/per610a/home/mvp/mvp_db/hodost-lv/2016/2016_04_26_04_56/2016_04_26_21_54.mpg;Shinzo ABE.jpg;30973;31017;91169;1550;1552;2
/net/per610a/home/mvp/mvp_db/hodost-lv/2016/2016_04_26_04_56/2016_04_26_21_54.mpg;Shinzo ABE.jpg;33005;33077;91169;1651;1655;4
/net/per610a/home/mvp/mvp_db/hodost-lv/2016/2016_04_26_04_56/2016_04_26_21_54.mpg;Shinzo ABE.jpg;33725;33933;91169;1687;1698;11
/net/per610a/home/mvp/mvp_db/hodost-lv/2016/2016_05_02_04_56/2016_05_02_21_54.mpg;Shinzo ABE.jpg;55561;55609;91169;2780;2783;3
/net/per610a/home/mvp/mvp_db/hodost-lv/2016/2016_05_02_04_56/2016_05_02_21_54.mpg;Shinzo ABE.jpg;55873;55941;91169;2796;2799;3
/net/per610a/home/mvp/mvp_db/hodost-lv/2016/2016_05_02_04_56/2016_05_02_21_54.mpg;Toru Hashimoto.jpg;89877;89973;91169;4498;4503;5
/net/per610a/home/mvp/mvp_db/hodost-lv/2016/2016_05_03_04_56/2016_05_03_21_54.mpg;Shinzo ABE.jpg;11789;12065;91169;590;603;13
/net/per610a/home/mvp/mvp_db/hodost-lv/2016/2016_05_03_04_56/2016_05_03_21_54.mpg;Shinzo ABE.jpg;49125;49237;91169;2458;2464;6
/net/per610a/home/mvp/mvp_db/hodost-lv/2016/2016_05_05_04_56/2016_05_05_21_54.mpg;Shinzo ABE.jpg;53541;54033;91169;2679;2704;25
/net/per610a/home/mvp/mvp_db/hodost-lv/2016/2016_05_10_04_56/2016_05_10_21_54.mpg;Shinzo ABE.jpg;1073;1777;91169;53;88;35
/net/per610a/home/mvp/mvp_db/hodost-lv/2016/2016_05_10_04_56/2016_05_10_21_54.mpg;Shinzo ABE.jpg;5377;5877;91169;269;294;25
/net/per610a/home/mvp/mvp_db/hodost-lv/2016/2016_05_10_04_56/2016_05_10_21_54.mpg;Shinzo ABE.jpg;13197;14393;91169;660;720;60
/net/per610a/home/mvp/mvp_db/hodost-lv/2016/2016_05_15_04_56/2016_05_15_16_30.mpg;Shinzo ABE.jpg;21849;21949;107949;1093;1098;5
/net/per610a/home/mvp/mvp_db/hodost-lv/2016/2016_05_15_04_56/2016_05_15_16_30.mpg;Shinzo ABE.jpg;22181;22285;107949;1109;1115;6
/net/per610a/home/mvp/mvp_db/hodost-lv/2016/2016_05_15_04_56/2016_05_15_16_30.mpg;Shinzo ABE.jpg;22393;22521;107949;1120;1126;6
/net/per610a/home/mvp/mvp_db/hodost-lv/2016/2016_05_15_04_56/2016_05_15_16_30.mpg;Shinzo ABE.jpg;88521;88577;107949;4429;4432;3
/net/per610a/home/mvp/mvp_db/hodost-lv/2016/2016_05_15_04_56/2016_05_15_16_30.mpg;Shinzo ABE.jpg;88657;88761;107949;4436;4441;5
/net/per610a/home/mvp/mvp_db/hodost-lv/2016/2016_05_16_04_56/2016_05_16_21_54.mpg;Shinzo ABE.jpg;40249;40513;91169;2014;2027;13
/net/per610a/home/mvp/mvp_db/hodost-lv/2016/2016_05_16_04_56/2016_05_16_21_54.mpg;Shinzo ABE.jpg;44001;44357;91169;2202;2220;18
/net/per610a/home/mvp/mvp_db/hodost-lv/2016/2016_05_16_04_56/2016_05_16_21_54.mpg;Shinzo ABE.jpg;44869;44925;91169;2245;2248;3
/net/per610a/home/mvp/mvp_db/hodost-lv/2016/2016_05_17_04_56/2016_05_17_21_54.mpg;Shinzo ABE.jpg;24401;24485;91169;1221;1225;4
/net/per610a/home/mvp/mvp_db/hodost-lv/2016/2016_05_17_04_56/2016_05_17_21_54.mpg;Shinzo ABE.jpg;24781;25321;91169;1240;1267;27
/net/per610a/home/mvp/mvp_db/hodost-lv/2016/2016_05_17_04_56/2016_05_17_21_54.mpg;Shinzo ABE.jpg;25385;25541;91169;1270;1278;8
/net/per610a/home/mvp/mvp_db/hodost-lv/2016/2016_05_17_04_56/2016_05_17_21_54.mpg;Shinzo ABE.jpg;26661;26901;91169;1334;1346;12
/net/per610a/home/mvp/mvp_db/hodost-lv/2016/2016_05_18_04_56/2016_05_18_21_54.mpg;Shinzo ABE.jpg;25593;25701;91169;1280;1286;6
/net/per610a/home/mvp/mvp_db/hodost-lv/2016/2016_05_18_04_56/2016_05_18_21_54.mpg;Shinzo ABE.jpg;25925;26569;91169;1297;1329;32
/net/per610a/home/mvp/mvp_db/hodost-lv/2016/2016_05_18_04_56/2016_05_18_21_54.mpg;Shinzo ABE.jpg;27865;28553;91169;1394;1429;35
/net/per610a/home/mvp/mvp_db/hodost-lv/2016/2016_05_18_04_56/2016_05_18_21_54.mpg;Shinzo ABE.jpg;29725;29961;91169;1487;1499;12
/net/per610a/home/mvp/mvp_db/hodost-lv/2016/2016_05_18_04_56/2016_05_18_21_54.mpg;Shinzo ABE.jpg;31825;32221;91169;1592;1612;20
/net/per610a/home/mvp/mvp_db/hodost-lv/2016/2016_05_18_04_56/2016_05_18_21_54.mpg;Junichiro KOIZUMI.jpg;55609;56041;91169;2783;2804;21
/net/per610a/home/mvp/mvp_db/hodost-lv/2016/2016_05_18_04_56/2016_05_18_21_54.mpg;Junichiro KOIZUMI.jpg;56209;56285;91169;2813;2817;4
/net/per610a/home/mvp/mvp_db/hodost-lv/2016/2016_05_18_04_56/2016_05_18_21_54.mpg;Junichiro KOIZUMI.jpg;57121;57425;91169;2858;2874;16
/net/per610a/home/mvp/mvp_db/hodost-lv/2016/2016_05_19_04_56/2016_05_19_21_54.mpg;Shinzo ABE.jpg;20929;21005;91169;1047;1051;4
/net/per610a/home/mvp/mvp_db/hodost-lv/2016/2016_05_19_04_56/2016_05_19_21_54.mpg;Shinzo ABE.jpg;26421;26541;91169;1322;1328;6
/net/per610a/home/mvp/mvp_db/hodost-lv/2016/2016_05_20_04_56/2016_05_20_21_54.mpg;Shinzo ABE.jpg;34585;34797;91169;1730;1741;11
/net/per610a/home/mvp/mvp_db/hodost-lv/2016/2016_05_20_04_56/2016_05_20_21_54.mpg;Taro ASO.jpg;35217;35697;91169;1762;1786;24
/net/per610a/home/mvp/mvp_db/hodost-lv/2016/2016_05_22_04_56/2016_05_22_16_30.mpg;Shinzo ABE.jpg;79165;79229;107949;3961;3964;3
/net/per610a/home/mvp/mvp_db/hodost-lv/2016/2016_05_22_04_56/2016_05_22_16_30.mpg;Shinzo ABE.jpg;80481;80541;107949;4027;4030;3
/net/per610a/home/mvp/mvp_db/hodost-lv/2016/2016_05_22_04_56/2016_05_22_16_30.mpg;Shinzo ABE.jpg;87969;88105;107949;4402;4408;6
/net/per610a/home/mvp/mvp_db/hodost-lv/2016/2016_05_22_04_56/2016_05_22_16_30.mpg;Shinzo ABE.jpg;88233;88373;107949;4415;4422;7
/net/per610a/home/mvp/mvp_db/hodost-lv/2016/2016_05_22_04_56/2016_05_22_16_30.mpg;Shinzo ABE.jpg;89389;89525;107949;4473;4480;7
/net/per610a/home/mvp/mvp_db/hodost-lv/2016/2016_05_22_04_56/2016_05_22_16_30.mpg;Shinzo ABE.jpg;89653;89793;107949;4486;4493;7
/net/per610a/home/mvp/mvp_db/hodost-lv/2016/2016_05_23_04_56/2016_05_23_21_54.mpg;Toru Hashimoto.jpg;89861;89957;91161;4496;4501;5
/net/per610a/home/mvp/mvp_db/hodost-lv/2016/2016_05_24_04_56/2016_05_24_21_54.mpg;Natsuo YAMAGUCHI.jpg;29517;29753;91169;1477;1489;12
/net/per610a/home/mvp/mvp_db/hodost-lv/2016/2016_05_25_04_56/2016_05_25_21_54.mpg;Shinzo ABE.jpg;1765;1773;91169;88;88;0
/net/per610a/home/mvp/mvp_db/hodost-lv/2016/2016_05_25_04_56/2016_05_25_21_54.mpg;Shinzo ABE.jpg;5777;5777;91169;289;289;0
/net/per610a/home/mvp/mvp_db/hodost-lv/2016/2016_05_25_04_56/2016_05_25_21_54.mpg;Shinzo ABE.jpg;5977;6009;91169;299;300;1
/net/per610a/home/mvp/mvp_db/hodost-lv/2016/2016_05_25_04_56/2016_05_25_21_54.mpg;Shinzo ABE.jpg;60253;60449;91169;3015;3025;10
/net/per610a/home/mvp/mvp_db/hodost-lv/2016/2016_05_25_04_56/2016_05_25_21_54.mpg;Shinzo ABE.jpg;60677;60769;91169;3036;3041;5
/net/per610a/home/mvp/mvp_db/hodost-lv/2016/2016_05_25_04_56/2016_05_25_21_54.mpg;Shinzo ABE.jpg;60973;61609;91169;3051;3083;32
/net/per610a/home/mvp/mvp_db/hodost-lv/2016/2016_05_25_04_56/2016_05_25_21_54.mpg;Shinzo ABE.jpg;62093;62325;91169;3107;3119;12
/net/per610a/home/mvp/mvp_db/hodost-lv/2016/2016_05_25_04_56/2016_05_25_21_54.mpg;Shinzo ABE.jpg;63033;63165;91169;3154;3161;7
/net/per610a/home/mvp/mvp_db/hodost-lv/2016/2016_05_25_04_56/2016_05_25_21_54.mpg;Shinzo ABE.jpg;63873;64185;91169;3196;3212;16
/net/per610a/home/mvp/mvp_db/hodost-lv/2016/2016_05_25_04_56/2016_05_25_21_54.mpg;Shinzo ABE.jpg;64581;65061;91169;3232;3256;24
/net/per610a/home/mvp/mvp_db/hodost-lv/2016/2016_05_25_04_56/2016_05_25_21_54.mpg;Shinzo ABE.jpg;65677;65961;91169;3287;3301;14
/net/per610a/home/mvp/mvp_db/hodost-lv/2016/2016_05_25_04_56/2016_05_25_21_54.mpg;Shinzo ABE.jpg;66337;66389;91169;3320;3322;2
/net/per610a/home/mvp/mvp_db/hodost-lv/2016/2016_05_25_04_56/2016_05_25_21_54.mpg;Shinzo ABE.jpg;67473;67889;91169;3377;3397;20
/net/per610a/home/mvp/mvp_db/hodost-lv/2016/2016_05_25_04_56/2016_05_25_21_54.mpg;Shinzo ABE.jpg;70601;70693;91169;3533;3538;5
/net/per610a/home/mvp/mvp_db/hodost-lv/2016/2016_05_25_04_56/2016_05_25_21_54.mpg;Shinzo ABE.jpg;77761;77957;91169;3891;3901;10
/net/per610a/home/mvp/mvp_db/hodost-lv/2016/2016_05_25_04_56/2016_05_25_21_54.mpg;Shinzo ABE.jpg;65973;66017;91169;3301;3304;3
/net/per610a/home/mvp/mvp_db/hodost-lv/2016/2016_05_25_04_56/2016_05_25_21_54.mpg;Shinzo ABE.jpg;66397;66737;91169;3323;3340;17
/net/per610a/home/mvp/mvp_db/hodost-lv/2016/2016_05_25_04_56/2016_05_25_21_54.mpg;Shinzo ABE.jpg;68713;68849;91169;3439;3445;6
/net/per610a/home/mvp/mvp_db/hodost-lv/2016/2016_05_26_04_56/2016_05_26_21_54.mpg;Shinzo ABE.jpg;22701;22909;91169;1136;1146;10
/net/per610a/home/mvp/mvp_db/hodost-lv/2016/2016_05_26_04_56/2016_05_26_21_54.mpg;Shinzo ABE.jpg;33265;33929;91169;1664;1698;34
/net/per610a/home/mvp/mvp_db/hodost-lv/2016/2016_05_26_04_56/2016_05_26_21_54.mpg;Shinzo ABE.jpg;35073;35109;91169;1755;1757;2
/net/per610a/home/mvp/mvp_db/hodost-lv/2016/2016_05_27_04_56/2016_05_27_21_54.mpg;Shinzo ABE.jpg;17029;17229;91169;852;862;10
/net/per610a/home/mvp/mvp_db/hodost-lv/2016/2016_05_27_04_56/2016_05_27_21_54.mpg;Shinzo ABE.jpg;37205;37337;91169;1862;1868;6
/net/per610a/home/mvp/mvp_db/hodost-lv/2016/2016_05_27_04_56/2016_05_27_21_54.mpg;Shinzo ABE.jpg;48445;48481;91169;2424;2426;2
/net/per610a/home/mvp/mvp_db/hodost-lv/2016/2016_05_27_04_56/2016_05_27_21_54.mpg;Shinzo ABE.jpg;59745;60061;91169;2990;3006;16
/net/per610a/home/mvp/mvp_db/hodost-lv/2016/2016_05_29_04_56/2016_05_29_16_30.mpg;Shinzo ABE.jpg;68045;68105;107949;3405;3408;3
/net/per610a/home/mvp/mvp_db/hodost-lv/2016/2016_05_29_04_56/2016_05_29_16_30.mpg;Shinzo ABE.jpg;76461;76533;107949;3826;3829;3
/net/per610a/home/mvp/mvp_db/hodost-lv/2016/2016_05_30_04_56/2016_05_30_21_54.mpg;Shinzo ABE.jpg;8809;8861;91169;440;443;3
/net/per610a/home/mvp/mvp_db/hodost-lv/2016/2016_05_30_04_56/2016_05_30_21_54.mpg;Shinzo ABE.jpg;9373;9545;91169;469;477;8
/net/per610a/home/mvp/mvp_db/hodost-lv/2016/2016_05_30_04_56/2016_05_30_21_54.mpg;Shinzo ABE.jpg;10561;10637;91169;528;532;4
/net/per610a/home/mvp/mvp_db/hodost-lv/2016/2016_05_30_04_56/2016_05_30_21_54.mpg;Shinzo ABE.jpg;15297;15485;91169;765;775;10
/net/per610a/home/mvp/mvp_db/hodost-lv/2016/2016_05_30_04_56/2016_05_30_21_54.mpg;Shinzo ABE.jpg;23097;23797;91169;1156;1191;35
/net/per610a/home/mvp/mvp_db/hodost-lv/2016/2016_05_30_04_56/2016_05_30_21_54.mpg;Shinzo ABE.jpg;23989;24317;91169;1200;1217;17
/net/per610a/home/mvp/mvp_db/hodost-lv/2016/2016_05_30_04_56/2016_05_30_21_54.mpg;Shinzo ABE.jpg;24441;24565;91169;1223;1229;6
/net/per610a/home/mvp/mvp_db/hodost-lv/2016/2016_05_30_04_56/2016_05_30_21_54.mpg;Shinzo ABE.jpg;26281;26297;91169;1315;1316;1
/net/per610a/home/mvp/mvp_db/hodost-lv/2016/2016_05_30_04_56/2016_05_30_21_54.mpg;Shinzo ABE.jpg;10325;10369;91169;516;518;2
/net/per610a/home/mvp/mvp_db/hodost-lv/2016/2016_05_30_04_56/2016_05_30_21_54.mpg;Shinzo ABE.jpg;28733;28905;91169;1438;1446;8
/net/per610a/home/mvp/mvp_db/hodost-lv/2016/2016_05_30_04_56/2016_05_30_21_54.mpg;Taro ASO.jpg;11237;11825;91169;562;591;29
/net/per610a/home/mvp/mvp_db/hodost-lv/2016/2016_05_30_04_56/2016_05_30_21_54.mpg;Sadakazu TANIGAKI.jpg;18329;18465;91169;917;924;7
/net/per610a/home/mvp/mvp_db/hodost-lv/2016/2016_05_31_04_56/2016_05_31_21_54.mpg;Taro ASO.jpg;20505;21341;91169;1026;1068;42
/net/per610a/home/mvp/mvp_db/hodost-lv/2016/2016_06_01_04_56/2016_06_01_21_54.mpg;Shinzo ABE.jpg;1209;1657;91169;60;82;22
/net/per610a/home/mvp/mvp_db/hodost-lv/2016/2016_06_01_04_56/2016_06_01_21_54.mpg;Shinzo ABE.jpg;1981;1993;91169;99;99;0
/net/per610a/home/mvp/mvp_db/hodost-lv/2016/2016_06_01_04_56/2016_06_01_21_54.mpg;Shinzo ABE.jpg;4577;5333;91169;229;266;37
/net/per610a/home/mvp/mvp_db/hodost-lv/2016/2016_06_01_04_56/2016_06_01_21_54.mpg;Shinzo ABE.jpg;7781;8577;91169;389;429;40
/net/per610a/home/mvp/mvp_db/hodost-lv/2016/2016_06_01_04_56/2016_06_01_21_54.mpg;Shinzo ABE.jpg;8709;9577;91169;435;479;44
/net/per610a/home/mvp/mvp_db/hodost-lv/2016/2016_06_01_04_56/2016_06_01_21_54.mpg;Shinzo ABE.jpg;11225;11541;91169;561;577;16
/net/per610a/home/mvp/mvp_db/hodost-lv/2016/2016_06_01_04_56/2016_06_01_21_54.mpg;Shinzo ABE.jpg;11853;12537;91169;593;627;34
/net/per610a/home/mvp/mvp_db/hodost-lv/2016/2016_06_01_04_56/2016_06_01_21_54.mpg;Natsuo YAMAGUCHI.jpg;13337;15009;91169;667;751;84
/net/per610a/home/mvp/mvp_db/hodost-lv/2016/2016_06_02_04_56/2016_06_02_21_54.mpg;Shinzo ABE.jpg;22525;22597;91169;1127;1130;3
/net/per610a/home/mvp/mvp_db/hodost-lv/2016/2016_06_02_04_56/2016_06_02_21_54.mpg;Shinzo ABE.jpg;23189;23885;91169;1160;1195;35
/net/per610a/home/mvp/mvp_db/hodost-lv/2016/2016_06_02_04_56/2016_06_02_21_54.mpg;Shinzo ABE.jpg;29481;30081;91169;1475;1505;30
/net/per610a/home/mvp/mvp_db/hodost-lv/2016/2016_06_02_04_56/2016_06_02_21_54.mpg;Shinzo ABE.jpg;30217;30281;91169;1512;1515;3
/net/per610a/home/mvp/mvp_db/hodost-lv/2016/2016_06_09_04_56/2016_06_09_21_54.mpg;Natsuo YAMAGUCHI.jpg;27157;27633;91169;1359;1383;24
/net/per610a/home/mvp/mvp_db/hodost-lv/2016/2016_06_09_04_56/2016_06_09_21_54.mpg;Shinzo ABE.jpg;27877;28037;91169;1395;1403;8
/net/per610a/home/mvp/mvp_db/hodost-lv/2016/2016_06_09_04_56/2016_06_09_21_54.mpg;Ichiro OZAWA.jpg;29449;29633;91169;1473;1483;10
/net/per610a/home/mvp/mvp_db/hodost-lv/2016/2016_06_09_04_56/2016_06_09_21_54.mpg;Ichiro Matsui.jpeg;30461;30749;91169;1524;1538;14
/net/per610a/home/mvp/mvp_db/hodost-lv/2016/2016_06_09_04_56/2016_06_09_21_54.mpg;Kyoko Nakayama.jpg;30461;30749;91169;1524;1538;14
/net/per610a/home/mvp/mvp_db/hodost-lv/2016/2016_06_13_04_56/2016_06_13_21_54.mpg;Toru Hashimoto.jpg;89865;89961;91169;4497;4502;5
/net/per610a/home/mvp/mvp_db/hodost-lv/2016/2016_06_14_04_56/2016_06_14_21_54.mpg;Natsuo YAMAGUCHI.jpg;10429;11249;91169;521;563;42
/net/per610a/home/mvp/mvp_db/hodost-lv/2016/2016_06_14_04_56/2016_06_14_21_54.mpg;Natsuo YAMAGUCHI.jpg;12573;12581;91169;629;629;0
/net/per610a/home/mvp/mvp_db/hodost-lv/2016/2016_06_14_04_56/2016_06_14_21_54.mpg;Natsuo YAMAGUCHI.jpg;13085;13185;91169;654;659;5
/net/per610a/home/mvp/mvp_db/hodost-lv/2016/2016_06_15_04_56/2016_06_15_21_54.mpg;Sadakazu TANIGAKI.jpg;7741;8285;91169;387;414;27
/net/per610a/home/mvp/mvp_db/hodost-lv/2016/2016_06_17_04_56/2016_06_17_21_54.mpg;Naoto KAN.jpg;18533;19373;91169;927;969;42
/net/per610a/home/mvp/mvp_db/hodost-lv/2016/2016_06_19_04_56/2016_06_19_16_30.mpg;Shintaro ISHIHARA.jpg;6009;6113;107949;300;305;5
/net/per610a/home/mvp/mvp_db/hodost-lv/2016/2016_06_20_04_56/2016_06_20_21_54.mpg;Shinzo ABE.jpg;32445;32681;91169;1623;1635;12
/net/per610a/home/mvp/mvp_db/hodost-lv/2016/2016_06_20_04_56/2016_06_20_21_54.mpg;Shinzo ABE.jpg;39209;39473;91169;1962;1975;13
/net/per610a/home/mvp/mvp_db/hodost-lv/2016/2016_06_20_04_56/2016_06_20_21_54.mpg;Shinzo ABE.jpg;39713;39917;91169;1987;1997;10
/net/per610a/home/mvp/mvp_db/hodost-lv/2016/2016_06_20_04_56/2016_06_20_21_54.mpg;Natsuo YAMAGUCHI.jpg;44629;45557;91169;2233;2280;47
/net/per610a/home/mvp/mvp_db/hodost-lv/2016/2016_06_20_04_56/2016_06_20_21_54.mpg;Kyoko Nakayama.jpg;45561;45753;91169;2280;2289;9
/net/per610a/home/mvp/mvp_db/hodost-lv/2016/2016_06_20_04_56/2016_06_20_21_54.mpg;Kazuo SHII.jpg;45841;46493;91169;2294;2326;32
/net/per610a/home/mvp/mvp_db/hodost-lv/2016/2016_06_20_04_56/2016_06_20_21_54.mpg;Tadatomo Yoshida.jpg;46857;47061;91169;2345;2355;10
/net/per610a/home/mvp/mvp_db/hodost-lv/2016/2016_06_21_04_56/2016_06_21_21_54.mpg;Shinzo ABE.jpg;6613;7441;91169;330;372;42
/net/per610a/home/mvp/mvp_db/hodost-lv/2016/2016_06_21_04_56/2016_06_21_21_54.mpg;Shinzo ABE.jpg;7557;7693;91169;378;384;6
/net/per610a/home/mvp/mvp_db/hodost-lv/2016/2016_06_21_04_56/2016_06_21_21_54.mpg;Shinzo ABE.jpg;7881;8245;91169;394;412;18
/net/per610a/home/mvp/mvp_db/hodost-lv/2016/2016_06_21_04_56/2016_06_21_21_54.mpg;Shinzo ABE.jpg;19009;19761;91169;951;988;37
/net/per610a/home/mvp/mvp_db/hodost-lv/2016/2016_06_21_04_56/2016_06_21_21_54.mpg;Shinzo ABE.jpg;20185;20189;91169;1010;1010;0
/net/per610a/home/mvp/mvp_db/hodost-lv/2016/2016_06_21_04_56/2016_06_21_21_54.mpg;Shinzo ABE.jpg;20485;20673;91169;1025;1034;9
/net/per610a/home/mvp/mvp_db/hodost-lv/2016/2016_06_21_04_56/2016_06_21_21_54.mpg;Shinzo ABE.jpg;20881;21065;91169;1044;1054;10
/net/per610a/home/mvp/mvp_db/hodost-lv/2016/2016_06_21_04_56/2016_06_21_21_54.mpg;Shinzo ABE.jpg;23685;23697;91169;1185;1185;0
/net/per610a/home/mvp/mvp_db/hodost-lv/2016/2016_06_21_04_56/2016_06_21_21_54.mpg;Shinzo ABE.jpg;25245;25345;91169;1263;1268;5
/net/per610a/home/mvp/mvp_db/hodost-lv/2016/2016_06_21_04_56/2016_06_21_21_54.mpg;Shinzo ABE.jpg;25893;26353;91169;1295;1318;23
/net/per610a/home/mvp/mvp_db/hodost-lv/2016/2016_06_21_04_56/2016_06_21_21_54.mpg;Shinzo ABE.jpg;26585;26813;91169;1330;1341;11
/net/per610a/home/mvp/mvp_db/hodost-lv/2016/2016_06_21_04_56/2016_06_21_21_54.mpg;Shinzo ABE.jpg;27561;28465;91169;1379;1424;45
/net/per610a/home/mvp/mvp_db/hodost-lv/2016/2016_06_21_04_56/2016_06_21_21_54.mpg;Shinzo ABE.jpg;30737;30737;91169;1538;1538;0
/net/per610a/home/mvp/mvp_db/hodost-lv/2016/2016_06_21_04_56/2016_06_21_21_54.mpg;Shinzo ABE.jpg;32165;32165;91169;1609;1609;0
/net/per610a/home/mvp/mvp_db/hodost-lv/2016/2016_06_21_04_56/2016_06_21_21_54.mpg;Shinzo ABE.jpg;32229;33033;91169;1612;1652;40
/net/per610a/home/mvp/mvp_db/hodost-lv/2016/2016_06_21_04_56/2016_06_21_21_54.mpg;Shinzo ABE.jpg;33137;33537;91169;1658;1678;20
/net/per610a/home/mvp/mvp_db/hodost-lv/2016/2016_06_21_04_56/2016_06_21_21_54.mpg;Shinzo ABE.jpg;34385;35193;91169;1720;1761;41
/net/per610a/home/mvp/mvp_db/hodost-lv/2016/2016_06_21_04_56/2016_06_21_21_54.mpg;Shinzo ABE.jpg;35385;35489;91169;1770;1775;5
/net/per610a/home/mvp/mvp_db/hodost-lv/2016/2016_06_21_04_56/2016_06_21_21_54.mpg;Shinzo ABE.jpg;39093;39117;91169;1956;1957;1
/net/per610a/home/mvp/mvp_db/hodost-lv/2016/2016_06_21_04_56/2016_06_21_21_54.mpg;Shinzo ABE.jpg;39217;39497;91169;1962;1976;14
/net/per610a/home/mvp/mvp_db/hodost-lv/2016/2016_06_21_04_56/2016_06_21_21_54.mpg;Shinzo ABE.jpg;39673;40285;91169;1985;2015;30
/net/per610a/home/mvp/mvp_db/hodost-lv/2016/2016_06_21_04_56/2016_06_21_21_54.mpg;Shinzo ABE.jpg;41165;42565;91169;2059;2129;70
/net/per610a/home/mvp/mvp_db/hodost-lv/2016/2016_06_21_04_56/2016_06_21_21_54.mpg;Shinzo ABE.jpg;45925;47165;91169;2298;2360;62
/net/per610a/home/mvp/mvp_db/hodost-lv/2016/2016_06_21_04_56/2016_06_21_21_54.mpg;Shinzo ABE.jpg;47281;48009;91169;2365;2402;37
/net/per610a/home/mvp/mvp_db/hodost-lv/2016/2016_06_21_04_56/2016_06_21_21_54.mpg;Shinzo ABE.jpg;48393;48489;91169;2421;2426;5
/net/per610a/home/mvp/mvp_db/hodost-lv/2016/2016_06_21_04_56/2016_06_21_21_54.mpg;Shinzo ABE.jpg;49317;49449;91169;2467;2474;7
/net/per610a/home/mvp/mvp_db/hodost-lv/2016/2016_06_21_04_56/2016_06_21_21_54.mpg;Shinzo ABE.jpg;50677;50821;91169;2535;2543;8
/net/per610a/home/mvp/mvp_db/hodost-lv/2016/2016_06_21_04_56/2016_06_21_21_54.mpg;Shinzo ABE.jpg;53473;54425;91169;2675;2723;48
/net/per610a/home/mvp/mvp_db/hodost-lv/2016/2016_06_21_04_56/2016_06_21_21_54.mpg;Shinzo ABE.jpg;54685;54781;91169;2736;2741;5
/net/per610a/home/mvp/mvp_db/hodost-lv/2016/2016_06_21_04_56/2016_06_21_21_54.mpg;Shinzo ABE.jpg;54981;55361;91169;2751;2770;19
/net/per610a/home/mvp/mvp_db/hodost-lv/2016/2016_06_21_04_56/2016_06_21_21_54.mpg;Shinzo ABE.jpg;55781;56589;91169;2791;2831;40
/net/per610a/home/mvp/mvp_db/hodost-lv/2016/2016_06_21_04_56/2016_06_21_21_54.mpg;Shinzo ABE.jpg;56665;56725;91169;2835;2838;3
/net/per610a/home/mvp/mvp_db/hodost-lv/2016/2016_06_21_04_56/2016_06_21_21_54.mpg;Shinzo ABE.jpg;56857;57045;91169;2845;2854;9
/net/per610a/home/mvp/mvp_db/hodost-lv/2016/2016_06_21_04_56/2016_06_21_21_54.mpg;Shinzo ABE.jpg;57257;57361;91169;2865;2870;5
/net/per610a/home/mvp/mvp_db/hodost-lv/2016/2016_06_21_04_56/2016_06_21_21_54.mpg;Shinzo ABE.jpg;58961;59353;91169;2950;2969;19
/net/per610a/home/mvp/mvp_db/hodost-lv/2016/2016_06_21_04_56/2016_06_21_21_54.mpg;Shinzo ABE.jpg;60273;60369;91169;3015;3020;5
/net/per610a/home/mvp/mvp_db/hodost-lv/2016/2016_06_21_04_56/2016_06_21_21_54.mpg;Shinzo ABE.jpg;60649;60737;91169;3034;3039;5
/net/per610a/home/mvp/mvp_db/hodost-lv/2016/2016_06_21_04_56/2016_06_21_21_54.mpg;Kazuo SHII.jpg;10161;10357;91169;508;518;10
/net/per610a/home/mvp/mvp_db/hodost-lv/2016/2016_06_21_04_56/2016_06_21_21_54.mpg;Kazuo SHII.jpg;10465;10545;91169;523;527;4
/net/per610a/home/mvp/mvp_db/hodost-lv/2016/2016_06_21_04_56/2016_06_21_21_54.mpg;Kazuo SHII.jpg;10833;11033;91169;542;552;10
/net/per610a/home/mvp/mvp_db/hodost-lv/2016/2016_06_21_04_56/2016_06_21_21_54.mpg;Kazuo SHII.jpg;20689;20717;91169;1035;1036;1
/net/per610a/home/mvp/mvp_db/hodost-lv/2016/2016_06_21_04_56/2016_06_21_21_54.mpg;Kazuo SHII.jpg;22065;22165;91169;1104;1109;5
/net/per610a/home/mvp/mvp_db/hodost-lv/2016/2016_06_21_04_56/2016_06_21_21_54.mpg;Kazuo SHII.jpg;22681;23125;91169;1134;1157;23
/net/per610a/home/mvp/mvp_db/hodost-lv/2016/2016_06_21_04_56/2016_06_21_21_54.mpg;Kazuo SHII.jpg;24693;24701;91169;1235;1236;1
/net/per610a/home/mvp/mvp_db/hodost-lv/2016/2016_06_21_04_56/2016_06_21_21_54.mpg;Kazuo SHII.jpg;24777;24777;91169;1239;1239;0
/net/per610a/home/mvp/mvp_db/hodost-lv/2016/2016_06_21_04_56/2016_06_21_21_54.mpg;Kazuo SHII.jpg;27081;27213;91169;1355;1361;6
/net/per610a/home/mvp/mvp_db/hodost-lv/2016/2016_06_21_04_56/2016_06_21_21_54.mpg;Kazuo SHII.jpg;50597;50821;91169;2531;2543;12
/net/per610a/home/mvp/mvp_db/hodost-lv/2016/2016_06_21_04_56/2016_06_21_21_54.mpg;Kazuo SHII.jpg;55417;55457;91169;2773;2775;2
/net/per610a/home/mvp/mvp_db/hodost-lv/2016/2016_06_21_04_56/2016_06_21_21_54.mpg;Kazuo SHII.jpg;55553;56589;91169;2779;2831;52
/net/per610a/home/mvp/mvp_db/hodost-lv/2016/2016_06_21_04_56/2016_06_21_21_54.mpg;Toranosuke Katayama.jpg;11121;11501;91169;556;575;19
/net/per610a/home/mvp/mvp_db/hodost-lv/2016/2016_06_21_04_56/2016_06_21_21_54.mpg;Toranosuke Katayama.jpg;11681;11825;91169;584;591;7
/net/per610a/home/mvp/mvp_db/hodost-lv/2016/2016_06_21_04_56/2016_06_21_21_54.mpg;Toranosuke Katayama.jpg;11921;12197;91169;596;610;14
/net/per610a/home/mvp/mvp_db/hodost-lv/2016/2016_06_21_04_56/2016_06_21_21_54.mpg;Toranosuke Katayama.jpg;12777;13241;91169;639;662;23
/net/per610a/home/mvp/mvp_db/hodost-lv/2016/2016_06_21_04_56/2016_06_21_21_54.mpg;Toranosuke Katayama.jpg;29613;29921;91169;1481;1497;16
/net/per610a/home/mvp/mvp_db/hodost-lv/2016/2016_06_21_04_56/2016_06_21_21_54.mpg;Toranosuke Katayama.jpg;30053;30225;91169;1503;1512;9
/net/per610a/home/mvp/mvp_db/hodost-lv/2016/2016_06_21_04_56/2016_06_21_21_54.mpg;Toranosuke Katayama.jpg;30409;30469;91169;1521;1524;3
/net/per610a/home/mvp/mvp_db/hodost-lv/2016/2016_06_21_04_56/2016_06_21_21_54.mpg;Taro Yamamoto.jpg;13485;13749;91169;674;687;13
/net/per610a/home/mvp/mvp_db/hodost-lv/2016/2016_06_21_04_56/2016_06_21_21_54.mpg;Taro Yamamoto.jpg;14013;14309;91169;701;716;15
/net/per610a/home/mvp/mvp_db/hodost-lv/2016/2016_06_21_04_56/2016_06_21_21_54.mpg;Taro Yamamoto.jpg;35493;35725;91169;1776;1787;11
/net/per610a/home/mvp/mvp_db/hodost-lv/2016/2016_06_21_04_56/2016_06_21_21_54.mpg;Taro Yamamoto.jpg;36021;36061;91169;1802;1804;2
/net/per610a/home/mvp/mvp_db/hodost-lv/2016/2016_06_21_04_56/2016_06_21_21_54.mpg;Taro Yamamoto.jpg;36237;36237;91169;1813;1813;0
/net/per610a/home/mvp/mvp_db/hodost-lv/2016/2016_06_21_04_56/2016_06_21_21_54.mpg;Taro Yamamoto.jpg;36517;36621;91169;1827;1832;5
/net/per610a/home/mvp/mvp_db/hodost-lv/2016/2016_06_21_04_56/2016_06_21_21_54.mpg;Taro Yamamoto.jpg;59413;59749;91169;2972;2989;17
/net/per610a/home/mvp/mvp_db/hodost-lv/2016/2016_06_21_04_56/2016_06_21_21_54.mpg;Tadatomo Yoshida.jpg;14473;15161;91169;724;758;34
/net/per610a/home/mvp/mvp_db/hodost-lv/2016/2016_06_21_04_56/2016_06_21_21_54.mpg;Tadatomo Yoshida.jpg;15793;15881;91169;790;794;4
/net/per610a/home/mvp/mvp_db/hodost-lv/2016/2016_06_21_04_56/2016_06_21_21_54.mpg;Kyoko Nakayama.jpg;15969;16437;91169;799;822;23
/net/per610a/home/mvp/mvp_db/hodost-lv/2016/2016_06_21_04_56/2016_06_21_21_54.mpg;Kyoko Nakayama.jpg;16657;16989;91169;833;850;17
/net/per610a/home/mvp/mvp_db/hodost-lv/2016/2016_06_21_04_56/2016_06_21_21_54.mpg;Kyoko Nakayama.jpg;57977;58325;91169;2901;2918;17
/net/per610a/home/mvp/mvp_db/hodost-lv/2016/2016_06_21_04_56/2016_06_21_21_54.mpg;Kyoko Nakayama.jpg;58517;58525;91169;2928;2928;0
/net/per610a/home/mvp/mvp_db/hodost-lv/2016/2016_06_21_04_56/2016_06_21_21_54.mpg;Natsuo YAMAGUCHI.jpg;48593;48857;91169;2431;2444;13
/net/per610a/home/mvp/mvp_db/hodost-lv/2016/2016_06_22_04_56/2016_06_22_21_54.mpg;Shinzo ABE.jpg;18749;18889;91169;938;945;7
/net/per610a/home/mvp/mvp_db/hodost-lv/2016/2016_06_22_04_56/2016_06_22_21_54.mpg;Taro Yamamoto.jpg;20397;21541;91169;1020;1078;58
/net/per610a/home/mvp/mvp_db/hodost-lv/2016/2016_06_23_04_56/2016_06_23_21_54.mpg;Shinzo ABE.jpg;36165;36565;91169;1810;1830;20
/net/per610a/home/mvp/mvp_db/hodost-lv/2016/2016_06_23_04_56/2016_06_23_21_54.mpg;Shinzo ABE.jpg;46969;47565;91169;2350;2380;30
/net/per610a/home/mvp/mvp_db/hodost-lv/2016/2016_06_24_04_56/2016_06_24_21_54.mpg;Taro ASO.jpg;17169;17593;91169;859;880;21
/net/per610a/home/mvp/mvp_db/hodost-lv/2016/2016_06_24_04_56/2016_06_24_21_54.mpg;Shinzo ABE.jpg;18849;19213;91169;943;961;18
/net/per610a/home/mvp/mvp_db/hodost-lv/2016/2016_06_27_04_56/2016_06_27_21_54.mpg;Kohei Otsuka.jpg;83893;84113;91161;4198;4209;11
/net/per610a/home/mvp/mvp_db/hodost-lv/2016/2016_06_28_04_56/2016_06_28_21_54.mpg;Shinzo ABE.jpg;44593;44677;91169;2231;2236;5
/net/per610a/home/mvp/mvp_db/hodost-lv/2016/2016_06_28_04_56/2016_06_28_21_54.mpg;Shinzo ABE.jpg;45585;45665;91169;2281;2285;4
/net/per610a/home/mvp/mvp_db/hodost-lv/2016/2016_06_28_04_56/2016_06_28_21_54.mpg;Shinzo ABE.jpg;45849;46249;91169;2294;2314;20
/net/per610a/home/mvp/mvp_db/hodost-lv/2016/2016_06_28_04_56/2016_06_28_21_54.mpg;Shinzo ABE.jpg;47285;47325;91169;2366;2368;2
/net/per610a/home/mvp/mvp_db/hodost-lv/2016/2016_06_29_04_56/2016_06_29_21_54.mpg;YUriko Koike.jpg;26733;26921;91169;1337;1347;10
/net/per610a/home/mvp/mvp_db/hodost-lv/2016/2016_06_29_04_56/2016_06_29_21_54.mpg;YUriko Koike.jpg;27241;27377;91169;1363;1370;7
/net/per610a/home/mvp/mvp_db/hodost-lv/2016/2016_06_29_04_56/2016_06_29_21_54.mpg;YUriko Koike.jpg;27953;28717;91169;1399;1437;38
/net/per610a/home/mvp/mvp_db/hodost-lv/2016/2016_06_29_04_56/2016_06_29_21_54.mpg;YUriko Koike.jpg;30245;30773;91169;1513;1540;27
/net/per610a/home/mvp/mvp_db/hodost-lv/2016/2016_06_29_04_56/2016_06_29_21_54.mpg;YUriko Koike.jpg;34101;34273;91169;1706;1715;9
/net/per610a/home/mvp/mvp_db/hodost-lv/2016/2016_07_01_04_56/2016_07_01_21_54.mpg;YUriko Koike.jpg;12581;12677;91169;629;634;5
/net/per610a/home/mvp/mvp_db/hodost-lv/2016/2016_07_01_04_56/2016_07_01_21_54.mpg;Shinzo ABE.jpg;26745;26825;91169;1338;1342;4
/net/per610a/home/mvp/mvp_db/hodost-lv/2016/2016_07_03_04_56/2016_07_03_16_30.mpg;Shinzo ABE.jpg;10465;11073;107949;523;554;31
/net/per610a/home/mvp/mvp_db/hodost-lv/2016/2016_07_03_04_56/2016_07_03_16_30.mpg;YUriko Koike.jpg;89765;90097;107949;4492;4508;16
/net/per610a/home/mvp/mvp_db/hodost-lv/2016/2016_07_04_04_56/2016_07_04_21_54.mpg;Kazuo SHII.jpg;33517;33669;91169;1677;1685;8
/net/per610a/home/mvp/mvp_db/hodost-lv/2016/2016_07_04_04_56/2016_07_04_21_54.mpg;YUriko Koike.jpg;57261;57445;91169;2865;2875;10
/net/per610a/home/mvp/mvp_db/hodost-lv/2016/2016_07_04_04_56/2016_07_04_21_54.mpg;YUriko Koike.jpg;60025;60605;91169;3004;3033;29
/net/per610a/home/mvp/mvp_db/hodost-lv/2016/2016_07_05_04_56/2016_07_05_21_54.mpg;Ichiro OZAWA.jpg;23569;24349;91169;1179;1218;39
/net/per610a/home/mvp/mvp_db/hodost-lv/2016/2016_07_05_04_56/2016_07_05_21_54.mpg;Junichiro KOIZUMI.jpg;29021;29281;91169;1452;1465;13
/net/per610a/home/mvp/mvp_db/hodost-lv/2016/2016_07_05_04_56/2016_07_05_21_54.mpg;Junichiro KOIZUMI.jpg;29513;29837;91169;1477;1493;16
/net/per610a/home/mvp/mvp_db/hodost-lv/2016/2016_07_05_04_56/2016_07_05_21_54.mpg;Junichiro KOIZUMI.jpg;30021;30473;91169;1502;1525;23
/net/per610a/home/mvp/mvp_db/hodost-lv/2016/2016_07_05_04_56/2016_07_05_21_54.mpg;YUriko Koike.jpg;32369;32477;91169;1620;1625;5
/net/per610a/home/mvp/mvp_db/hodost-lv/2016/2016_07_07_04_56/2016_07_07_21_54.mpg;Renho.jpg;22273;22649;91169;1114;1133;19
/net/per610a/home/mvp/mvp_db/hodost-lv/2016/2016_07_07_04_56/2016_07_07_21_54.mpg;Renho.jpg;22953;23637;91169;1148;1183;35
/net/per610a/home/mvp/mvp_db/hodost-lv/2016/2016_07_08_04_56/2016_07_08_21_54.mpg;Kazuo SHII.jpg;20933;21101;91169;1047;1056;9
/net/per610a/home/mvp/mvp_db/hodost-lv/2016/2016_07_08_04_56/2016_07_08_21_54.mpg;Kazuo SHII.jpg;26325;26809;91169;1317;1341;24
/net/per610a/home/mvp/mvp_db/hodost-lv/2016/2016_07_08_04_56/2016_07_08_21_54.mpg;Kazuo SHII.jpg;27133;27609;91169;1358;1381;23
/net/per610a/home/mvp/mvp_db/hodost-lv/2016/2016_07_08_04_56/2016_07_08_21_54.mpg;Kazuo SHII.jpg;28593;28681;91169;1431;1435;4
/net/per610a/home/mvp/mvp_db/hodost-lv/2016/2016_07_08_04_56/2016_07_08_21_54.mpg;Shinzo ABE.jpg;22181;22193;91169;1110;1110;0
/net/per610a/home/mvp/mvp_db/hodost-lv/2016/2016_07_08_04_56/2016_07_08_21_54.mpg;Shinzo ABE.jpg;22449;22825;91169;1123;1142;19
/net/per610a/home/mvp/mvp_db/hodost-lv/2016/2016_07_08_04_56/2016_07_08_21_54.mpg;Natsuo YAMAGUCHI.jpg;24909;25013;91169;1246;1251;5
/net/per610a/home/mvp/mvp_db/hodost-lv/2016/2016_07_08_04_56/2016_07_08_21_54.mpg;Natsuo YAMAGUCHI.jpg;25089;25449;91169;1255;1273;18
/net/per610a/home/mvp/mvp_db/hodost-lv/2016/2016_07_08_04_56/2016_07_08_21_54.mpg;Natsuo YAMAGUCHI.jpg;25709;26189;91169;1286;1310;24
/net/per610a/home/mvp/mvp_db/hodost-lv/2016/2016_07_08_04_56/2016_07_08_21_54.mpg;Ichiro Matsui.jpeg;27829;28589;91169;1392;1430;38
/net/per610a/home/mvp/mvp_db/hodost-lv/2016/2016_07_08_04_56/2016_07_08_21_54.mpg;YUriko Koike.jpg;53409;53621;91169;2673;2683;10
/net/per610a/home/mvp/mvp_db/hodost-lv/2016/2016_07_11_04_56/2016_07_11_21_54.mpg;Shinzo ABE.jpg;2685;2857;91161;134;142;8
/net/per610a/home/mvp/mvp_db/hodost-lv/2016/2016_07_11_04_56/2016_07_11_21_54.mpg;Shinzo ABE.jpg;3029;3029;91161;151;151;0
/net/per610a/home/mvp/mvp_db/hodost-lv/2016/2016_07_11_04_56/2016_07_11_21_54.mpg;Shinzo ABE.jpg;13701;13841;91161;685;692;7
/net/per610a/home/mvp/mvp_db/hodost-lv/2016/2016_07_11_04_56/2016_07_11_21_54.mpg;Shinzo ABE.jpg;17929;18145;91161;897;908;11
/net/per610a/home/mvp/mvp_db/hodost-lv/2016/2016_07_11_04_56/2016_07_11_21_54.mpg;Shinzo ABE.jpg;6893;6921;91161;344;346;2
/net/per610a/home/mvp/mvp_db/hodost-lv/2016/2016_07_11_04_56/2016_07_11_21_54.mpg;Shinzo ABE.jpg;7033;7217;91161;351;361;10
/net/per610a/home/mvp/mvp_db/hodost-lv/2016/2016_07_11_04_56/2016_07_11_21_54.mpg;Shinzo ABE.jpg;10137;10649;91161;507;532;25
/net/per610a/home/mvp/mvp_db/hodost-lv/2016/2016_07_11_04_56/2016_07_11_21_54.mpg;Shinzo ABE.jpg;10813;11389;91161;541;569;28
/net/per610a/home/mvp/mvp_db/hodost-lv/2016/2016_07_11_04_56/2016_07_11_21_54.mpg;Shinzo ABE.jpg;14465;14585;91161;723;729;6
/net/per610a/home/mvp/mvp_db/hodost-lv/2016/2016_07_11_04_56/2016_07_11_21_54.mpg;Shinzo ABE.jpg;14649;15345;91161;733;767;34
/net/per610a/home/mvp/mvp_db/hodost-lv/2016/2016_07_11_04_56/2016_07_11_21_54.mpg;Shinzo ABE.jpg;15413;15501;91161;771;775;4
/net/per610a/home/mvp/mvp_db/hodost-lv/2016/2016_07_11_04_56/2016_07_11_21_54.mpg;Natsuo YAMAGUCHI.jpg;9841;10085;91161;492;504;12
/net/per610a/home/mvp/mvp_db/hodost-lv/2016/2016_07_12_04_56/2016_07_12_21_54.mpg;YUriko Koike.jpg;5357;5457;91169;268;273;5
/net/per610a/home/mvp/mvp_db/hodost-lv/2016/2016_07_12_04_56/2016_07_12_21_54.mpg;YUriko Koike.jpg;13613;14493;91169;681;725;44
/net/per610a/home/mvp/mvp_db/hodost-lv/2016/2016_07_12_04_56/2016_07_12_21_54.mpg;YUriko Koike.jpg;20693;21185;91169;1035;1060;25
/net/per610a/home/mvp/mvp_db/hodost-lv/2016/2016_07_13_04_56/2016_07_13_22_09.mpg;YUriko Koike.jpg;10417;10485;91169;521;524;3
/net/per610a/home/mvp/mvp_db/hodost-lv/2016/2016_07_13_04_56/2016_07_13_22_09.mpg;YUriko Koike.jpg;13421;13569;91169;671;679;8
/net/per610a/home/mvp/mvp_db/hodost-lv/2016/2016_07_13_04_56/2016_07_13_22_09.mpg;YUriko Koike.jpg;13677;13729;91169;684;687;3
/net/per610a/home/mvp/mvp_db/hodost-lv/2016/2016_07_13_04_56/2016_07_13_22_09.mpg;YUriko Koike.jpg;18629;19121;91169;932;957;25
/net/per610a/home/mvp/mvp_db/hodost-lv/2016/2016_07_13_04_56/2016_07_13_22_09.mpg;YUriko Koike.jpg;20969;21757;91169;1049;1088;39
/net/per610a/home/mvp/mvp_db/hodost-lv/2016/2016_07_13_04_56/2016_07_13_22_09.mpg;YUriko Koike.jpg;25985;26549;91169;1300;1328;28
/net/per610a/home/mvp/mvp_db/hodost-lv/2016/2016_07_13_04_56/2016_07_13_22_09.mpg;YUriko Koike.jpg;26809;26877;91169;1341;1345;4
/net/per610a/home/mvp/mvp_db/hodost-lv/2016/2016_07_13_04_56/2016_07_13_22_09.mpg;YUriko Koike.jpg;27069;27381;91169;1354;1370;16
/net/per610a/home/mvp/mvp_db/hodost-lv/2016/2016_07_13_04_56/2016_07_13_22_09.mpg;YUriko Koike.jpg;27533;28325;91169;1378;1417;39
/net/per610a/home/mvp/mvp_db/hodost-lv/2016/2016_07_13_04_56/2016_07_13_22_09.mpg;YUriko Koike.jpg;28781;29077;91169;1440;1455;15
/net/per610a/home/mvp/mvp_db/hodost-lv/2016/2016_07_13_04_56/2016_07_13_22_09.mpg;YUriko Koike.jpg;29165;29549;91169;1459;1478;19
/net/per610a/home/mvp/mvp_db/hodost-lv/2016/2016_07_13_04_56/2016_07_13_22_09.mpg;YUriko Koike.jpg;29625;29933;91169;1482;1498;16
/net/per610a/home/mvp/mvp_db/hodost-lv/2016/2016_07_13_04_56/2016_07_13_22_09.mpg;YUriko Koike.jpg;30657;31265;91169;1534;1564;30
/net/per610a/home/mvp/mvp_db/hodost-lv/2016/2016_07_13_04_56/2016_07_13_22_09.mpg;YUriko Koike.jpg;38693;38901;91169;1936;1946;10
/net/per610a/home/mvp/mvp_db/hodost-lv/2016/2016_07_13_04_56/2016_07_13_22_09.mpg;YUriko Koike.jpg;39073;39353;91169;1955;1969;14
/net/per610a/home/mvp/mvp_db/hodost-lv/2016/2016_07_13_04_56/2016_07_13_22_09.mpg;YUriko Koike.jpg;39473;39525;91169;1975;1978;3
/net/per610a/home/mvp/mvp_db/hodost-lv/2016/2016_07_13_04_56/2016_07_13_22_09.mpg;YUriko Koike.jpg;41609;42229;91169;2082;2113;31
/net/per610a/home/mvp/mvp_db/hodost-lv/2016/2016_07_13_04_56/2016_07_13_22_09.mpg;YUriko Koike.jpg;44037;44641;91169;2204;2234;30
/net/per610a/home/mvp/mvp_db/hodost-lv/2016/2016_07_13_04_56/2016_07_13_22_09.mpg;YUriko Koike.jpg;44761;45409;91169;2240;2272;32
/net/per610a/home/mvp/mvp_db/hodost-lv/2016/2016_07_13_04_56/2016_07_13_22_09.mpg;YUriko Koike.jpg;47557;47565;91169;2380;2380;0
/net/per610a/home/mvp/mvp_db/hodost-lv/2016/2016_07_13_04_56/2016_07_13_22_09.mpg;YUriko Koike.jpg;48605;48909;91169;2432;2447;15
/net/per610a/home/mvp/mvp_db/hodost-lv/2016/2016_07_13_04_56/2016_07_13_22_09.mpg;YUriko Koike.jpg;48989;49317;91169;2451;2468;17
/net/per610a/home/mvp/mvp_db/hodost-lv/2016/2016_07_14_04_56/2016_07_14_22_09.mpg;Shinzo ABE.jpg;6205;6601;91169;310;330;20
/net/per610a/home/mvp/mvp_db/hodost-lv/2016/2016_07_14_04_56/2016_07_14_22_09.mpg;Shinzo ABE.jpg;49701;49785;91169;2487;2491;4
/net/per610a/home/mvp/mvp_db/hodost-lv/2016/2016_07_14_04_56/2016_07_14_22_09.mpg;Shinzo ABE.jpg;50289;50473;91169;2516;2526;10
/net/per610a/home/mvp/mvp_db/hodost-lv/2016/2016_07_17_04_56/2016_07_17_16_30.mpg;Shinzo ABE.jpg;26417;26429;107949;1321;1322;1
/net/per610a/home/mvp/mvp_db/hodost-lv/2016/2016_07_17_04_56/2016_07_17_16_30.mpg;Shinzo ABE.jpg;26677;26881;107949;1334;1345;11
/net/per610a/home/mvp/mvp_db/hodost-lv/2016/2016_07_17_04_56/2016_07_17_16_30.mpg;Shinzo ABE.jpg;26973;27009;107949;1349;1351;2
/net/per610a/home/mvp/mvp_db/hodost-lv/2016/2016_07_18_04_56/2016_07_18_21_54.mpg;YUriko Koike.jpg;6413;6609;91169;320;330;10
/net/per610a/home/mvp/mvp_db/hodost-lv/2016/2016_07_18_04_56/2016_07_18_21_54.mpg;YUriko Koike.jpg;7617;7877;91169;381;394;13
/net/per610a/home/mvp/mvp_db/hodost-lv/2016/2016_07_18_04_56/2016_07_18_21_54.mpg;Toru Hashimoto.jpg;89873;89977;91169;4498;4503;5
/net/per610a/home/mvp/mvp_db/hodost-lv/2016/2016_07_19_04_56/2016_07_19_21_54.mpg;Ichiro OZAWA.jpg;27897;28265;91169;1395;1414;19
/net/per610a/home/mvp/mvp_db/hodost-lv/2016/2016_07_19_04_56/2016_07_19_21_54.mpg;Shinzo ABE.jpg;30925;31229;91169;1547;1562;15
/net/per610a/home/mvp/mvp_db/hodost-lv/2016/2016_07_21_04_56/2016_07_21_21_54.mpg;YUriko Koike.jpg;43393;43589;91169;2171;2181;10
/net/per610a/home/mvp/mvp_db/hodost-lv/2016/2016_07_21_04_56/2016_07_21_21_54.mpg;YUriko Koike.jpg;43733;43853;91169;2188;2194;6
/net/per610a/home/mvp/mvp_db/hodost-lv/2016/2016_07_25_04_56/2016_07_25_21_54.mpg;YUriko Koike.jpg;4729;5081;91169;236;254;18
/net/per610a/home/mvp/mvp_db/hodost-lv/2016/2016_07_25_04_56/2016_07_25_21_54.mpg;YUriko Koike.jpg;13001;13297;91169;650;665;15
/net/per610a/home/mvp/mvp_db/hodost-lv/2016/2016_07_26_04_56/2016_07_26_21_54.mpg;Shinzo ABE.jpg;52033;52077;91169;2604;2606;2
/net/per610a/home/mvp/mvp_db/hodost-lv/2016/2016_07_26_04_56/2016_07_26_21_54.mpg;Shinzo ABE.jpg;52269;52357;91169;2616;2620;4
/net/per610a/home/mvp/mvp_db/hodost-lv/2016/2016_07_27_04_56/2016_07_27_21_54.mpg;Shinzo ABE.jpg;51633;52081;91169;2584;2606;22
/net/per610a/home/mvp/mvp_db/hodost-lv/2016/2016_07_28_04_56/2016_07_28_21_54.mpg;Shinzo ABE.jpg;49585;49985;91161;2481;2501;20
/net/per610a/home/mvp/mvp_db/hodost-lv/2016/2016_07_29_04_56/2016_07_29_21_54.mpg;Shinzo ABE.jpg;20569;20945;91169;1029;1048;19
/net/per610a/home/mvp/mvp_db/hodost-lv/2016/2016_07_29_04_56/2016_07_29_21_54.mpg;Shinzo ABE.jpg;21937;22161;91169;1097;1109;12
/net/per610a/home/mvp/mvp_db/hodost-lv/2016/2016_07_29_04_56/2016_07_29_21_54.mpg;Shinzo ABE.jpg;22261;22313;91169;1114;1116;2
/net/per610a/home/mvp/mvp_db/hodost-lv/2016/2016_07_29_04_56/2016_07_29_21_54.mpg;Shinzo ABE.jpg;22377;22469;91169;1119;1124;5
/net/per610a/home/mvp/mvp_db/hodost-lv/2016/2016_07_29_04_56/2016_07_29_21_54.mpg;Shinzo ABE.jpg;24721;24905;91169;1237;1246;9
/net/per610a/home/mvp/mvp_db/hodost-lv/2016/2016_08_01_04_56/2016_08_01_21_54.mpg;YUriko Koike.jpg;9693;9741;91169;485;487;2
/net/per610a/home/mvp/mvp_db/hodost-lv/2016/2016_08_01_04_56/2016_08_01_21_54.mpg;YUriko Koike.jpg;9885;10109;91169;494;505;11
/net/per610a/home/mvp/mvp_db/hodost-lv/2016/2016_08_01_04_56/2016_08_01_21_54.mpg;YUriko Koike.jpg;10353;10733;91169;518;537;19
/net/per610a/home/mvp/mvp_db/hodost-lv/2016/2016_08_01_04_56/2016_08_01_21_54.mpg;YUriko Koike.jpg;11017;11117;91169;551;556;5
/net/per610a/home/mvp/mvp_db/hodost-lv/2016/2016_08_01_04_56/2016_08_01_21_54.mpg;YUriko Koike.jpg;16753;16769;91169;838;839;1
/net/per610a/home/mvp/mvp_db/hodost-lv/2016/2016_08_01_04_56/2016_08_01_21_54.mpg;YUriko Koike.jpg;11389;12369;91169;570;619;49
/net/per610a/home/mvp/mvp_db/hodost-lv/2016/2016_08_01_04_56/2016_08_01_21_54.mpg;YUriko Koike.jpg;12649;14029;91169;633;702;69
/net/per610a/home/mvp/mvp_db/hodost-lv/2016/2016_08_01_04_56/2016_08_01_21_54.mpg;YUriko Koike.jpg;17869;18005;91169;894;901;7
/net/per610a/home/mvp/mvp_db/hodost-lv/2016/2016_08_01_04_56/2016_08_01_21_54.mpg;YUriko Koike.jpg;18561;18885;91169;928;945;17
/net/per610a/home/mvp/mvp_db/hodost-lv/2016/2016_08_01_04_56/2016_08_01_21_54.mpg;YUriko Koike.jpg;19085;19145;91169;955;958;3
/net/per610a/home/mvp/mvp_db/hodost-lv/2016/2016_08_01_04_56/2016_08_01_21_54.mpg;Ichiro OZAWA.jpg;21013;21085;91169;1051;1055;4
/net/per610a/home/mvp/mvp_db/hodost-lv/2016/2016_08_01_04_56/2016_08_01_21_54.mpg;Ichiro OZAWA.jpg;22413;22481;91169;1121;1125;4
/net/per610a/home/mvp/mvp_db/hodost-lv/2016/2016_08_01_04_56/2016_08_01_21_54.mpg;Ichiro OZAWA.jpg;23365;23693;91169;1169;1185;16
/net/per610a/home/mvp/mvp_db/hodost-lv/2016/2016_08_01_04_56/2016_08_01_21_54.mpg;Ichiro OZAWA.jpg;29097;29273;91169;1456;1465;9
/net/per610a/home/mvp/mvp_db/hodost-lv/2016/2016_08_01_04_56/2016_08_01_21_54.mpg;Shinzo ABE.jpg;23253;23309;91169;1163;1166;3
/net/per610a/home/mvp/mvp_db/hodost-lv/2016/2016_08_01_04_56/2016_08_01_21_54.mpg;Yoshimi WATANABE.jpg;24553;25097;91169;1228;1256;28
/net/per610a/home/mvp/mvp_db/hodost-lv/2016/2016_08_01_04_56/2016_08_01_21_54.mpg;Yoshimi WATANABE.jpg;27101;27237;91169;1356;1363;7
/net/per610a/home/mvp/mvp_db/hodost-lv/2016/2016_08_02_04_56/2016_08_02_21_54.mpg;Taro ASO.jpg;31149;31449;91169;1559;1574;15
/net/per610a/home/mvp/mvp_db/hodost-lv/2016/2016_08_02_04_56/2016_08_02_21_54.mpg;Shinzo ABE.jpg;31817;31997;91169;1592;1601;9
/net/per610a/home/mvp/mvp_db/hodost-lv/2016/2016_08_03_04_56/2016_08_03_21_54.mpg;Shinzo ABE.jpg;5165;5517;91169;258;276;18
/net/per610a/home/mvp/mvp_db/hodost-lv/2016/2016_08_03_04_56/2016_08_03_21_54.mpg;Shinzo ABE.jpg;16649;16697;91169;833;835;2
/net/per610a/home/mvp/mvp_db/hodost-lv/2016/2016_08_03_04_56/2016_08_03_21_54.mpg;YUriko Koike.jpg;17753;17945;91169;888;898;10
/net/per610a/home/mvp/mvp_db/hodost-lv/2016/2016_08_03_04_56/2016_08_03_21_54.mpg;Ichiro OZAWA.jpg;21693;21805;91169;1085;1091;6
/net/per610a/home/mvp/mvp_db/hodost-lv/2016/2016_08_03_04_56/2016_08_03_21_54.mpg;Ichiro OZAWA.jpg;27529;27861;91169;1377;1394;17
/net/per610a/home/mvp/mvp_db/hodost-lv/2016/2016_08_03_04_56/2016_08_03_21_54.mpg;Taro ASO.jpg;22217;22561;91169;1111;1129;18
/net/per610a/home/mvp/mvp_db/hodost-lv/2016/2016_08_04_04_56/2016_08_04_21_54.mpg;Shinzo ABE.jpg;3281;3325;91169;164;166;2
/net/per610a/home/mvp/mvp_db/hodost-lv/2016/2016_08_04_04_56/2016_08_04_21_54.mpg;Shinzo ABE.jpg;3953;3981;91169;197;199;2
/net/per610a/home/mvp/mvp_db/hodost-lv/2016/2016_08_04_04_56/2016_08_04_21_54.mpg;Shinzo ABE.jpg;4481;4481;91169;224;224;0
/net/per610a/home/mvp/mvp_db/hodost-lv/2016/2016_08_04_04_56/2016_08_04_21_54.mpg;Shinzo ABE.jpg;19697;19737;91169;985;987;2
/net/per610a/home/mvp/mvp_db/hodost-lv/2016/2016_08_04_04_56/2016_08_04_21_54.mpg;Shinzo ABE.jpg;20245;20369;91169;1013;1019;6
/net/per610a/home/mvp/mvp_db/hodost-lv/2016/2016_08_04_04_56/2016_08_04_21_54.mpg;YUriko Koike.jpg;3381;3433;91169;169;171;2
/net/per610a/home/mvp/mvp_db/hodost-lv/2016/2016_08_04_04_56/2016_08_04_21_54.mpg;YUriko Koike.jpg;19797;19849;91169;990;993;3
/net/per610a/home/mvp/mvp_db/hodost-lv/2016/2016_08_04_04_56/2016_08_04_21_54.mpg;Shintaro ISHIHARA.jpg;12649;12697;91169;633;635;2
/net/per610a/home/mvp/mvp_db/hodost-lv/2016/2016_08_04_04_56/2016_08_04_21_54.mpg;Shintaro ISHIHARA.jpg;13757;13933;91169;688;697;9
/net/per610a/home/mvp/mvp_db/hodost-lv/2016/2016_08_04_04_56/2016_08_04_21_54.mpg;Renho.jpg;54609;54993;91169;2733;2752;19
/net/per610a/home/mvp/mvp_db/hodost-lv/2016/2016_08_05_04_56/2016_08_05_21_54.mpg;YUriko Koike.jpg;41105;41769;91169;2057;2090;33
/net/per610a/home/mvp/mvp_db/hodost-lv/2016/2016_08_07_04_56/2016_08_07_16_30.mpg;YUriko Koike.jpg;59577;59749;107949;2981;2989;8
/net/per610a/home/mvp/mvp_db/hodost-lv/2016/2016_08_10_04_56/2016_08_10_21_54.mpg;YUriko Koike.jpg;26085;26933;91169;1305;1347;42
/net/per610a/home/mvp/mvp_db/hodost-lv/2016/2016_08_12_04_56/2016_08_12_21_54.mpg;YUriko Koike.jpg;31389;31609;91169;1571;1582;11
/net/per610a/home/mvp/mvp_db/hodost-lv/2016/2016_08_15_04_56/2016_08_15_21_54.mpg;Shinzo ABE.jpg;5653;5925;91169;282;296;14
/net/per610a/home/mvp/mvp_db/hodost-lv/2016/2016_08_16_04_56/2016_08_16_21_54.mpg;YUriko Koike.jpg;40417;40525;91169;2022;2028;6
/net/per610a/home/mvp/mvp_db/hodost-lv/2016/2016_08_16_04_56/2016_08_16_21_54.mpg;YUriko Koike.jpg;40753;41701;91169;2039;2087;48
/net/per610a/home/mvp/mvp_db/hodost-lv/2016/2016_08_16_04_56/2016_08_16_21_54.mpg;YUriko Koike.jpg;42513;42753;91169;2127;2139;12
/net/per610a/home/mvp/mvp_db/hodost-lv/2016/2016_08_16_04_56/2016_08_16_21_54.mpg;YUriko Koike.jpg;43669;43685;91169;2185;2186;1
/net/per610a/home/mvp/mvp_db/hodost-lv/2016/2016_08_16_04_56/2016_08_16_21_54.mpg;Shinzo ABE.jpg;62421;62545;91169;3124;3130;6
/net/per610a/home/mvp/mvp_db/hodost-lv/2016/2016_08_18_04_56/2016_08_18_21_54.mpg;YUriko Koike.jpg;62109;62333;91169;3108;3119;11
/net/per610a/home/mvp/mvp_db/hodost-lv/2016/2016_08_18_04_56/2016_08_18_21_54.mpg;Shinzo ABE.jpg;64341;64441;91169;3220;3225;5
/net/per610a/home/mvp/mvp_db/hodost-lv/2016/2016_08_18_04_56/2016_08_18_21_54.mpg;Shinzo ABE.jpg;66253;66381;91169;3315;3322;7
/net/per610a/home/mvp/mvp_db/hodost-lv/2016/2016_08_18_04_56/2016_08_18_21_54.mpg;Shinzo ABE.jpg;66457;66645;91169;3326;3335;9
/net/per610a/home/mvp/mvp_db/hodost-lv/2016/2016_08_19_04_56/2016_08_19_21_54.mpg;Shinzo ABE.jpg;34077;34317;91169;1705;1717;12
/net/per610a/home/mvp/mvp_db/hodost-lv/2016/2016_08_19_04_56/2016_08_19_21_54.mpg;Shinzo ABE.jpg;34493;34585;91169;1726;1730;4
/net/per610a/home/mvp/mvp_db/hodost-lv/2016/2016_08_19_04_56/2016_08_19_21_54.mpg;YUriko Koike.jpg;85469;85641;91169;4277;4286;9
/net/per610a/home/mvp/mvp_db/hodost-lv/2016/2016_08_21_04_56/2016_08_21_16_30.mpg;YUriko Koike.jpg;74929;75021;107949;3749;3754;5
/net/per610a/home/mvp/mvp_db/hodost-lv/2016/2016_08_21_04_56/2016_08_21_16_30.mpg;YUriko Koike.jpg;75025;75181;107949;3754;3762;8
/net/per610a/home/mvp/mvp_db/hodost-lv/2016/2016_08_22_04_56/2016_08_22_21_54.mpg;YUriko Koike.jpg;30681;30825;91169;1535;1542;7
/net/per610a/home/mvp/mvp_db/hodost-lv/2016/2016_08_22_04_56/2016_08_22_21_54.mpg;YUriko Koike.jpg;31377;31385;91169;1570;1570;0
/net/per610a/home/mvp/mvp_db/hodost-lv/2016/2016_08_22_04_56/2016_08_22_21_54.mpg;YUriko Koike.jpg;32001;32389;91169;1601;1621;20
/net/per610a/home/mvp/mvp_db/hodost-lv/2016/2016_08_22_04_56/2016_08_22_21_54.mpg;YUriko Koike.jpg;32685;32813;91169;1635;1642;7
/net/per610a/home/mvp/mvp_db/hodost-lv/2016/2016_08_23_04_56/2016_08_23_21_54.mpg;YUriko Koike.jpg;45069;45161;91169;2255;2260;5
/net/per610a/home/mvp/mvp_db/hodost-lv/2016/2016_08_23_04_56/2016_08_23_21_54.mpg;YUriko Koike.jpg;45397;45653;91169;2272;2284;12
/net/per610a/home/mvp/mvp_db/hodost-lv/2016/2016_08_24_04_56/2016_08_24_21_54.mpg;Shinzo ABE.jpg;23489;23705;91169;1175;1186;11
/net/per610a/home/mvp/mvp_db/hodost-lv/2016/2016_08_24_04_56/2016_08_24_21_54.mpg;Shinzo ABE.jpg;24173;24429;91169;1209;1222;13
/net/per610a/home/mvp/mvp_db/hodost-lv/2016/2016_08_25_04_56/2016_08_25_21_54.mpg;Shinzo ABE.jpg;18453;18577;91169;923;929;6
/net/per610a/home/mvp/mvp_db/hodost-lv/2016/2016_08_25_04_56/2016_08_25_21_54.mpg;Renho.jpg;56409;56721;91169;2823;2838;15
/net/per610a/home/mvp/mvp_db/hodost-lv/2016/2016_08_25_04_56/2016_08_25_21_54.mpg;Renho.jpg;57477;57613;91169;2876;2883;7
/net/per610a/home/mvp/mvp_db/hodost-lv/2016/2016_08_25_04_56/2016_08_25_21_54.mpg;Seiji MAEHARA.jpg;57381;57613;91169;2871;2883;12
/net/per610a/home/mvp/mvp_db/hodost-lv/2016/2016_08_26_04_56/2016_08_26_21_54.mpg;Shinzo ABE.jpg;42137;42285;91169;2108;2116;8
/net/per610a/home/mvp/mvp_db/hodost-lv/2016/2016_08_28_04_56/2016_08_28_16_30.mpg;Shinzo ABE.jpg;35989;35993;107949;1800;1801;1
/net/per610a/home/mvp/mvp_db/hodost-lv/2016/2016_08_28_04_56/2016_08_28_16_30.mpg;Shinzo ABE.jpg;86877;86925;107949;4347;4349;2
/net/per610a/home/mvp/mvp_db/hodost-lv/2016/2016_08_28_04_56/2016_08_28_16_30.mpg;Shinzo ABE.jpg;87173;87861;107949;4362;4396;34
/net/per610a/home/mvp/mvp_db/hodost-lv/2016/2016_08_28_04_56/2016_08_28_16_30.mpg;Shinzo ABE.jpg;89245;89341;107949;4466;4470;4
/net/per610a/home/mvp/mvp_db/hodost-lv/2016/2016_08_28_04_56/2016_08_28_16_30.mpg;Shinzo ABE.jpg;89841;89909;107949;4495;4499;4
/net/per610a/home/mvp/mvp_db/hodost-lv/2016/2016_08_29_04_56/2016_08_29_21_54.mpg;YUriko Koike.jpg;53981;54305;91169;2701;2717;16
/net/per610a/home/mvp/mvp_db/hodost-lv/2016/2016_08_30_04_56/2016_08_30_21_54.mpg;YUriko Koike.jpg;27377;27717;91169;1369;1386;17
/net/per610a/home/mvp/mvp_db/hodost-lv/2016/2016_08_30_04_56/2016_08_30_21_54.mpg;YUriko Koike.jpg;28057;28165;91169;1403;1409;6
/net/per610a/home/mvp/mvp_db/hodost-lv/2016/2016_08_30_04_56/2016_08_30_21_54.mpg;YUriko Koike.jpg;29365;29669;91169;1469;1484;15
/net/per610a/home/mvp/mvp_db/hodost-lv/2016/2016_08_30_04_56/2016_08_30_21_54.mpg;YUriko Koike.jpg;34693;35193;91169;1736;1761;25
/net/per610a/home/mvp/mvp_db/hodost-lv/2016/2016_09_01_04_56/2016_09_01_21_35.mpg;YUriko Koike.jpg;12881;12977;113949;644;649;5
/net/per610a/home/mvp/mvp_db/hodost-lv/2016/2016_09_01_04_56/2016_09_01_21_35.mpg;YUriko Koike.jpg;14945;14973;113949;747;749;2
/net/per610a/home/mvp/mvp_db/hodost-lv/2016/2016_09_01_04_56/2016_09_01_21_35.mpg;YUriko Koike.jpg;15045;15049;113949;752;753;1
/net/per610a/home/mvp/mvp_db/hodost-lv/2016/2016_09_01_04_56/2016_09_01_21_35.mpg;YUriko Koike.jpg;23125;23209;113949;1157;1161;4
/net/per610a/home/mvp/mvp_db/hodost-lv/2016/2016_09_01_04_56/2016_09_01_21_35.mpg;YUriko Koike.jpg;23561;23649;113949;1179;1183;4
/net/per610a/home/mvp/mvp_db/hodost-lv/2016/2016_09_01_04_56/2016_09_01_21_35.mpg;YUriko Koike.jpg;24629;24729;113949;1232;1237;5
/net/per610a/home/mvp/mvp_db/hodost-lv/2016/2016_09_01_04_56/2016_09_01_21_35.mpg;Shinzo ABE.jpg;63557;63573;113949;3180;3181;1
/net/per610a/home/mvp/mvp_db/hodost-lv/2016/2016_09_01_04_56/2016_09_01_21_35.mpg;Shinzo ABE.jpg;65681;65733;113949;3287;3289;2
/net/per610a/home/mvp/mvp_db/hodost-lv/2016/2016_09_01_04_56/2016_09_01_21_35.mpg;Shinzo ABE.jpg;79905;79969;113949;3999;4002;3
/net/per610a/home/mvp/mvp_db/hodost-lv/2016/2016_09_02_04_56/2016_09_02_21_54.mpg;Shinzo ABE.jpg;24765;24765;91169;1239;1239;0
/net/per610a/home/mvp/mvp_db/hodost-lv/2016/2016_09_02_04_56/2016_09_02_21_54.mpg;Shinzo ABE.jpg;25017;25253;91169;1252;1263;11
/net/per610a/home/mvp/mvp_db/hodost-lv/2016/2016_09_02_04_56/2016_09_02_21_54.mpg;Shinzo ABE.jpg;25373;25393;91169;1269;1270;1
/net/per610a/home/mvp/mvp_db/hodost-lv/2016/2016_09_02_04_56/2016_09_02_21_54.mpg;Shinzo ABE.jpg;28645;29241;91169;1433;1463;30
/net/per610a/home/mvp/mvp_db/hodost-lv/2016/2016_09_02_04_56/2016_09_02_21_54.mpg;Shinzo ABE.jpg;34397;34401;91169;1721;1721;0
/net/per610a/home/mvp/mvp_db/hodost-lv/2016/2016_09_02_04_56/2016_09_02_21_54.mpg;Seiji MAEHARA.jpg;39173;39685;91169;1960;1986;26
/net/per610a/home/mvp/mvp_db/hodost-lv/2016/2016_09_04_04_56/2016_09_04_16_30.mpg;YUriko Koike.jpg;58389;58437;107949;2921;2924;3
/net/per610a/home/mvp/mvp_db/hodost-lv/2016/2016_09_04_04_56/2016_09_04_16_30.mpg;YUriko Koike.jpg;58569;58641;107949;2930;2934;4
/net/per610a/home/mvp/mvp_db/hodost-lv/2016/2016_09_04_04_56/2016_09_04_16_30.mpg;Shinzo ABE.jpg;75817;75861;107949;3794;3796;2
/net/per610a/home/mvp/mvp_db/hodost-lv/2016/2016_09_04_04_56/2016_09_04_16_30.mpg;Shinzo ABE.jpg;75949;75953;107949;3800;3800;0
/net/per610a/home/mvp/mvp_db/hodost-lv/2016/2016_09_04_04_56/2016_09_04_16_30.mpg;Shinzo ABE.jpg;76053;76057;107949;3805;3806;1
/net/per610a/home/mvp/mvp_db/hodost-lv/2016/2016_09_04_04_56/2016_09_04_16_30.mpg;Shinzo ABE.jpg;88853;89069;107949;4446;4457;11
/net/per610a/home/mvp/mvp_db/hodost-lv/2016/2016_09_04_04_56/2016_09_04_16_30.mpg;Shinzo ABE.jpg;89209;89481;107949;4464;4477;13
/net/per610a/home/mvp/mvp_db/hodost-lv/2016/2016_09_04_04_56/2016_09_04_16_30.mpg;Shinzo ABE.jpg;89553;89665;107949;4481;4487;6
/net/per610a/home/mvp/mvp_db/hodost-lv/2016/2016_09_05_04_56/2016_09_05_21_54.mpg;Shinzo ABE.jpg;1021;1061;91161;51;53;2
/net/per610a/home/mvp/mvp_db/hodost-lv/2016/2016_09_05_04_56/2016_09_05_21_54.mpg;Shinzo ABE.jpg;1289;1365;91161;64;68;4
/net/per610a/home/mvp/mvp_db/hodost-lv/2016/2016_09_05_04_56/2016_09_05_21_54.mpg;Shinzo ABE.jpg;4957;4997;91161;248;250;2
/net/per610a/home/mvp/mvp_db/hodost-lv/2016/2016_09_05_04_56/2016_09_05_21_54.mpg;Shinzo ABE.jpg;11905;13233;91161;595;662;67
/net/per610a/home/mvp/mvp_db/hodost-lv/2016/2016_09_05_04_56/2016_09_05_21_54.mpg;Shinzo ABE.jpg;26301;26885;91161;1316;1345;29
/net/per610a/home/mvp/mvp_db/hodost-lv/2016/2016_09_05_04_56/2016_09_05_21_54.mpg;Shinzo ABE.jpg;50405;50573;91161;2522;2530;8
/net/per610a/home/mvp/mvp_db/hodost-lv/2016/2016_09_05_04_56/2016_09_05_21_54.mpg;Shinzo ABE.jpg;1641;1757;91161;82;87;5
/net/per610a/home/mvp/mvp_db/hodost-lv/2016/2016_09_05_04_56/2016_09_05_21_54.mpg;Shinzo ABE.jpg;5565;5645;91161;278;282;4
/net/per610a/home/mvp/mvp_db/hodost-lv/2016/2016_09_05_04_56/2016_09_05_21_54.mpg;Shinzo ABE.jpg;5797;5917;91161;290;296;6
/net/per610a/home/mvp/mvp_db/hodost-lv/2016/2016_09_05_04_56/2016_09_05_21_54.mpg;Shinzo ABE.jpg;11673;11809;91161;584;590;6
/net/per610a/home/mvp/mvp_db/hodost-lv/2016/2016_09_05_04_56/2016_09_05_21_54.mpg;Shinzo ABE.jpg;22625;22661;91161;1132;1134;2
/net/per610a/home/mvp/mvp_db/hodost-lv/2016/2016_09_05_04_56/2016_09_05_21_54.mpg;Kyoko Nakayama.jpg;23753;23877;91161;1188;1194;6
/net/per610a/home/mvp/mvp_db/hodost-lv/2016/2016_09_05_04_56/2016_09_05_21_54.mpg;Kyoko Nakayama.jpg;24061;24109;91161;1204;1206;2
/net/per610a/home/mvp/mvp_db/hodost-lv/2016/2016_09_05_04_56/2016_09_05_21_54.mpg;Kyoko Nakayama.jpg;24745;24765;91161;1238;1239;1
/net/per610a/home/mvp/mvp_db/hodost-lv/2016/2016_09_05_04_56/2016_09_05_21_54.mpg;Toru Hashimoto.jpg;89861;89985;91161;4496;4503;7
/net/per610a/home/mvp/mvp_db/hodost-lv/2016/2016_09_08_04_56/2016_09_08_21_54.mpg;YUriko Koike.jpg;50153;50249;91161;2509;2514;5
/net/per610a/home/mvp/mvp_db/hodost-lv/2016/2016_09_08_04_56/2016_09_08_21_54.mpg;YUriko Koike.jpg;50377;50437;91161;2521;2524;3
/net/per610a/home/mvp/mvp_db/hodost-lv/2016/2016_09_09_04_56/2016_09_09_21_54.mpg;Shinzo ABE.jpg;9373;9609;91169;469;480;11
/net/per610a/home/mvp/mvp_db/hodost-lv/2016/2016_09_09_04_56/2016_09_09_21_54.mpg;Shinzo ABE.jpg;25805;25929;91169;1291;1297;6
/net/per610a/home/mvp/mvp_db/hodost-lv/2016/2016_09_09_04_56/2016_09_09_21_54.mpg;Shinzo ABE.jpg;28597;28701;91169;1431;1436;5
/net/per610a/home/mvp/mvp_db/hodost-lv/2016/2016_09_09_04_56/2016_09_09_21_54.mpg;Shinzo ABE.jpg;28949;29233;91169;1448;1463;15
/net/per610a/home/mvp/mvp_db/hodost-lv/2016/2016_09_09_04_56/2016_09_09_21_54.mpg;YUriko Koike.jpg;44581;44853;91169;2231;2244;13
/net/per610a/home/mvp/mvp_db/hodost-lv/2016/2016_09_13_04_56/2016_09_13_21_54.mpg;Renho.jpg;30249;30537;91169;1513;1528;15
/net/per610a/home/mvp/mvp_db/hodost-lv/2016/2016_09_13_04_56/2016_09_13_21_54.mpg;Renho.jpg;31925;31985;91169;1597;1600;3
/net/per610a/home/mvp/mvp_db/hodost-lv/2016/2016_09_13_04_56/2016_09_13_21_54.mpg;Renho.jpg;33453;33665;91169;1674;1684;10
/net/per610a/home/mvp/mvp_db/hodost-lv/2016/2016_09_13_04_56/2016_09_13_21_54.mpg;Renho.jpg;30609;30917;91169;1531;1547;16
/net/per610a/home/mvp/mvp_db/hodost-lv/2016/2016_09_13_04_56/2016_09_13_21_54.mpg;Renho.jpg;34257;34813;91169;1714;1742;28
/net/per610a/home/mvp/mvp_db/hodost-lv/2016/2016_09_14_04_56/2016_09_14_21_54.mpg;YUriko Koike.jpg;19341;19537;91169;968;977;9
/net/per610a/home/mvp/mvp_db/hodost-lv/2016/2016_09_14_04_56/2016_09_14_21_54.mpg;YUriko Koike.jpg;20793;20997;91169;1040;1050;10
/net/per610a/home/mvp/mvp_db/hodost-lv/2016/2016_09_15_04_56/2016_09_15_21_54.mpg;Shintaro ISHIHARA.jpg;2113;2361;91169;105;118;13
/net/per610a/home/mvp/mvp_db/hodost-lv/2016/2016_09_15_04_56/2016_09_15_21_54.mpg;Shintaro ISHIHARA.jpg;6753;8045;91169;337;402;65
/net/per610a/home/mvp/mvp_db/hodost-lv/2016/2016_09_15_04_56/2016_09_15_21_54.mpg;Shintaro ISHIHARA.jpg;8353;8569;91169;418;428;10
/net/per610a/home/mvp/mvp_db/hodost-lv/2016/2016_09_15_04_56/2016_09_15_21_54.mpg;Shintaro ISHIHARA.jpg;11221;11789;91169;561;590;29
/net/per610a/home/mvp/mvp_db/hodost-lv/2016/2016_09_15_04_56/2016_09_15_21_54.mpg;YUriko Koike.jpg;15365;16317;91169;769;816;47
/net/per610a/home/mvp/mvp_db/hodost-lv/2016/2016_09_15_04_56/2016_09_15_21_54.mpg;Renho.jpg;26057;26585;91169;1304;1330;26
/net/per610a/home/mvp/mvp_db/hodost-lv/2016/2016_09_15_04_56/2016_09_15_21_54.mpg;Renho.jpg;27373;27553;91169;1370;1379;9
/net/per610a/home/mvp/mvp_db/hodost-lv/2016/2016_09_15_04_56/2016_09_15_21_54.mpg;Renho.jpg;29025;29181;91169;1452;1460;8
/net/per610a/home/mvp/mvp_db/hodost-lv/2016/2016_09_18_04_56/2016_09_18_16_30.mpg;Renho.jpg;55273;55529;107949;2765;2778;13
/net/per610a/home/mvp/mvp_db/hodost-lv/2016/2016_09_19_04_56/2016_09_19_21_54.mpg;YUriko Koike.jpg;52657;52937;91169;2635;2649;14
/net/per610a/home/mvp/mvp_db/hodost-lv/2016/2016_09_21_04_56/2016_09_21_21_54.mpg;YUriko Koike.jpg;5001;5141;91161;250;257;7
/net/per610a/home/mvp/mvp_db/hodost-lv/2016/2016_09_21_04_56/2016_09_21_21_54.mpg;YUriko Koike.jpg;7321;7697;91161;366;385;19
/net/per610a/home/mvp/mvp_db/hodost-lv/2016/2016_09_21_04_56/2016_09_21_21_54.mpg;YUriko Koike.jpg;10997;11493;91161;550;575;25
/net/per610a/home/mvp/mvp_db/hodost-lv/2016/2016_09_21_04_56/2016_09_21_21_54.mpg;YUriko Koike.jpg;13177;13697;91161;659;685;26
/net/per610a/home/mvp/mvp_db/hodost-lv/2016/2016_09_22_04_56/2016_09_22_21_54.mpg;Shinzo ABE.jpg;47381;47877;91169;2371;2396;25
/net/per610a/home/mvp/mvp_db/hodost-lv/2016/2016_09_23_04_56/2016_09_23_21_54.mpg;YUriko Koike.jpg;9461;9461;91169;473;473;0
/net/per610a/home/mvp/mvp_db/hodost-lv/2016/2016_09_23_04_56/2016_09_23_21_54.mpg;YUriko Koike.jpg;9593;9977;91169;480;499;19
/net/per610a/home/mvp/mvp_db/hodost-lv/2016/2016_09_23_04_56/2016_09_23_21_54.mpg;YUriko Koike.jpg;10781;10941;91169;539;547;8
/net/per610a/home/mvp/mvp_db/hodost-lv/2016/2016_09_23_04_56/2016_09_23_21_54.mpg;YUriko Koike.jpg;11133;11137;91169;557;557;0
/net/per610a/home/mvp/mvp_db/hodost-lv/2016/2016_09_23_04_56/2016_09_23_21_54.mpg;YUriko Koike.jpg;12245;12573;91169;612;629;17
/net/per610a/home/mvp/mvp_db/hodost-lv/2016/2016_09_23_04_56/2016_09_23_21_54.mpg;YUriko Koike.jpg;15029;15293;91169;752;765;13
/net/per610a/home/mvp/mvp_db/hodost-lv/2016/2016_09_23_04_56/2016_09_23_21_54.mpg;YUriko Koike.jpg;17685;17997;91169;885;900;15
/net/per610a/home/mvp/mvp_db/hodost-lv/2016/2016_09_23_04_56/2016_09_23_21_54.mpg;Shinzo ABE.jpg;40897;40929;91169;2046;2048;2
/net/per610a/home/mvp/mvp_db/hodost-lv/2016/2016_09_23_04_56/2016_09_23_21_54.mpg;Shinzo ABE.jpg;41873;42069;91169;2095;2105;10
/net/per610a/home/mvp/mvp_db/hodost-lv/2016/2016_09_23_04_56/2016_09_23_21_54.mpg;Shinzo ABE.jpg;43505;43549;91169;2177;2179;2
/net/per610a/home/mvp/mvp_db/hodost-lv/2016/2016_09_25_04_56/2016_09_25_16_30.mpg;Shinzo ABE.jpg;86649;86713;107949;4336;4339;3
/net/per610a/home/mvp/mvp_db/hodost-lv/2016/2016_09_25_04_56/2016_09_25_16_30.mpg;Shinzo ABE.jpg;86845;86889;107949;4345;4348;3
/net/per610a/home/mvp/mvp_db/hodost-lv/2016/2016_09_25_04_56/2016_09_25_16_30.mpg;Shinzo ABE.jpg;103233;103509;107949;5166;5179;13
/net/per610a/home/mvp/mvp_db/hodost-lv/2016/2016_09_25_04_56/2016_09_25_16_30.mpg;Renho.jpg;102481;102757;107949;5128;5142;14
/net/per610a/home/mvp/mvp_db/hodost-lv/2016/2016_09_26_04_56/2016_09_26_21_54.mpg;Shinzo ABE.jpg;20033;20277;91169;1002;1014;12
/net/per610a/home/mvp/mvp_db/hodost-lv/2016/2016_09_26_04_56/2016_09_26_21_54.mpg;Shinzo ABE.jpg;20561;21073;91169;1029;1054;25
/net/per610a/home/mvp/mvp_db/hodost-lv/2016/2016_09_26_04_56/2016_09_26_21_54.mpg;Shinzo ABE.jpg;21269;22049;91169;1064;1103;39
/net/per610a/home/mvp/mvp_db/hodost-lv/2016/2016_09_26_04_56/2016_09_26_21_54.mpg;Shinzo ABE.jpg;24025;24121;91169;1202;1207;5
/net/per610a/home/mvp/mvp_db/hodost-lv/2016/2016_09_26_04_56/2016_09_26_21_54.mpg;Shinzo ABE.jpg;24445;24793;91169;1223;1240;17
/net/per610a/home/mvp/mvp_db/hodost-lv/2016/2016_09_26_04_56/2016_09_26_21_54.mpg;Shinzo ABE.jpg;49953;49985;91169;2500;2501;1
/net/per610a/home/mvp/mvp_db/hodost-lv/2016/2016_09_26_04_56/2016_09_26_21_54.mpg;Shinzo ABE.jpg;50209;50253;91169;2512;2515;3
/net/per610a/home/mvp/mvp_db/hodost-lv/2016/2016_09_26_04_56/2016_09_26_21_54.mpg;Renho.jpg;25317;25525;91169;1267;1277;10
/net/per610a/home/mvp/mvp_db/hodost-lv/2016/2016_09_26_04_56/2016_09_26_21_54.mpg;YUriko Koike.jpg;30949;31005;91169;1548;1551;3
/net/per610a/home/mvp/mvp_db/hodost-lv/2016/2016_09_26_04_56/2016_09_26_21_54.mpg;YUriko Koike.jpg;31997;32177;91169;1601;1610;9
/net/per610a/home/mvp/mvp_db/hodost-lv/2016/2016_09_26_04_56/2016_09_26_21_54.mpg;Toru Hashimoto.jpg;89869;89965;91169;4497;4502;5
/net/per610a/home/mvp/mvp_db/hodost-lv/2016/2016_09_27_04_56/2016_09_27_21_54.mpg;Yoshihiko Noda.jpg;23733;24081;91161;1187;1205;18
/net/per610a/home/mvp/mvp_db/hodost-lv/2016/2016_09_27_04_56/2016_09_27_21_54.mpg;Yoshihiko Noda.jpg;24497;26753;91161;1225;1338;113
/net/per610a/home/mvp/mvp_db/hodost-lv/2016/2016_09_27_04_56/2016_09_27_21_54.mpg;Yoshihiko Noda.jpg;26897;27429;91161;1346;1372;26
/net/per610a/home/mvp/mvp_db/hodost-lv/2016/2016_09_28_04_56/2016_09_28_21_54.mpg;YUriko Koike.jpg;2205;2273;91169;110;113;3
/net/per610a/home/mvp/mvp_db/hodost-lv/2016/2016_09_28_04_56/2016_09_28_21_54.mpg;YUriko Koike.jpg;11817;12009;91169;591;601;10
/net/per610a/home/mvp/mvp_db/hodost-lv/2016/2016_09_28_04_56/2016_09_28_21_54.mpg;YUriko Koike.jpg;16825;16909;91169;842;846;4
/net/per610a/home/mvp/mvp_db/hodost-lv/2016/2016_09_28_04_56/2016_09_28_21_54.mpg;YUriko Koike.jpg;6289;6341;91169;314;317;3
/net/per610a/home/mvp/mvp_db/hodost-lv/2016/2016_09_28_04_56/2016_09_28_21_54.mpg;YUriko Koike.jpg;6809;7013;91169;340;351;11
/net/per610a/home/mvp/mvp_db/hodost-lv/2016/2016_09_28_04_56/2016_09_28_21_54.mpg;YUriko Koike.jpg;7125;7381;91169;356;369;13
/net/per610a/home/mvp/mvp_db/hodost-lv/2016/2016_09_28_04_56/2016_09_28_21_54.mpg;YUriko Koike.jpg;7561;7737;91169;378;387;9
/net/per610a/home/mvp/mvp_db/hodost-lv/2016/2016_09_28_04_56/2016_09_28_21_54.mpg;YUriko Koike.jpg;7869;8337;91169;393;417;24
/net/per610a/home/mvp/mvp_db/hodost-lv/2016/2016_09_28_04_56/2016_09_28_21_54.mpg;YUriko Koike.jpg;12057;12177;91169;603;609;6
/net/per610a/home/mvp/mvp_db/hodost-lv/2016/2016_09_28_04_56/2016_09_28_21_54.mpg;YUriko Koike.jpg;16013;16105;91169;801;806;5
/net/per610a/home/mvp/mvp_db/hodost-lv/2016/2016_09_28_04_56/2016_09_28_21_54.mpg;YUriko Koike.jpg;16537;16617;91169;827;831;4
/net/per610a/home/mvp/mvp_db/hodost-lv/2016/2016_09_28_04_56/2016_09_28_21_54.mpg;Renho.jpg;18669;18873;91169;934;944;10
/net/per610a/home/mvp/mvp_db/hodost-lv/2016/2016_09_28_04_56/2016_09_28_21_54.mpg;Renho.jpg;19553;19901;91169;978;996;18
/net/per610a/home/mvp/mvp_db/hodost-lv/2016/2016_09_28_04_56/2016_09_28_21_54.mpg;Renho.jpg;20297;20533;91169;1015;1027;12
/net/per610a/home/mvp/mvp_db/hodost-lv/2016/2016_09_28_04_56/2016_09_28_21_54.mpg;Renho.jpg;21849;22037;91169;1093;1102;9
/net/per610a/home/mvp/mvp_db/hodost-lv/2016/2016_09_28_04_56/2016_09_28_21_54.mpg;Renho.jpg;24421;24745;91169;1222;1238;16
/net/per610a/home/mvp/mvp_db/hodost-lv/2016/2016_09_29_04_56/2016_09_29_21_54.mpg;YUriko Koike.jpg;8465;8965;91161;423;448;25
/net/per610a/home/mvp/mvp_db/hodost-lv/2016/2016_09_29_04_56/2016_09_29_21_54.mpg;YUriko Koike.jpg;15389;15901;91161;770;795;25
/net/per610a/home/mvp/mvp_db/hodost-lv/2016/2016_09_29_04_56/2016_09_29_21_54.mpg;YUriko Koike.jpg;16465;16793;91161;823;840;17
/net/per610a/home/mvp/mvp_db/hodost-lv/2016/2016_09_29_04_56/2016_09_29_21_54.mpg;YUriko Koike.jpg;38205;38313;91161;1911;1917;6
/net/per610a/home/mvp/mvp_db/hodost-lv/2016/2016_09_29_04_56/2016_09_29_21_54.mpg;Shinzo ABE.jpg;25313;25577;91161;1266;1279;13
/net/per610a/home/mvp/mvp_db/hodost-lv/2016/2016_09_29_04_56/2016_09_29_21_54.mpg;Ichiro Matsui.jpeg;30433;30565;91161;1522;1529;7
/net/per610a/home/mvp/mvp_db/hodost-lv/2016/2016_09_29_04_56/2016_09_29_21_54.mpg;Yukio EDANO.jpg;64609;64657;91161;3233;3235;2
/net/per610a/home/mvp/mvp_db/hodost-lv/2016/2016_09_29_04_56/2016_09_29_21_54.mpg;Yukio EDANO.jpg;76753;76965;91161;3840;3851;11
/net/per610a/home/mvp/mvp_db/hodost-lv/2016/2016_09_29_04_56/2016_09_29_21_54.mpg;Yukio EDANO.jpg;80265;80761;91161;4016;4041;25
/net/per610a/home/mvp/mvp_db/hodost-lv/2016/2016_09_29_04_56/2016_09_29_21_54.mpg;Yukio EDANO.jpg;80901;81261;91161;4048;4066;18
/net/per610a/home/mvp/mvp_db/hodost-lv/2016/2016_09_30_04_56/2016_09_30_21_54.mpg;YUriko Koike.jpg;3009;3141;91169;150;157;7
/net/per610a/home/mvp/mvp_db/hodost-lv/2016/2016_09_30_04_56/2016_09_30_21_54.mpg;YUriko Koike.jpg;3253;3461;91169;162;173;11
/net/per610a/home/mvp/mvp_db/hodost-lv/2016/2016_09_30_04_56/2016_09_30_21_54.mpg;YUriko Koike.jpg;7889;8373;91169;394;419;25
/net/per610a/home/mvp/mvp_db/hodost-lv/2016/2016_09_30_04_56/2016_09_30_21_54.mpg;YUriko Koike.jpg;8513;8689;91169;426;434;8
/net/per610a/home/mvp/mvp_db/hodost-lv/2016/2016_09_30_04_56/2016_09_30_21_54.mpg;YUriko Koike.jpg;8941;9757;91169;447;488;41
/net/per610a/home/mvp/mvp_db/hodost-lv/2016/2016_09_30_04_56/2016_09_30_21_54.mpg;YUriko Koike.jpg;10569;11373;91169;528;569;41
/net/per610a/home/mvp/mvp_db/hodost-lv/2016/2016_09_30_04_56/2016_09_30_21_54.mpg;YUriko Koike.jpg;6189;6293;91169;309;314;5
/net/per610a/home/mvp/mvp_db/hodost-lv/2016/2016_10_02_04_56/2016_10_02_16_30.mpg;YUriko Koike.jpg;22253;22761;107961;1113;1139;26
/net/per610a/home/mvp/mvp_db/hodost-lv/2016/2016_10_02_04_56/2016_10_02_16_30.mpg;YUriko Koike.jpg;23397;23605;107961;1170;1181;11
/net/per610a/home/mvp/mvp_db/hodost-lv/2016/2016_10_02_04_56/2016_10_02_16_30.mpg;YUriko Koike.jpg;32769;32989;107961;1639;1650;11
/net/per610a/home/mvp/mvp_db/hodost-lv/2016/2016_10_02_04_56/2016_10_02_16_30.mpg;YUriko Koike.jpg;34957;34997;107961;1749;1751;2
/net/per610a/home/mvp/mvp_db/hodost-lv/2016/2016_10_02_04_56/2016_10_02_16_30.mpg;YUriko Koike.jpg;35321;35349;107961;1767;1769;2
/net/per610a/home/mvp/mvp_db/hodost-lv/2016/2016_10_02_04_56/2016_10_02_16_30.mpg;YUriko Koike.jpg;35461;35701;107961;1774;1786;12
/net/per610a/home/mvp/mvp_db/hodost-lv/2016/2016_10_02_04_56/2016_10_02_16_30.mpg;YUriko Koike.jpg;88649;88713;107961;4436;4439;3
/net/per610a/home/mvp/mvp_db/hodost-lv/2016/2016_10_02_04_56/2016_10_02_16_30.mpg;Shinzo ABE.jpg;55137;55285;107961;2759;2766;7
/net/per610a/home/mvp/mvp_db/hodost-lv/2016/2016_10_02_04_56/2016_10_02_16_30.mpg;Shinzo ABE.jpg;55457;55497;107961;2775;2777;2
/net/per610a/home/mvp/mvp_db/hodost-lv/2016/2016_10_02_04_56/2016_10_02_16_30.mpg;Shinzo ABE.jpg;55957;56037;107961;2800;2804;4
/net/per610a/home/mvp/mvp_db/hodost-lv/2016/2016_10_02_04_56/2016_10_02_16_30.mpg;Shinzo ABE.jpg;56485;56505;107961;2826;2827;1
/net/per610a/home/mvp/mvp_db/hodost-lv/2016/2016_10_02_04_56/2016_10_02_16_30.mpg;Shinzo ABE.jpg;56873;56885;107961;2846;2846;0
/net/per610a/home/mvp/mvp_db/hodost-lv/2016/2016_10_03_04_56/2016_10_03_21_54.mpg;YUriko Koike.jpg;32469;32493;91169;1625;1626;1
/net/per610a/home/mvp/mvp_db/hodost-lv/2016/2016_10_03_04_56/2016_10_03_21_54.mpg;YUriko Koike.jpg;32625;32665;91169;1632;1634;2
/net/per610a/home/mvp/mvp_db/hodost-lv/2016/2016_10_03_04_56/2016_10_03_21_54.mpg;YUriko Koike.jpg;33013;33349;91169;1652;1669;17
/net/per610a/home/mvp/mvp_db/hodost-lv/2016/2016_10_03_04_56/2016_10_03_21_54.mpg;YUriko Koike.jpg;42257;42329;91169;2114;2118;4
/net/per610a/home/mvp/mvp_db/hodost-lv/2016/2016_10_03_04_56/2016_10_03_21_54.mpg;Shinzo ABE.jpg;48689;48869;91169;2436;2445;9
/net/per610a/home/mvp/mvp_db/hodost-lv/2016/2016_10_03_04_56/2016_10_03_21_54.mpg;Shinzo ABE.jpg;49585;49745;91169;2481;2489;8
/net/per610a/home/mvp/mvp_db/hodost-lv/2016/2016_10_03_04_56/2016_10_03_21_54.mpg;Shinzo ABE.jpg;50753;50793;91169;2540;2542;2
/net/per610a/home/mvp/mvp_db/hodost-lv/2016/2016_10_04_04_56/2016_10_04_21_54.mpg;YUriko Koike.jpg;1173;1249;91169;58;62;4
/net/per610a/home/mvp/mvp_db/hodost-lv/2016/2016_10_04_04_56/2016_10_04_21_54.mpg;YUriko Koike.jpg;4805;4817;91169;240;241;1
/net/per610a/home/mvp/mvp_db/hodost-lv/2016/2016_10_04_04_56/2016_10_04_21_54.mpg;YUriko Koike.jpg;4945;5033;91169;247;251;4
/net/per610a/home/mvp/mvp_db/hodost-lv/2016/2016_10_04_04_56/2016_10_04_21_54.mpg;YUriko Koike.jpg;6333;8049;91169;316;402;86
/net/per610a/home/mvp/mvp_db/hodost-lv/2016/2016_10_04_04_56/2016_10_04_21_54.mpg;YUriko Koike.jpg;8181;8413;91169;409;421;12
/net/per610a/home/mvp/mvp_db/hodost-lv/2016/2016_10_04_04_56/2016_10_04_21_54.mpg;YUriko Koike.jpg;8721;9485;91169;436;474;38
/net/per610a/home/mvp/mvp_db/hodost-lv/2016/2016_10_04_04_56/2016_10_04_21_54.mpg;YUriko Koike.jpg;11041;11245;91169;552;562;10
/net/per610a/home/mvp/mvp_db/hodost-lv/2016/2016_10_04_04_56/2016_10_04_21_54.mpg;YUriko Koike.jpg;11341;11905;91169;567;595;28
/net/per610a/home/mvp/mvp_db/hodost-lv/2016/2016_10_04_04_56/2016_10_04_21_54.mpg;YUriko Koike.jpg;12525;12653;91169;626;633;7
/net/per610a/home/mvp/mvp_db/hodost-lv/2016/2016_10_04_04_56/2016_10_04_21_54.mpg;Taro ASO.jpg;33345;33377;91169;1668;1670;2
/net/per610a/home/mvp/mvp_db/hodost-lv/2016/2016_10_04_04_56/2016_10_04_21_54.mpg;Taro ASO.jpg;34177;34377;91169;1710;1720;10
/net/per610a/home/mvp/mvp_db/hodost-lv/2016/2016_10_05_04_56/2016_10_05_21_54.mpg;YUriko Koike.jpg;23893;24277;91169;1195;1215;20
/net/per610a/home/mvp/mvp_db/hodost-lv/2016/2016_10_05_04_56/2016_10_05_21_54.mpg;Shinzo ABE.jpg;28341;28353;91169;1418;1419;1
/net/per610a/home/mvp/mvp_db/hodost-lv/2016/2016_10_05_04_56/2016_10_05_21_54.mpg;Shinzo ABE.jpg;28541;28593;91169;1428;1431;3
/net/per610a/home/mvp/mvp_db/hodost-lv/2016/2016_10_05_04_56/2016_10_05_21_54.mpg;Shinzo ABE.jpg;31633;31669;91169;1583;1585;2
/net/per610a/home/mvp/mvp_db/hodost-lv/2016/2016_10_05_04_56/2016_10_05_21_54.mpg;Shinzo ABE.jpg;32293;32293;91169;1616;1616;0
/net/per610a/home/mvp/mvp_db/hodost-lv/2016/2016_10_05_04_56/2016_10_05_21_54.mpg;Shinzo ABE.jpg;28669;28717;91169;1434;1437;3
/net/per610a/home/mvp/mvp_db/hodost-lv/2016/2016_10_05_04_56/2016_10_05_21_54.mpg;Shinzo ABE.jpg;28873;29005;91169;1445;1451;6
/net/per610a/home/mvp/mvp_db/hodost-lv/2016/2016_10_05_04_56/2016_10_05_21_54.mpg;Shinzo ABE.jpg;29509;29629;91169;1476;1482;6
/net/per610a/home/mvp/mvp_db/hodost-lv/2016/2016_10_05_04_56/2016_10_05_21_54.mpg;Shinzo ABE.jpg;29761;29901;91169;1489;1496;7
/net/per610a/home/mvp/mvp_db/hodost-lv/2016/2016_10_05_04_56/2016_10_05_21_54.mpg;Shinzo ABE.jpg;30433;30581;91169;1523;1530;7
/net/per610a/home/mvp/mvp_db/hodost-lv/2016/2016_10_05_04_56/2016_10_05_21_54.mpg;Yoshihiko Noda.jpg;61805;62081;91169;3093;3107;14
/net/per610a/home/mvp/mvp_db/hodost-lv/2016/2016_10_05_04_56/2016_10_05_21_54.mpg;Yoshihiko Noda.jpg;62205;62241;91169;3113;3115;2
/net/per610a/home/mvp/mvp_db/hodost-lv/2016/2016_10_05_04_56/2016_10_05_21_54.mpg;Yoshihiko Noda.jpg;62505;62629;91169;3128;3134;6
/net/per610a/home/mvp/mvp_db/hodost-lv/2016/2016_10_05_04_56/2016_10_05_21_54.mpg;Seiji Mataichi.jpg;62161;62205;91169;3111;3113;2
/net/per610a/home/mvp/mvp_db/hodost-lv/2016/2016_10_05_04_56/2016_10_05_21_54.mpg;Seiji Mataichi.jpg;62325;62381;91169;3119;3122;3
/net/per610a/home/mvp/mvp_db/hodost-lv/2016/2016_10_06_04_56/2016_10_06_21_40.mpg;YUriko Koike.jpg;28613;29229;107949;1431;1462;31
/net/per610a/home/mvp/mvp_db/hodost-lv/2016/2016_10_06_04_56/2016_10_06_21_40.mpg;Shinzo ABE.jpg;40313;40809;107949;2017;2042;25
/net/per610a/home/mvp/mvp_db/hodost-lv/2016/2016_10_09_04_56/2016_10_09_16_30.mpg;YUriko Koike.jpg;20557;20725;107961;1028;1037;9
/net/per610a/home/mvp/mvp_db/hodost-lv/2016/2016_10_09_04_56/2016_10_09_16_30.mpg;Shinzo ABE.jpg;103729;103857;107961;5191;5197;6
/net/per610a/home/mvp/mvp_db/hodost-lv/2016/2016_10_10_04_56/2016_10_10_21_54.mpg;YUriko Koike.jpg;54129;54369;91169;2709;2721;12
/net/per610a/home/mvp/mvp_db/hodost-lv/2016/2016_10_13_04_56/2016_10_13_22_09.mpg;YUriko Koike.jpg;27289;27293;91169;1365;1366;1
/net/per610a/home/mvp/mvp_db/hodost-lv/2016/2016_10_13_04_56/2016_10_13_22_09.mpg;YUriko Koike.jpg;29337;29649;91169;1468;1483;15
/net/per610a/home/mvp/mvp_db/hodost-lv/2016/2016_10_14_04_56/2016_10_14_21_54.mpg;YUriko Koike.jpg;9557;10165;91169;478;508;30
/net/per610a/home/mvp/mvp_db/hodost-lv/2016/2016_10_16_04_56/2016_10_16_17_25.mpg;YUriko Koike.jpg;12405;12689;42009;620;634;14
/net/per610a/home/mvp/mvp_db/hodost-lv/2016/2016_10_16_04_56/2016_10_16_17_25.mpg;YUriko Koike.jpg;13313;13821;42009;666;691;25
/net/per610a/home/mvp/mvp_db/hodost-lv/2016/2016_10_17_04_56/2016_10_17_21_54.mpg;Shinzo ABE.jpg;29569;29637;91169;1479;1483;4
/net/per610a/home/mvp/mvp_db/hodost-lv/2016/2016_10_17_04_56/2016_10_17_21_54.mpg;Shinzo ABE.jpg;36409;36605;91169;1822;1832;10
/net/per610a/home/mvp/mvp_db/hodost-lv/2016/2016_10_17_04_56/2016_10_17_21_54.mpg;Shinzo ABE.jpg;38041;38181;91169;1903;1910;7
/net/per610a/home/mvp/mvp_db/hodost-lv/2016/2016_10_17_04_56/2016_10_17_21_54.mpg;Toru Hashimoto.jpg;89873;89969;91169;4498;4502;4
/net/per610a/home/mvp/mvp_db/hodost-lv/2016/2016_10_18_04_56/2016_10_18_21_54.mpg;YUriko Koike.jpg;16817;17433;91169;841;872;31
/net/per610a/home/mvp/mvp_db/hodost-lv/2016/2016_10_18_04_56/2016_10_18_21_54.mpg;YUriko Koike.jpg;20997;21141;91169;1050;1058;8
/net/per610a/home/mvp/mvp_db/hodost-lv/2016/2016_10_18_04_56/2016_10_18_21_54.mpg;YUriko Koike.jpg;21441;21465;91169;1073;1074;1
/net/per610a/home/mvp/mvp_db/hodost-lv/2016/2016_10_18_04_56/2016_10_18_21_54.mpg;YUriko Koike.jpg;24797;24857;91169;1241;1244;3
/net/per610a/home/mvp/mvp_db/hodost-lv/2016/2016_10_18_04_56/2016_10_18_21_54.mpg;YUriko Koike.jpg;27037;27177;91169;1353;1360;7
/net/per610a/home/mvp/mvp_db/hodost-lv/2016/2016_10_19_04_56/2016_10_19_21_54.mpg;YUriko Koike.jpg;16113;16141;91169;806;807;1
/net/per610a/home/mvp/mvp_db/hodost-lv/2016/2016_10_19_04_56/2016_10_19_21_54.mpg;YUriko Koike.jpg;18397;18841;91169;920;942;22
/net/per610a/home/mvp/mvp_db/hodost-lv/2016/2016_10_20_04_56/2016_10_20_22_09.mpg;YUriko Koike.jpg;22157;22841;91169;1108;1143;35
/net/per610a/home/mvp/mvp_db/hodost-lv/2016/2016_10_21_04_56/2016_10_21_21_54.mpg;YUriko Koike.jpg;24377;24801;91169;1220;1241;21
/net/per610a/home/mvp/mvp_db/hodost-lv/2016/2016_10_21_04_56/2016_10_21_21_54.mpg;YUriko Koike.jpg;25785;25805;91169;1290;1291;1
/net/per610a/home/mvp/mvp_db/hodost-lv/2016/2016_10_21_04_56/2016_10_21_21_54.mpg;YUriko Koike.jpg;26085;26313;91169;1305;1316;11
/net/per610a/home/mvp/mvp_db/hodost-lv/2016/2016_10_21_04_56/2016_10_21_21_54.mpg;Shinzo ABE.jpg;37897;37973;91169;1896;1900;4
/net/per610a/home/mvp/mvp_db/hodost-lv/2016/2016_10_24_04_56/2016_10_24_21_54.mpg;YUriko Koike.jpg;1549;1641;91169;77;82;5
/net/per610a/home/mvp/mvp_db/hodost-lv/2016/2016_10_24_04_56/2016_10_24_21_54.mpg;YUriko Koike.jpg;1985;1985;91169;99;99;0
/net/per610a/home/mvp/mvp_db/hodost-lv/2016/2016_10_24_04_56/2016_10_24_21_54.mpg;YUriko Koike.jpg;4977;5001;91169;249;250;1
/net/per610a/home/mvp/mvp_db/hodost-lv/2016/2016_10_24_04_56/2016_10_24_21_54.mpg;YUriko Koike.jpg;9245;9501;91169;462;475;13
/net/per610a/home/mvp/mvp_db/hodost-lv/2016/2016_10_24_04_56/2016_10_24_21_54.mpg;YUriko Koike.jpg;15217;15237;91169;761;762;1
/net/per610a/home/mvp/mvp_db/hodost-lv/2016/2016_10_24_04_56/2016_10_24_21_54.mpg;YUriko Koike.jpg;5389;5441;91169;269;272;3
/net/per610a/home/mvp/mvp_db/hodost-lv/2016/2016_10_24_04_56/2016_10_24_21_54.mpg;YUriko Koike.jpg;11253;11421;91169;563;571;8
/net/per610a/home/mvp/mvp_db/hodost-lv/2016/2016_10_24_04_56/2016_10_24_21_54.mpg;YUriko Koike.jpg;15377;15449;91169;769;773;4
/net/per610a/home/mvp/mvp_db/hodost-lv/2016/2016_10_24_04_56/2016_10_24_21_54.mpg;YUriko Koike.jpg;15673;15761;91169;784;788;4
/net/per610a/home/mvp/mvp_db/hodost-lv/2016/2016_10_24_04_56/2016_10_24_21_54.mpg;YUriko Koike.jpg;6793;7065;91169;339;353;14
/net/per610a/home/mvp/mvp_db/hodost-lv/2016/2016_10_26_04_56/2016_10_26_21_54.mpg;Shinzo ABE.jpg;1657;1729;91169;82;86;4
/net/per610a/home/mvp/mvp_db/hodost-lv/2016/2016_10_26_04_56/2016_10_26_21_54.mpg;Shinzo ABE.jpg;2149;2149;91169;107;107;0
/net/per610a/home/mvp/mvp_db/hodost-lv/2016/2016_10_26_04_56/2016_10_26_21_54.mpg;Shinzo ABE.jpg;5441;5441;91169;272;272;0
/net/per610a/home/mvp/mvp_db/hodost-lv/2016/2016_10_26_04_56/2016_10_26_21_54.mpg;Shinzo ABE.jpg;6653;6653;91169;332;332;0
/net/per610a/home/mvp/mvp_db/hodost-lv/2016/2016_10_26_04_56/2016_10_26_21_54.mpg;Shinzo ABE.jpg;9805;10649;91169;490;532;42
/net/per610a/home/mvp/mvp_db/hodost-lv/2016/2016_10_26_04_56/2016_10_26_21_54.mpg;YUriko Koike.jpg;23725;23793;91169;1187;1190;3
/net/per610a/home/mvp/mvp_db/hodost-lv/2016/2016_10_26_04_56/2016_10_26_21_54.mpg;YUriko Koike.jpg;28797;29369;91169;1440;1469;29
/net/per610a/home/mvp/mvp_db/hodost-lv/2016/2016_10_27_04_56/2016_10_27_22_44.mpg;Shinzo ABE.jpg;18737;18741;91169;937;937;0
/net/per610a/home/mvp/mvp_db/hodost-lv/2016/2016_10_27_04_56/2016_10_27_22_44.mpg;Shinzo ABE.jpg;19269;19413;91169;964;971;7
/net/per610a/home/mvp/mvp_db/hodost-lv/2016/2016_10_27_04_56/2016_10_27_22_44.mpg;Shinzo ABE.jpg;72113;72221;91169;3609;3614;5
/net/per610a/home/mvp/mvp_db/hodost-lv/2016/2016_10_28_04_56/2016_10_28_21_54.mpg;Shinzo ABE.jpg;10189;10237;91169;509;512;3
/net/per610a/home/mvp/mvp_db/hodost-lv/2016/2016_10_28_04_56/2016_10_28_21_54.mpg;Shinzo ABE.jpg;12813;13049;91169;641;653;12
/net/per610a/home/mvp/mvp_db/hodost-lv/2016/2016_10_28_04_56/2016_10_28_21_54.mpg;Shinzo ABE.jpg;14009;14065;91169;701;703;2
/net/per610a/home/mvp/mvp_db/hodost-lv/2016/2016_10_28_04_56/2016_10_28_21_54.mpg;Shinzo ABE.jpg;14133;14349;91169;707;718;11
/net/per610a/home/mvp/mvp_db/hodost-lv/2016/2016_10_28_04_56/2016_10_28_21_54.mpg;Shinzo ABE.jpg;14489;14717;91169;725;736;11
/net/per610a/home/mvp/mvp_db/hodost-lv/2016/2016_10_28_04_56/2016_10_28_21_54.mpg;YUriko Koike.jpg;24677;25805;91169;1235;1291;56
/net/per610a/home/mvp/mvp_db/hodost-lv/2016/2016_10_28_04_56/2016_10_28_21_54.mpg;YUriko Koike.jpg;26685;27533;91169;1335;1378;43
/net/per610a/home/mvp/mvp_db/hodost-lv/2016/2016_10_28_04_56/2016_10_28_21_54.mpg;YUriko Koike.jpg;29825;31217;91169;1492;1562;70
/net/per610a/home/mvp/mvp_db/hodost-lv/2016/2016_10_30_04_56/2016_10_30_17_25.mpg;YUriko Koike.jpg;7913;10165;42021;396;508;112
/net/per610a/home/mvp/mvp_db/hodost-lv/2016/2016_10_31_04_56/2016_10_31_21_54.mpg;Ichiro OZAWA.jpg;19593;19617;91169;980;981;1
/net/per610a/home/mvp/mvp_db/hodost-lv/2016/2016_10_31_04_56/2016_10_31_21_54.mpg;Ichiro OZAWA.jpg;20089;20581;91169;1005;1030;25
/net/per610a/home/mvp/mvp_db/hodost-lv/2016/2016_10_31_04_56/2016_10_31_21_54.mpg;Ichiro OZAWA.jpg;21121;21345;91169;1057;1068;11
/net/per610a/home/mvp/mvp_db/hodost-lv/2016/2016_10_31_04_56/2016_10_31_21_54.mpg;Ichiro OZAWA.jpg;21469;21633;91169;1074;1082;8
/net/per610a/home/mvp/mvp_db/hodost-lv/2016/2016_10_31_04_56/2016_10_31_21_54.mpg;Shinzo ABE.jpg;37177;37821;91169;1860;1892;32
/net/per610a/home/mvp/mvp_db/hodost-lv/2016/2016_10_31_04_56/2016_10_31_21_54.mpg;Yukio HATOYAMA.jpg;89865;90001;91169;4497;4504;7
/net/per610a/home/mvp/mvp_db/hodost-lv/2016/2016_11_01_04_56/2016_11_01_21_54.mpg;YUriko Koike.jpg;1389;1433;91169;69;71;2
/net/per610a/home/mvp/mvp_db/hodost-lv/2016/2016_11_01_04_56/2016_11_01_21_54.mpg;YUriko Koike.jpg;8637;8849;91169;432;442;10
/net/per610a/home/mvp/mvp_db/hodost-lv/2016/2016_11_01_04_56/2016_11_01_21_54.mpg;YUriko Koike.jpg;11657;11713;91169;583;586;3
/net/per610a/home/mvp/mvp_db/hodost-lv/2016/2016_11_01_04_56/2016_11_01_21_54.mpg;YUriko Koike.jpg;11469;11613;91169;573;581;8
/net/per610a/home/mvp/mvp_db/hodost-lv/2016/2016_11_01_04_56/2016_11_01_21_54.mpg;YUriko Koike.jpg;12261;12329;91169;613;616;3
/net/per610a/home/mvp/mvp_db/hodost-lv/2016/2016_11_01_04_56/2016_11_01_21_54.mpg;YUriko Koike.jpg;18985;19373;91169;949;969;20
/net/per610a/home/mvp/mvp_db/hodost-lv/2016/2016_11_01_04_56/2016_11_01_21_54.mpg;YUriko Koike.jpg;19749;20021;91169;988;1001;13
/net/per610a/home/mvp/mvp_db/hodost-lv/2016/2016_11_01_04_56/2016_11_01_21_54.mpg;YUriko Koike.jpg;24245;24365;91169;1213;1219;6
/net/per610a/home/mvp/mvp_db/hodost-lv/2016/2016_11_02_04_56/2016_11_02_21_54.mpg;Renho.jpg;11369;11617;91169;568;581;13
/net/per610a/home/mvp/mvp_db/hodost-lv/2016/2016_11_03_04_56/2016_11_03_21_54.mpg;Shinzo ABE.jpg;14369;14397;91169;719;720;1
/net/per610a/home/mvp/mvp_db/hodost-lv/2016/2016_11_03_04_56/2016_11_03_21_54.mpg;Shinzo ABE.jpg;39901;40145;91169;1997;2009;12
/net/per610a/home/mvp/mvp_db/hodost-lv/2016/2016_11_04_04_56/2016_11_04_21_54.mpg;Shinzo ABE.jpg;21669;21773;91161;1084;1089;5
/net/per610a/home/mvp/mvp_db/hodost-lv/2016/2016_11_06_04_56/2016_11_06_16_30.mpg;YUriko Koike.jpg;63641;63945;107949;3184;3199;15
/net/per610a/home/mvp/mvp_db/hodost-lv/2016/2016_11_06_04_56/2016_11_06_16_30.mpg;Renho.jpg;66025;66253;107949;3304;3315;11
/net/per610a/home/mvp/mvp_db/hodost-lv/2016/2016_11_08_04_56/2016_11_08_21_54.mpg;YUriko Koike.jpg;67161;67309;91161;3360;3368;8
/net/per610a/home/mvp/mvp_db/hodost-lv/2016/2016_11_10_04_56/2016_11_10_21_54.mpg;Renho.jpg;23217;23529;91161;1161;1177;16
/net/per610a/home/mvp/mvp_db/hodost-lv/2016/2016_11_10_04_56/2016_11_10_21_54.mpg;Shinzo ABE.jpg;29285;29341;91161;1465;1468;3
/net/per610a/home/mvp/mvp_db/hodost-lv/2016/2016_11_10_04_56/2016_11_10_21_54.mpg;Shinzo ABE.jpg;29797;29949;91161;1491;1498;7
/net/per610a/home/mvp/mvp_db/hodost-lv/2016/2016_11_10_04_56/2016_11_10_21_54.mpg;Shinzo ABE.jpg;29345;29365;91161;1468;1469;1
/net/per610a/home/mvp/mvp_db/hodost-lv/2016/2016_11_10_04_56/2016_11_10_21_54.mpg;Shinzo ABE.jpg;30093;30277;91161;1505;1515;10
/net/per610a/home/mvp/mvp_db/hodost-lv/2016/2016_11_11_04_56/2016_11_11_21_54.mpg;Shinzo ABE.jpg;22621;23481;91169;1132;1175;43
/net/per610a/home/mvp/mvp_db/hodost-lv/2016/2016_11_13_04_56/2016_11_13_16_30.mpg;Shinzo ABE.jpg;102701;103013;107949;5139;5154;15
/net/per610a/home/mvp/mvp_db/hodost-lv/2016/2016_11_13_04_56/2016_11_13_16_30.mpg;Shinzo ABE.jpg;104029;104241;107949;5205;5216;11
/net/per610a/home/mvp/mvp_db/hodost-lv/2016/2016_11_14_04_56/2016_11_14_21_54.mpg;Shinzo ABE.jpg;18257;18489;91169;913;925;12
/net/per610a/home/mvp/mvp_db/hodost-lv/2016/2016_11_15_04_56/2016_11_15_21_35.mpg;Shinzo ABE.jpg;24157;24209;113941;1208;1211;3
/net/per610a/home/mvp/mvp_db/hodost-lv/2016/2016_11_15_04_56/2016_11_15_21_35.mpg;Shinzo ABE.jpg;77525;77737;113941;3879;3890;11
/net/per610a/home/mvp/mvp_db/hodost-lv/2016/2016_11_15_04_56/2016_11_15_21_35.mpg;YUriko Koike.jpg;56961;57205;113941;2850;2862;12
/net/per610a/home/mvp/mvp_db/hodost-lv/2016/2016_11_15_04_56/2016_11_15_21_35.mpg;YUriko Koike.jpg;57365;57661;113941;2870;2885;15
/net/per610a/home/mvp/mvp_db/hodost-lv/2016/2016_11_17_04_56/2016_11_17_21_54.mpg;Shinzo ABE.jpg;5569;5605;91161;278;280;2
/net/per610a/home/mvp/mvp_db/hodost-lv/2016/2016_11_17_04_56/2016_11_17_21_54.mpg;Shinzo ABE.jpg;8921;9069;91161;446;453;7
/net/per610a/home/mvp/mvp_db/hodost-lv/2016/2016_11_17_04_56/2016_11_17_21_54.mpg;Yukio HATOYAMA.jpg;15777;15925;91161;789;796;7
/net/per610a/home/mvp/mvp_db/hodost-lv/2016/2016_11_17_04_56/2016_11_17_21_54.mpg;Yukio HATOYAMA.jpg;16049;16277;91161;803;814;11
/net/per610a/home/mvp/mvp_db/hodost-lv/2016/2016_11_17_04_56/2016_11_17_21_54.mpg;Yukio HATOYAMA.jpg;19581;19853;91161;979;993;14
/net/per610a/home/mvp/mvp_db/hodost-lv/2016/2016_11_18_04_56/2016_11_18_21_54.mpg;Shinzo ABE.jpg;1789;1953;91169;89;97;8
/net/per610a/home/mvp/mvp_db/hodost-lv/2016/2016_11_18_04_56/2016_11_18_21_54.mpg;Shinzo ABE.jpg;4993;5421;91169;249;271;22
/net/per610a/home/mvp/mvp_db/hodost-lv/2016/2016_11_18_04_56/2016_11_18_21_54.mpg;Shinzo ABE.jpg;9037;9465;91169;452;473;21
/net/per610a/home/mvp/mvp_db/hodost-lv/2016/2016_11_18_04_56/2016_11_18_21_54.mpg;Shinzo ABE.jpg;12297;12377;91169;615;619;4
/net/per610a/home/mvp/mvp_db/hodost-lv/2016/2016_11_18_04_56/2016_11_18_21_54.mpg;Shinzo ABE.jpg;9937;9981;91169;497;499;2
/net/per610a/home/mvp/mvp_db/hodost-lv/2016/2016_11_18_04_56/2016_11_18_21_54.mpg;Shinzo ABE.jpg;11137;11745;91169;557;587;30
/net/per610a/home/mvp/mvp_db/hodost-lv/2016/2016_11_18_04_56/2016_11_18_21_54.mpg;YUriko Koike.jpg;21177;21313;91169;1059;1066;7
/net/per610a/home/mvp/mvp_db/hodost-lv/2016/2016_11_18_04_56/2016_11_18_21_54.mpg;YUriko Koike.jpg;24517;24625;91169;1227;1232;5
/net/per610a/home/mvp/mvp_db/hodost-lv/2016/2016_11_18_04_56/2016_11_18_21_54.mpg;YUriko Koike.jpg;26041;26109;91169;1303;1306;3
/net/per610a/home/mvp/mvp_db/hodost-lv/2016/2016_11_18_04_56/2016_11_18_21_54.mpg;YUriko Koike.jpg;27929;28229;91169;1397;1412;15
/net/per610a/home/mvp/mvp_db/hodost-lv/2016/2016_11_18_04_56/2016_11_18_21_54.mpg;YUriko Koike.jpg;28553;28745;91169;1429;1438;9
/net/per610a/home/mvp/mvp_db/hodost-lv/2016/2016_11_18_04_56/2016_11_18_21_54.mpg;YUriko Koike.jpg;28909;29165;91169;1446;1459;13
/net/per610a/home/mvp/mvp_db/hodost-lv/2016/2016_11_20_04_56/2016_11_20_16_30.mpg;Shinzo ABE.jpg;67569;67621;107949;3381;3383;2
/net/per610a/home/mvp/mvp_db/hodost-lv/2016/2016_11_20_04_56/2016_11_20_16_30.mpg;Shinzo ABE.jpg;68245;68301;107949;3415;3417;2
/net/per610a/home/mvp/mvp_db/hodost-lv/2016/2016_11_20_04_56/2016_11_20_16_30.mpg;Shinzo ABE.jpg;87161;87509;107949;4361;4379;18
/net/per610a/home/mvp/mvp_db/hodost-lv/2016/2016_11_20_04_56/2016_11_20_16_30.mpg;Shinzo ABE.jpg;87617;87773;107949;4384;4392;8
/net/per610a/home/mvp/mvp_db/hodost-lv/2016/2016_11_20_04_56/2016_11_20_16_30.mpg;Shinzo ABE.jpg;87897;88045;107949;4398;4405;7
/net/per610a/home/mvp/mvp_db/hodost-lv/2016/2016_11_21_04_56/2016_11_21_21_54.mpg;Shinzo ABE.jpg;1485;1761;91161;74;88;14
/net/per610a/home/mvp/mvp_db/hodost-lv/2016/2016_11_21_04_56/2016_11_21_21_54.mpg;Shinzo ABE.jpg;1989;2337;91161;99;116;17
/net/per610a/home/mvp/mvp_db/hodost-lv/2016/2016_11_21_04_56/2016_11_21_21_54.mpg;Shinzo ABE.jpg;5325;5709;91161;266;285;19
/net/per610a/home/mvp/mvp_db/hodost-lv/2016/2016_11_21_04_56/2016_11_21_21_54.mpg;Shinzo ABE.jpg;5877;5925;91161;294;296;2
/net/per610a/home/mvp/mvp_db/hodost-lv/2016/2016_11_21_04_56/2016_11_21_21_54.mpg;Shinzo ABE.jpg;6321;7161;91161;316;358;42
/net/per610a/home/mvp/mvp_db/hodost-lv/2016/2016_11_21_04_56/2016_11_21_21_54.mpg;Shinzo ABE.jpg;7413;7725;91161;370;386;16
/net/per610a/home/mvp/mvp_db/hodost-lv/2016/2016_11_21_04_56/2016_11_21_21_54.mpg;Shinzo ABE.jpg;7805;8129;91161;390;406;16
/net/per610a/home/mvp/mvp_db/hodost-lv/2016/2016_11_21_04_56/2016_11_21_21_54.mpg;Shinzo ABE.jpg;8325;8497;91161;416;425;9
/net/per610a/home/mvp/mvp_db/hodost-lv/2016/2016_11_21_04_56/2016_11_21_21_54.mpg;Shinzo ABE.jpg;9169;9241;91161;458;462;4
/net/per610a/home/mvp/mvp_db/hodost-lv/2016/2016_11_21_04_56/2016_11_21_21_54.mpg;Shinzo ABE.jpg;10849;10877;91161;542;544;2
/net/per610a/home/mvp/mvp_db/hodost-lv/2016/2016_11_21_04_56/2016_11_21_21_54.mpg;Shinzo ABE.jpg;12733;12769;91161;637;639;2
/net/per610a/home/mvp/mvp_db/hodost-lv/2016/2016_11_21_04_56/2016_11_21_21_54.mpg;Shinzo ABE.jpg;13217;13301;91161;661;665;4
/net/per610a/home/mvp/mvp_db/hodost-lv/2016/2016_11_22_04_56/2016_11_22_21_54.mpg;Shinzo ABE.jpg;46957;47177;91169;2349;2360;11
/net/per610a/home/mvp/mvp_db/hodost-lv/2016/2016_11_22_04_56/2016_11_22_21_54.mpg;Shinzo ABE.jpg;47457;47757;91169;2374;2389;15
/net/per610a/home/mvp/mvp_db/hodost-lv/2016/2016_11_24_04_56/2016_11_24_21_54.mpg;Shinzo ABE.jpg;13677;14245;91169;684;712;28
/net/per610a/home/mvp/mvp_db/hodost-lv/2016/2016_11_24_04_56/2016_11_24_21_54.mpg;Shinzo ABE.jpg;14825;15121;91169;741;756;15
/net/per610a/home/mvp/mvp_db/hodost-lv/2016/2016_11_24_04_56/2016_11_24_21_54.mpg;Shinzo ABE.jpg;15221;15393;91169;761;770;9
/net/per610a/home/mvp/mvp_db/hodost-lv/2016/2016_11_24_04_56/2016_11_24_21_54.mpg;Shinzo ABE.jpg;16773;17145;91169;839;858;19
/net/per610a/home/mvp/mvp_db/hodost-lv/2016/2016_11_24_04_56/2016_11_24_21_54.mpg;Shinzo ABE.jpg;17557;17669;91169;878;884;6
/net/per610a/home/mvp/mvp_db/hodost-lv/2016/2016_11_24_04_56/2016_11_24_21_54.mpg;Shinzo ABE.jpg;18561;18625;91169;928;932;4
/net/per610a/home/mvp/mvp_db/hodost-lv/2016/2016_11_24_04_56/2016_11_24_21_54.mpg;Shinzo ABE.jpg;18905;19001;91169;946;950;4
/net/per610a/home/mvp/mvp_db/hodost-lv/2016/2016_11_24_04_56/2016_11_24_21_54.mpg;Shinzo ABE.jpg;19685;19713;91169;985;986;1
/net/per610a/home/mvp/mvp_db/hodost-lv/2016/2016_11_24_04_56/2016_11_24_21_54.mpg;Shinzo ABE.jpg;19845;20021;91169;993;1002;9
/net/per610a/home/mvp/mvp_db/hodost-lv/2016/2016_11_24_04_56/2016_11_24_21_54.mpg;Shinzo ABE.jpg;20097;20129;91169;1005;1007;2
/net/per610a/home/mvp/mvp_db/hodost-lv/2016/2016_11_24_04_56/2016_11_24_21_54.mpg;Shinzo ABE.jpg;24853;24857;91169;1243;1244;1
/net/per610a/home/mvp/mvp_db/hodost-lv/2016/2016_11_24_04_56/2016_11_24_21_54.mpg;Shinzo ABE.jpg;26753;27041;91169;1338;1353;15
/net/per610a/home/mvp/mvp_db/hodost-lv/2016/2016_11_24_04_56/2016_11_24_21_54.mpg;Ichiro OZAWA.jpg;50621;51273;91169;2533;2566;33
/net/per610a/home/mvp/mvp_db/hodost-lv/2016/2016_11_24_04_56/2016_11_24_21_54.mpg;Renho.jpg;51797;51957;91169;2592;2600;8
/net/per610a/home/mvp/mvp_db/hodost-lv/2016/2016_11_25_04_56/2016_11_25_21_54.mpg;Shinzo ABE.jpg;1781;1865;91161;89;93;4
/net/per610a/home/mvp/mvp_db/hodost-lv/2016/2016_11_25_04_56/2016_11_25_21_54.mpg;Shinzo ABE.jpg;5097;5289;91161;255;264;9
/net/per610a/home/mvp/mvp_db/hodost-lv/2016/2016_11_25_04_56/2016_11_25_21_54.mpg;Shinzo ABE.jpg;5365;5449;91161;268;272;4
/net/per610a/home/mvp/mvp_db/hodost-lv/2016/2016_11_25_04_56/2016_11_25_21_54.mpg;Shinzo ABE.jpg;5677;5821;91161;284;291;7
/net/per610a/home/mvp/mvp_db/hodost-lv/2016/2016_11_25_04_56/2016_11_25_21_54.mpg;Shinzo ABE.jpg;5917;5937;91161;296;297;1
/net/per610a/home/mvp/mvp_db/hodost-lv/2016/2016_11_25_04_56/2016_11_25_21_54.mpg;Shinzo ABE.jpg;6597;6669;91161;330;333;3
/net/per610a/home/mvp/mvp_db/hodost-lv/2016/2016_11_25_04_56/2016_11_25_21_54.mpg;Shinzo ABE.jpg;7509;7545;91161;375;377;2
/net/per610a/home/mvp/mvp_db/hodost-lv/2016/2016_11_25_04_56/2016_11_25_21_54.mpg;Shinzo ABE.jpg;7893;8065;91161;394;403;9
/net/per610a/home/mvp/mvp_db/hodost-lv/2016/2016_11_25_04_56/2016_11_25_21_54.mpg;Shinzo ABE.jpg;8373;8465;91161;419;423;4
/net/per610a/home/mvp/mvp_db/hodost-lv/2016/2016_11_25_04_56/2016_11_25_21_54.mpg;Shinzo ABE.jpg;8801;9073;91161;440;454;14
/net/per610a/home/mvp/mvp_db/hodost-lv/2016/2016_11_25_04_56/2016_11_25_21_54.mpg;Shinzo ABE.jpg;24245;24489;91161;1213;1225;12
/net/per610a/home/mvp/mvp_db/hodost-lv/2016/2016_11_25_04_56/2016_11_25_21_54.mpg;YUriko Koike.jpg;13693;13693;91161;685;685;0
/net/per610a/home/mvp/mvp_db/hodost-lv/2016/2016_11_25_04_56/2016_11_25_21_54.mpg;YUriko Koike.jpg;13833;13909;91161;692;696;4
/net/per610a/home/mvp/mvp_db/hodost-lv/2016/2016_11_25_04_56/2016_11_25_21_54.mpg;YUriko Koike.jpg;14113;14461;91161;706;723;17
/net/per610a/home/mvp/mvp_db/hodost-lv/2016/2016_11_25_04_56/2016_11_25_21_54.mpg;YUriko Koike.jpg;14957;15537;91161;748;777;29
/net/per610a/home/mvp/mvp_db/hodost-lv/2016/2016_11_25_04_56/2016_11_25_21_54.mpg;YUriko Koike.jpg;16161;16589;91161;808;830;22
/net/per610a/home/mvp/mvp_db/hodost-lv/2016/2016_11_25_04_56/2016_11_25_21_54.mpg;YUriko Koike.jpg;21213;21293;91161;1061;1065;4
/net/per610a/home/mvp/mvp_db/hodost-lv/2016/2016_11_25_04_56/2016_11_25_21_54.mpg;YUriko Koike.jpg;21869;21941;91161;1094;1098;4
/net/per610a/home/mvp/mvp_db/hodost-lv/2016/2016_11_25_04_56/2016_11_25_21_54.mpg;YUriko Koike.jpg;17789;18105;91161;890;906;16
/net/per610a/home/mvp/mvp_db/hodost-lv/2016/2016_11_25_04_56/2016_11_25_21_54.mpg;YUriko Koike.jpg;18289;18305;91161;915;916;1
/net/per610a/home/mvp/mvp_db/hodost-lv/2016/2016_11_25_04_56/2016_11_25_21_54.mpg;YUriko Koike.jpg;19141;19229;91161;957;962;5
/net/per610a/home/mvp/mvp_db/hodost-lv/2016/2016_11_25_04_56/2016_11_25_21_54.mpg;YUriko Koike.jpg;19769;20033;91161;989;1002;13
/net/per610a/home/mvp/mvp_db/hodost-lv/2016/2016_11_25_04_56/2016_11_25_21_54.mpg;YUriko Koike.jpg;20361;20473;91161;1018;1024;6
/net/per610a/home/mvp/mvp_db/hodost-lv/2016/2016_11_25_04_56/2016_11_25_21_54.mpg;YUriko Koike.jpg;20565;20777;91161;1029;1039;10
/net/per610a/home/mvp/mvp_db/hodost-lv/2016/2016_11_27_04_56/2016_11_27_16_30.mpg;Shinzo ABE.jpg;86517;86561;107949;4329;4331;2
/net/per610a/home/mvp/mvp_db/hodost-lv/2016/2016_11_27_04_56/2016_11_27_16_30.mpg;Shinzo ABE.jpg;103841;103869;107949;5196;5197;1
/net/per610a/home/mvp/mvp_db/hodost-lv/2016/2016_11_28_04_56/2016_11_28_21_54.mpg;YUriko Koike.jpg;22169;22737;91169;1109;1137;28
/net/per610a/home/mvp/mvp_db/hodost-lv/2016/2016_11_28_04_56/2016_11_28_21_54.mpg;YUriko Koike.jpg;23005;23033;91169;1151;1152;1
/net/per610a/home/mvp/mvp_db/hodost-lv/2016/2016_11_28_04_56/2016_11_28_21_54.mpg;YUriko Koike.jpg;27073;27253;91169;1355;1364;9
/net/per610a/home/mvp/mvp_db/hodost-lv/2016/2016_11_28_04_56/2016_11_28_21_54.mpg;YUriko Koike.jpg;28249;28341;91169;1413;1418;5
/net/per610a/home/mvp/mvp_db/hodost-lv/2016/2016_11_28_04_56/2016_11_28_21_54.mpg;YUriko Koike.jpg;23085;23261;91169;1155;1164;9
/net/per610a/home/mvp/mvp_db/hodost-lv/2016/2016_11_28_04_56/2016_11_28_21_54.mpg;YUriko Koike.jpg;26777;27445;91169;1340;1373;33
/net/per610a/home/mvp/mvp_db/hodost-lv/2016/2016_11_28_04_56/2016_11_28_21_54.mpg;YUriko Koike.jpg;28993;29017;91169;1451;1452;1
/net/per610a/home/mvp/mvp_db/hodost-lv/2016/2016_11_29_04_56/2016_11_29_21_54.mpg;YUriko Koike.jpg;5129;5265;91169;256;263;7
/net/per610a/home/mvp/mvp_db/hodost-lv/2016/2016_11_29_04_56/2016_11_29_21_54.mpg;YUriko Koike.jpg;17549;17701;91169;878;885;7
/net/per610a/home/mvp/mvp_db/hodost-lv/2016/2016_11_29_04_56/2016_11_29_21_54.mpg;YUriko Koike.jpg;18473;18477;91169;924;924;0
/net/per610a/home/mvp/mvp_db/hodost-lv/2016/2016_11_29_04_56/2016_11_29_21_54.mpg;Shinzo ABE.jpg;44113;44117;91169;2207;2208;1
/net/per610a/home/mvp/mvp_db/hodost-lv/2016/2016_11_29_04_56/2016_11_29_21_54.mpg;Shinzo ABE.jpg;44185;44425;91169;2211;2223;12
/net/per610a/home/mvp/mvp_db/hodost-lv/2016/2016_11_29_04_56/2016_11_29_21_54.mpg;Shinzo ABE.jpg;47229;47441;91169;2363;2374;11
/net/per610a/home/mvp/mvp_db/hodost-lv/2016/2016_11_30_04_56/2016_11_30_21_54.mpg;YUriko Koike.jpg;3949;3953;91169;197;197;0
/net/per610a/home/mvp/mvp_db/hodost-lv/2016/2016_11_30_04_56/2016_11_30_21_54.mpg;YUriko Koike.jpg;8701;9085;91169;435;454;19
/net/per610a/home/mvp/mvp_db/hodost-lv/2016/2016_11_30_04_56/2016_11_30_21_54.mpg;YUriko Koike.jpg;9937;10081;91169;497;504;7
/net/per610a/home/mvp/mvp_db/hodost-lv/2016/2016_11_30_04_56/2016_11_30_21_54.mpg;YUriko Koike.jpg;10325;10421;91169;516;521;5
/net/per610a/home/mvp/mvp_db/hodost-lv/2016/2016_11_30_04_56/2016_11_30_21_54.mpg;YUriko Koike.jpg;10657;10737;91169;533;537;4
/net/per610a/home/mvp/mvp_db/hodost-lv/2016/2016_11_30_04_56/2016_11_30_21_54.mpg;YUriko Koike.jpg;11397;11689;91169;570;584;14
/net/per610a/home/mvp/mvp_db/hodost-lv/2016/2016_11_30_04_56/2016_11_30_21_54.mpg;YUriko Koike.jpg;11809;12013;91169;590;601;11
/net/per610a/home/mvp/mvp_db/hodost-lv/2016/2016_11_30_04_56/2016_11_30_21_54.mpg;YUriko Koike.jpg;12173;12941;91169;609;647;38
/net/per610a/home/mvp/mvp_db/hodost-lv/2016/2016_11_30_04_56/2016_11_30_21_54.mpg;YUriko Koike.jpg;13121;13237;91169;656;662;6
/net/per610a/home/mvp/mvp_db/hodost-lv/2016/2016_11_30_04_56/2016_11_30_21_54.mpg;YUriko Koike.jpg;13341;13661;91169;667;683;16
/net/per610a/home/mvp/mvp_db/hodost-lv/2016/2016_11_30_04_56/2016_11_30_21_54.mpg;YUriko Koike.jpg;14025;14113;91169;701;706;5
/net/per610a/home/mvp/mvp_db/hodost-lv/2016/2016_11_30_04_56/2016_11_30_21_54.mpg;YUriko Koike.jpg;14545;14773;91169;727;739;12
/net/per610a/home/mvp/mvp_db/hodost-lv/2016/2016_11_30_04_56/2016_11_30_21_54.mpg;YUriko Koike.jpg;14973;15713;91169;749;786;37
/net/per610a/home/mvp/mvp_db/hodost-lv/2016/2016_11_30_04_56/2016_11_30_21_54.mpg;YUriko Koike.jpg;15793;15985;91169;790;799;9
/net/per610a/home/mvp/mvp_db/hodost-lv/2016/2016_11_30_04_56/2016_11_30_21_54.mpg;YUriko Koike.jpg;16093;16193;91169;805;810;5
/net/per610a/home/mvp/mvp_db/hodost-lv/2016/2016_11_30_04_56/2016_11_30_21_54.mpg;YUriko Koike.jpg;16661;16921;91169;833;846;13
/net/per610a/home/mvp/mvp_db/hodost-lv/2016/2016_11_30_04_56/2016_11_30_21_54.mpg;YUriko Koike.jpg;17601;17869;91169;880;894;14
/net/per610a/home/mvp/mvp_db/hodost-lv/2016/2016_11_30_04_56/2016_11_30_21_54.mpg;YUriko Koike.jpg;18109;18373;91169;906;919;13
/net/per610a/home/mvp/mvp_db/hodost-lv/2016/2016_11_30_04_56/2016_11_30_21_54.mpg;YUriko Koike.jpg;18797;18981;91169;940;949;9
/net/per610a/home/mvp/mvp_db/hodost-lv/2016/2016_11_30_04_56/2016_11_30_21_54.mpg;YUriko Koike.jpg;19205;19369;91169;960;969;9
/net/per610a/home/mvp/mvp_db/hodost-lv/2016/2016_11_30_04_56/2016_11_30_21_54.mpg;YUriko Koike.jpg;20561;20709;91169;1028;1036;8
/net/per610a/home/mvp/mvp_db/hodost-lv/2016/2016_11_30_04_56/2016_11_30_21_54.mpg;YUriko Koike.jpg;23605;23741;91169;1181;1187;6
/net/per610a/home/mvp/mvp_db/hodost-lv/2016/2016_11_30_04_56/2016_11_30_21_54.mpg;YUriko Koike.jpg;6073;6325;91169;303;316;13
/net/per610a/home/mvp/mvp_db/hodost-lv/2016/2016_11_30_04_56/2016_11_30_21_54.mpg;YUriko Koike.jpg;6745;6797;91169;337;340;3
/net/per610a/home/mvp/mvp_db/hodost-lv/2016/2016_11_30_04_56/2016_11_30_21_54.mpg;YUriko Koike.jpg;19557;19789;91169;978;990;12
/net/per610a/home/mvp/mvp_db/hodost-lv/2016/2016_11_30_04_56/2016_11_30_21_54.mpg;YUriko Koike.jpg;22237;22781;91169;1112;1139;27
/net/per610a/home/mvp/mvp_db/hodost-lv/2016/2016_12_01_04_56/2016_12_01_21_54.mpg;YUriko Koike.jpg;7389;8029;91169;369;401;32
/net/per610a/home/mvp/mvp_db/hodost-lv/2016/2016_12_01_04_56/2016_12_01_21_54.mpg;YUriko Koike.jpg;8717;9005;91169;436;450;14
/net/per610a/home/mvp/mvp_db/hodost-lv/2016/2016_12_01_04_56/2016_12_01_21_54.mpg;YUriko Koike.jpg;12649;13561;91169;633;678;45
/net/per610a/home/mvp/mvp_db/hodost-lv/2016/2016_12_01_04_56/2016_12_01_21_54.mpg;YUriko Koike.jpg;14793;15241;91169;740;762;22
/net/per610a/home/mvp/mvp_db/hodost-lv/2016/2016_12_01_04_56/2016_12_01_21_54.mpg;Natsuo YAMAGUCHI.jpg;44057;44393;91169;2205;2221;16
/net/per610a/home/mvp/mvp_db/hodost-lv/2016/2016_12_02_04_56/2016_12_02_21_54.mpg;Shinzo ABE.jpg;16949;17097;91161;848;855;7
/net/per610a/home/mvp/mvp_db/hodost-lv/2016/2016_12_02_04_56/2016_12_02_21_54.mpg;Shinzo ABE.jpg;17161;17213;91161;858;861;3
/net/per610a/home/mvp/mvp_db/hodost-lv/2016/2016_12_02_04_56/2016_12_02_21_54.mpg;Shinzo ABE.jpg;17325;17377;91161;867;869;2
/net/per610a/home/mvp/mvp_db/hodost-lv/2016/2016_12_02_04_56/2016_12_02_21_54.mpg;Kohei Otsuka.jpg;22285;22345;91161;1115;1118;3
/net/per610a/home/mvp/mvp_db/hodost-lv/2016/2016_12_02_04_56/2016_12_02_21_54.mpg;Kohei Otsuka.jpg;22485;22641;91161;1125;1133;8
/net/per610a/home/mvp/mvp_db/hodost-lv/2016/2016_12_02_04_56/2016_12_02_21_54.mpg;Kohei Otsuka.jpg;33941;34033;91161;1698;1703;5
/net/per610a/home/mvp/mvp_db/hodost-lv/2016/2016_12_02_04_56/2016_12_02_21_54.mpg;Kohei Otsuka.jpg;52101;52189;91161;2607;2611;4
/net/per610a/home/mvp/mvp_db/hodost-lv/2016/2016_12_02_04_56/2016_12_02_21_54.mpg;YUriko Koike.jpg;52197;52277;91161;2612;2616;4
/net/per610a/home/mvp/mvp_db/hodost-lv/2016/2016_12_02_04_56/2016_12_02_21_54.mpg;YUriko Koike.jpg;54853;56293;91161;2745;2817;72
/net/per610a/home/mvp/mvp_db/hodost-lv/2016/2016_12_04_04_56/2016_12_04_16_30.mpg;Shinzo ABE.jpg;25885;26097;107957;1295;1306;11
/net/per610a/home/mvp/mvp_db/hodost-lv/2016/2016_12_04_04_56/2016_12_04_16_30.mpg;Ichiro Matsui.jpeg;26897;27369;107957;1346;1369;23
/net/per610a/home/mvp/mvp_db/hodost-lv/2016/2016_12_05_04_56/2016_12_05_21_54.mpg;Shinzo ABE.jpg;621;1269;91169;31;63;32
/net/per610a/home/mvp/mvp_db/hodost-lv/2016/2016_12_05_04_56/2016_12_05_21_54.mpg;Shinzo ABE.jpg;1481;1629;91169;74;81;7
/net/per610a/home/mvp/mvp_db/hodost-lv/2016/2016_12_05_04_56/2016_12_05_21_54.mpg;Shinzo ABE.jpg;4545;5293;91169;227;264;37
/net/per610a/home/mvp/mvp_db/hodost-lv/2016/2016_12_05_04_56/2016_12_05_21_54.mpg;Shinzo ABE.jpg;6481;6525;91169;324;326;2
/net/per610a/home/mvp/mvp_db/hodost-lv/2016/2016_12_05_04_56/2016_12_05_21_54.mpg;Shinzo ABE.jpg;10249;10601;91169;512;530;18
/net/per610a/home/mvp/mvp_db/hodost-lv/2016/2016_12_05_04_56/2016_12_05_21_54.mpg;Shinzo ABE.jpg;4421;4457;91169;221;223;2
/net/per610a/home/mvp/mvp_db/hodost-lv/2016/2016_12_05_04_56/2016_12_05_21_54.mpg;Shinzo ABE.jpg;15577;15705;91169;779;786;7
/net/per610a/home/mvp/mvp_db/hodost-lv/2016/2016_12_06_04_56/2016_12_06_21_54.mpg;Ichiro OZAWA.jpg;11169;11345;91169;558;567;9
/net/per610a/home/mvp/mvp_db/hodost-lv/2016/2016_12_06_04_56/2016_12_06_21_54.mpg;Ichiro OZAWA.jpg;14089;14733;91169;704;737;33
/net/per610a/home/mvp/mvp_db/hodost-lv/2016/2016_12_06_04_56/2016_12_06_21_54.mpg;Yukio HATOYAMA.jpg;38429;38805;91169;1922;1941;19
/net/per610a/home/mvp/mvp_db/hodost-lv/2016/2016_12_06_04_56/2016_12_06_21_54.mpg;Yukio HATOYAMA.jpg;50273;50765;91169;2515;2540;25
/net/per610a/home/mvp/mvp_db/hodost-lv/2016/2016_12_07_04_56/2016_12_07_21_54.mpg;Shinzo ABE.jpg;9145;9269;91169;457;463;6
/net/per610a/home/mvp/mvp_db/hodost-lv/2016/2016_12_07_04_56/2016_12_07_21_54.mpg;Shinzo ABE.jpg;18501;18513;91169;925;926;1
/net/per610a/home/mvp/mvp_db/hodost-lv/2016/2016_12_07_04_56/2016_12_07_21_54.mpg;Shinzo ABE.jpg;10641;10869;91169;532;543;11
/net/per610a/home/mvp/mvp_db/hodost-lv/2016/2016_12_07_04_56/2016_12_07_21_54.mpg;YUriko Koike.jpg;39761;40193;91169;1989;2011;22
/net/per610a/home/mvp/mvp_db/hodost-lv/2016/2016_12_11_04_56/2016_12_11_16_30.mpg;Kyoko Nakayama.jpg;23357;23445;107949;1168;1173;5
/net/per610a/home/mvp/mvp_db/hodost-lv/2016/2016_12_11_04_56/2016_12_11_16_30.mpg;Kyoko Nakayama.jpg;27693;27785;107949;1385;1390;5
/net/per610a/home/mvp/mvp_db/hodost-lv/2016/2016_12_11_04_56/2016_12_11_16_30.mpg;Shinzo ABE.jpg;73001;73029;107949;3653;3654;1
/net/per610a/home/mvp/mvp_db/hodost-lv/2016/2016_12_11_04_56/2016_12_11_16_30.mpg;Shinzo ABE.jpg;84117;84313;107949;4209;4219;10
/net/per610a/home/mvp/mvp_db/hodost-lv/2016/2016_12_11_04_56/2016_12_11_16_30.mpg;Shinzo ABE.jpg;85305;85353;107949;4268;4271;3
/net/per610a/home/mvp/mvp_db/hodost-lv/2016/2016_12_11_04_56/2016_12_11_16_30.mpg;Shinzo ABE.jpg;85945;85993;107949;4300;4303;3
/net/per610a/home/mvp/mvp_db/hodost-lv/2016/2016_12_11_04_56/2016_12_11_16_30.mpg;Shinzo ABE.jpg;80649;80673;107949;4035;4037;2
/net/per610a/home/mvp/mvp_db/hodost-lv/2016/2016_12_11_04_56/2016_12_11_16_30.mpg;Shinzo ABE.jpg;84333;84489;107949;4220;4228;8
/net/per610a/home/mvp/mvp_db/hodost-lv/2016/2016_12_11_04_56/2016_12_11_16_30.mpg;Shinzo ABE.jpg;85589;85681;107949;4283;4287;4
/net/per610a/home/mvp/mvp_db/hodost-lv/2016/2016_12_11_04_56/2016_12_11_16_30.mpg;Shinzo ABE.jpg;86673;86713;107949;4337;4339;2
/net/per610a/home/mvp/mvp_db/hodost-lv/2016/2016_12_11_04_56/2016_12_11_16_30.mpg;Shinzo ABE.jpg;86805;86833;107949;4343;4345;2
/net/per610a/home/mvp/mvp_db/hodost-lv/2016/2016_12_11_04_56/2016_12_11_16_30.mpg;Shinzo ABE.jpg;103445;103569;107949;5176;5182;6
/net/per610a/home/mvp/mvp_db/hodost-lv/2016/2016_12_11_04_56/2016_12_11_16_30.mpg;Shinzo ABE.jpg;103789;103805;107949;5193;5194;1
/net/per610a/home/mvp/mvp_db/hodost-lv/2016/2016_12_12_04_56/2016_12_12_21_54.mpg;Shinzo ABE.jpg;23109;23417;91169;1156;1172;16
/net/per610a/home/mvp/mvp_db/hodost-lv/2016/2016_12_12_04_56/2016_12_12_21_54.mpg;Shinzo ABE.jpg;46949;47093;91169;2349;2357;8
/net/per610a/home/mvp/mvp_db/hodost-lv/2016/2016_12_12_04_56/2016_12_12_21_54.mpg;YUriko Koike.jpg;53129;53185;91169;2659;2661;2
/net/per610a/home/mvp/mvp_db/hodost-lv/2016/2016_12_13_04_56/2016_12_13_21_54.mpg;Shinzo ABE.jpg;7285;7397;91169;364;370;6
/net/per610a/home/mvp/mvp_db/hodost-lv/2016/2016_12_13_04_56/2016_12_13_21_54.mpg;Shinzo ABE.jpg;9845;9877;91169;492;494;2
/net/per610a/home/mvp/mvp_db/hodost-lv/2016/2016_12_13_04_56/2016_12_13_21_54.mpg;YUriko Koike.jpg;49373;49501;91169;2470;2476;6
/net/per610a/home/mvp/mvp_db/hodost-lv/2016/2016_12_13_04_56/2016_12_13_21_54.mpg;YUriko Koike.jpg;49621;49733;91169;2482;2488;6
/net/per610a/home/mvp/mvp_db/hodost-lv/2016/2016_12_13_04_56/2016_12_13_21_54.mpg;YUriko Koike.jpg;50133;50297;91169;2508;2516;8
/net/per610a/home/mvp/mvp_db/hodost-lv/2016/2016_12_14_04_56/2016_12_14_21_54.mpg;Shinzo ABE.jpg;10845;11113;91169;542;556;14
/net/per610a/home/mvp/mvp_db/hodost-lv/2016/2016_12_14_04_56/2016_12_14_21_54.mpg;Shinzo ABE.jpg;23269;23301;91169;1164;1166;2
/net/per610a/home/mvp/mvp_db/hodost-lv/2016/2016_12_14_04_56/2016_12_14_21_54.mpg;Shinzo ABE.jpg;23385;23385;91169;1170;1170;0
/net/per610a/home/mvp/mvp_db/hodost-lv/2016/2016_12_14_04_56/2016_12_14_21_54.mpg;Shinzo ABE.jpg;39701;39737;91169;1987;1988;1
/net/per610a/home/mvp/mvp_db/hodost-lv/2016/2016_12_14_04_56/2016_12_14_21_54.mpg;Renho.jpg;21837;21913;91169;1092;1096;4
/net/per610a/home/mvp/mvp_db/hodost-lv/2016/2016_12_14_04_56/2016_12_14_21_54.mpg;Renho.jpg;25713;25965;91169;1286;1299;13
/net/per610a/home/mvp/mvp_db/hodost-lv/2016/2016_12_14_04_56/2016_12_14_21_54.mpg;YUriko Koike.jpg;53741;54081;91169;2689;2706;17
/net/per610a/home/mvp/mvp_db/hodost-lv/2016/2016_12_15_04_56/2016_12_15_21_54.mpg;Shinzo ABE.jpg;1329;1485;91169;66;74;8
/net/per610a/home/mvp/mvp_db/hodost-lv/2016/2016_12_15_04_56/2016_12_15_21_54.mpg;Shinzo ABE.jpg;1561;5041;91169;78;252;174
/net/per610a/home/mvp/mvp_db/hodost-lv/2016/2016_12_15_04_56/2016_12_15_21_54.mpg;Shinzo ABE.jpg;6473;6493;91169;323;324;1
/net/per610a/home/mvp/mvp_db/hodost-lv/2016/2016_12_15_04_56/2016_12_15_21_54.mpg;Shinzo ABE.jpg;7421;8133;91169;371;407;36
/net/per610a/home/mvp/mvp_db/hodost-lv/2016/2016_12_15_04_56/2016_12_15_21_54.mpg;Shinzo ABE.jpg;15173;15433;91169;759;772;13
/net/per610a/home/mvp/mvp_db/hodost-lv/2016/2016_12_15_04_56/2016_12_15_21_54.mpg;Shinzo ABE.jpg;9185;9237;91169;459;462;3
/net/per610a/home/mvp/mvp_db/hodost-lv/2016/2016_12_15_04_56/2016_12_15_21_54.mpg;Shinzo ABE.jpg;14893;15057;91169;745;753;8
/net/per610a/home/mvp/mvp_db/hodost-lv/2016/2016_12_15_04_56/2016_12_15_21_54.mpg;Shinzo ABE.jpg;29205;29489;91169;1461;1475;14
/net/per610a/home/mvp/mvp_db/hodost-lv/2016/2016_12_15_04_56/2016_12_15_21_54.mpg;Shinzo ABE.jpg;33149;33221;91169;1659;1662;3
/net/per610a/home/mvp/mvp_db/hodost-lv/2016/2016_12_15_04_56/2016_12_15_21_54.mpg;YUriko Koike.jpg;41805;41829;91169;2092;2093;1
/net/per610a/home/mvp/mvp_db/hodost-lv/2016/2016_12_15_04_56/2016_12_15_21_54.mpg;YUriko Koike.jpg;44841;45061;91169;2244;2255;11
/net/per610a/home/mvp/mvp_db/hodost-lv/2016/2016_12_15_04_56/2016_12_15_21_54.mpg;YUriko Koike.jpg;46145;46349;91169;2309;2319;10
/net/per610a/home/mvp/mvp_db/hodost-lv/2016/2016_12_16_04_56/2016_12_16_21_54.mpg;Shinzo ABE.jpg;5261;5353;91169;263;267;4
/net/per610a/home/mvp/mvp_db/hodost-lv/2016/2016_12_16_04_56/2016_12_16_21_54.mpg;Shinzo ABE.jpg;7149;7253;91169;357;363;6
/net/per610a/home/mvp/mvp_db/hodost-lv/2016/2016_12_16_04_56/2016_12_16_21_54.mpg;Shinzo ABE.jpg;9981;10037;91169;499;502;3
/net/per610a/home/mvp/mvp_db/hodost-lv/2016/2016_12_16_04_56/2016_12_16_21_54.mpg;Shinzo ABE.jpg;10417;10517;91169;521;526;5
/net/per610a/home/mvp/mvp_db/hodost-lv/2016/2016_12_16_04_56/2016_12_16_21_54.mpg;Shinzo ABE.jpg;10749;11041;91169;537;552;15
/net/per610a/home/mvp/mvp_db/hodost-lv/2016/2016_12_16_04_56/2016_12_16_21_54.mpg;Shinzo ABE.jpg;11129;11317;91169;557;566;9
/net/per610a/home/mvp/mvp_db/hodost-lv/2016/2016_12_16_04_56/2016_12_16_21_54.mpg;Shinzo ABE.jpg;11505;11693;91169;575;585;10
/net/per610a/home/mvp/mvp_db/hodost-lv/2016/2016_12_16_04_56/2016_12_16_21_54.mpg;Shinzo ABE.jpg;11765;12173;91169;588;609;21
/net/per610a/home/mvp/mvp_db/hodost-lv/2016/2016_12_16_04_56/2016_12_16_21_54.mpg;Shinzo ABE.jpg;12265;12693;91169;613;635;22
/net/per610a/home/mvp/mvp_db/hodost-lv/2016/2016_12_16_04_56/2016_12_16_21_54.mpg;Shinzo ABE.jpg;12901;13233;91169;645;662;17
/net/per610a/home/mvp/mvp_db/hodost-lv/2016/2016_12_16_04_56/2016_12_16_21_54.mpg;Shinzo ABE.jpg;13305;13629;91169;665;682;17
/net/per610a/home/mvp/mvp_db/hodost-lv/2016/2016_12_16_04_56/2016_12_16_21_54.mpg;Shinzo ABE.jpg;13833;14865;91169;692;743;51
/net/per610a/home/mvp/mvp_db/hodost-lv/2016/2016_12_16_04_56/2016_12_16_21_54.mpg;Shinzo ABE.jpg;15161;15317;91169;758;766;8
/net/per610a/home/mvp/mvp_db/hodost-lv/2016/2016_12_16_04_56/2016_12_16_21_54.mpg;Shinzo ABE.jpg;16237;16449;91169;812;823;11
/net/per610a/home/mvp/mvp_db/hodost-lv/2016/2016_12_16_04_56/2016_12_16_21_54.mpg;Shinzo ABE.jpg;16837;17217;91169;842;861;19
/net/per610a/home/mvp/mvp_db/hodost-lv/2016/2016_12_16_04_56/2016_12_16_21_54.mpg;Shinzo ABE.jpg;18157;18401;91169;908;920;12
/net/per610a/home/mvp/mvp_db/hodost-lv/2016/2016_12_16_04_56/2016_12_16_21_54.mpg;Shinzo ABE.jpg;18557;18605;91169;928;931;3
/net/per610a/home/mvp/mvp_db/hodost-lv/2016/2016_12_16_04_56/2016_12_16_21_54.mpg;Shinzo ABE.jpg;18741;19269;91169;937;964;27
/net/per610a/home/mvp/mvp_db/hodost-lv/2016/2016_12_16_04_56/2016_12_16_21_54.mpg;Shinzo ABE.jpg;19401;19617;91169;971;981;10
/net/per610a/home/mvp/mvp_db/hodost-lv/2016/2016_12_16_04_56/2016_12_16_21_54.mpg;Shinzo ABE.jpg;19717;19861;91169;986;994;8
/net/per610a/home/mvp/mvp_db/hodost-lv/2016/2016_12_16_04_56/2016_12_16_21_54.mpg;Shinzo ABE.jpg;20045;20445;91169;1003;1023;20
/net/per610a/home/mvp/mvp_db/hodost-lv/2016/2016_12_16_04_56/2016_12_16_21_54.mpg;Shinzo ABE.jpg;20677;20861;91169;1034;1044;10
/net/per610a/home/mvp/mvp_db/hodost-lv/2016/2016_12_16_04_56/2016_12_16_21_54.mpg;Shinzo ABE.jpg;21049;21305;91169;1053;1066;13
/net/per610a/home/mvp/mvp_db/hodost-lv/2016/2016_12_16_04_56/2016_12_16_21_54.mpg;Shinzo ABE.jpg;21465;22245;91169;1074;1113;39
/net/per610a/home/mvp/mvp_db/hodost-lv/2016/2016_12_16_04_56/2016_12_16_21_54.mpg;Shinzo ABE.jpg;22365;22461;91169;1119;1124;5
/net/per610a/home/mvp/mvp_db/hodost-lv/2016/2016_12_16_04_56/2016_12_16_21_54.mpg;Shinzo ABE.jpg;22629;22977;91169;1132;1149;17
/net/per610a/home/mvp/mvp_db/hodost-lv/2016/2016_12_16_04_56/2016_12_16_21_54.mpg;Shinzo ABE.jpg;23053;23333;91169;1153;1167;14
/net/per610a/home/mvp/mvp_db/hodost-lv/2016/2016_12_16_04_56/2016_12_16_21_54.mpg;Shinzo ABE.jpg;23557;24005;91169;1179;1201;22
/net/per610a/home/mvp/mvp_db/hodost-lv/2016/2016_12_16_04_56/2016_12_16_21_54.mpg;Shinzo ABE.jpg;24121;25029;91169;1207;1252;45
/net/per610a/home/mvp/mvp_db/hodost-lv/2016/2016_12_16_04_56/2016_12_16_21_54.mpg;Shinzo ABE.jpg;25161;25473;91169;1259;1274;15
/net/per610a/home/mvp/mvp_db/hodost-lv/2016/2016_12_16_04_56/2016_12_16_21_54.mpg;Shinzo ABE.jpg;25693;26021;91169;1285;1302;17
/net/per610a/home/mvp/mvp_db/hodost-lv/2016/2016_12_16_04_56/2016_12_16_21_54.mpg;Shinzo ABE.jpg;26169;26517;91169;1309;1327;18
/net/per610a/home/mvp/mvp_db/hodost-lv/2016/2016_12_16_04_56/2016_12_16_21_54.mpg;Shinzo ABE.jpg;26693;26837;91169;1335;1343;8
/net/per610a/home/mvp/mvp_db/hodost-lv/2016/2016_12_16_04_56/2016_12_16_21_54.mpg;Shinzo ABE.jpg;27041;27421;91169;1353;1372;19
/net/per610a/home/mvp/mvp_db/hodost-lv/2016/2016_12_16_04_56/2016_12_16_21_54.mpg;Shinzo ABE.jpg;27517;28025;91169;1377;1402;25
/net/per610a/home/mvp/mvp_db/hodost-lv/2016/2016_12_16_04_56/2016_12_16_21_54.mpg;Shinzo ABE.jpg;29389;29445;91169;1470;1473;3
/net/per610a/home/mvp/mvp_db/hodost-lv/2016/2016_12_16_04_56/2016_12_16_21_54.mpg;Shinzo ABE.jpg;30249;30425;91169;1513;1522;9
/net/per610a/home/mvp/mvp_db/hodost-lv/2016/2016_12_16_04_56/2016_12_16_21_54.mpg;Shinzo ABE.jpg;30945;31029;91169;1548;1552;4
/net/per610a/home/mvp/mvp_db/hodost-lv/2016/2016_12_16_04_56/2016_12_16_21_54.mpg;Shinzo ABE.jpg;31189;31509;91169;1561;1577;16
/net/per610a/home/mvp/mvp_db/hodost-lv/2016/2016_12_16_04_56/2016_12_16_21_54.mpg;Shinzo ABE.jpg;31645;32213;91169;1583;1612;29
/net/per610a/home/mvp/mvp_db/hodost-lv/2016/2016_12_16_04_56/2016_12_16_21_54.mpg;Shinzo ABE.jpg;32409;32521;91169;1622;1627;5
/net/per610a/home/mvp/mvp_db/hodost-lv/2016/2016_12_16_04_56/2016_12_16_21_54.mpg;Shinzo ABE.jpg;32629;33265;91169;1633;1664;31
/net/per610a/home/mvp/mvp_db/hodost-lv/2016/2016_12_16_04_56/2016_12_16_21_54.mpg;Shinzo ABE.jpg;34237;34881;91169;1713;1745;32
/net/per610a/home/mvp/mvp_db/hodost-lv/2016/2016_12_16_04_56/2016_12_16_21_54.mpg;Shinzo ABE.jpg;35005;35313;91169;1751;1767;16
/net/per610a/home/mvp/mvp_db/hodost-lv/2016/2016_12_16_04_56/2016_12_16_21_54.mpg;Shinzo ABE.jpg;35409;35761;91169;1772;1789;17
/net/per610a/home/mvp/mvp_db/hodost-lv/2016/2016_12_16_04_56/2016_12_16_21_54.mpg;Shinzo ABE.jpg;36041;37093;91169;1803;1856;53
/net/per610a/home/mvp/mvp_db/hodost-lv/2016/2016_12_16_04_56/2016_12_16_21_54.mpg;Shinzo ABE.jpg;37253;37405;91169;1864;1872;8
/net/per610a/home/mvp/mvp_db/hodost-lv/2016/2016_12_16_04_56/2016_12_16_21_54.mpg;Shinzo ABE.jpg;37485;37857;91169;1876;1894;18
/net/per610a/home/mvp/mvp_db/hodost-lv/2016/2016_12_16_04_56/2016_12_16_21_54.mpg;YUriko Koike.jpg;41349;41625;91169;2069;2083;14
/net/per610a/home/mvp/mvp_db/hodost-lv/2016/2016_12_16_04_56/2016_12_16_21_54.mpg;YUriko Koike.jpg;41729;41853;91169;2088;2094;6
/net/per610a/home/mvp/mvp_db/hodost-lv/2016/2016_12_16_04_56/2016_12_16_21_54.mpg;YUriko Koike.jpg;42805;43333;91169;2142;2168;26
/net/per610a/home/mvp/mvp_db/hodost-lv/2016/2016_12_16_04_56/2016_12_16_21_54.mpg;YUriko Koike.jpg;44077;44729;91169;2206;2238;32
/net/per610a/home/mvp/mvp_db/hodost-lv/2016/2016_12_18_04_56/2016_12_18_16_30.mpg;Renho.jpg;34621;34677;107949;1732;1735;3
/net/per610a/home/mvp/mvp_db/hodost-lv/2016/2016_12_18_04_56/2016_12_18_16_30.mpg;Renho.jpg;35293;35397;107949;1766;1771;5
/net/per610a/home/mvp/mvp_db/hodost-lv/2016/2016_12_18_04_56/2016_12_18_16_30.mpg;Renho.jpg;36337;36521;107949;1818;1827;9
/net/per610a/home/mvp/mvp_db/hodost-lv/2016/2016_12_18_04_56/2016_12_18_16_30.mpg;Shinzo ABE.jpg;86545;86761;107949;4330;4341;11
/net/per610a/home/mvp/mvp_db/hodost-lv/2016/2016_12_18_04_56/2016_12_18_16_30.mpg;Shinzo ABE.jpg;103769;103821;107949;5192;5195;3
/net/per610a/home/mvp/mvp_db/hodost-lv/2016/2016_12_18_04_56/2016_12_18_16_30.mpg;Yoshihiko Noda.jpg;98785;99049;107949;4943;4956;13
/net/per610a/home/mvp/mvp_db/hodost-lv/2016/2016_12_21_04_56/2016_12_21_21_54.mpg;YUriko Koike.jpg;6505;6589;91169;325;329;4
/net/per610a/home/mvp/mvp_db/hodost-lv/2016/2016_12_21_04_56/2016_12_21_21_54.mpg;YUriko Koike.jpg;6869;7257;91169;343;363;20
/net/per610a/home/mvp/mvp_db/hodost-lv/2016/2016_12_21_04_56/2016_12_21_21_54.mpg;YUriko Koike.jpg;7601;7725;91169;380;386;6
/net/per610a/home/mvp/mvp_db/hodost-lv/2016/2016_12_21_04_56/2016_12_21_21_54.mpg;YUriko Koike.jpg;12049;12617;91169;603;631;28
/net/per610a/home/mvp/mvp_db/hodost-lv/2016/2016_12_21_04_56/2016_12_21_21_54.mpg;YUriko Koike.jpg;16033;16193;91169;802;810;8
/net/per610a/home/mvp/mvp_db/hodost-lv/2016/2016_12_22_04_56/2016_12_22_22_09.mpg;YUriko Koike.jpg;25717;25785;91161;1286;1290;4
/net/per610a/home/mvp/mvp_db/hodost-lv/2016/2016_12_22_04_56/2016_12_22_22_09.mpg;YUriko Koike.jpg;26085;26917;91161;1305;1347;42
/net/per610a/home/mvp/mvp_db/hodost-lv/2016/2016_12_22_04_56/2016_12_22_22_09.mpg;YUriko Koike.jpg;27097;27257;91161;1356;1364;8
/net/per610a/home/mvp/mvp_db/hodost-lv/2016/2016_12_22_04_56/2016_12_22_22_09.mpg;YUriko Koike.jpg;29429;29669;91161;1472;1484;12
/net/per610a/home/mvp/mvp_db/hodost-lv/2016/2016_12_25_04_56/2016_12_25_16_00.mpg;Shinzo ABE.jpg;45013;45117;143909;2252;2257;5
/net/per610a/home/mvp/mvp_db/hodost-lv/2016/2016_12_25_04_56/2016_12_25_16_00.mpg;YUriko Koike.jpg;80793;80893;143909;4043;4048;5
/net/per610a/home/mvp/mvp_db/hodost-lv/2016/2016_12_25_04_56/2016_12_25_16_00.mpg;YUriko Koike.jpg;81245;81729;143909;4065;4090;25
/net/per610a/home/mvp/mvp_db/hodost-lv/2016/2016_12_25_04_56/2016_12_25_16_00.mpg;YUriko Koike.jpg;81801;82045;143909;4093;4105;12
/net/per610a/home/mvp/mvp_db/hodost-lv/2017/2017_01_05_04_56/2017_01_05_21_54.mpg;Shinzo ABE.jpg;41433;41589;91169;2073;2081;8
/net/per610a/home/mvp/mvp_db/hodost-lv/2017/2017_01_05_04_56/2017_01_05_21_54.mpg;Shinzo ABE.jpg;41737;42833;91169;2088;2143;55
/net/per610a/home/mvp/mvp_db/hodost-lv/2017/2017_01_05_04_56/2017_01_05_21_54.mpg;Shinzo ABE.jpg;42997;43161;91169;2151;2160;9
/net/per610a/home/mvp/mvp_db/hodost-lv/2017/2017_01_05_04_56/2017_01_05_21_54.mpg;Shinzo ABE.jpg;44021;44365;91169;2203;2220;17
/net/per610a/home/mvp/mvp_db/hodost-lv/2017/2017_01_05_04_56/2017_01_05_21_54.mpg;Shinzo ABE.jpg;44481;44569;91169;2226;2230;4
/net/per610a/home/mvp/mvp_db/hodost-lv/2017/2017_01_05_04_56/2017_01_05_21_54.mpg;Shinzo ABE.jpg;45173;45353;91169;2260;2269;9
/net/per610a/home/mvp/mvp_db/hodost-lv/2017/2017_01_05_04_56/2017_01_05_21_54.mpg;YUriko Koike.jpg;62453;62753;91169;3125;3140;15
/net/per610a/home/mvp/mvp_db/hodost-lv/2017/2017_01_05_04_56/2017_01_05_21_54.mpg;YUriko Koike.jpg;62937;63305;91169;3149;3168;19
/net/per610a/home/mvp/mvp_db/hodost-lv/2017/2017_01_04_04_56/2017_01_04_21_54.mpg;Shinzo ABE.jpg;12977;13841;91161;649;692;43
/net/per610a/home/mvp/mvp_db/hodost-lv/2017/2017_01_04_04_56/2017_01_04_21_54.mpg;Kohei Otsuka.jpg;34193;34685;91161;1711;1735;24
/net/per610a/home/mvp/mvp_db/hodost-lv/2017/2017_01_04_04_56/2017_01_04_21_54.mpg;Kohei Otsuka.jpg;42973;43041;91161;2150;2153;3
/net/per610a/home/mvp/mvp_db/hodost-lv/2017/2017_01_04_04_56/2017_01_04_21_54.mpg;YUriko Koike.jpg;34785;34809;91161;1740;1741;1
/net/per610a/home/mvp/mvp_db/hodost-lv/2017/2017_01_04_04_56/2017_01_04_21_54.mpg;YUriko Koike.jpg;37197;37209;91161;1861;1862;1
/net/per610a/home/mvp/mvp_db/hodost-lv/2017/2017_01_04_04_56/2017_01_04_21_54.mpg;YUriko Koike.jpg;37621;37657;91161;1882;1884;2
/net/per610a/home/mvp/mvp_db/hodost-lv/2017/2017_01_04_04_56/2017_01_04_21_54.mpg;YUriko Koike.jpg;39201;39429;91161;1961;1973;12
/net/per610a/home/mvp/mvp_db/hodost-lv/2017/2017_01_08_04_56/2017_01_08_16_30.mpg;Taro ASO.jpg;18357;18785;107949;918;940;22
/net/per610a/home/mvp/mvp_db/hodost-lv/2017/2017_01_08_04_56/2017_01_08_16_30.mpg;Shinzo ABE.jpg;97665;97817;107949;4887;4894;7
/net/per610a/home/mvp/mvp_db/hodost-lv/2017/2017_01_08_04_56/2017_01_08_16_30.mpg;Shinzo ABE.jpg;103697;103701;107949;5189;5189;0
/net/per610a/home/mvp/mvp_db/hodost-lv/2017/2017_01_08_04_56/2017_01_08_16_30.mpg;Shinzo ABE.jpg;103961;104049;107949;5202;5206;4
/net/per610a/home/mvp/mvp_db/hodost-lv/2017/2017_01_09_04_56/2017_01_09_21_54.mpg;YUriko Koike.jpg;25593;25709;91169;1280;1286;6
/net/per610a/home/mvp/mvp_db/hodost-lv/2017/2017_01_09_04_56/2017_01_09_21_54.mpg;YUriko Koike.jpg;26077;26233;91169;1305;1312;7
/net/per610a/home/mvp/mvp_db/hodost-lv/2017/2017_01_12_04_56/2017_01_12_22_09.mpg;YUriko Koike.jpg;27921;28093;91169;1397;1406;9
/net/per610a/home/mvp/mvp_db/hodost-lv/2017/2017_01_12_04_56/2017_01_12_22_09.mpg;YUriko Koike.jpg;29297;29437;91169;1466;1473;7
/net/per610a/home/mvp/mvp_db/hodost-lv/2017/2017_01_12_04_56/2017_01_12_22_09.mpg;YUriko Koike.jpg;29589;29709;91169;1480;1486;6
/net/per610a/home/mvp/mvp_db/hodost-lv/2017/2017_01_12_04_56/2017_01_12_22_09.mpg;YUriko Koike.jpg;30553;30773;91169;1529;1540;11
/net/per610a/home/mvp/mvp_db/hodost-lv/2017/2017_01_12_04_56/2017_01_12_22_09.mpg;YUriko Koike.jpg;32981;33209;91169;1650;1662;12
/net/per610a/home/mvp/mvp_db/hodost-lv/2017/2017_01_12_04_56/2017_01_12_22_09.mpg;Kohei Otsuka.jpg;42277;42393;91169;2115;2121;6
/net/per610a/home/mvp/mvp_db/hodost-lv/2017/2017_01_12_04_56/2017_01_12_22_09.mpg;Kohei Otsuka.jpg;46493;46733;91169;2326;2338;12
/net/per610a/home/mvp/mvp_db/hodost-lv/2017/2017_01_12_04_56/2017_01_12_22_09.mpg;Kohei Otsuka.jpg;67889;67945;91169;3397;3400;3
/net/per610a/home/mvp/mvp_db/hodost-lv/2017/2017_01_12_04_56/2017_01_12_22_09.mpg;Kohei Otsuka.jpg;70201;70341;91169;3513;3520;7
/net/per610a/home/mvp/mvp_db/hodost-lv/2017/2017_01_12_04_56/2017_01_12_22_09.mpg;Kohei Otsuka.jpg;76789;76881;91169;3843;3847;4
/net/per610a/home/mvp/mvp_db/hodost-lv/2017/2017_01_15_04_56/2017_01_15_16_30.mpg;YUriko Koike.jpg;41257;41957;107961;2064;2099;35
/net/per610a/home/mvp/mvp_db/hodost-lv/2017/2017_01_16_04_56/2017_01_16_21_54.mpg;Shinzo ABE.jpg;37725;37849;91169;1888;1894;6
/net/per610a/home/mvp/mvp_db/hodost-lv/2017/2017_01_16_04_56/2017_01_16_21_54.mpg;Shinzo ABE.jpg;41417;42517;91169;2072;2127;55
/net/per610a/home/mvp/mvp_db/hodost-lv/2017/2017_01_16_04_56/2017_01_16_21_54.mpg;Toru Hashimoto.jpg;89869;90033;91169;4497;4506;9
/net/per610a/home/mvp/mvp_db/hodost-lv/2017/2017_01_18_04_56/2017_01_18_21_54.mpg;YUriko Koike.jpg;10293;10457;91177;515;523;8
/net/per610a/home/mvp/mvp_db/hodost-lv/2017/2017_01_18_04_56/2017_01_18_21_54.mpg;YUriko Koike.jpg;10565;10585;91177;528;529;1
/net/per610a/home/mvp/mvp_db/hodost-lv/2017/2017_01_18_04_56/2017_01_18_21_54.mpg;YUriko Koike.jpg;11141;11245;91177;557;562;5
/net/per610a/home/mvp/mvp_db/hodost-lv/2017/2017_01_18_04_56/2017_01_18_21_54.mpg;YUriko Koike.jpg;11453;11633;91177;573;582;9
/net/per610a/home/mvp/mvp_db/hodost-lv/2017/2017_01_18_04_56/2017_01_18_21_54.mpg;YUriko Koike.jpg;13741;13833;91177;687;692;5
/net/per610a/home/mvp/mvp_db/hodost-lv/2017/2017_01_18_04_56/2017_01_18_21_54.mpg;YUriko Koike.jpg;13901;14249;91177;695;713;18
/net/per610a/home/mvp/mvp_db/hodost-lv/2017/2017_01_18_04_56/2017_01_18_21_54.mpg;YUriko Koike.jpg;14417;14529;91177;721;727;6
/net/per610a/home/mvp/mvp_db/hodost-lv/2017/2017_01_18_04_56/2017_01_18_21_54.mpg;Shinzo ABE.jpg;10565;10641;91177;528;532;4
/net/per610a/home/mvp/mvp_db/hodost-lv/2017/2017_01_18_04_56/2017_01_18_21_54.mpg;Shinzo ABE.jpg;13697;13733;91177;685;687;2
/net/per610a/home/mvp/mvp_db/hodost-lv/2017/2017_01_19_04_56/2017_01_19_21_54.mpg;Shinzo ABE.jpg;43093;43257;91169;2156;2165;9
/net/per610a/home/mvp/mvp_db/hodost-lv/2017/2017_01_20_04_56/2017_01_20_21_54.mpg;Shinzo ABE.jpg;44153;44253;91169;2209;2214;5
/net/per610a/home/mvp/mvp_db/hodost-lv/2017/2017_01_20_04_56/2017_01_20_21_54.mpg;Shinzo ABE.jpg;45153;45333;91169;2259;2268;9
/net/per610a/home/mvp/mvp_db/hodost-lv/2017/2017_01_20_04_56/2017_01_20_21_54.mpg;Shinzo ABE.jpg;45409;45549;91169;2272;2279;7
/net/per610a/home/mvp/mvp_db/hodost-lv/2017/2017_01_20_04_56/2017_01_20_21_54.mpg;YUriko Koike.jpg;57901;58065;91169;2897;2906;9
/net/per610a/home/mvp/mvp_db/hodost-lv/2017/2017_01_20_04_56/2017_01_20_21_54.mpg;YUriko Koike.jpg;58129;58357;91169;2909;2920;11
/net/per610a/home/mvp/mvp_db/hodost-lv/2017/2017_01_20_04_56/2017_01_20_21_54.mpg;YUriko Koike.jpg;58997;59201;91169;2952;2963;11
/net/per610a/home/mvp/mvp_db/hodost-lv/2017/2017_01_20_04_56/2017_01_20_21_54.mpg;YUriko Koike.jpg;59265;59481;91169;2966;2977;11
/net/per610a/home/mvp/mvp_db/hodost-lv/2017/2017_01_22_04_56/2017_01_22_16_30.mpg;YUriko Koike.jpg;60465;60741;107949;3025;3039;14
/net/per610a/home/mvp/mvp_db/hodost-lv/2017/2017_01_22_04_56/2017_01_22_16_30.mpg;YUriko Koike.jpg;60857;60941;107949;3045;3049;4
/net/per610a/home/mvp/mvp_db/hodost-lv/2017/2017_01_22_04_56/2017_01_22_16_30.mpg;YUriko Koike.jpg;61757;61965;107949;3090;3100;10
/net/per610a/home/mvp/mvp_db/hodost-lv/2017/2017_01_22_04_56/2017_01_22_16_30.mpg;Shintaro ISHIHARA.jpg;61341;61673;107949;3069;3086;17
/net/per610a/home/mvp/mvp_db/hodost-lv/2017/2017_01_23_04_56/2017_01_23_21_54.mpg;Shinzo ABE.jpg;48029;48101;91169;2403;2407;4
/net/per610a/home/mvp/mvp_db/hodost-lv/2017/2017_01_23_04_56/2017_01_23_21_54.mpg;Shinzo ABE.jpg;49405;49689;91169;2472;2486;14
/net/per610a/home/mvp/mvp_db/hodost-lv/2017/2017_01_23_04_56/2017_01_23_21_54.mpg;Toru Hashimoto.jpg;89873;89969;91169;4498;4502;4
/net/per610a/home/mvp/mvp_db/hodost-lv/2017/2017_01_24_04_56/2017_01_24_21_54.mpg;Shinzo ABE.jpg;33529;33709;91169;1677;1686;9
/net/per610a/home/mvp/mvp_db/hodost-lv/2017/2017_01_24_04_56/2017_01_24_21_54.mpg;Shinzo ABE.jpg;37113;37141;91169;1857;1858;1
/net/per610a/home/mvp/mvp_db/hodost-lv/2017/2017_01_24_04_56/2017_01_24_21_54.mpg;Shinzo ABE.jpg;37657;37689;91169;1884;1885;1
/net/per610a/home/mvp/mvp_db/hodost-lv/2017/2017_01_24_04_56/2017_01_24_21_54.mpg;Kazuo SHII.jpg;35737;36381;91169;1788;1820;32
/net/per610a/home/mvp/mvp_db/hodost-lv/2017/2017_01_25_04_56/2017_01_25_21_54.mpg;Shinzo ABE.jpg;57681;57825;91169;2886;2894;8
/net/per610a/home/mvp/mvp_db/hodost-lv/2017/2017_01_25_04_56/2017_01_25_21_54.mpg;Shinzo ABE.jpg;57917;58009;91169;2898;2903;5
/net/per610a/home/mvp/mvp_db/hodost-lv/2017/2017_01_26_04_56/2017_01_26_21_54.mpg;Shinzo ABE.jpg;10633;10933;91169;532;547;15
/net/per610a/home/mvp/mvp_db/hodost-lv/2017/2017_01_26_04_56/2017_01_26_21_54.mpg;Shinzo ABE.jpg;11801;11817;91169;590;591;1
/net/per610a/home/mvp/mvp_db/hodost-lv/2017/2017_01_26_04_56/2017_01_26_21_54.mpg;Shinzo ABE.jpg;11905;11905;91169;595;595;0
/net/per610a/home/mvp/mvp_db/hodost-lv/2017/2017_01_26_04_56/2017_01_26_21_54.mpg;Shinzo ABE.jpg;14833;15001;91169;742;750;8
/net/per610a/home/mvp/mvp_db/hodost-lv/2017/2017_01_26_04_56/2017_01_26_21_54.mpg;Shinzo ABE.jpg;22061;22065;91169;1104;1104;0
/net/per610a/home/mvp/mvp_db/hodost-lv/2017/2017_01_26_04_56/2017_01_26_21_54.mpg;Shinzo ABE.jpg;22129;22145;91169;1107;1108;1
/net/per610a/home/mvp/mvp_db/hodost-lv/2017/2017_01_26_04_56/2017_01_26_21_54.mpg;Shinzo ABE.jpg;23929;24061;91169;1197;1204;7
/net/per610a/home/mvp/mvp_db/hodost-lv/2017/2017_01_26_04_56/2017_01_26_21_54.mpg;Shinzo ABE.jpg;13913;13993;91169;696;700;4
/net/per610a/home/mvp/mvp_db/hodost-lv/2017/2017_01_26_04_56/2017_01_26_21_54.mpg;Shinzo ABE.jpg;14125;14221;91169;706;711;5
/net/per610a/home/mvp/mvp_db/hodost-lv/2017/2017_01_27_04_56/2017_01_27_21_54.mpg;Shinzo ABE.jpg;28085;28273;91169;1405;1415;10
/net/per610a/home/mvp/mvp_db/hodost-lv/2017/2017_01_27_04_56/2017_01_27_21_54.mpg;Shinzo ABE.jpg;28429;28485;91169;1422;1425;3
/net/per610a/home/mvp/mvp_db/hodost-lv/2017/2017_01_27_04_56/2017_01_27_21_54.mpg;Shinzo ABE.jpg;36949;37329;91169;1849;1868;19
/net/per610a/home/mvp/mvp_db/hodost-lv/2017/2017_01_27_04_56/2017_01_27_21_54.mpg;Shinzo ABE.jpg;28565;28693;91169;1429;1436;7
/net/per610a/home/mvp/mvp_db/hodost-lv/2017/2017_01_27_04_56/2017_01_27_21_54.mpg;Shinzo ABE.jpg;36893;36941;91169;1846;1848;2
/net/per610a/home/mvp/mvp_db/hodost-lv/2017/2017_01_29_04_56/2017_01_29_16_30.mpg;Shinzo ABE.jpg;31221;31277;107949;1562;1565;3
/net/per610a/home/mvp/mvp_db/hodost-lv/2017/2017_01_29_04_56/2017_01_29_16_30.mpg;Shinzo ABE.jpg;31569;31809;107949;1579;1591;12
/net/per610a/home/mvp/mvp_db/hodost-lv/2017/2017_01_29_04_56/2017_01_29_16_30.mpg;Shinzo ABE.jpg;31881;31957;107949;1595;1599;4
/net/per610a/home/mvp/mvp_db/hodost-lv/2017/2017_01_29_04_56/2017_01_29_16_30.mpg;Shinzo ABE.jpg;32229;32381;107949;1612;1620;8
/net/per610a/home/mvp/mvp_db/hodost-lv/2017/2017_01_29_04_56/2017_01_29_16_30.mpg;Shinzo ABE.jpg;32533;32917;107949;1628;1647;19
/net/per610a/home/mvp/mvp_db/hodost-lv/2017/2017_01_29_04_56/2017_01_29_16_30.mpg;Shinzo ABE.jpg;33737;34501;107949;1688;1726;38
/net/per610a/home/mvp/mvp_db/hodost-lv/2017/2017_01_29_04_56/2017_01_29_16_30.mpg;Shinzo ABE.jpg;35101;35341;107949;1756;1768;12
/net/per610a/home/mvp/mvp_db/hodost-lv/2017/2017_01_29_04_56/2017_01_29_16_30.mpg;Shinzo ABE.jpg;31385;31525;107949;1570;1577;7
/net/per610a/home/mvp/mvp_db/hodost-lv/2017/2017_01_29_04_56/2017_01_29_16_30.mpg;Shinzo ABE.jpg;32437;32493;107949;1623;1626;3
/net/per610a/home/mvp/mvp_db/hodost-lv/2017/2017_01_29_04_56/2017_01_29_16_30.mpg;Shinzo ABE.jpg;33645;33717;107949;1683;1687;4
/net/per610a/home/mvp/mvp_db/hodost-lv/2017/2017_01_29_04_56/2017_01_29_16_30.mpg;Shinzo ABE.jpg;35005;35077;107949;1751;1755;4
/net/per610a/home/mvp/mvp_db/hodost-lv/2017/2017_01_29_04_56/2017_01_29_16_30.mpg;YUriko Koike.jpg;98485;98761;107949;4928;4942;14
/net/per610a/home/mvp/mvp_db/hodost-lv/2017/2017_01_31_04_56/2017_01_31_21_54.mpg;Yukio HATOYAMA.jpg;23709;23937;91169;1186;1197;11
/net/per610a/home/mvp/mvp_db/hodost-lv/2017/2017_01_31_04_56/2017_01_31_21_54.mpg;Yukio HATOYAMA.jpg;25973;26293;91169;1299;1315;16
/net/per610a/home/mvp/mvp_db/hodost-lv/2017/2017_02_01_04_56/2017_02_01_21_54.mpg;Natsuo YAMAGUCHI.jpg;6833;6965;91169;341;348;7
/net/per610a/home/mvp/mvp_db/hodost-lv/2017/2017_02_01_04_56/2017_02_01_21_54.mpg;Shinzo ABE.jpg;23745;23833;91169;1188;1192;4
/net/per610a/home/mvp/mvp_db/hodost-lv/2017/2017_02_02_04_56/2017_02_02_21_54.mpg;Shinzo ABE.jpg;30705;30773;91169;1536;1540;4
/net/per610a/home/mvp/mvp_db/hodost-lv/2017/2017_02_02_04_56/2017_02_02_21_54.mpg;Shinzo ABE.jpg;32525;32569;91169;1627;1630;3
/net/per610a/home/mvp/mvp_db/hodost-lv/2017/2017_02_02_04_56/2017_02_02_21_54.mpg;Shinzo ABE.jpg;32933;33001;91169;1648;1651;3
/net/per610a/home/mvp/mvp_db/hodost-lv/2017/2017_02_03_04_56/2017_02_03_21_54.mpg;YUriko Koike.jpg;21789;22061;91169;1090;1104;14
/net/per610a/home/mvp/mvp_db/hodost-lv/2017/2017_02_03_04_56/2017_02_03_21_54.mpg;YUriko Koike.jpg;22961;23169;91169;1149;1159;10
/net/per610a/home/mvp/mvp_db/hodost-lv/2017/2017_02_03_04_56/2017_02_03_21_54.mpg;YUriko Koike.jpg;23869;24025;91169;1194;1202;8
/net/per610a/home/mvp/mvp_db/hodost-lv/2017/2017_02_03_04_56/2017_02_03_21_54.mpg;Shinzo ABE.jpg;31081;31081;91169;1555;1555;0
/net/per610a/home/mvp/mvp_db/hodost-lv/2017/2017_02_03_04_56/2017_02_03_21_54.mpg;Shinzo ABE.jpg;33313;33653;91169;1667;1684;17
/net/per610a/home/mvp/mvp_db/hodost-lv/2017/2017_02_03_04_56/2017_02_03_21_54.mpg;Shinzo ABE.jpg;33149;33313;91169;1659;1667;8
/net/per610a/home/mvp/mvp_db/hodost-lv/2017/2017_02_03_04_56/2017_02_03_21_54.mpg;Natsuo YAMAGUCHI.jpg;75777;76233;91169;3792;3815;23
/net/per610a/home/mvp/mvp_db/hodost-lv/2017/2017_02_06_04_56/2017_02_06_21_54.mpg;YUriko Koike.jpg;7229;7305;91169;361;365;4
/net/per610a/home/mvp/mvp_db/hodost-lv/2017/2017_02_06_04_56/2017_02_06_21_54.mpg;YUriko Koike.jpg;10453;10521;91169;523;526;3
/net/per610a/home/mvp/mvp_db/hodost-lv/2017/2017_02_06_04_56/2017_02_06_21_54.mpg;YUriko Koike.jpg;11761;11805;91169;588;590;2
/net/per610a/home/mvp/mvp_db/hodost-lv/2017/2017_02_06_04_56/2017_02_06_21_54.mpg;Toru Hashimoto.jpg;7473;7689;91169;374;384;10
/net/per610a/home/mvp/mvp_db/hodost-lv/2017/2017_02_06_04_56/2017_02_06_21_54.mpg;Toru Hashimoto.jpg;89877;89913;91169;4498;4500;2
/net/per610a/home/mvp/mvp_db/hodost-lv/2017/2017_02_07_04_56/2017_02_07_21_54.mpg;Kohei Otsuka.jpg;16809;16853;91169;841;843;2
/net/per610a/home/mvp/mvp_db/hodost-lv/2017/2017_02_07_04_56/2017_02_07_21_54.mpg;Kohei Otsuka.jpg;24121;24165;91169;1207;1209;2
/net/per610a/home/mvp/mvp_db/hodost-lv/2017/2017_02_07_04_56/2017_02_07_21_54.mpg;Kohei Otsuka.jpg;49693;49777;91169;2487;2491;4
/net/per610a/home/mvp/mvp_db/hodost-lv/2017/2017_02_07_04_56/2017_02_07_21_54.mpg;Kohei Otsuka.jpg;59353;59609;91169;2970;2983;13
/net/per610a/home/mvp/mvp_db/hodost-lv/2017/2017_02_07_04_56/2017_02_07_21_54.mpg;Kohei Otsuka.jpg;85745;86245;91169;4291;4316;25
/net/per610a/home/mvp/mvp_db/hodost-lv/2017/2017_02_08_04_56/2017_02_08_21_54.mpg;Ichiro OZAWA.jpg;1029;1285;91177;51;64;13
/net/per610a/home/mvp/mvp_db/hodost-lv/2017/2017_02_08_04_56/2017_02_08_21_54.mpg;Ichiro OZAWA.jpg;2621;2717;91177;131;135;4
/net/per610a/home/mvp/mvp_db/hodost-lv/2017/2017_02_08_04_56/2017_02_08_21_54.mpg;Ichiro OZAWA.jpg;3013;3153;91177;150;157;7
/net/per610a/home/mvp/mvp_db/hodost-lv/2017/2017_02_08_04_56/2017_02_08_21_54.mpg;Ichiro OZAWA.jpg;9189;9353;91177;459;468;9
/net/per610a/home/mvp/mvp_db/hodost-lv/2017/2017_02_08_04_56/2017_02_08_21_54.mpg;Ichiro OZAWA.jpg;9589;10037;91177;479;502;23
/net/per610a/home/mvp/mvp_db/hodost-lv/2017/2017_02_08_04_56/2017_02_08_21_54.mpg;YUriko Koike.jpg;3049;3153;91177;152;157;5
/net/per610a/home/mvp/mvp_db/hodost-lv/2017/2017_02_08_04_56/2017_02_08_21_54.mpg;YUriko Koike.jpg;3509;4445;91177;175;222;47
/net/per610a/home/mvp/mvp_db/hodost-lv/2017/2017_02_08_04_56/2017_02_08_21_54.mpg;YUriko Koike.jpg;9421;9497;91177;471;475;4
/net/per610a/home/mvp/mvp_db/hodost-lv/2017/2017_02_08_04_56/2017_02_08_21_54.mpg;Shintaro ISHIHARA.jpg;5337;5541;91177;267;277;10
/net/per610a/home/mvp/mvp_db/hodost-lv/2017/2017_02_08_04_56/2017_02_08_21_54.mpg;Shintaro ISHIHARA.jpg;7921;8093;91177;396;405;9
/net/per610a/home/mvp/mvp_db/hodost-lv/2017/2017_02_09_04_56/2017_02_09_21_54.mpg;Shinzo ABE.jpg;3241;3361;91169;162;168;6
/net/per610a/home/mvp/mvp_db/hodost-lv/2017/2017_02_09_04_56/2017_02_09_21_54.mpg;Shinzo ABE.jpg;6017;7165;91169;301;358;57
/net/per610a/home/mvp/mvp_db/hodost-lv/2017/2017_02_09_04_56/2017_02_09_21_54.mpg;Shinzo ABE.jpg;25569;25685;91169;1279;1285;6
/net/per610a/home/mvp/mvp_db/hodost-lv/2017/2017_02_09_04_56/2017_02_09_21_54.mpg;Shinzo ABE.jpg;7621;7761;91169;381;388;7
/net/per610a/home/mvp/mvp_db/hodost-lv/2017/2017_02_09_04_56/2017_02_09_21_54.mpg;Shinzo ABE.jpg;8545;8669;91169;427;433;6
/net/per610a/home/mvp/mvp_db/hodost-lv/2017/2017_02_10_04_56/2017_02_10_21_54.mpg;Shinzo ABE.jpg;25029;25505;91169;1252;1276;24
/net/per610a/home/mvp/mvp_db/hodost-lv/2017/2017_02_10_04_56/2017_02_10_21_54.mpg;Shinzo ABE.jpg;30853;31185;91169;1544;1560;16
/net/per610a/home/mvp/mvp_db/hodost-lv/2017/2017_02_12_04_56/2017_02_12_16_30.mpg;Shinzo ABE.jpg;39049;39169;107949;1954;1960;6
/net/per610a/home/mvp/mvp_db/hodost-lv/2017/2017_02_12_04_56/2017_02_12_16_30.mpg;Shinzo ABE.jpg;39301;39417;107949;1966;1972;6
/net/per610a/home/mvp/mvp_db/hodost-lv/2017/2017_02_12_04_56/2017_02_12_16_30.mpg;Shinzo ABE.jpg;77409;77417;107949;3873;3874;1
/net/per610a/home/mvp/mvp_db/hodost-lv/2017/2017_02_13_04_56/2017_02_13_21_54.mpg;Shinzo ABE.jpg;14361;14413;91169;718;721;3
/net/per610a/home/mvp/mvp_db/hodost-lv/2017/2017_02_13_04_56/2017_02_13_21_54.mpg;Shinzo ABE.jpg;18597;18625;91169;930;932;2
/net/per610a/home/mvp/mvp_db/hodost-lv/2017/2017_02_13_04_56/2017_02_13_21_54.mpg;Shinzo ABE.jpg;26361;26389;91169;1319;1320;1
/net/per610a/home/mvp/mvp_db/hodost-lv/2017/2017_02_13_04_56/2017_02_13_21_54.mpg;Toru Hashimoto.jpg;89877;89973;91169;4498;4503;5
/net/per610a/home/mvp/mvp_db/hodost-lv/2017/2017_02_14_04_56/2017_02_14_21_54.mpg;Junichiro KOIZUMI.jpg;6081;6377;91169;304;319;15
/net/per610a/home/mvp/mvp_db/hodost-lv/2017/2017_02_14_04_56/2017_02_14_21_54.mpg;Kohei Otsuka.jpg;24073;24309;91169;1204;1216;12
/net/per610a/home/mvp/mvp_db/hodost-lv/2017/2017_02_14_04_56/2017_02_14_21_54.mpg;Kohei Otsuka.jpg;36193;36393;91169;1811;1821;10
/net/per610a/home/mvp/mvp_db/hodost-lv/2017/2017_02_14_04_56/2017_02_14_21_54.mpg;Kohei Otsuka.jpg;40461;40577;91169;2025;2030;5
/net/per610a/home/mvp/mvp_db/hodost-lv/2017/2017_02_14_04_56/2017_02_14_21_54.mpg;Kohei Otsuka.jpg;52549;52573;91169;2630;2631;1
/net/per610a/home/mvp/mvp_db/hodost-lv/2017/2017_02_14_04_56/2017_02_14_21_54.mpg;Kohei Otsuka.jpg;56157;56177;91169;2810;2811;1
/net/per610a/home/mvp/mvp_db/hodost-lv/2017/2017_02_14_04_56/2017_02_14_21_54.mpg;Kohei Otsuka.jpg;56525;56649;91169;2829;2835;6
/net/per610a/home/mvp/mvp_db/hodost-lv/2017/2017_02_14_04_56/2017_02_14_21_54.mpg;Kohei Otsuka.jpg;74217;74293;91169;3714;3718;4
/net/per610a/home/mvp/mvp_db/hodost-lv/2017/2017_02_14_04_56/2017_02_14_21_54.mpg;Kohei Otsuka.jpg;77909;78069;91169;3899;3907;8
/net/per610a/home/mvp/mvp_db/hodost-lv/2017/2017_02_14_04_56/2017_02_14_21_54.mpg;Kohei Otsuka.jpg;85473;85625;91169;4277;4285;8
/net/per610a/home/mvp/mvp_db/hodost-lv/2017/2017_02_14_04_56/2017_02_14_21_54.mpg;Shinzo ABE.jpg;40701;40701;91169;2037;2037;0
/net/per610a/home/mvp/mvp_db/hodost-lv/2017/2017_02_14_04_56/2017_02_14_21_54.mpg;Shinzo ABE.jpg;42045;42057;91169;2104;2104;0
/net/per610a/home/mvp/mvp_db/hodost-lv/2017/2017_02_14_04_56/2017_02_14_21_54.mpg;Shinzo ABE.jpg;42609;42661;91169;2132;2135;3
/net/per610a/home/mvp/mvp_db/hodost-lv/2017/2017_02_14_04_56/2017_02_14_21_54.mpg;Shinzo ABE.jpg;44481;44533;91169;2226;2228;2
/net/per610a/home/mvp/mvp_db/hodost-lv/2017/2017_02_14_04_56/2017_02_14_21_54.mpg;Shinzo ABE.jpg;45341;45373;91169;2269;2270;1
/net/per610a/home/mvp/mvp_db/hodost-lv/2017/2017_02_14_04_56/2017_02_14_21_54.mpg;Shinzo ABE.jpg;70597;70765;91169;3533;3541;8
/net/per610a/home/mvp/mvp_db/hodost-lv/2017/2017_02_14_04_56/2017_02_14_21_54.mpg;Shintaro ISHIHARA.jpg;65693;66013;91169;3287;3303;16
/net/per610a/home/mvp/mvp_db/hodost-lv/2017/2017_02_16_04_56/2017_02_16_21_54.mpg;YUriko Koike.jpg;53761;54041;91169;2690;2704;14
/net/per610a/home/mvp/mvp_db/hodost-lv/2017/2017_02_17_04_56/2017_02_17_21_54.mpg;Kohei Otsuka.jpg;16465;16469;91169;824;824;0
/net/per610a/home/mvp/mvp_db/hodost-lv/2017/2017_02_17_04_56/2017_02_17_21_54.mpg;Kohei Otsuka.jpg;21821;21825;91169;1092;1092;0
/net/per610a/home/mvp/mvp_db/hodost-lv/2017/2017_02_17_04_56/2017_02_17_21_54.mpg;Kohei Otsuka.jpg;22549;22665;91169;1128;1134;6
/net/per610a/home/mvp/mvp_db/hodost-lv/2017/2017_02_17_04_56/2017_02_17_21_54.mpg;Kohei Otsuka.jpg;29237;29865;91169;1463;1494;31
/net/per610a/home/mvp/mvp_db/hodost-lv/2017/2017_02_17_04_56/2017_02_17_21_54.mpg;Kohei Otsuka.jpg;40233;40345;91169;2013;2019;6
/net/per610a/home/mvp/mvp_db/hodost-lv/2017/2017_02_17_04_56/2017_02_17_21_54.mpg;Kohei Otsuka.jpg;41305;41321;91169;2067;2068;1
/net/per610a/home/mvp/mvp_db/hodost-lv/2017/2017_02_17_04_56/2017_02_17_21_54.mpg;Kohei Otsuka.jpg;41881;41885;91169;2096;2096;0
/net/per610a/home/mvp/mvp_db/hodost-lv/2017/2017_02_17_04_56/2017_02_17_21_54.mpg;Kohei Otsuka.jpg;41961;41969;91169;2100;2100;0
/net/per610a/home/mvp/mvp_db/hodost-lv/2017/2017_02_17_04_56/2017_02_17_21_54.mpg;Kohei Otsuka.jpg;50297;50297;91169;2517;2517;0
/net/per610a/home/mvp/mvp_db/hodost-lv/2017/2017_02_17_04_56/2017_02_17_21_54.mpg;Kohei Otsuka.jpg;51897;51905;91169;2597;2597;0
/net/per610a/home/mvp/mvp_db/hodost-lv/2017/2017_02_17_04_56/2017_02_17_21_54.mpg;Kohei Otsuka.jpg;52049;52225;91169;2605;2613;8
/net/per610a/home/mvp/mvp_db/hodost-lv/2017/2017_02_17_04_56/2017_02_17_21_54.mpg;Shinzo ABE.jpg;25001;25121;91169;1251;1257;6
/net/per610a/home/mvp/mvp_db/hodost-lv/2017/2017_02_17_04_56/2017_02_17_21_54.mpg;Shinzo ABE.jpg;25613;25633;91169;1281;1282;1
/net/per610a/home/mvp/mvp_db/hodost-lv/2017/2017_02_17_04_56/2017_02_17_21_54.mpg;Shinzo ABE.jpg;25989;26161;91169;1300;1309;9
/net/per610a/home/mvp/mvp_db/hodost-lv/2017/2017_02_17_04_56/2017_02_17_21_54.mpg;Shinzo ABE.jpg;57601;57681;91169;2882;2886;4
/net/per610a/home/mvp/mvp_db/hodost-lv/2017/2017_02_17_04_56/2017_02_17_21_54.mpg;Shinzo ABE.jpg;57905;58045;91169;2898;2905;7
/net/per610a/home/mvp/mvp_db/hodost-lv/2017/2017_02_20_04_56/2017_02_20_21_54.mpg;Yoshihiko Noda.jpg;51437;51581;91169;2574;2581;7
/net/per610a/home/mvp/mvp_db/hodost-lv/2017/2017_02_20_04_56/2017_02_20_21_54.mpg;Seiji Mataichi.jpg;52013;52197;91169;2603;2612;9
/net/per610a/home/mvp/mvp_db/hodost-lv/2017/2017_02_21_04_56/2017_02_21_21_54.mpg;YUriko Koike.jpg;55233;55449;91169;2764;2775;11
/net/per610a/home/mvp/mvp_db/hodost-lv/2017/2017_02_21_04_56/2017_02_21_21_54.mpg;YUriko Koike.jpg;58509;58681;91169;2928;2936;8
/net/per610a/home/mvp/mvp_db/hodost-lv/2017/2017_02_24_04_56/2017_02_24_21_54.mpg;Shinzo ABE.jpg;5013;5121;91169;250;256;6
/net/per610a/home/mvp/mvp_db/hodost-lv/2017/2017_02_24_04_56/2017_02_24_21_54.mpg;Shinzo ABE.jpg;5729;6109;91169;286;305;19
/net/per610a/home/mvp/mvp_db/hodost-lv/2017/2017_02_24_04_56/2017_02_24_21_54.mpg;Shinzo ABE.jpg;7861;7913;91169;393;396;3
/net/per610a/home/mvp/mvp_db/hodost-lv/2017/2017_02_24_04_56/2017_02_24_21_54.mpg;Shinzo ABE.jpg;8001;8001;91169;400;400;0
/net/per610a/home/mvp/mvp_db/hodost-lv/2017/2017_02_24_04_56/2017_02_24_21_54.mpg;Shinzo ABE.jpg;8265;8265;91169;413;413;0
/net/per610a/home/mvp/mvp_db/hodost-lv/2017/2017_02_24_04_56/2017_02_24_21_54.mpg;Shinzo ABE.jpg;8917;9153;91169;446;458;12
/net/per610a/home/mvp/mvp_db/hodost-lv/2017/2017_02_24_04_56/2017_02_24_21_54.mpg;Shinzo ABE.jpg;11397;11397;91169;570;570;0
/net/per610a/home/mvp/mvp_db/hodost-lv/2017/2017_02_28_04_56/2017_02_28_21_54.mpg;Shinzo ABE.jpg;52733;52785;91161;2638;2641;3
/net/per610a/home/mvp/mvp_db/hodost-lv/2017/2017_02_28_04_56/2017_02_28_21_54.mpg;Shinzo ABE.jpg;53013;53037;91161;2652;2654;2
/net/per610a/home/mvp/mvp_db/hodost-lv/2017/2017_02_28_04_56/2017_02_28_21_54.mpg;Shinzo ABE.jpg;53861;53897;91161;2695;2697;2
/net/per610a/home/mvp/mvp_db/hodost-lv/2017/2017_02_27_04_56/2017_02_27_21_54.mpg;Shinzo ABE.jpg;1417;1705;91169;70;85;15
/net/per610a/home/mvp/mvp_db/hodost-lv/2017/2017_02_27_04_56/2017_02_27_21_54.mpg;Shinzo ABE.jpg;1805;1825;91169;90;91;1
/net/per610a/home/mvp/mvp_db/hodost-lv/2017/2017_02_27_04_56/2017_02_27_21_54.mpg;Shinzo ABE.jpg;12025;12093;91169;601;605;4
/net/per610a/home/mvp/mvp_db/hodost-lv/2017/2017_02_27_04_56/2017_02_27_21_54.mpg;Shinzo ABE.jpg;12621;12869;91169;631;644;13
/net/per610a/home/mvp/mvp_db/hodost-lv/2017/2017_02_27_04_56/2017_02_27_21_54.mpg;Shinzo ABE.jpg;13229;13249;91169;662;663;1
/net/per610a/home/mvp/mvp_db/hodost-lv/2017/2017_02_27_04_56/2017_02_27_21_54.mpg;Shinzo ABE.jpg;13313;13325;91169;666;666;0
/net/per610a/home/mvp/mvp_db/hodost-lv/2017/2017_02_27_04_56/2017_02_27_21_54.mpg;Shinzo ABE.jpg;13389;13485;91169;670;674;4
/net/per610a/home/mvp/mvp_db/hodost-lv/2017/2017_02_27_04_56/2017_02_27_21_54.mpg;Toru Hashimoto.jpg;89873;89969;91169;4498;4502;4
/net/per610a/home/mvp/mvp_db/hodost-lv/2017/2017_03_02_04_56/2017_03_02_21_54.mpg;Shinzo ABE.jpg;2449;2449;91169;122;122;0
/net/per610a/home/mvp/mvp_db/hodost-lv/2017/2017_03_02_04_56/2017_03_02_21_54.mpg;Shinzo ABE.jpg;9621;9721;91169;481;486;5
/net/per610a/home/mvp/mvp_db/hodost-lv/2017/2017_03_02_04_56/2017_03_02_21_54.mpg;Shinzo ABE.jpg;10709;10761;91169;535;538;3
/net/per610a/home/mvp/mvp_db/hodost-lv/2017/2017_03_02_04_56/2017_03_02_21_54.mpg;Shinzo ABE.jpg;10989;10993;91169;549;550;1
/net/per610a/home/mvp/mvp_db/hodost-lv/2017/2017_03_02_04_56/2017_03_02_21_54.mpg;Shinzo ABE.jpg;14049;14049;91169;703;703;0
/net/per610a/home/mvp/mvp_db/hodost-lv/2017/2017_03_02_04_56/2017_03_02_21_54.mpg;Shinzo ABE.jpg;14373;14529;91169;719;727;8
/net/per610a/home/mvp/mvp_db/hodost-lv/2017/2017_03_02_04_56/2017_03_02_21_54.mpg;Shinzo ABE.jpg;14741;14905;91169;737;745;8
/net/per610a/home/mvp/mvp_db/hodost-lv/2017/2017_03_02_04_56/2017_03_02_21_54.mpg;Shinzo ABE.jpg;16229;16253;91169;812;813;1
/net/per610a/home/mvp/mvp_db/hodost-lv/2017/2017_03_02_04_56/2017_03_02_21_54.mpg;Shinzo ABE.jpg;16341;16581;91169;817;829;12
/net/per610a/home/mvp/mvp_db/hodost-lv/2017/2017_03_02_04_56/2017_03_02_21_54.mpg;Shinzo ABE.jpg;61345;61689;91169;3070;3087;17
/net/per610a/home/mvp/mvp_db/hodost-lv/2017/2017_03_03_04_56/2017_03_03_21_54.mpg;Shintaro ISHIHARA.jpg;4813;6697;91169;240;335;95
/net/per610a/home/mvp/mvp_db/hodost-lv/2017/2017_03_03_04_56/2017_03_03_21_54.mpg;Shintaro ISHIHARA.jpg;7733;8929;91169;387;446;59
/net/per610a/home/mvp/mvp_db/hodost-lv/2017/2017_03_03_04_56/2017_03_03_21_54.mpg;Shintaro ISHIHARA.jpg;9009;9073;91169;450;454;4
/net/per610a/home/mvp/mvp_db/hodost-lv/2017/2017_03_03_04_56/2017_03_03_21_54.mpg;Shintaro ISHIHARA.jpg;10025;10797;91169;501;540;39
/net/per610a/home/mvp/mvp_db/hodost-lv/2017/2017_03_03_04_56/2017_03_03_21_54.mpg;Shintaro ISHIHARA.jpg;13069;14889;91169;654;745;91
/net/per610a/home/mvp/mvp_db/hodost-lv/2017/2017_03_05_04_56/2017_03_05_16_30.mpg;YUriko Koike.jpg;90097;90185;107961;4508;4513;5
/net/per610a/home/mvp/mvp_db/hodost-lv/2017/2017_03_06_04_56/2017_03_06_21_54.mpg;Shinzo ABE.jpg;11485;12045;91169;574;602;28
/net/per610a/home/mvp/mvp_db/hodost-lv/2017/2017_03_06_04_56/2017_03_06_21_54.mpg;Shinzo ABE.jpg;16757;16757;91169;838;838;0
/net/per610a/home/mvp/mvp_db/hodost-lv/2017/2017_03_06_04_56/2017_03_06_21_54.mpg;Shinzo ABE.jpg;16865;16865;91169;844;844;0
/net/per610a/home/mvp/mvp_db/hodost-lv/2017/2017_03_06_04_56/2017_03_06_21_54.mpg;Shinzo ABE.jpg;16989;17005;91169;850;851;1
/net/per610a/home/mvp/mvp_db/hodost-lv/2017/2017_03_06_04_56/2017_03_06_21_54.mpg;Shinzo ABE.jpg;17277;17377;91169;864;869;5
/net/per610a/home/mvp/mvp_db/hodost-lv/2017/2017_03_06_04_56/2017_03_06_21_54.mpg;Shinzo ABE.jpg;18113;18113;91169;906;906;0
/net/per610a/home/mvp/mvp_db/hodost-lv/2017/2017_03_06_04_56/2017_03_06_21_54.mpg;Shinzo ABE.jpg;18357;18449;91169;918;923;5
/net/per610a/home/mvp/mvp_db/hodost-lv/2017/2017_03_06_04_56/2017_03_06_21_54.mpg;Shinzo ABE.jpg;18577;18589;91169;929;930;1
/net/per610a/home/mvp/mvp_db/hodost-lv/2017/2017_03_06_04_56/2017_03_06_21_54.mpg;Shinzo ABE.jpg;18669;18673;91169;934;934;0
/net/per610a/home/mvp/mvp_db/hodost-lv/2017/2017_03_06_04_56/2017_03_06_21_54.mpg;Shinzo ABE.jpg;19745;20245;91169;988;1013;25
/net/per610a/home/mvp/mvp_db/hodost-lv/2017/2017_03_06_04_56/2017_03_06_21_54.mpg;Shinzo ABE.jpg;20925;21201;91169;1047;1061;14
/net/per610a/home/mvp/mvp_db/hodost-lv/2017/2017_03_06_04_56/2017_03_06_21_54.mpg;Shinzo ABE.jpg;21697;21709;91169;1085;1086;1
/net/per610a/home/mvp/mvp_db/hodost-lv/2017/2017_03_06_04_56/2017_03_06_21_54.mpg;Shinzo ABE.jpg;44613;44737;91169;2232;2239;7
/net/per610a/home/mvp/mvp_db/hodost-lv/2017/2017_03_06_04_56/2017_03_06_21_54.mpg;Shinzo ABE.jpg;47261;47353;91169;2365;2370;5
/net/per610a/home/mvp/mvp_db/hodost-lv/2017/2017_03_06_04_56/2017_03_06_21_54.mpg;Shinzo ABE.jpg;47745;47793;91169;2389;2392;3
/net/per610a/home/mvp/mvp_db/hodost-lv/2017/2017_03_06_04_56/2017_03_06_21_54.mpg;YUriko Koike.jpg;48205;48317;91169;2412;2418;6
/net/per610a/home/mvp/mvp_db/hodost-lv/2017/2017_03_06_04_56/2017_03_06_21_54.mpg;YUriko Koike.jpg;48541;48697;91169;2429;2437;8
/net/per610a/home/mvp/mvp_db/hodost-lv/2017/2017_03_06_04_56/2017_03_06_21_54.mpg;YUriko Koike.jpg;48809;49161;91169;2442;2460;18
/net/per610a/home/mvp/mvp_db/hodost-lv/2017/2017_03_07_04_56/2017_03_07_21_54.mpg;Shinzo ABE.jpg;5605;6149;91169;280;307;27
/net/per610a/home/mvp/mvp_db/hodost-lv/2017/2017_03_07_04_56/2017_03_07_21_54.mpg;Shinzo ABE.jpg;11393;11777;91169;570;589;19
/net/per610a/home/mvp/mvp_db/hodost-lv/2017/2017_03_07_04_56/2017_03_07_21_54.mpg;YUriko Koike.jpg;56149;56269;91169;2810;2816;6
/net/per610a/home/mvp/mvp_db/hodost-lv/2017/2017_03_08_04_56/2017_03_08_21_54.mpg;Ichiro Matsui.jpeg;21169;21809;91169;1059;1091;32
/net/per610a/home/mvp/mvp_db/hodost-lv/2017/2017_03_08_04_56/2017_03_08_21_54.mpg;Kohei Otsuka.jpg;38057;38073;91169;1904;1905;1
/net/per610a/home/mvp/mvp_db/hodost-lv/2017/2017_03_08_04_56/2017_03_08_21_54.mpg;Kohei Otsuka.jpg;38733;38981;91169;1938;1950;12
/net/per610a/home/mvp/mvp_db/hodost-lv/2017/2017_03_08_04_56/2017_03_08_21_54.mpg;Kohei Otsuka.jpg;46421;46461;91169;2323;2325;2
/net/per610a/home/mvp/mvp_db/hodost-lv/2017/2017_03_08_04_56/2017_03_08_21_54.mpg;Kohei Otsuka.jpg;85581;85633;91169;4283;4285;2
/net/per610a/home/mvp/mvp_db/hodost-lv/2017/2017_03_09_04_56/2017_03_09_21_54.mpg;Ichiro OZAWA.jpg;33049;33253;91169;1654;1664;10
/net/per610a/home/mvp/mvp_db/hodost-lv/2017/2017_03_09_04_56/2017_03_09_21_54.mpg;Ichiro OZAWA.jpg;59629;60561;91169;2984;3031;47
/net/per610a/home/mvp/mvp_db/hodost-lv/2017/2017_03_09_04_56/2017_03_09_21_54.mpg;Ichiro OZAWA.jpg;61453;61869;91169;3075;3096;21
/net/per610a/home/mvp/mvp_db/hodost-lv/2017/2017_03_09_04_56/2017_03_09_21_54.mpg;Ichiro OZAWA.jpg;63569;64013;91169;3181;3203;22
/net/per610a/home/mvp/mvp_db/hodost-lv/2017/2017_03_09_04_56/2017_03_09_21_54.mpg;Ichiro OZAWA.jpg;64141;65053;91169;3210;3255;45
/net/per610a/home/mvp/mvp_db/hodost-lv/2017/2017_03_10_04_56/2017_03_10_21_54.mpg;Shinzo ABE.jpg;9609;9921;91169;480;496;16
/net/per610a/home/mvp/mvp_db/hodost-lv/2017/2017_03_10_04_56/2017_03_10_21_54.mpg;Shinzo ABE.jpg;10257;11093;91169;513;555;42
/net/per610a/home/mvp/mvp_db/hodost-lv/2017/2017_03_10_04_56/2017_03_10_21_54.mpg;Shinzo ABE.jpg;12249;12825;91169;613;641;28
/net/per610a/home/mvp/mvp_db/hodost-lv/2017/2017_03_10_04_56/2017_03_10_21_54.mpg;Shinzo ABE.jpg;15409;15485;91169;771;775;4
/net/per610a/home/mvp/mvp_db/hodost-lv/2017/2017_03_12_04_56/2017_03_12_16_30.mpg;YUriko Koike.jpg;1205;1253;107949;60;62;2
/net/per610a/home/mvp/mvp_db/hodost-lv/2017/2017_03_12_04_56/2017_03_12_16_30.mpg;YUriko Koike.jpg;89781;90125;107949;4492;4510;18
/net/per610a/home/mvp/mvp_db/hodost-lv/2017/2017_03_13_04_56/2017_03_13_21_54.mpg;Shinzo ABE.jpg;15069;15225;91169;754;762;8
/net/per610a/home/mvp/mvp_db/hodost-lv/2017/2017_03_13_04_56/2017_03_13_21_54.mpg;Shinzo ABE.jpg;15297;15321;91169;765;766;1
/net/per610a/home/mvp/mvp_db/hodost-lv/2017/2017_03_13_04_56/2017_03_13_21_54.mpg;Shinzo ABE.jpg;17105;17113;91169;856;856;0
/net/per610a/home/mvp/mvp_db/hodost-lv/2017/2017_03_13_04_56/2017_03_13_21_54.mpg;Shinzo ABE.jpg;17177;17197;91169;859;860;1
/net/per610a/home/mvp/mvp_db/hodost-lv/2017/2017_03_13_04_56/2017_03_13_21_54.mpg;Shinzo ABE.jpg;17965;18153;91169;899;908;9
/net/per610a/home/mvp/mvp_db/hodost-lv/2017/2017_03_13_04_56/2017_03_13_21_54.mpg;Shinzo ABE.jpg;19973;19989;91169;999;1000;1
/net/per610a/home/mvp/mvp_db/hodost-lv/2017/2017_03_13_04_56/2017_03_13_21_54.mpg;Shinzo ABE.jpg;22445;22709;91169;1123;1136;13
/net/per610a/home/mvp/mvp_db/hodost-lv/2017/2017_03_13_04_56/2017_03_13_21_54.mpg;Shinzo ABE.jpg;26349;26653;91169;1318;1333;15
/net/per610a/home/mvp/mvp_db/hodost-lv/2017/2017_03_13_04_56/2017_03_13_21_54.mpg;Shinzo ABE.jpg;27157;27201;91169;1359;1361;2
/net/per610a/home/mvp/mvp_db/hodost-lv/2017/2017_03_14_04_56/2017_03_14_21_54.mpg;Masashi Nakano.jpg;51405;51517;91169;2572;2578;6
/net/per610a/home/mvp/mvp_db/hodost-lv/2017/2017_03_15_04_56/2017_03_15_21_54.mpg;Shinzo ABE.jpg;84217;84461;103149;4214;4226;12
/net/per610a/home/mvp/mvp_db/hodost-lv/2017/2017_03_16_04_56/2017_03_16_21_54.mpg;Natsuo YAMAGUCHI.jpg;70649;71137;91169;3535;3560;25
/net/per610a/home/mvp/mvp_db/hodost-lv/2017/2017_03_16_04_56/2017_03_16_21_54.mpg;Natsuo YAMAGUCHI.jpg;71201;71585;91169;3563;3582;19
/net/per610a/home/mvp/mvp_db/hodost-lv/2017/2017_03_16_04_56/2017_03_16_21_54.mpg;Natsuo YAMAGUCHI.jpg;74209;74261;91169;3714;3716;2
/net/per610a/home/mvp/mvp_db/hodost-lv/2017/2017_03_17_04_56/2017_03_17_21_54.mpg;Kohei Otsuka.jpg;50797;50801;91169;2542;2542;0
/net/per610a/home/mvp/mvp_db/hodost-lv/2017/2017_03_17_04_56/2017_03_17_21_54.mpg;Kohei Otsuka.jpg;52333;52821;91169;2619;2643;24
/net/per610a/home/mvp/mvp_db/hodost-lv/2017/2017_03_17_04_56/2017_03_17_21_54.mpg;Kohei Otsuka.jpg;68781;68881;91169;3442;3447;5
/net/per610a/home/mvp/mvp_db/hodost-lv/2017/2017_03_17_04_56/2017_03_17_21_54.mpg;YUriko Koike.jpg;55429;56077;91169;2774;2806;32
/net/per610a/home/mvp/mvp_db/hodost-lv/2017/2017_03_17_04_56/2017_03_17_21_54.mpg;YUriko Koike.jpg;56201;56649;91169;2812;2835;23
/net/per610a/home/mvp/mvp_db/hodost-lv/2017/2017_03_19_04_56/2017_03_19_16_30.mpg;Shintaro ISHIHARA.jpg;5945;6049;107949;297;302;5
/net/per610a/home/mvp/mvp_db/hodost-lv/2017/2017_03_19_04_56/2017_03_19_16_30.mpg;Shinzo ABE.jpg;59609;59661;107949;2982;2985;3
/net/per610a/home/mvp/mvp_db/hodost-lv/2017/2017_03_19_04_56/2017_03_19_16_30.mpg;Shinzo ABE.jpg;61369;61473;107949;3071;3076;5
/net/per610a/home/mvp/mvp_db/hodost-lv/2017/2017_03_19_04_56/2017_03_19_16_30.mpg;Shinzo ABE.jpg;68325;68369;107949;3419;3421;2
/net/per610a/home/mvp/mvp_db/hodost-lv/2017/2017_03_19_04_56/2017_03_19_16_30.mpg;Shinzo ABE.jpg;68437;68633;107949;3424;3434;10
/net/per610a/home/mvp/mvp_db/hodost-lv/2017/2017_03_19_04_56/2017_03_19_16_30.mpg;Shinzo ABE.jpg;67521;67885;107949;3378;3397;19
/net/per610a/home/mvp/mvp_db/hodost-lv/2017/2017_03_19_04_56/2017_03_19_16_30.mpg;Shinzo ABE.jpg;68021;68093;107949;3403;3407;4
/net/per610a/home/mvp/mvp_db/hodost-lv/2017/2017_03_19_04_56/2017_03_19_16_30.mpg;Shinzo ABE.jpg;69773;69809;107949;3491;3493;2
/net/per610a/home/mvp/mvp_db/hodost-lv/2017/2017_03_19_04_56/2017_03_19_16_30.mpg;Shinzo ABE.jpg;69917;69949;107949;3498;3500;2
/net/per610a/home/mvp/mvp_db/hodost-lv/2017/2017_03_19_04_56/2017_03_19_16_30.mpg;Shinzo ABE.jpg;70877;70913;107949;3546;3548;2
/net/per610a/home/mvp/mvp_db/hodost-lv/2017/2017_03_19_04_56/2017_03_19_16_30.mpg;Shinzo ABE.jpg;98021;98313;107949;4905;4919;14
/net/per610a/home/mvp/mvp_db/hodost-lv/2017/2017_03_19_04_56/2017_03_19_16_30.mpg;YUriko Koike.jpg;75677;76377;107949;3787;3822;35
/net/per610a/home/mvp/mvp_db/hodost-lv/2017/2017_03_20_04_56/2017_03_20_21_54.mpg;Shinzo ABE.jpg;54409;54961;91169;2723;2750;27
/net/per610a/home/mvp/mvp_db/hodost-lv/2017/2017_03_20_04_56/2017_03_20_21_54.mpg;Shinzo ABE.jpg;55081;55173;91169;2756;2761;5
/net/per610a/home/mvp/mvp_db/hodost-lv/2017/2017_03_21_04_56/2017_03_21_21_54.mpg;Shinzo ABE.jpg;47161;47361;91169;2360;2370;10
/net/per610a/home/mvp/mvp_db/hodost-lv/2017/2017_03_24_04_56/2017_03_24_21_54.mpg;Shinzo ABE.jpg;19629;19693;91169;982;985;3
/net/per610a/home/mvp/mvp_db/hodost-lv/2017/2017_03_24_04_56/2017_03_24_21_54.mpg;Shinzo ABE.jpg;25161;25233;91169;1259;1262;3
/net/per610a/home/mvp/mvp_db/hodost-lv/2017/2017_03_24_04_56/2017_03_24_21_54.mpg;Shinzo ABE.jpg;30841;30857;91169;1543;1544;1
/net/per610a/home/mvp/mvp_db/hodost-lv/2017/2017_03_24_04_56/2017_03_24_21_54.mpg;Shinzo ABE.jpg;31505;31605;91169;1576;1581;5
/net/per610a/home/mvp/mvp_db/hodost-lv/2017/2017_03_24_04_56/2017_03_24_21_54.mpg;Shinzo ABE.jpg;32041;32149;91169;1603;1609;6
/net/per610a/home/mvp/mvp_db/hodost-lv/2017/2017_03_26_04_56/2017_03_26_16_30.mpg;Shinzo ABE.jpg;58957;59433;107949;2950;2974;24
/net/per610a/home/mvp/mvp_db/hodost-lv/2017/2017_03_26_04_56/2017_03_26_16_30.mpg;Shinzo ABE.jpg;74269;74353;107949;3716;3720;4
/net/per610a/home/mvp/mvp_db/hodost-lv/2017/2017_03_26_04_56/2017_03_26_16_30.mpg;Shinzo ABE.jpg;74529;74845;107949;3729;3745;16
/net/per610a/home/mvp/mvp_db/hodost-lv/2017/2017_03_26_04_56/2017_03_26_16_30.mpg;Shinzo ABE.jpg;69169;69249;107949;3461;3465;4
/net/per610a/home/mvp/mvp_db/hodost-lv/2017/2017_03_26_04_56/2017_03_26_16_30.mpg;Shinzo ABE.jpg;74361;74493;107949;3721;3727;6
/net/per610a/home/mvp/mvp_db/hodost-lv/2017/2017_03_26_04_56/2017_03_26_16_30.mpg;Ichiro Matsui.jpeg;72909;73313;107949;3648;3668;20
/net/per610a/home/mvp/mvp_db/hodost-lv/2017/2017_03_28_04_56/2017_03_28_21_35.mpg;Kohei Otsuka.jpg;43833;44045;113949;2193;2204;11
/net/per610a/home/mvp/mvp_db/hodost-lv/2017/2017_03_28_04_56/2017_03_28_21_35.mpg;Kohei Otsuka.jpg;52949;53041;113949;2650;2654;4
/net/per610a/home/mvp/mvp_db/hodost-lv/2017/2017_03_28_04_56/2017_03_28_21_35.mpg;Kohei Otsuka.jpg;53197;53357;113949;2662;2670;8
/net/per610a/home/mvp/mvp_db/hodost-lv/2017/2017_03_28_04_56/2017_03_28_21_35.mpg;Kohei Otsuka.jpg;61161;61285;113949;3061;3067;6
/net/per610a/home/mvp/mvp_db/hodost-lv/2017/2017_03_28_04_56/2017_03_28_21_35.mpg;Kohei Otsuka.jpg;63693;63901;113949;3187;3198;11
/net/per610a/home/mvp/mvp_db/hodost-lv/2017/2017_03_28_04_56/2017_03_28_21_35.mpg;Kohei Otsuka.jpg;64241;64281;113949;3215;3217;2
/net/per610a/home/mvp/mvp_db/hodost-lv/2017/2017_03_28_04_56/2017_03_28_21_35.mpg;Kohei Otsuka.jpg;86045;86161;113949;4306;4312;6
/net/per610a/home/mvp/mvp_db/hodost-lv/2017/2017_03_28_04_56/2017_03_28_21_35.mpg;Shinzo ABE.jpg;73125;73529;113949;3659;3680;21
/net/per610a/home/mvp/mvp_db/hodost-lv/2017/2017_03_28_04_56/2017_03_28_21_35.mpg;Shinzo ABE.jpg;74925;75037;113949;3749;3755;6
/net/per610a/home/mvp/mvp_db/hodost-lv/2017/2017_03_29_04_56/2017_03_29_21_54.mpg;Yuichiro Tamaki.png;19609;19829;91169;981;992;11
/net/per610a/home/mvp/mvp_db/hodost-lv/2017/2017_03_29_04_56/2017_03_29_21_54.mpg;Kohei Otsuka.jpg;42021;42429;91169;2103;2123;20
/net/per610a/home/mvp/mvp_db/hodost-lv/2017/2017_03_30_04_56/2017_03_30_21_54.mpg;YUriko Koike.jpg;41381;41545;91169;2071;2079;8
/net/per610a/home/mvp/mvp_db/hodost-lv/2017/2017_03_30_04_56/2017_03_30_21_54.mpg;YUriko Koike.jpg;42453;42801;91169;2124;2142;18
/net/per610a/home/mvp/mvp_db/hodost-lv/2017/2017_04_02_04_56/2017_04_02_16_30.mpg;YUriko Koike.jpg;17597;17961;107961;880;898;18
/net/per610a/home/mvp/mvp_db/hodost-lv/2017/2017_04_02_04_56/2017_04_02_16_30.mpg;YUriko Koike.jpg;21597;21837;107961;1080;1092;12
/net/per610a/home/mvp/mvp_db/hodost-lv/2017/2017_04_02_04_56/2017_04_02_16_30.mpg;Shinzo ABE.jpg;61689;61801;107961;3087;3092;5
/net/per610a/home/mvp/mvp_db/hodost-lv/2017/2017_04_02_04_56/2017_04_02_16_30.mpg;Shinzo ABE.jpg;75517;75845;107961;3779;3795;16
/net/per610a/home/mvp/mvp_db/hodost-lv/2017/2017_04_02_04_56/2017_04_02_16_30.mpg;Shinzo ABE.jpg;78473;78489;107961;3927;3928;1
/net/per610a/home/mvp/mvp_db/hodost-lv/2017/2017_04_03_04_56/2017_04_03_21_54.mpg;YUriko Koike.jpg;15541;15717;91169;777;786;9
/net/per610a/home/mvp/mvp_db/hodost-lv/2017/2017_04_03_04_56/2017_04_03_21_54.mpg;YUriko Koike.jpg;18673;19005;91169;934;951;17
/net/per610a/home/mvp/mvp_db/hodost-lv/2017/2017_04_03_04_56/2017_04_03_21_54.mpg;YUriko Koike.jpg;19725;20137;91169;987;1007;20
/net/per610a/home/mvp/mvp_db/hodost-lv/2017/2017_04_03_04_56/2017_04_03_21_54.mpg;YUriko Koike.jpg;28737;29081;91169;1438;1455;17
/net/per610a/home/mvp/mvp_db/hodost-lv/2017/2017_04_03_04_56/2017_04_03_21_54.mpg;YUriko Koike.jpg;21129;21417;91169;1057;1071;14
/net/per610a/home/mvp/mvp_db/hodost-lv/2017/2017_04_03_04_56/2017_04_03_21_54.mpg;YUriko Koike.jpg;23757;24253;91169;1189;1213;24
/net/per610a/home/mvp/mvp_db/hodost-lv/2017/2017_04_03_04_56/2017_04_03_21_54.mpg;YUriko Koike.jpg;25865;26073;91169;1294;1304;10
/net/per610a/home/mvp/mvp_db/hodost-lv/2017/2017_04_03_04_56/2017_04_03_21_54.mpg;YUriko Koike.jpg;26189;26901;91169;1310;1346;36
/net/per610a/home/mvp/mvp_db/hodost-lv/2017/2017_04_03_04_56/2017_04_03_21_54.mpg;Shinzo ABE.jpg;38481;39505;91169;1925;1977;52
/net/per610a/home/mvp/mvp_db/hodost-lv/2017/2017_04_06_04_56/2017_04_06_21_54.mpg;Shinzo ABE.jpg;19665;19717;91169;984;986;2
/net/per610a/home/mvp/mvp_db/hodost-lv/2017/2017_04_06_04_56/2017_04_06_21_54.mpg;Shinzo ABE.jpg;19909;19909;91169;996;996;0
/net/per610a/home/mvp/mvp_db/hodost-lv/2017/2017_04_06_04_56/2017_04_06_21_54.mpg;Shinzo ABE.jpg;27401;27525;91169;1371;1377;6
/net/per610a/home/mvp/mvp_db/hodost-lv/2017/2017_04_06_04_56/2017_04_06_21_54.mpg;Shinzo ABE.jpg;29621;29625;91169;1482;1482;0
/net/per610a/home/mvp/mvp_db/hodost-lv/2017/2017_04_06_04_56/2017_04_06_21_54.mpg;Shinzo ABE.jpg;31313;31705;91169;1566;1586;20
/net/per610a/home/mvp/mvp_db/hodost-lv/2017/2017_04_06_04_56/2017_04_06_21_54.mpg;Junichiro KOIZUMI.jpg;20357;20653;91169;1018;1033;15
/net/per610a/home/mvp/mvp_db/hodost-lv/2017/2017_04_06_04_56/2017_04_06_21_54.mpg;Kenji Eda.jpg;21093;21269;91169;1055;1064;9
/net/per610a/home/mvp/mvp_db/hodost-lv/2017/2017_04_06_04_56/2017_04_06_21_54.mpg;Renho.jpg;51665;51893;91169;2585;2596;11
/net/per610a/home/mvp/mvp_db/hodost-lv/2017/2017_04_07_04_56/2017_04_07_21_54.mpg;Shinzo ABE.jpg;18733;19281;91169;937;965;28
/net/per610a/home/mvp/mvp_db/hodost-lv/2017/2017_04_10_04_56/2017_04_10_21_54.mpg;YUriko Koike.jpg;38089;38157;91169;1906;1909;3
/net/per610a/home/mvp/mvp_db/hodost-lv/2017/2017_04_10_04_56/2017_04_10_21_54.mpg;YUriko Koike.jpg;38261;38529;91169;1914;1928;14
/net/per610a/home/mvp/mvp_db/hodost-lv/2017/2017_04_10_04_56/2017_04_10_21_54.mpg;Renho.jpg;51017;51229;91169;2553;2564;11
/net/per610a/home/mvp/mvp_db/hodost-lv/2017/2017_04_11_04_56/2017_04_11_21_54.mpg;Shinzo ABE.jpg;33293;33361;91169;1666;1669;3
/net/per610a/home/mvp/mvp_db/hodost-lv/2017/2017_04_11_04_56/2017_04_11_21_54.mpg;Shinzo ABE.jpg;33757;34173;91169;1689;1710;21
/net/per610a/home/mvp/mvp_db/hodost-lv/2017/2017_04_11_04_56/2017_04_11_21_54.mpg;Shinzo ABE.jpg;34261;34341;91169;1714;1718;4
/net/per610a/home/mvp/mvp_db/hodost-lv/2017/2017_04_11_04_56/2017_04_11_21_54.mpg;Shinzo ABE.jpg;38177;38261;91169;1910;1914;4
/net/per610a/home/mvp/mvp_db/hodost-lv/2017/2017_04_11_04_56/2017_04_11_21_54.mpg;Shinzo ABE.jpg;34989;35057;91169;1751;1754;3
/net/per610a/home/mvp/mvp_db/hodost-lv/2017/2017_04_13_04_56/2017_04_13_21_54.mpg;Shinzo ABE.jpg;17041;17193;91161;852;860;8
/net/per610a/home/mvp/mvp_db/hodost-lv/2017/2017_04_13_04_56/2017_04_13_21_54.mpg;Shinzo ABE.jpg;29373;29445;91161;1469;1473;4
/net/per610a/home/mvp/mvp_db/hodost-lv/2017/2017_04_14_04_56/2017_04_14_21_54.mpg;Ichiro OZAWA.jpg;39697;39729;91161;1986;1988;2
/net/per610a/home/mvp/mvp_db/hodost-lv/2017/2017_04_14_04_56/2017_04_14_21_54.mpg;Ichiro OZAWA.jpg;39997;40161;91161;2001;2009;8
/net/per610a/home/mvp/mvp_db/hodost-lv/2017/2017_04_14_04_56/2017_04_14_21_54.mpg;Ichiro OZAWA.jpg;40525;40957;91161;2028;2049;21
/net/per610a/home/mvp/mvp_db/hodost-lv/2017/2017_04_17_04_56/2017_04_17_21_54.mpg;Toru Hashimoto.jpg;89877;90001;91169;4498;4504;6
/net/per610a/home/mvp/mvp_db/hodost-lv/2017/2017_04_18_04_56/2017_04_18_21_54.mpg;Shinzo ABE.jpg;12329;12637;91169;617;632;15
/net/per610a/home/mvp/mvp_db/hodost-lv/2017/2017_04_18_04_56/2017_04_18_21_54.mpg;Taro ASO.jpg;25093;25433;91169;1255;1272;17
/net/per610a/home/mvp/mvp_db/hodost-lv/2017/2017_04_19_04_56/2017_04_19_21_54.mpg;Shinzo ABE.jpg;17625;17653;91169;882;883;1
/net/per610a/home/mvp/mvp_db/hodost-lv/2017/2017_04_19_04_56/2017_04_19_21_54.mpg;Shinzo ABE.jpg;20549;20605;91169;1028;1031;3
/net/per610a/home/mvp/mvp_db/hodost-lv/2017/2017_04_19_04_56/2017_04_19_21_54.mpg;Shinzo ABE.jpg;24669;24705;91169;1234;1236;2
/net/per610a/home/mvp/mvp_db/hodost-lv/2017/2017_04_19_04_56/2017_04_19_21_54.mpg;Shinzo ABE.jpg;25133;25149;91169;1257;1258;1
/net/per610a/home/mvp/mvp_db/hodost-lv/2017/2017_04_19_04_56/2017_04_19_21_54.mpg;Shinzo ABE.jpg;30577;30605;91169;1530;1531;1
/net/per610a/home/mvp/mvp_db/hodost-lv/2017/2017_04_19_04_56/2017_04_19_21_54.mpg;Shinzo ABE.jpg;30897;31009;91169;1546;1551;5
/net/per610a/home/mvp/mvp_db/hodost-lv/2017/2017_04_19_04_56/2017_04_19_21_54.mpg;Shinzo ABE.jpg;24825;24981;91169;1242;1250;8
/net/per610a/home/mvp/mvp_db/hodost-lv/2017/2017_04_19_04_56/2017_04_19_21_54.mpg;Ichiro OZAWA.jpg;39501;39885;91169;1977;1996;19
/net/per610a/home/mvp/mvp_db/hodost-lv/2017/2017_04_19_04_56/2017_04_19_21_54.mpg;Ichiro OZAWA.jpg;39969;40045;91169;2000;2004;4
/net/per610a/home/mvp/mvp_db/hodost-lv/2017/2017_04_19_04_56/2017_04_19_21_54.mpg;Ichiro OZAWA.jpg;40549;40825;91169;2029;2043;14
/net/per610a/home/mvp/mvp_db/hodost-lv/2017/2017_04_19_04_56/2017_04_19_21_54.mpg;YUriko Koike.jpg;55161;55297;91169;2760;2767;7
/net/per610a/home/mvp/mvp_db/hodost-lv/2017/2017_04_20_04_56/2017_04_20_22_09.mpg;Shinzo ABE.jpg;22657;23157;91169;1133;1159;26
/net/per610a/home/mvp/mvp_db/hodost-lv/2017/2017_04_23_04_56/2017_04_23_20_54.mpg;Ichiro OZAWA.jpg;86521;86781;100761;4330;4343;13
/net/per610a/home/mvp/mvp_db/hodost-lv/2017/2017_04_22_04_56/2017_04_22_20_54.mpg;Shinzo ABE.jpg;12817;12829;71989;641;642;1
/net/per610a/home/mvp/mvp_db/hodost-lv/2017/2017_04_22_04_56/2017_04_22_20_54.mpg;Shinzo ABE.jpg;15505;15585;71989;776;780;4
/net/per610a/home/mvp/mvp_db/hodost-lv/2017/2017_04_22_04_56/2017_04_22_20_54.mpg;Shinzo ABE.jpg;20265;20521;71989;1014;1027;13
/net/per610a/home/mvp/mvp_db/hodost-lv/2017/2017_04_22_04_56/2017_04_22_20_54.mpg;Shinzo ABE.jpg;21233;21269;71989;1062;1064;2
/net/per610a/home/mvp/mvp_db/hodost-lv/2017/2017_04_22_04_56/2017_04_22_20_54.mpg;Junichiro KOIZUMI.jpg;13261;13297;71989;663;665;2
/net/per610a/home/mvp/mvp_db/hodost-lv/2017/2017_04_22_04_56/2017_04_22_20_54.mpg;Junichiro KOIZUMI.jpg;13453;13569;71989;673;679;6
/net/per610a/home/mvp/mvp_db/hodost-lv/2017/2017_04_22_04_56/2017_04_22_20_54.mpg;YUriko Koike.jpg;13453;13569;71989;673;679;6
/net/per610a/home/mvp/mvp_db/hodost-lv/2017/2017_04_22_04_56/2017_04_22_20_54.mpg;Shinzo ABE.jpg;21273;21437;71989;1064;1072;8
/net/per610a/home/mvp/mvp_db/hodost-lv/2017/2017_04_24_04_56/2017_04_24_21_54.mpg;Shinzo ABE.jpg;2177;2437;91169;108;121;13
/net/per610a/home/mvp/mvp_db/hodost-lv/2017/2017_04_24_04_56/2017_04_24_21_54.mpg;Shinzo ABE.jpg;5049;5525;91169;252;276;24
/net/per610a/home/mvp/mvp_db/hodost-lv/2017/2017_04_24_04_56/2017_04_24_21_54.mpg;Shinzo ABE.jpg;8069;8937;91169;403;447;44
/net/per610a/home/mvp/mvp_db/hodost-lv/2017/2017_04_25_04_56/2017_04_25_21_54.mpg;Shinzo ABE.jpg;5945;6449;91161;297;322;25
/net/per610a/home/mvp/mvp_db/hodost-lv/2017/2017_04_25_04_56/2017_04_25_21_54.mpg;Shinzo ABE.jpg;8741;9021;91161;437;451;14
/net/per610a/home/mvp/mvp_db/hodost-lv/2017/2017_04_26_04_56/2017_04_26_21_54.mpg;Shinzo ABE.jpg;1585;1609;91169;79;80;1
/net/per610a/home/mvp/mvp_db/hodost-lv/2017/2017_04_26_04_56/2017_04_26_21_54.mpg;Shinzo ABE.jpg;10817;10885;91169;541;544;3
/net/per610a/home/mvp/mvp_db/hodost-lv/2017/2017_04_26_04_56/2017_04_26_21_54.mpg;Shinzo ABE.jpg;11125;11253;91169;556;563;7
/net/per610a/home/mvp/mvp_db/hodost-lv/2017/2017_04_26_04_56/2017_04_26_21_54.mpg;Shinzo ABE.jpg;13757;13841;91169;688;692;4
/net/per610a/home/mvp/mvp_db/hodost-lv/2017/2017_04_26_04_56/2017_04_26_21_54.mpg;Shinzo ABE.jpg;5253;5693;91169;262;284;22
/net/per610a/home/mvp/mvp_db/hodost-lv/2017/2017_04_27_04_56/2017_04_27_21_54.mpg;Shinzo ABE.jpg;1577;1577;91169;78;78;0
/net/per610a/home/mvp/mvp_db/hodost-lv/2017/2017_04_27_04_56/2017_04_27_21_54.mpg;Shinzo ABE.jpg;9265;9289;91169;463;464;1
/net/per610a/home/mvp/mvp_db/hodost-lv/2017/2017_04_27_04_56/2017_04_27_21_54.mpg;Shinzo ABE.jpg;16513;16557;91169;826;828;2
/net/per610a/home/mvp/mvp_db/hodost-lv/2017/2017_04_27_04_56/2017_04_27_21_54.mpg;Shinzo ABE.jpg;18705;18749;91169;936;938;2
/net/per610a/home/mvp/mvp_db/hodost-lv/2017/2017_04_27_04_56/2017_04_27_21_54.mpg;Shinzo ABE.jpg;20165;20285;91169;1009;1015;6
/net/per610a/home/mvp/mvp_db/hodost-lv/2017/2017_04_28_04_56/2017_04_28_21_54.mpg;Shinzo ABE.jpg;34753;34841;91169;1739;1743;4
/net/per610a/home/mvp/mvp_db/hodost-lv/2017/2017_04_29_04_56/2017_04_29_20_54.mpg;Shinzo ABE.jpg;9721;10193;71981;486;510;24
/net/per610a/home/mvp/mvp_db/hodost-lv/2017/2017_04_29_04_56/2017_04_29_20_54.mpg;Shinzo ABE.jpg;26273;26401;71981;1314;1321;7
/net/per610a/home/mvp/mvp_db/hodost-lv/2017/2017_05_01_04_56/2017_05_01_21_54.mpg;Shinzo ABE.jpg;13561;13585;91161;678;679;1
/net/per610a/home/mvp/mvp_db/hodost-lv/2017/2017_05_01_04_56/2017_05_01_21_54.mpg;Shinzo ABE.jpg;51333;51465;91161;2568;2575;7
/net/per610a/home/mvp/mvp_db/hodost-lv/2017/2017_05_01_04_56/2017_05_01_21_54.mpg;Shinzo ABE.jpg;51673;51861;91161;2585;2595;10
/net/per610a/home/mvp/mvp_db/hodost-lv/2017/2017_05_03_04_56/2017_05_03_21_54.mpg;Shinzo ABE.jpg;13161;13885;91169;658;694;36
/net/per610a/home/mvp/mvp_db/hodost-lv/2017/2017_05_03_04_56/2017_05_03_21_54.mpg;Shinzo ABE.jpg;14137;14313;91169;707;716;9
/net/per610a/home/mvp/mvp_db/hodost-lv/2017/2017_05_03_04_56/2017_05_03_21_54.mpg;Shinzo ABE.jpg;14537;14685;91169;727;734;7
/net/per610a/home/mvp/mvp_db/hodost-lv/2017/2017_05_03_04_56/2017_05_03_21_54.mpg;Shinzo ABE.jpg;15277;15485;91169;764;775;11
/net/per610a/home/mvp/mvp_db/hodost-lv/2017/2017_05_03_04_56/2017_05_03_21_54.mpg;Shinzo ABE.jpg;21257;21757;91169;1063;1088;25
/net/per610a/home/mvp/mvp_db/hodost-lv/2017/2017_05_03_04_56/2017_05_03_21_54.mpg;Shinzo ABE.jpg;25597;25613;91169;1281;1281;0
/net/per610a/home/mvp/mvp_db/hodost-lv/2017/2017_05_04_04_56/2017_05_04_21_54.mpg;YUriko Koike.jpg;13977;14073;91169;699;704;5
/net/per610a/home/mvp/mvp_db/hodost-lv/2017/2017_05_04_04_56/2017_05_04_21_54.mpg;YUriko Koike.jpg;14749;14797;91169;738;740;2
/net/per610a/home/mvp/mvp_db/hodost-lv/2017/2017_05_04_04_56/2017_05_04_21_54.mpg;YUriko Koike.jpg;15013;15017;91169;751;751;0
/net/per610a/home/mvp/mvp_db/hodost-lv/2017/2017_05_04_04_56/2017_05_04_21_54.mpg;Renho.jpg;18173;18325;91169;909;917;8
/net/per610a/home/mvp/mvp_db/hodost-lv/2017/2017_05_04_04_56/2017_05_04_21_54.mpg;Renho.jpg;18485;18665;91169;925;934;9
/net/per610a/home/mvp/mvp_db/hodost-lv/2017/2017_05_07_04_56/2017_05_07_20_54.mpg;Nariaki Nakayama.png;37389;37469;71989;1871;1875;4
/net/per610a/home/mvp/mvp_db/hodost-lv/2017/2017_05_07_04_56/2017_05_07_20_54.mpg;Nariaki Nakayama.png;38449;38601;71989;1924;1931;7
/net/per610a/home/mvp/mvp_db/hodost-lv/2017/2017_05_08_04_56/2017_05_08_21_54.mpg;Shinzo ABE.jpg;18789;18805;91169;940;941;1
/net/per610a/home/mvp/mvp_db/hodost-lv/2017/2017_05_08_04_56/2017_05_08_21_54.mpg;Shinzo ABE.jpg;21757;21953;91169;1088;1098;10
/net/per610a/home/mvp/mvp_db/hodost-lv/2017/2017_05_08_04_56/2017_05_08_21_54.mpg;Shinzo ABE.jpg;24269;24545;91169;1214;1228;14
/net/per610a/home/mvp/mvp_db/hodost-lv/2017/2017_05_08_04_56/2017_05_08_21_54.mpg;Shinzo ABE.jpg;25313;25501;91169;1266;1276;10
/net/per610a/home/mvp/mvp_db/hodost-lv/2017/2017_05_08_04_56/2017_05_08_21_54.mpg;Shinzo ABE.jpg;27005;27021;91169;1351;1352;1
/net/per610a/home/mvp/mvp_db/hodost-lv/2017/2017_05_08_04_56/2017_05_08_21_54.mpg;Shinzo ABE.jpg;27865;27973;91169;1394;1400;6
/net/per610a/home/mvp/mvp_db/hodost-lv/2017/2017_05_09_04_56/2017_05_09_21_54.mpg;Shinzo ABE.jpg;21021;21285;91169;1052;1065;13
/net/per610a/home/mvp/mvp_db/hodost-lv/2017/2017_05_09_04_56/2017_05_09_21_54.mpg;Shinzo ABE.jpg;22169;22317;91169;1109;1116;7
/net/per610a/home/mvp/mvp_db/hodost-lv/2017/2017_05_09_04_56/2017_05_09_21_54.mpg;Shinzo ABE.jpg;23841;24017;91169;1193;1202;9
/net/per610a/home/mvp/mvp_db/hodost-lv/2017/2017_05_09_04_56/2017_05_09_21_54.mpg;Shinzo ABE.jpg;24105;24709;91169;1206;1236;30
/net/per610a/home/mvp/mvp_db/hodost-lv/2017/2017_05_09_04_56/2017_05_09_21_54.mpg;Shinzo ABE.jpg;24801;25037;91169;1241;1253;12
/net/per610a/home/mvp/mvp_db/hodost-lv/2017/2017_05_09_04_56/2017_05_09_21_54.mpg;Shinzo ABE.jpg;25141;25189;91169;1258;1260;2
/net/per610a/home/mvp/mvp_db/hodost-lv/2017/2017_05_09_04_56/2017_05_09_21_54.mpg;Shinzo ABE.jpg;27661;27769;91169;1384;1389;5
/net/per610a/home/mvp/mvp_db/hodost-lv/2017/2017_05_09_04_56/2017_05_09_21_54.mpg;Shinzo ABE.jpg;30161;30341;91169;1509;1518;9
/net/per610a/home/mvp/mvp_db/hodost-lv/2017/2017_05_09_04_56/2017_05_09_21_54.mpg;Shinzo ABE.jpg;35469;36081;91169;1775;1805;30
/net/per610a/home/mvp/mvp_db/hodost-lv/2017/2017_05_09_04_56/2017_05_09_21_54.mpg;YUriko Koike.jpg;46381;46513;91169;2321;2327;6
/net/per610a/home/mvp/mvp_db/hodost-lv/2017/2017_05_10_04_56/2017_05_10_21_54.mpg;YUriko Koike.jpg;15777;15977;91169;789;799;10
/net/per610a/home/mvp/mvp_db/hodost-lv/2017/2017_05_10_04_56/2017_05_10_21_54.mpg;YUriko Koike.jpg;21285;21665;91169;1065;1084;19
/net/per610a/home/mvp/mvp_db/hodost-lv/2017/2017_05_11_04_56/2017_05_11_21_54.mpg;Shinzo ABE.jpg;1905;1973;91169;95;98;3
/net/per610a/home/mvp/mvp_db/hodost-lv/2017/2017_05_11_04_56/2017_05_11_21_54.mpg;Shinzo ABE.jpg;8005;8049;91169;400;402;2
/net/per610a/home/mvp/mvp_db/hodost-lv/2017/2017_05_11_04_56/2017_05_11_21_54.mpg;Shinzo ABE.jpg;12609;13073;91169;631;654;23
/net/per610a/home/mvp/mvp_db/hodost-lv/2017/2017_05_11_04_56/2017_05_11_21_54.mpg;Shinzo ABE.jpg;13157;13285;91169;658;664;6
/net/per610a/home/mvp/mvp_db/hodost-lv/2017/2017_05_11_04_56/2017_05_11_21_54.mpg;Shinzo ABE.jpg;13557;13917;91169;678;696;18
/net/per610a/home/mvp/mvp_db/hodost-lv/2017/2017_05_11_04_56/2017_05_11_21_54.mpg;Shinzo ABE.jpg;14037;14909;91169;702;746;44
/net/per610a/home/mvp/mvp_db/hodost-lv/2017/2017_05_11_04_56/2017_05_11_21_54.mpg;YUriko Koike.jpg;2801;3053;91169;140;152;12
/net/per610a/home/mvp/mvp_db/hodost-lv/2017/2017_05_11_04_56/2017_05_11_21_54.mpg;YUriko Koike.jpg;7317;7393;91169;366;370;4
/net/per610a/home/mvp/mvp_db/hodost-lv/2017/2017_05_11_04_56/2017_05_11_21_54.mpg;YUriko Koike.jpg;8009;8097;91169;400;405;5
/net/per610a/home/mvp/mvp_db/hodost-lv/2017/2017_05_11_04_56/2017_05_11_21_54.mpg;Shinzo ABE.jpg;13401;13553;91169;670;678;8
/net/per610a/home/mvp/mvp_db/hodost-lv/2017/2017_05_11_04_56/2017_05_11_21_54.mpg;Shinzo ABE.jpg;17385;17433;91169;870;872;2
/net/per610a/home/mvp/mvp_db/hodost-lv/2017/2017_05_11_04_56/2017_05_11_21_54.mpg;Shinzo ABE.jpg;18773;18777;91169;939;939;0
/net/per610a/home/mvp/mvp_db/hodost-lv/2017/2017_05_11_04_56/2017_05_11_21_54.mpg;Shinzo ABE.jpg;19953;20033;91169;998;1002;4
/net/per610a/home/mvp/mvp_db/hodost-lv/2017/2017_05_11_04_56/2017_05_11_21_54.mpg;Shinzo ABE.jpg;20665;20769;91169;1034;1039;5
/net/per610a/home/mvp/mvp_db/hodost-lv/2017/2017_05_12_04_56/2017_05_12_21_54.mpg;Shinzo ABE.jpg;15669;15977;91169;784;799;15
/net/per610a/home/mvp/mvp_db/hodost-lv/2017/2017_05_12_04_56/2017_05_12_21_54.mpg;Shinzo ABE.jpg;57909;58229;91169;2898;2914;16
/net/per610a/home/mvp/mvp_db/hodost-lv/2017/2017_05_12_04_56/2017_05_12_21_54.mpg;YUriko Koike.jpg;42081;42281;91169;2106;2116;10
/net/per610a/home/mvp/mvp_db/hodost-lv/2017/2017_05_12_04_56/2017_05_12_21_54.mpg;YUriko Koike.jpg;43489;43633;91169;2176;2183;7
/net/per610a/home/mvp/mvp_db/hodost-lv/2017/2017_05_12_04_56/2017_05_12_21_54.mpg;YUriko Koike.jpg;45029;45161;91169;2253;2260;7
/net/per610a/home/mvp/mvp_db/hodost-lv/2017/2017_05_13_04_56/2017_05_13_20_54.mpg;Shinzo ABE.jpg;20157;20197;71981;1008;1010;2
/net/per610a/home/mvp/mvp_db/hodost-lv/2017/2017_05_13_04_56/2017_05_13_20_54.mpg;Shinzo ABE.jpg;26709;26809;71981;1336;1341;5
/net/per610a/home/mvp/mvp_db/hodost-lv/2017/2017_05_13_04_56/2017_05_13_20_54.mpg;Shinzo ABE.jpg;21277;21317;71981;1064;1066;2
/net/per610a/home/mvp/mvp_db/hodost-lv/2017/2017_05_13_04_56/2017_05_13_20_54.mpg;Shinzo ABE.jpg;21589;21653;71981;1080;1083;3
/net/per610a/home/mvp/mvp_db/hodost-lv/2017/2017_05_13_04_56/2017_05_13_20_54.mpg;Shinzo ABE.jpg;22625;22625;71981;1132;1132;0
/net/per610a/home/mvp/mvp_db/hodost-lv/2017/2017_05_13_04_56/2017_05_13_20_54.mpg;Shinzo ABE.jpg;22997;23301;71981;1150;1166;16
/net/per610a/home/mvp/mvp_db/hodost-lv/2017/2017_05_13_04_56/2017_05_13_20_54.mpg;Shinzo ABE.jpg;23617;23625;71981;1181;1182;1
/net/per610a/home/mvp/mvp_db/hodost-lv/2017/2017_05_13_04_56/2017_05_13_20_54.mpg;Shinzo ABE.jpg;24533;24545;71981;1227;1228;1
/net/per610a/home/mvp/mvp_db/hodost-lv/2017/2017_05_13_04_56/2017_05_13_20_54.mpg;Shinzo ABE.jpg;25021;25193;71981;1252;1260;8
/net/per610a/home/mvp/mvp_db/hodost-lv/2017/2017_05_14_04_56/2017_05_14_20_54.mpg;Kenji Eda.jpg;47165;47261;71989;2359;2364;5
/net/per610a/home/mvp/mvp_db/hodost-lv/2017/2017_05_15_04_56/2017_05_15_21_54.mpg;YUriko Koike.jpg;32305;32385;91169;1616;1620;4
/net/per610a/home/mvp/mvp_db/hodost-lv/2017/2017_05_15_04_56/2017_05_15_21_54.mpg;YUriko Koike.jpg;33733;33889;91169;1688;1696;8
/net/per610a/home/mvp/mvp_db/hodost-lv/2017/2017_05_15_04_56/2017_05_15_21_54.mpg;YUriko Koike.jpg;34545;34789;91169;1728;1741;13
/net/per610a/home/mvp/mvp_db/hodost-lv/2017/2017_05_15_04_56/2017_05_15_21_54.mpg;YUriko Koike.jpg;35925;35993;91169;1798;1801;3
/net/per610a/home/mvp/mvp_db/hodost-lv/2017/2017_05_15_04_56/2017_05_15_21_54.mpg;YUriko Koike.jpg;38149;38289;91169;1909;1916;7
/net/per610a/home/mvp/mvp_db/hodost-lv/2017/2017_05_15_04_56/2017_05_15_21_54.mpg;YUriko Koike.jpg;38889;39009;91169;1946;1952;6
/net/per610a/home/mvp/mvp_db/hodost-lv/2017/2017_05_15_04_56/2017_05_15_21_54.mpg;YUriko Koike.jpg;35125;35125;91169;1758;1758;0
/net/per610a/home/mvp/mvp_db/hodost-lv/2017/2017_05_15_04_56/2017_05_15_21_54.mpg;YUriko Koike.jpg;35225;35241;91169;1763;1763;0
/net/per610a/home/mvp/mvp_db/hodost-lv/2017/2017_05_15_04_56/2017_05_15_21_54.mpg;YUriko Koike.jpg;35633;35677;91169;1783;1785;2
/net/per610a/home/mvp/mvp_db/hodost-lv/2017/2017_05_15_04_56/2017_05_15_21_54.mpg;YUriko Koike.jpg;35877;35913;91169;1795;1797;2
/net/per610a/home/mvp/mvp_db/hodost-lv/2017/2017_05_15_04_56/2017_05_15_21_54.mpg;YUriko Koike.jpg;37469;37985;91169;1875;1901;26
/net/per610a/home/mvp/mvp_db/hodost-lv/2017/2017_05_16_04_56/2017_05_16_21_54.mpg;Natsuo YAMAGUCHI.jpg;30877;31041;91161;1545;1553;8
/net/per610a/home/mvp/mvp_db/hodost-lv/2017/2017_05_16_04_56/2017_05_16_21_54.mpg;Shinzo ABE.jpg;31909;32129;91161;1596;1607;11
/net/per610a/home/mvp/mvp_db/hodost-lv/2017/2017_05_17_04_56/2017_05_17_21_54.mpg;Shinzo ABE.jpg;1353;1425;91161;67;71;4
/net/per610a/home/mvp/mvp_db/hodost-lv/2017/2017_05_17_04_56/2017_05_17_21_54.mpg;Shinzo ABE.jpg;12557;12701;91161;628;635;7
/net/per610a/home/mvp/mvp_db/hodost-lv/2017/2017_05_17_04_56/2017_05_17_21_54.mpg;Shinzo ABE.jpg;23965;24213;91161;1199;1211;12
/net/per610a/home/mvp/mvp_db/hodost-lv/2017/2017_05_17_04_56/2017_05_17_21_54.mpg;Shinzo ABE.jpg;31145;31193;91161;1558;1561;3
/net/per610a/home/mvp/mvp_db/hodost-lv/2017/2017_05_17_04_56/2017_05_17_21_54.mpg;Yoshihiko Noda.jpg;31049;31137;91161;1553;1558;5
/net/per610a/home/mvp/mvp_db/hodost-lv/2017/2017_05_17_04_56/2017_05_17_21_54.mpg;Yoshihiko Noda.jpg;32017;32117;91161;1602;1607;5
/net/per610a/home/mvp/mvp_db/hodost-lv/2017/2017_05_18_04_56/2017_05_18_21_54.mpg;Shinzo ABE.jpg;52729;52993;91169;2639;2652;13
/net/per610a/home/mvp/mvp_db/hodost-lv/2017/2017_05_19_04_56/2017_05_19_21_54.mpg;Shinzo ABE.jpg;22553;22677;91161;1128;1134;6
/net/per610a/home/mvp/mvp_db/hodost-lv/2017/2017_05_19_04_56/2017_05_19_21_54.mpg;Shinzo ABE.jpg;24505;24589;91161;1226;1230;4
/net/per610a/home/mvp/mvp_db/hodost-lv/2017/2017_05_19_04_56/2017_05_19_21_54.mpg;YUriko Koike.jpg;53085;53269;91161;2656;2665;9
/net/per610a/home/mvp/mvp_db/hodost-lv/2017/2017_05_19_04_56/2017_05_19_21_54.mpg;YUriko Koike.jpg;53721;54081;91161;2688;2706;18
/net/per610a/home/mvp/mvp_db/hodost-lv/2017/2017_05_20_04_56/2017_05_20_20_54.mpg;Shinzo ABE.jpg;15797;15997;71989;790;800;10
/net/per610a/home/mvp/mvp_db/hodost-lv/2017/2017_05_20_04_56/2017_05_20_20_54.mpg;Shinzo ABE.jpg;19377;19593;71989;969;980;11
/net/per610a/home/mvp/mvp_db/hodost-lv/2017/2017_05_20_04_56/2017_05_20_20_54.mpg;Junichiro KOIZUMI.jpg;36657;36701;71989;1834;1836;2
/net/per610a/home/mvp/mvp_db/hodost-lv/2017/2017_05_20_04_56/2017_05_20_20_54.mpg;Junichiro KOIZUMI.jpg;37173;37525;71989;1860;1878;18
/net/per610a/home/mvp/mvp_db/hodost-lv/2017/2017_05_22_04_56/2017_05_22_21_54.mpg;Shinzo ABE.jpg;41417;41661;91169;2072;2085;13
/net/per610a/home/mvp/mvp_db/hodost-lv/2017/2017_05_22_04_56/2017_05_22_21_54.mpg;Shinzo ABE.jpg;41833;41893;91169;2093;2096;3
/net/per610a/home/mvp/mvp_db/hodost-lv/2017/2017_05_22_04_56/2017_05_22_21_54.mpg;Shinzo ABE.jpg;42589;42725;91169;2131;2138;7
/net/per610a/home/mvp/mvp_db/hodost-lv/2017/2017_05_24_04_56/2017_05_24_21_54.mpg;Shinzo ABE.jpg;11685;11813;91169;584;591;7
/net/per610a/home/mvp/mvp_db/hodost-lv/2017/2017_05_24_04_56/2017_05_24_21_54.mpg;Ichiro OZAWA.jpg;19465;19709;91169;974;986;12
/net/per610a/home/mvp/mvp_db/hodost-lv/2017/2017_05_24_04_56/2017_05_24_21_54.mpg;Shinzo ABE.jpg;20333;20697;91169;1017;1035;18
/net/per610a/home/mvp/mvp_db/hodost-lv/2017/2017_05_24_04_56/2017_05_24_21_54.mpg;Shinzo ABE.jpg;20777;20833;91169;1039;1042;3
/net/per610a/home/mvp/mvp_db/hodost-lv/2017/2017_05_24_04_56/2017_05_24_21_54.mpg;Shinzo ABE.jpg;22505;22521;91169;1126;1127;1
/net/per610a/home/mvp/mvp_db/hodost-lv/2017/2017_05_24_04_56/2017_05_24_21_54.mpg;Shinzo ABE.jpg;24949;25005;91169;1248;1251;3
/net/per610a/home/mvp/mvp_db/hodost-lv/2017/2017_05_24_04_56/2017_05_24_21_54.mpg;Shinzo ABE.jpg;29869;29913;91169;1494;1497;3
/net/per610a/home/mvp/mvp_db/hodost-lv/2017/2017_05_24_04_56/2017_05_24_21_54.mpg;YUriko Koike.jpg;58225;58461;91169;2914;2925;11
/net/per610a/home/mvp/mvp_db/hodost-lv/2017/2017_05_25_04_56/2017_05_25_21_54.mpg;Shinzo ABE.jpg;25449;25585;91161;1273;1280;7
/net/per610a/home/mvp/mvp_db/hodost-lv/2017/2017_05_26_04_56/2017_05_26_21_54.mpg;YUriko Koike.jpg;31085;31209;91169;1555;1562;7
/net/per610a/home/mvp/mvp_db/hodost-lv/2017/2017_05_26_04_56/2017_05_26_21_54.mpg;YUriko Koike.jpg;35205;35625;91169;1762;1783;21
/net/per610a/home/mvp/mvp_db/hodost-lv/2017/2017_05_26_04_56/2017_05_26_21_54.mpg;Shinzo ABE.jpg;35717;36065;91169;1787;1805;18
/net/per610a/home/mvp/mvp_db/hodost-lv/2017/2017_05_28_04_56/2017_05_28_20_54.mpg;Shinzo ABE.jpg;20757;20857;71989;1038;1043;5
/net/per610a/home/mvp/mvp_db/hodost-lv/2017/2017_05_28_04_56/2017_05_28_20_54.mpg;Shinzo ABE.jpg;24561;24673;71989;1228;1234;6
/net/per610a/home/mvp/mvp_db/hodost-lv/2017/2017_05_28_04_56/2017_05_28_20_54.mpg;Shinzo ABE.jpg;24973;25217;71989;1249;1261;12
/net/per610a/home/mvp/mvp_db/hodost-lv/2017/2017_05_29_04_56/2017_05_29_21_54.mpg;Shinzo ABE.jpg;13925;14017;91169;696;701;5
/net/per610a/home/mvp/mvp_db/hodost-lv/2017/2017_05_29_04_56/2017_05_29_21_54.mpg;Shinzo ABE.jpg;17437;17437;91169;872;872;0
/net/per610a/home/mvp/mvp_db/hodost-lv/2017/2017_05_29_04_56/2017_05_29_21_54.mpg;Shinzo ABE.jpg;17517;17521;91169;876;876;0
/net/per610a/home/mvp/mvp_db/hodost-lv/2017/2017_05_29_04_56/2017_05_29_21_54.mpg;Shinzo ABE.jpg;30721;30925;91169;1537;1547;10
/net/per610a/home/mvp/mvp_db/hodost-lv/2017/2017_05_29_04_56/2017_05_29_21_54.mpg;Yoshihiko Noda.jpg;16445;17373;91169;823;869;46
/net/per610a/home/mvp/mvp_db/hodost-lv/2017/2017_05_29_04_56/2017_05_29_21_54.mpg;Toru Hashimoto.jpg;89865;89961;91169;4497;4502;5
/net/per610a/home/mvp/mvp_db/hodost-lv/2017/2017_05_30_04_56/2017_05_30_21_54.mpg;Shinzo ABE.jpg;11873;12013;91169;594;601;7
/net/per610a/home/mvp/mvp_db/hodost-lv/2017/2017_05_30_04_56/2017_05_30_21_54.mpg;Shinzo ABE.jpg;12109;12345;91169;605;617;12
/net/per610a/home/mvp/mvp_db/hodost-lv/2017/2017_05_30_04_56/2017_05_30_21_54.mpg;Shinzo ABE.jpg;14193;14205;91169;710;710;0
/net/per610a/home/mvp/mvp_db/hodost-lv/2017/2017_05_30_04_56/2017_05_30_21_54.mpg;YUriko Koike.jpg;36557;36661;91169;1829;1834;5
/net/per610a/home/mvp/mvp_db/hodost-lv/2017/2017_05_30_04_56/2017_05_30_21_54.mpg;YUriko Koike.jpg;36821;36893;91169;1842;1846;4
/net/per610a/home/mvp/mvp_db/hodost-lv/2017/2017_05_30_04_56/2017_05_30_21_54.mpg;YUriko Koike.jpg;37693;38497;91169;1886;1926;40
/net/per610a/home/mvp/mvp_db/hodost-lv/2017/2017_05_31_04_56/2017_05_31_21_54.mpg;YUriko Koike.jpg;16889;17349;91169;845;868;23
/net/per610a/home/mvp/mvp_db/hodost-lv/2017/2017_05_31_04_56/2017_05_31_21_54.mpg;YUriko Koike.jpg;19669;19737;91169;984;987;3
/net/per610a/home/mvp/mvp_db/hodost-lv/2017/2017_05_31_04_56/2017_05_31_21_54.mpg;Shinzo ABE.jpg;35441;35605;91169;1773;1782;9
/net/per610a/home/mvp/mvp_db/hodost-lv/2017/2017_05_31_04_56/2017_05_31_21_54.mpg;Shinzo ABE.jpg;47305;47673;91169;2367;2386;19
/net/per610a/home/mvp/mvp_db/hodost-lv/2017/2017_06_01_04_56/2017_06_01_21_54.mpg;Shinzo ABE.jpg;13745;13841;91169;687;692;5
/net/per610a/home/mvp/mvp_db/hodost-lv/2017/2017_06_01_04_56/2017_06_01_21_54.mpg;Shinzo ABE.jpg;26085;27217;91169;1305;1362;57
/net/per610a/home/mvp/mvp_db/hodost-lv/2017/2017_06_01_04_56/2017_06_01_21_54.mpg;Junichiro KOIZUMI.jpg;16337;19145;91169;817;958;141
/net/per610a/home/mvp/mvp_db/hodost-lv/2017/2017_06_01_04_56/2017_06_01_21_54.mpg;YUriko Koike.jpg;42297;42297;91169;2116;2116;0
/net/per610a/home/mvp/mvp_db/hodost-lv/2017/2017_06_01_04_56/2017_06_01_21_54.mpg;YUriko Koike.jpg;43529;43529;91169;2178;2178;0
/net/per610a/home/mvp/mvp_db/hodost-lv/2017/2017_06_01_04_56/2017_06_01_21_54.mpg;YUriko Koike.jpg;43885;44217;91169;2196;2213;17
/net/per610a/home/mvp/mvp_db/hodost-lv/2017/2017_06_01_04_56/2017_06_01_21_54.mpg;YUriko Koike.jpg;44381;44389;91169;2221;2221;0
/net/per610a/home/mvp/mvp_db/hodost-lv/2017/2017_06_01_04_56/2017_06_01_21_54.mpg;YUriko Koike.jpg;44593;44941;91169;2231;2249;18
/net/per610a/home/mvp/mvp_db/hodost-lv/2017/2017_06_01_04_56/2017_06_01_21_54.mpg;YUriko Koike.jpg;48289;48481;91169;2416;2426;10
/net/per610a/home/mvp/mvp_db/hodost-lv/2017/2017_06_02_04_56/2017_06_02_21_54.mpg;Taro ASO.jpg;25589;25865;91169;1280;1294;14
/net/per610a/home/mvp/mvp_db/hodost-lv/2017/2017_06_03_04_56/2017_06_03_20_54.mpg;Natsuo YAMAGUCHI.jpg;65021;65181;71989;3254;3262;8
/net/per610a/home/mvp/mvp_db/hodost-lv/2017/2017_06_05_04_56/2017_06_05_21_54.mpg;Shinzo ABE.jpg;24953;25113;91169;1248;1256;8
/net/per610a/home/mvp/mvp_db/hodost-lv/2017/2017_06_05_04_56/2017_06_05_21_54.mpg;YUriko Koike.jpg;45097;45237;91169;2257;2264;7
/net/per610a/home/mvp/mvp_db/hodost-lv/2017/2017_06_05_04_56/2017_06_05_21_54.mpg;YUriko Koike.jpg;47853;48033;91169;2395;2404;9
/net/per610a/home/mvp/mvp_db/hodost-lv/2017/2017_06_06_04_56/2017_06_06_21_54.mpg;Shinzo ABE.jpg;2917;3077;91169;145;154;9
/net/per610a/home/mvp/mvp_db/hodost-lv/2017/2017_06_06_04_56/2017_06_06_21_54.mpg;Shinzo ABE.jpg;18897;18941;91169;945;947;2
/net/per610a/home/mvp/mvp_db/hodost-lv/2017/2017_06_06_04_56/2017_06_06_21_54.mpg;Renho.jpg;18433;18525;91169;922;927;5
/net/per610a/home/mvp/mvp_db/hodost-lv/2017/2017_06_06_04_56/2017_06_06_21_54.mpg;Kazuo SHII.jpg;18593;18697;91169;930;935;5
/net/per610a/home/mvp/mvp_db/hodost-lv/2017/2017_06_09_04_56/2017_06_09_21_54.mpg;Shinzo ABE.jpg;565;565;91169;28;28;0
/net/per610a/home/mvp/mvp_db/hodost-lv/2017/2017_06_09_04_56/2017_06_09_21_54.mpg;Shinzo ABE.jpg;953;953;91169;47;47;0
/net/per610a/home/mvp/mvp_db/hodost-lv/2017/2017_06_09_04_56/2017_06_09_21_54.mpg;Shinzo ABE.jpg;1041;1041;91169;52;52;0
/net/per610a/home/mvp/mvp_db/hodost-lv/2017/2017_06_09_04_56/2017_06_09_21_54.mpg;Shinzo ABE.jpg;1213;1213;91169;60;60;0
/net/per610a/home/mvp/mvp_db/hodost-lv/2017/2017_06_09_04_56/2017_06_09_21_54.mpg;Shinzo ABE.jpg;1321;1321;91169;66;66;0
/net/per610a/home/mvp/mvp_db/hodost-lv/2017/2017_06_09_04_56/2017_06_09_21_54.mpg;Shinzo ABE.jpg;1409;1409;91169;70;70;0
/net/per610a/home/mvp/mvp_db/hodost-lv/2017/2017_06_09_04_56/2017_06_09_21_54.mpg;Shinzo ABE.jpg;1549;1549;91169;77;77;0
/net/per610a/home/mvp/mvp_db/hodost-lv/2017/2017_06_09_04_56/2017_06_09_21_54.mpg;Shinzo ABE.jpg;1637;2145;91169;81;107;26
/net/per610a/home/mvp/mvp_db/hodost-lv/2017/2017_06_09_04_56/2017_06_09_21_54.mpg;Shinzo ABE.jpg;15053;15165;91169;753;759;6
/net/per610a/home/mvp/mvp_db/hodost-lv/2017/2017_06_09_04_56/2017_06_09_21_54.mpg;YUriko Koike.jpg;51401;51609;91169;2572;2583;11
/net/per610a/home/mvp/mvp_db/hodost-lv/2017/2017_06_09_04_56/2017_06_09_21_54.mpg;YUriko Koike.jpg;52153;52265;91169;2610;2615;5
/net/per610a/home/mvp/mvp_db/hodost-lv/2017/2017_06_11_04_56/2017_06_11_20_54.mpg;YUriko Koike.jpg;11901;12005;71989;595;600;5
/net/per610a/home/mvp/mvp_db/hodost-lv/2017/2017_06_11_04_56/2017_06_11_20_54.mpg;YUriko Koike.jpg;12245;12281;71989;612;614;2
/net/per610a/home/mvp/mvp_db/hodost-lv/2017/2017_06_11_04_56/2017_06_11_20_54.mpg;YUriko Koike.jpg;13241;13269;71989;662;664;2
/net/per610a/home/mvp/mvp_db/hodost-lv/2017/2017_06_11_04_56/2017_06_11_20_54.mpg;YUriko Koike.jpg;12041;12121;71989;602;606;4
/net/per610a/home/mvp/mvp_db/hodost-lv/2017/2017_06_11_04_56/2017_06_11_20_54.mpg;YUriko Koike.jpg;13689;13889;71989;685;695;10
/net/per610a/home/mvp/mvp_db/hodost-lv/2017/2017_06_11_04_56/2017_06_11_20_54.mpg;YUriko Koike.jpg;15201;15321;71989;760;766;6
/net/per610a/home/mvp/mvp_db/hodost-lv/2017/2017_06_14_04_56/2017_06_14_21_54.mpg;Shinzo ABE.jpg;18597;18657;91169;930;933;3
/net/per610a/home/mvp/mvp_db/hodost-lv/2017/2017_06_14_04_56/2017_06_14_21_54.mpg;Shinzo ABE.jpg;24321;24421;91169;1217;1222;5
/net/per610a/home/mvp/mvp_db/hodost-lv/2017/2017_06_14_04_56/2017_06_14_21_54.mpg;Shinzo ABE.jpg;31313;31521;91169;1567;1577;10
/net/per610a/home/mvp/mvp_db/hodost-lv/2017/2017_06_14_04_56/2017_06_14_21_54.mpg;Shinzo ABE.jpg;40469;40609;91169;2025;2032;7
/net/per610a/home/mvp/mvp_db/hodost-lv/2017/2017_06_14_04_56/2017_06_14_21_54.mpg;Shinzo ABE.jpg;40877;40925;91169;2045;2048;3
/net/per610a/home/mvp/mvp_db/hodost-lv/2017/2017_06_15_04_56/2017_06_15_22_09.mpg;Natsuo YAMAGUCHI.jpg;4881;5217;91169;244;261;17
/net/per610a/home/mvp/mvp_db/hodost-lv/2017/2017_06_15_04_56/2017_06_15_22_09.mpg;Toranosuke Katayama.jpg;5333;6645;91169;266;332;66
/net/per610a/home/mvp/mvp_db/hodost-lv/2017/2017_06_15_04_56/2017_06_15_22_09.mpg;YUriko Koike.jpg;39777;39981;91169;1990;2001;11
/net/per610a/home/mvp/mvp_db/hodost-lv/2017/2017_06_15_04_56/2017_06_15_22_09.mpg;YUriko Koike.jpg;40829;41149;91169;2043;2059;16
/net/per610a/home/mvp/mvp_db/hodost-lv/2017/2017_06_15_04_56/2017_06_15_22_09.mpg;YUriko Koike.jpg;41301;41473;91169;2067;2075;8
/net/per610a/home/mvp/mvp_db/hodost-lv/2017/2017_06_15_04_56/2017_06_15_22_09.mpg;YUriko Koike.jpg;41573;41713;91169;2080;2087;7
/net/per610a/home/mvp/mvp_db/hodost-lv/2017/2017_06_15_04_56/2017_06_15_22_09.mpg;YUriko Koike.jpg;41809;41973;91169;2092;2100;8
/net/per610a/home/mvp/mvp_db/hodost-lv/2017/2017_06_16_04_56/2017_06_16_21_54.mpg;Shinzo ABE.jpg;513;645;91161;25;32;7
/net/per610a/home/mvp/mvp_db/hodost-lv/2017/2017_06_16_04_56/2017_06_16_21_54.mpg;Shinzo ABE.jpg;873;961;91161;43;48;5
/net/per610a/home/mvp/mvp_db/hodost-lv/2017/2017_06_16_04_56/2017_06_16_21_54.mpg;Shinzo ABE.jpg;1577;2497;91161;78;124;46
/net/per610a/home/mvp/mvp_db/hodost-lv/2017/2017_06_16_04_56/2017_06_16_21_54.mpg;Shinzo ABE.jpg;16773;16925;91161;839;846;7
/net/per610a/home/mvp/mvp_db/hodost-lv/2017/2017_06_16_04_56/2017_06_16_21_54.mpg;Shinzo ABE.jpg;26529;26617;91161;1327;1332;5
/net/per610a/home/mvp/mvp_db/hodost-lv/2017/2017_06_16_04_56/2017_06_16_21_54.mpg;Shinzo ABE.jpg;28977;29337;91161;1450;1468;18
/net/per610a/home/mvp/mvp_db/hodost-lv/2017/2017_06_16_04_56/2017_06_16_21_54.mpg;Shinzo ABE.jpg;30945;31005;91161;1548;1551;3
/net/per610a/home/mvp/mvp_db/hodost-lv/2017/2017_06_16_04_56/2017_06_16_21_54.mpg;Shinzo ABE.jpg;33469;33697;91161;1674;1686;12
/net/per610a/home/mvp/mvp_db/hodost-lv/2017/2017_06_16_04_56/2017_06_16_21_54.mpg;YUriko Koike.jpg;41841;41841;91161;2093;2093;0
/net/per610a/home/mvp/mvp_db/hodost-lv/2017/2017_06_16_04_56/2017_06_16_21_54.mpg;YUriko Koike.jpg;41909;42401;91161;2097;2121;24
/net/per610a/home/mvp/mvp_db/hodost-lv/2017/2017_06_17_04_56/2017_06_17_20_54.mpg;Shinzo ABE.jpg;27665;27757;107949;1384;1389;5
/net/per610a/home/mvp/mvp_db/hodost-lv/2017/2017_06_19_04_56/2017_06_19_21_54.mpg;Shinzo ABE.jpg;2873;3169;91169;143;158;15
/net/per610a/home/mvp/mvp_db/hodost-lv/2017/2017_06_19_04_56/2017_06_19_21_54.mpg;Shinzo ABE.jpg;8517;10281;91169;426;514;88
/net/per610a/home/mvp/mvp_db/hodost-lv/2017/2017_06_19_04_56/2017_06_19_21_54.mpg;Shinzo ABE.jpg;10445;11801;91169;522;590;68
/net/per610a/home/mvp/mvp_db/hodost-lv/2017/2017_06_19_04_56/2017_06_19_21_54.mpg;Shinzo ABE.jpg;12185;12317;91169;609;616;7
/net/per610a/home/mvp/mvp_db/hodost-lv/2017/2017_06_19_04_56/2017_06_19_21_54.mpg;Shinzo ABE.jpg;12937;13737;91169;647;687;40
/net/per610a/home/mvp/mvp_db/hodost-lv/2017/2017_06_19_04_56/2017_06_19_21_54.mpg;Shinzo ABE.jpg;15045;15693;91169;753;785;32
/net/per610a/home/mvp/mvp_db/hodost-lv/2017/2017_06_19_04_56/2017_06_19_21_54.mpg;Shinzo ABE.jpg;17605;18177;91169;881;909;28
/net/per610a/home/mvp/mvp_db/hodost-lv/2017/2017_06_19_04_56/2017_06_19_21_54.mpg;Shinzo ABE.jpg;20681;20933;91169;1035;1047;12
/net/per610a/home/mvp/mvp_db/hodost-lv/2017/2017_06_19_04_56/2017_06_19_21_54.mpg;Ichiro OZAWA.jpg;6265;6609;91169;313;330;17
/net/per610a/home/mvp/mvp_db/hodost-lv/2017/2017_06_19_04_56/2017_06_19_21_54.mpg;Ichiro OZAWA.jpg;6721;6745;91169;336;337;1
/net/per610a/home/mvp/mvp_db/hodost-lv/2017/2017_06_19_04_56/2017_06_19_21_54.mpg;Yoshihiko Noda.jpg;6929;7689;91169;346;384;38
/net/per610a/home/mvp/mvp_db/hodost-lv/2017/2017_06_19_04_56/2017_06_19_21_54.mpg;Taro ASO.jpg;16081;16605;91169;804;831;27
/net/per610a/home/mvp/mvp_db/hodost-lv/2017/2017_06_19_04_56/2017_06_19_21_54.mpg;YUriko Koike.jpg;34065;34157;91169;1704;1709;5
/net/per610a/home/mvp/mvp_db/hodost-lv/2017/2017_06_19_04_56/2017_06_19_21_54.mpg;YUriko Koike.jpg;35137;35497;91169;1758;1776;18
/net/per610a/home/mvp/mvp_db/hodost-lv/2017/2017_06_19_04_56/2017_06_19_21_54.mpg;YUriko Koike.jpg;37261;37433;91169;1864;1873;9
/net/per610a/home/mvp/mvp_db/hodost-lv/2017/2017_06_19_04_56/2017_06_19_21_54.mpg;YUriko Koike.jpg;39117;39121;91169;1957;1958;1
/net/per610a/home/mvp/mvp_db/hodost-lv/2017/2017_06_19_04_56/2017_06_19_21_54.mpg;YUriko Koike.jpg;39805;39929;91169;1992;1998;6
/net/per610a/home/mvp/mvp_db/hodost-lv/2017/2017_06_19_04_56/2017_06_19_21_54.mpg;Toru Hashimoto.jpg;89865;89961;91169;4497;4502;5
/net/per610a/home/mvp/mvp_db/hodost-lv/2017/2017_06_20_04_56/2017_06_20_21_54.mpg;YUriko Koike.jpg;4253;4297;91161;212;215;3
/net/per610a/home/mvp/mvp_db/hodost-lv/2017/2017_06_20_04_56/2017_06_20_21_54.mpg;YUriko Koike.jpg;6625;7141;91161;331;357;26
/net/per610a/home/mvp/mvp_db/hodost-lv/2017/2017_06_20_04_56/2017_06_20_21_54.mpg;YUriko Koike.jpg;10265;10545;91161;513;527;14
/net/per610a/home/mvp/mvp_db/hodost-lv/2017/2017_06_20_04_56/2017_06_20_21_54.mpg;YUriko Koike.jpg;13553;13641;91161;678;682;4
/net/per610a/home/mvp/mvp_db/hodost-lv/2017/2017_06_20_04_56/2017_06_20_21_54.mpg;YUriko Koike.jpg;13877;15033;91161;694;752;58
/net/per610a/home/mvp/mvp_db/hodost-lv/2017/2017_06_20_04_56/2017_06_20_21_54.mpg;YUriko Koike.jpg;16745;16781;91161;837;839;2
/net/per610a/home/mvp/mvp_db/hodost-lv/2017/2017_06_20_04_56/2017_06_20_21_54.mpg;YUriko Koike.jpg;17129;17233;91161;857;862;5
/net/per610a/home/mvp/mvp_db/hodost-lv/2017/2017_06_20_04_56/2017_06_20_21_54.mpg;YUriko Koike.jpg;17321;17405;91161;866;871;5
/net/per610a/home/mvp/mvp_db/hodost-lv/2017/2017_06_20_04_56/2017_06_20_21_54.mpg;YUriko Koike.jpg;17661;17669;91161;883;884;1
/net/per610a/home/mvp/mvp_db/hodost-lv/2017/2017_06_20_04_56/2017_06_20_21_54.mpg;Natsuo YAMAGUCHI.jpg;10877;11305;91161;544;565;21
/net/per610a/home/mvp/mvp_db/hodost-lv/2017/2017_06_20_04_56/2017_06_20_21_54.mpg;Shinzo ABE.jpg;32965;33493;91161;1649;1676;27
/net/per610a/home/mvp/mvp_db/hodost-lv/2017/2017_06_20_04_56/2017_06_20_21_54.mpg;Shinzo ABE.jpg;35097;35361;91161;1756;1769;13
/net/per610a/home/mvp/mvp_db/hodost-lv/2017/2017_06_21_04_56/2017_06_21_21_54.mpg;Shinzo ABE.jpg;19685;20005;91169;985;1001;16
/net/per610a/home/mvp/mvp_db/hodost-lv/2017/2017_06_21_04_56/2017_06_21_21_54.mpg;Shinzo ABE.jpg;20661;21277;91169;1034;1064;30
/net/per610a/home/mvp/mvp_db/hodost-lv/2017/2017_06_21_04_56/2017_06_21_21_54.mpg;Shinzo ABE.jpg;22097;22461;91169;1105;1124;19
/net/per610a/home/mvp/mvp_db/hodost-lv/2017/2017_06_21_04_56/2017_06_21_21_54.mpg;Shinzo ABE.jpg;25385;25485;91169;1270;1275;5
/net/per610a/home/mvp/mvp_db/hodost-lv/2017/2017_06_21_04_56/2017_06_21_21_54.mpg;Shinzo ABE.jpg;28501;28965;91169;1426;1449;23
/net/per610a/home/mvp/mvp_db/hodost-lv/2017/2017_06_22_04_56/2017_06_22_21_54.mpg;Yoshihiko Noda.jpg;1153;1233;91169;57;61;4
/net/per610a/home/mvp/mvp_db/hodost-lv/2017/2017_06_22_04_56/2017_06_22_21_54.mpg;Yoshihiko Noda.jpg;1317;1345;91169;65;67;2
/net/per610a/home/mvp/mvp_db/hodost-lv/2017/2017_06_22_04_56/2017_06_22_21_54.mpg;Yoshihiko Noda.jpg;7109;7325;91169;355;366;11
/net/per610a/home/mvp/mvp_db/hodost-lv/2017/2017_06_22_04_56/2017_06_22_21_54.mpg;Shinzo ABE.jpg;1657;1681;91169;82;84;2
/net/per610a/home/mvp/mvp_db/hodost-lv/2017/2017_06_22_04_56/2017_06_22_21_54.mpg;Shinzo ABE.jpg;8537;8589;91169;427;429;2
/net/per610a/home/mvp/mvp_db/hodost-lv/2017/2017_06_22_04_56/2017_06_22_21_54.mpg;Natsuo YAMAGUCHI.jpg;7805;8301;91169;390;415;25
/net/per610a/home/mvp/mvp_db/hodost-lv/2017/2017_06_22_04_56/2017_06_22_21_54.mpg;Shinzo ABE.jpg;17289;17433;91169;865;872;7
/net/per610a/home/mvp/mvp_db/hodost-lv/2017/2017_06_22_04_56/2017_06_22_21_54.mpg;YUriko Koike.jpg;27937;27997;91169;1398;1401;3
/net/per610a/home/mvp/mvp_db/hodost-lv/2017/2017_06_22_04_56/2017_06_22_21_54.mpg;YUriko Koike.jpg;28845;28885;91169;1443;1445;2
/net/per610a/home/mvp/mvp_db/hodost-lv/2017/2017_06_22_04_56/2017_06_22_21_54.mpg;YUriko Koike.jpg;29329;29653;91169;1467;1484;17
/net/per610a/home/mvp/mvp_db/hodost-lv/2017/2017_06_22_04_56/2017_06_22_21_54.mpg;YUriko Koike.jpg;32537;33133;91169;1628;1658;30
/net/per610a/home/mvp/mvp_db/hodost-lv/2017/2017_06_23_04_56/2017_06_23_21_54.mpg;Yukio HATOYAMA.jpg;26973;27105;91161;1349;1356;7
/net/per610a/home/mvp/mvp_db/hodost-lv/2017/2017_06_25_04_56/2017_06_25_20_54.mpg;Shinzo ABE.jpg;2317;2365;71989;115;118;3
/net/per610a/home/mvp/mvp_db/hodost-lv/2017/2017_06_25_04_56/2017_06_25_20_54.mpg;Shinzo ABE.jpg;64589;64765;71989;3232;3241;9
/net/per610a/home/mvp/mvp_db/hodost-lv/2017/2017_06_25_04_56/2017_06_25_20_54.mpg;Shinzo ABE.jpg;66161;66269;71989;3311;3316;5
/net/per610a/home/mvp/mvp_db/hodost-lv/2017/2017_06_26_04_56/2017_06_26_21_54.mpg;Yoshihiko Noda.jpg;33581;34189;91169;1680;1711;31
/net/per610a/home/mvp/mvp_db/hodost-lv/2017/2017_06_26_04_56/2017_06_26_21_54.mpg;Toru Hashimoto.jpg;89869;89969;91169;4497;4502;5
/net/per610a/home/mvp/mvp_db/hodost-lv/2017/2017_06_27_04_56/2017_06_27_21_54.mpg;Kazuo SHII.jpg;21253;21817;91161;1063;1091;28
/net/per610a/home/mvp/mvp_db/hodost-lv/2017/2017_06_28_04_56/2017_06_28_21_54.mpg;Taro ASO.jpg;12741;12873;91169;637;644;7
/net/per610a/home/mvp/mvp_db/hodost-lv/2017/2017_06_28_04_56/2017_06_28_21_54.mpg;Shinzo ABE.jpg;12753;12969;91169;638;649;11
/net/per610a/home/mvp/mvp_db/hodost-lv/2017/2017_06_28_04_56/2017_06_28_21_54.mpg;Shinzo ABE.jpg;12977;13341;91169;649;667;18
/net/per610a/home/mvp/mvp_db/hodost-lv/2017/2017_06_28_04_56/2017_06_28_21_54.mpg;Shinzo ABE.jpg;17681;17841;91169;884;892;8
/net/per610a/home/mvp/mvp_db/hodost-lv/2017/2017_06_28_04_56/2017_06_28_21_54.mpg;Shinzo ABE.jpg;20345;20449;91169;1018;1023;5
/net/per610a/home/mvp/mvp_db/hodost-lv/2017/2017_06_29_04_56/2017_06_29_21_54.mpg;Shinzo ABE.jpg;12141;12245;91169;607;612;5
/net/per610a/home/mvp/mvp_db/hodost-lv/2017/2017_06_29_04_56/2017_06_29_21_54.mpg;Shinzo ABE.jpg;37773;37817;91169;1890;1892;2
/net/per610a/home/mvp/mvp_db/hodost-lv/2017/2017_06_30_04_56/2017_06_30_21_54.mpg;Shinzo ABE.jpg;25281;25369;91169;1265;1269;4
/net/per610a/home/mvp/mvp_db/hodost-lv/2017/2017_07_02_04_56/2017_07_02_20_54.mpg;YUriko Koike.jpg;18461;18609;71989;923;931;8
/net/per610a/home/mvp/mvp_db/hodost-lv/2017/2017_07_02_04_56/2017_07_02_20_54.mpg;YUriko Koike.jpg;23289;23441;71989;1165;1173;8
/net/per610a/home/mvp/mvp_db/hodost-lv/2017/2017_07_02_04_56/2017_07_02_20_54.mpg;YUriko Koike.jpg;48013;55445;71989;2403;2774;371
/net/per610a/home/mvp/mvp_db/hodost-lv/2017/2017_07_03_04_56/2017_07_03_21_54.mpg;YUriko Koike.jpg;3321;3781;91169;166;189;23
/net/per610a/home/mvp/mvp_db/hodost-lv/2017/2017_07_03_04_56/2017_07_03_21_54.mpg;YUriko Koike.jpg;7757;7989;91169;388;399;11
/net/per610a/home/mvp/mvp_db/hodost-lv/2017/2017_07_03_04_56/2017_07_03_21_54.mpg;YUriko Koike.jpg;9353;9453;91169;468;473;5
/net/per610a/home/mvp/mvp_db/hodost-lv/2017/2017_07_03_04_56/2017_07_03_21_54.mpg;YUriko Koike.jpg;9573;9877;91169;479;494;15
/net/per610a/home/mvp/mvp_db/hodost-lv/2017/2017_07_03_04_56/2017_07_03_21_54.mpg;YUriko Koike.jpg;25921;26325;91169;1297;1317;20
/net/per610a/home/mvp/mvp_db/hodost-lv/2017/2017_07_03_04_56/2017_07_03_21_54.mpg;YUriko Koike.jpg;26425;26561;91169;1322;1329;7
/net/per610a/home/mvp/mvp_db/hodost-lv/2017/2017_07_03_04_56/2017_07_03_21_54.mpg;YUriko Koike.jpg;27805;27881;91169;1391;1395;4
/net/per610a/home/mvp/mvp_db/hodost-lv/2017/2017_07_03_04_56/2017_07_03_21_54.mpg;Shinzo ABE.jpg;6749;6921;91169;337;346;9
/net/per610a/home/mvp/mvp_db/hodost-lv/2017/2017_07_03_04_56/2017_07_03_21_54.mpg;Shinzo ABE.jpg;29257;29317;91169;1464;1467;3
/net/per610a/home/mvp/mvp_db/hodost-lv/2017/2017_07_03_04_56/2017_07_03_21_54.mpg;Shinzo ABE.jpg;31821;31857;91169;1592;1594;2
/net/per610a/home/mvp/mvp_db/hodost-lv/2017/2017_07_03_04_56/2017_07_03_21_54.mpg;Kazuo SHII.jpg;8457;8697;91169;423;435;12
/net/per610a/home/mvp/mvp_db/hodost-lv/2017/2017_07_03_04_56/2017_07_03_21_54.mpg;Shinzo ABE.jpg;15869;16061;91169;794;803;9
/net/per610a/home/mvp/mvp_db/hodost-lv/2017/2017_07_03_04_56/2017_07_03_21_54.mpg;Shinzo ABE.jpg;16553;16633;91169;828;832;4
/net/per610a/home/mvp/mvp_db/hodost-lv/2017/2017_07_03_04_56/2017_07_03_21_54.mpg;Shinzo ABE.jpg;17497;18321;91169;875;916;41
/net/per610a/home/mvp/mvp_db/hodost-lv/2017/2017_07_03_04_56/2017_07_03_21_54.mpg;Shinzo ABE.jpg;21105;21181;91169;1056;1060;4
/net/per610a/home/mvp/mvp_db/hodost-lv/2017/2017_07_03_04_56/2017_07_03_21_54.mpg;Shinzo ABE.jpg;21297;21333;91169;1065;1067;2
/net/per610a/home/mvp/mvp_db/hodost-lv/2017/2017_07_03_04_56/2017_07_03_21_54.mpg;Taro ASO.jpg;23449;23521;91169;1173;1177;4
/net/per610a/home/mvp/mvp_db/hodost-lv/2017/2017_07_03_04_56/2017_07_03_21_54.mpg;Taro ASO.jpg;23849;23985;91169;1193;1200;7
/net/per610a/home/mvp/mvp_db/hodost-lv/2017/2017_07_03_04_56/2017_07_03_21_54.mpg;YUriko Koike.jpg;28021;28205;91169;1402;1411;9
/net/per610a/home/mvp/mvp_db/hodost-lv/2017/2017_07_03_04_56/2017_07_03_21_54.mpg;YUriko Koike.jpg;28349;28709;91169;1418;1436;18
/net/per610a/home/mvp/mvp_db/hodost-lv/2017/2017_07_03_04_56/2017_07_03_21_54.mpg;YUriko Koike.jpg;28781;28925;91169;1440;1447;7
/net/per610a/home/mvp/mvp_db/hodost-lv/2017/2017_07_04_04_56/2017_07_04_21_54.mpg;Shinzo ABE.jpg;18525;18993;91169;927;950;23
/net/per610a/home/mvp/mvp_db/hodost-lv/2017/2017_07_04_04_56/2017_07_04_21_54.mpg;Shinzo ABE.jpg;30877;31269;91169;1545;1565;20
/net/per610a/home/mvp/mvp_db/hodost-lv/2017/2017_07_04_04_56/2017_07_04_21_54.mpg;Shinzo ABE.jpg;37329;37605;91169;1868;1882;14
/net/per610a/home/mvp/mvp_db/hodost-lv/2017/2017_07_04_04_56/2017_07_04_21_54.mpg;Shinzo ABE.jpg;51293;51301;91169;2567;2567;0
/net/per610a/home/mvp/mvp_db/hodost-lv/2017/2017_07_04_04_56/2017_07_04_21_54.mpg;Shinzo ABE.jpg;35761;36237;91169;1789;1813;24
/net/per610a/home/mvp/mvp_db/hodost-lv/2017/2017_07_04_04_56/2017_07_04_21_54.mpg;Shinzo ABE.jpg;36349;36501;91169;1819;1826;7
/net/per610a/home/mvp/mvp_db/hodost-lv/2017/2017_07_04_04_56/2017_07_04_21_54.mpg;Shinzo ABE.jpg;37093;37313;91169;1856;1867;11
/net/per610a/home/mvp/mvp_db/hodost-lv/2017/2017_07_04_04_56/2017_07_04_21_54.mpg;Shinzo ABE.jpg;37645;37721;91169;1884;1887;3
/net/per610a/home/mvp/mvp_db/hodost-lv/2017/2017_07_04_04_56/2017_07_04_21_54.mpg;Shinzo ABE.jpg;43897;44053;91169;2197;2204;7
/net/per610a/home/mvp/mvp_db/hodost-lv/2017/2017_07_04_04_56/2017_07_04_21_54.mpg;Taro ASO.jpg;50701;50989;91169;2537;2551;14
/net/per610a/home/mvp/mvp_db/hodost-lv/2017/2017_07_04_04_56/2017_07_04_21_54.mpg;Taro ASO.jpg;51421;51465;91169;2573;2575;2
/net/per610a/home/mvp/mvp_db/hodost-lv/2017/2017_07_05_04_56/2017_07_05_21_54.mpg;YUriko Koike.jpg;53117;53945;91169;2658;2699;41
/net/per610a/home/mvp/mvp_db/hodost-lv/2017/2017_07_06_04_56/2017_07_06_21_54.mpg;Natsuo YAMAGUCHI.jpg;44349;44849;91169;2219;2244;25
/net/per610a/home/mvp/mvp_db/hodost-lv/2017/2017_07_06_04_56/2017_07_06_21_54.mpg;Shinzo ABE.jpg;52341;52665;91169;2619;2635;16
/net/per610a/home/mvp/mvp_db/hodost-lv/2017/2017_07_08_04_56/2017_07_08_20_54.mpg;Shinzo ABE.jpg;51445;51717;71989;2574;2588;14
/net/per610a/home/mvp/mvp_db/hodost-lv/2017/2017_07_09_04_56/2017_07_09_20_54.mpg;Shinzo ABE.jpg;24697;24889;71989;1236;1245;9
/net/per610a/home/mvp/mvp_db/hodost-lv/2017/2017_07_09_04_56/2017_07_09_20_54.mpg;Shinzo ABE.jpg;25669;25701;71989;1284;1286;2
/net/per610a/home/mvp/mvp_db/hodost-lv/2017/2017_07_09_04_56/2017_07_09_20_54.mpg;Shinzo ABE.jpg;27501;28721;71989;1376;1437;61
/net/per610a/home/mvp/mvp_db/hodost-lv/2017/2017_07_09_04_56/2017_07_09_20_54.mpg;Shinzo ABE.jpg;30801;31373;71989;1541;1570;29
/net/per610a/home/mvp/mvp_db/hodost-lv/2017/2017_07_09_04_56/2017_07_09_20_54.mpg;Shinzo ABE.jpg;24973;25137;71989;1249;1258;9
/net/per610a/home/mvp/mvp_db/hodost-lv/2017/2017_07_09_04_56/2017_07_09_20_54.mpg;Shinzo ABE.jpg;30421;30565;71989;1522;1529;7
/net/per610a/home/mvp/mvp_db/hodost-lv/2017/2017_07_10_04_56/2017_07_10_21_54.mpg;Shinzo ABE.jpg;28525;28973;91169;1427;1450;23
/net/per610a/home/mvp/mvp_db/hodost-lv/2017/2017_07_10_04_56/2017_07_10_21_54.mpg;Shinzo ABE.jpg;30141;30205;91169;1508;1511;3
/net/per610a/home/mvp/mvp_db/hodost-lv/2017/2017_07_10_04_56/2017_07_10_21_54.mpg;Shinzo ABE.jpg;30529;30665;91169;1527;1534;7
/net/per610a/home/mvp/mvp_db/hodost-lv/2017/2017_07_10_04_56/2017_07_10_21_54.mpg;Toru Hashimoto.jpg;89873;89969;91169;4498;4502;4
/net/per610a/home/mvp/mvp_db/hodost-lv/2017/2017_07_11_04_56/2017_07_11_21_54.mpg;Renho.jpg;53601;53745;91169;2682;2689;7
/net/per610a/home/mvp/mvp_db/hodost-lv/2017/2017_07_13_04_56/2017_07_13_21_54.mpg;Shinzo ABE.jpg;20569;20645;91169;1029;1033;4
/net/per610a/home/mvp/mvp_db/hodost-lv/2017/2017_07_13_04_56/2017_07_13_21_54.mpg;Shinzo ABE.jpg;22765;23069;91169;1139;1154;15
/net/per610a/home/mvp/mvp_db/hodost-lv/2017/2017_07_13_04_56/2017_07_13_21_54.mpg;Shinzo ABE.jpg;23161;23449;91169;1159;1173;14
/net/per610a/home/mvp/mvp_db/hodost-lv/2017/2017_07_16_04_56/2017_07_16_20_54.mpg;Shinzo ABE.jpg;66177;66265;71989;3312;3316;4
/net/per610a/home/mvp/mvp_db/hodost-lv/2017/2017_07_17_04_56/2017_07_17_21_54.mpg;Shinzo ABE.jpg;13041;13677;91169;652;684;32
/net/per610a/home/mvp/mvp_db/hodost-lv/2017/2017_07_17_04_56/2017_07_17_21_54.mpg;Shinzo ABE.jpg;16065;16301;91169;804;815;11
/net/per610a/home/mvp/mvp_db/hodost-lv/2017/2017_07_17_04_56/2017_07_17_21_54.mpg;Shinzo ABE.jpg;16605;16793;91169;831;840;9
/net/per610a/home/mvp/mvp_db/hodost-lv/2017/2017_07_17_04_56/2017_07_17_21_54.mpg;Shinzo ABE.jpg;16885;17325;91169;845;867;22
/net/per610a/home/mvp/mvp_db/hodost-lv/2017/2017_07_17_04_56/2017_07_17_21_54.mpg;Shinzo ABE.jpg;18689;18873;91169;935;944;9
/net/per610a/home/mvp/mvp_db/hodost-lv/2017/2017_07_17_04_56/2017_07_17_21_54.mpg;Shinzo ABE.jpg;19265;19545;91169;964;978;14
/net/per610a/home/mvp/mvp_db/hodost-lv/2017/2017_07_17_04_56/2017_07_17_21_54.mpg;Shinzo ABE.jpg;20109;20165;91169;1006;1009;3
/net/per610a/home/mvp/mvp_db/hodost-lv/2017/2017_07_17_04_56/2017_07_17_21_54.mpg;Shinzo ABE.jpg;21269;21701;91169;1064;1086;22
/net/per610a/home/mvp/mvp_db/hodost-lv/2017/2017_07_17_04_56/2017_07_17_21_54.mpg;Shinzo ABE.jpg;18537;18657;91169;927;933;6
/net/per610a/home/mvp/mvp_db/hodost-lv/2017/2017_07_17_04_56/2017_07_17_21_54.mpg;Shinzo ABE.jpg;20517;20661;91169;1026;1034;8
/net/per610a/home/mvp/mvp_db/hodost-lv/2017/2017_07_17_04_56/2017_07_17_21_54.mpg;Renho.jpg;25325;25473;91169;1267;1274;7
/net/per610a/home/mvp/mvp_db/hodost-lv/2017/2017_07_17_04_56/2017_07_17_21_54.mpg;Renho.jpg;30849;30885;91169;1543;1545;2
/net/per610a/home/mvp/mvp_db/hodost-lv/2017/2017_07_17_04_56/2017_07_17_21_54.mpg;Renho.jpg;25477;25653;91169;1275;1283;8
/net/per610a/home/mvp/mvp_db/hodost-lv/2017/2017_07_17_04_56/2017_07_17_21_54.mpg;Renho.jpg;31013;31197;91169;1552;1561;9
/net/per610a/home/mvp/mvp_db/hodost-lv/2017/2017_07_17_04_56/2017_07_17_21_54.mpg;Renho.jpg;32153;32725;91169;1609;1637;28
/net/per610a/home/mvp/mvp_db/hodost-lv/2017/2017_07_17_04_56/2017_07_17_21_54.mpg;Renho.jpg;29613;29725;91169;1482;1487;5
/net/per610a/home/mvp/mvp_db/hodost-lv/2017/2017_07_17_04_56/2017_07_17_21_54.mpg;Toru Hashimoto.jpg;89877;89973;91169;4498;4503;5
/net/per610a/home/mvp/mvp_db/hodost-lv/2017/2017_07_18_04_56/2017_07_18_21_54.mpg;Shinzo ABE.jpg;22097;22097;91169;1105;1105;0
/net/per610a/home/mvp/mvp_db/hodost-lv/2017/2017_07_18_04_56/2017_07_18_21_54.mpg;Shinzo ABE.jpg;22457;23077;91169;1123;1155;32
/net/per610a/home/mvp/mvp_db/hodost-lv/2017/2017_07_18_04_56/2017_07_18_21_54.mpg;Shinzo ABE.jpg;27325;27381;91169;1367;1370;3
/net/per610a/home/mvp/mvp_db/hodost-lv/2017/2017_07_18_04_56/2017_07_18_21_54.mpg;Shinzo ABE.jpg;30169;30177;91169;1509;1510;1
/net/per610a/home/mvp/mvp_db/hodost-lv/2017/2017_07_18_04_56/2017_07_18_21_54.mpg;Shinzo ABE.jpg;23225;23445;91169;1162;1173;11
/net/per610a/home/mvp/mvp_db/hodost-lv/2017/2017_07_18_04_56/2017_07_18_21_54.mpg;Shinzo ABE.jpg;23549;23557;91169;1178;1179;1
/net/per610a/home/mvp/mvp_db/hodost-lv/2017/2017_07_18_04_56/2017_07_18_21_54.mpg;Shinzo ABE.jpg;26929;27225;91169;1347;1362;15
/net/per610a/home/mvp/mvp_db/hodost-lv/2017/2017_07_18_04_56/2017_07_18_21_54.mpg;Renho.jpg;28233;28689;91169;1413;1435;22
/net/per610a/home/mvp/mvp_db/hodost-lv/2017/2017_07_18_04_56/2017_07_18_21_54.mpg;Renho.jpg;30397;30749;91169;1521;1538;17
/net/per610a/home/mvp/mvp_db/hodost-lv/2017/2017_07_18_04_56/2017_07_18_21_54.mpg;Renho.jpg;31805;32133;91169;1591;1608;17
/net/per610a/home/mvp/mvp_db/hodost-lv/2017/2017_07_18_04_56/2017_07_18_21_54.mpg;Renho.jpg;32709;33253;91169;1637;1664;27
/net/per610a/home/mvp/mvp_db/hodost-lv/2017/2017_07_19_04_56/2017_07_19_22_09.mpg;Shinzo ABE.jpg;1445;1545;91161;72;77;5
/net/per610a/home/mvp/mvp_db/hodost-lv/2017/2017_07_19_04_56/2017_07_19_22_09.mpg;Shinzo ABE.jpg;7597;7689;91161;380;384;4
/net/per610a/home/mvp/mvp_db/hodost-lv/2017/2017_07_19_04_56/2017_07_19_22_09.mpg;Shinzo ABE.jpg;7833;7945;91161;391;397;6
/net/per610a/home/mvp/mvp_db/hodost-lv/2017/2017_07_19_04_56/2017_07_19_22_09.mpg;Shinzo ABE.jpg;15509;15601;91161;776;780;4
/net/per610a/home/mvp/mvp_db/hodost-lv/2017/2017_07_19_04_56/2017_07_19_22_09.mpg;Shinzo ABE.jpg;17705;17865;91161;886;894;8
/net/per610a/home/mvp/mvp_db/hodost-lv/2017/2017_07_20_04_56/2017_07_20_22_09.mpg;Shinzo ABE.jpg;23213;23281;91169;1161;1165;4
/net/per610a/home/mvp/mvp_db/hodost-lv/2017/2017_07_20_04_56/2017_07_20_22_09.mpg;Shinzo ABE.jpg;33993;34053;91169;1701;1704;3
/net/per610a/home/mvp/mvp_db/hodost-lv/2017/2017_07_21_04_56/2017_07_21_21_54.mpg;YUriko Koike.jpg;33917;34337;91161;1697;1718;21
/net/per610a/home/mvp/mvp_db/hodost-lv/2017/2017_07_24_04_56/2017_07_24_21_54.mpg;Shinzo ABE.jpg;725;1093;91169;36;54;18
/net/per610a/home/mvp/mvp_db/hodost-lv/2017/2017_07_24_04_56/2017_07_24_21_54.mpg;Shinzo ABE.jpg;11277;11357;91169;564;568;4
/net/per610a/home/mvp/mvp_db/hodost-lv/2017/2017_07_24_04_56/2017_07_24_21_54.mpg;Shinzo ABE.jpg;11857;12093;91169;593;605;12
/net/per610a/home/mvp/mvp_db/hodost-lv/2017/2017_07_24_04_56/2017_07_24_21_54.mpg;Shinzo ABE.jpg;12293;12553;91169;615;628;13
/net/per610a/home/mvp/mvp_db/hodost-lv/2017/2017_07_24_04_56/2017_07_24_21_54.mpg;Shinzo ABE.jpg;13045;13189;91169;652;660;8
/net/per610a/home/mvp/mvp_db/hodost-lv/2017/2017_07_24_04_56/2017_07_24_21_54.mpg;Shinzo ABE.jpg;13845;13893;91169;692;695;3
/net/per610a/home/mvp/mvp_db/hodost-lv/2017/2017_07_24_04_56/2017_07_24_21_54.mpg;Shinzo ABE.jpg;14085;14229;91169;704;712;8
/net/per610a/home/mvp/mvp_db/hodost-lv/2017/2017_07_24_04_56/2017_07_24_21_54.mpg;Shinzo ABE.jpg;14793;14897;91169;740;745;5
/net/per610a/home/mvp/mvp_db/hodost-lv/2017/2017_07_24_04_56/2017_07_24_21_54.mpg;Shinzo ABE.jpg;15089;15269;91169;755;764;9
/net/per610a/home/mvp/mvp_db/hodost-lv/2017/2017_07_24_04_56/2017_07_24_21_54.mpg;Shinzo ABE.jpg;19477;19765;91169;974;989;15
/net/per610a/home/mvp/mvp_db/hodost-lv/2017/2017_07_24_04_56/2017_07_24_21_54.mpg;Shinzo ABE.jpg;20077;20157;91169;1004;1008;4
/net/per610a/home/mvp/mvp_db/hodost-lv/2017/2017_07_24_04_56/2017_07_24_21_54.mpg;Shinzo ABE.jpg;20369;20633;91169;1019;1032;13
/net/per610a/home/mvp/mvp_db/hodost-lv/2017/2017_07_24_04_56/2017_07_24_21_54.mpg;Shinzo ABE.jpg;23145;23313;91169;1158;1166;8
/net/per610a/home/mvp/mvp_db/hodost-lv/2017/2017_07_24_04_56/2017_07_24_21_54.mpg;Shinzo ABE.jpg;24281;24461;91169;1215;1224;9
/net/per610a/home/mvp/mvp_db/hodost-lv/2017/2017_07_24_04_56/2017_07_24_21_54.mpg;Shinzo ABE.jpg;26729;26913;91169;1337;1346;9
/net/per610a/home/mvp/mvp_db/hodost-lv/2017/2017_07_24_04_56/2017_07_24_21_54.mpg;Shinzo ABE.jpg;27921;28045;91169;1397;1403;6
/net/per610a/home/mvp/mvp_db/hodost-lv/2017/2017_07_24_04_56/2017_07_24_21_54.mpg;Shinzo ABE.jpg;20729;20825;91169;1037;1042;5
/net/per610a/home/mvp/mvp_db/hodost-lv/2017/2017_07_25_04_56/2017_07_25_21_54.mpg;Shinzo ABE.jpg;14273;14865;91161;714;743;29
/net/per610a/home/mvp/mvp_db/hodost-lv/2017/2017_07_25_04_56/2017_07_25_21_54.mpg;Shinzo ABE.jpg;18829;19009;91161;942;951;9
/net/per610a/home/mvp/mvp_db/hodost-lv/2017/2017_07_25_04_56/2017_07_25_21_54.mpg;Shinzo ABE.jpg;19713;19753;91161;986;988;2
/net/per610a/home/mvp/mvp_db/hodost-lv/2017/2017_07_25_04_56/2017_07_25_21_54.mpg;Yoshihiko Noda.jpg;48729;48817;91161;2438;2442;4
/net/per610a/home/mvp/mvp_db/hodost-lv/2017/2017_07_25_04_56/2017_07_25_21_54.mpg;Yoshihiko Noda.jpg;48917;49021;91161;2447;2453;6
/net/per610a/home/mvp/mvp_db/hodost-lv/2017/2017_07_26_04_56/2017_07_26_21_54.mpg;Shinzo ABE.jpg;17261;17897;91169;863;895;32
/net/per610a/home/mvp/mvp_db/hodost-lv/2017/2017_07_26_04_56/2017_07_26_21_54.mpg;Shinzo ABE.jpg;18613;18693;91169;931;935;4
/net/per610a/home/mvp/mvp_db/hodost-lv/2017/2017_07_26_04_56/2017_07_26_21_54.mpg;Shinzo ABE.jpg;18785;18833;91169;940;942;2
/net/per610a/home/mvp/mvp_db/hodost-lv/2017/2017_07_27_04_56/2017_07_27_22_09.mpg;Yoshihiko Noda.jpg;16873;16969;91169;844;849;5
/net/per610a/home/mvp/mvp_db/hodost-lv/2017/2017_07_27_04_56/2017_07_27_22_09.mpg;Yoshihiko Noda.jpg;18413;18629;91169;921;932;11
/net/per610a/home/mvp/mvp_db/hodost-lv/2017/2017_07_27_04_56/2017_07_27_22_09.mpg;Yuichiro Tamaki.png;20105;20285;91169;1006;1015;9
/net/per610a/home/mvp/mvp_db/hodost-lv/2017/2017_07_29_04_56/2017_07_29_20_54.mpg;Taro ASO.jpg;5057;5129;71981;253;256;3
/net/per610a/home/mvp/mvp_db/hodost-lv/2017/2017_07_29_04_56/2017_07_29_20_54.mpg;Shinzo ABE.jpg;5305;5681;71981;265;284;19
/net/per610a/home/mvp/mvp_db/hodost-lv/2017/2017_07_30_04_56/2017_07_30_20_54.mpg;YUriko Koike.jpg;61405;61413;71989;3073;3073;0
/net/per610a/home/mvp/mvp_db/hodost-lv/2017/2017_07_30_04_56/2017_07_30_20_54.mpg;YUriko Koike.jpg;67241;67309;71989;3365;3368;3
/net/per610a/home/mvp/mvp_db/hodost-lv/2017/2017_07_30_04_56/2017_07_30_20_54.mpg;YUriko Koike.jpg;67617;67701;71989;3384;3388;4
/net/per610a/home/mvp/mvp_db/hodost-lv/2017/2017_07_30_04_56/2017_07_30_20_54.mpg;YUriko Koike.jpg;67801;67981;71989;3393;3402;9
/net/per610a/home/mvp/mvp_db/hodost-lv/2017/2017_07_31_04_56/2017_07_31_21_54.mpg;Shinzo ABE.jpg;25273;25401;91169;1264;1271;7
/net/per610a/home/mvp/mvp_db/hodost-lv/2017/2017_07_31_04_56/2017_07_31_21_54.mpg;Shinzo ABE.jpg;25873;25909;91169;1294;1296;2
/net/per610a/home/mvp/mvp_db/hodost-lv/2017/2017_08_01_04_56/2017_08_01_21_54.mpg;Sadakazu TANIGAKI.jpg;31049;31597;91169;1553;1581;28
/net/per610a/home/mvp/mvp_db/hodost-lv/2017/2017_08_01_04_56/2017_08_01_21_54.mpg;Shinzo ABE.jpg;31633;31729;91169;1583;1588;5
/net/per610a/home/mvp/mvp_db/hodost-lv/2017/2017_08_01_04_56/2017_08_01_21_54.mpg;Seiji MAEHARA.jpg;37977;38325;91169;1900;1918;18
/net/per610a/home/mvp/mvp_db/hodost-lv/2017/2017_08_01_04_56/2017_08_01_21_54.mpg;Taro ASO.jpg;49257;49417;91169;2465;2473;8
/net/per610a/home/mvp/mvp_db/hodost-lv/2017/2017_08_02_04_56/2017_08_02_21_54.mpg;Shinzo ABE.jpg;2829;2829;91169;141;141;0
/net/per610a/home/mvp/mvp_db/hodost-lv/2017/2017_08_02_04_56/2017_08_02_21_54.mpg;Shinzo ABE.jpg;5449;5549;91169;272;277;5
/net/per610a/home/mvp/mvp_db/hodost-lv/2017/2017_08_02_04_56/2017_08_02_21_54.mpg;Shinzo ABE.jpg;5913;6033;91169;295;301;6
/net/per610a/home/mvp/mvp_db/hodost-lv/2017/2017_08_02_04_56/2017_08_02_21_54.mpg;Shinzo ABE.jpg;6109;6133;91169;305;306;1
/net/per610a/home/mvp/mvp_db/hodost-lv/2017/2017_08_02_04_56/2017_08_02_21_54.mpg;Shinzo ABE.jpg;9829;9925;91169;491;496;5
/net/per610a/home/mvp/mvp_db/hodost-lv/2017/2017_08_02_04_56/2017_08_02_21_54.mpg;Shinzo ABE.jpg;35189;35289;91169;1761;1766;5
/net/per610a/home/mvp/mvp_db/hodost-lv/2017/2017_08_02_04_56/2017_08_02_21_54.mpg;Yuichiro Tamaki.png;22577;22681;91169;1129;1135;6
/net/per610a/home/mvp/mvp_db/hodost-lv/2017/2017_08_02_04_56/2017_08_02_21_54.mpg;Kenji Eda.jpg;22577;22681;91169;1129;1135;6
/net/per610a/home/mvp/mvp_db/hodost-lv/2017/2017_08_03_04_56/2017_08_03_21_54.mpg;Shinzo ABE.jpg;18397;18441;91169;920;922;2
/net/per610a/home/mvp/mvp_db/hodost-lv/2017/2017_08_03_04_56/2017_08_03_21_54.mpg;Shinzo ABE.jpg;19265;19317;91169;964;966;2
/net/per610a/home/mvp/mvp_db/hodost-lv/2017/2017_08_03_04_56/2017_08_03_21_54.mpg;Shinzo ABE.jpg;25061;25065;91169;1254;1254;0
/net/per610a/home/mvp/mvp_db/hodost-lv/2017/2017_08_03_04_56/2017_08_03_21_54.mpg;Shinzo ABE.jpg;22373;22417;91169;1119;1121;2
/net/per610a/home/mvp/mvp_db/hodost-lv/2017/2017_08_03_04_56/2017_08_03_21_54.mpg;Shinzo ABE.jpg;27617;28213;91169;1382;1412;30
/net/per610a/home/mvp/mvp_db/hodost-lv/2017/2017_08_03_04_56/2017_08_03_21_54.mpg;Shinzo ABE.jpg;30493;31189;91169;1526;1561;35
/net/per610a/home/mvp/mvp_db/hodost-lv/2017/2017_08_03_04_56/2017_08_03_21_54.mpg;Taro ASO.jpg;25069;25081;91169;1254;1255;1
/net/per610a/home/mvp/mvp_db/hodost-lv/2017/2017_08_03_04_56/2017_08_03_21_54.mpg;Taro ASO.jpg;25265;25309;91169;1264;1266;2
/net/per610a/home/mvp/mvp_db/hodost-lv/2017/2017_08_03_04_56/2017_08_03_21_54.mpg;Taro ASO.jpg;34577;34629;91169;1730;1733;3
/net/per610a/home/mvp/mvp_db/hodost-lv/2017/2017_08_03_04_56/2017_08_03_21_54.mpg;Taro ASO.jpg;34877;34973;91169;1745;1750;5
/net/per610a/home/mvp/mvp_db/hodost-lv/2017/2017_08_03_04_56/2017_08_03_21_54.mpg;Renho.jpg;26633;26949;91169;1332;1348;16
/net/per610a/home/mvp/mvp_db/hodost-lv/2017/2017_08_04_04_56/2017_08_04_21_54.mpg;Taro ASO.jpg;19933;20017;91169;997;1001;4
/net/per610a/home/mvp/mvp_db/hodost-lv/2017/2017_08_04_04_56/2017_08_04_21_54.mpg;Taro ASO.jpg;23329;23537;91169;1167;1178;11
/net/per610a/home/mvp/mvp_db/hodost-lv/2017/2017_08_04_04_56/2017_08_04_21_54.mpg;Taro ASO.jpg;24137;24141;91169;1208;1208;0
/net/per610a/home/mvp/mvp_db/hodost-lv/2017/2017_08_04_04_56/2017_08_04_21_54.mpg;Taro ASO.jpg;24221;24265;91169;1212;1214;2
/net/per610a/home/mvp/mvp_db/hodost-lv/2017/2017_08_04_04_56/2017_08_04_21_54.mpg;Taro ASO.jpg;27289;27465;91169;1365;1374;9
/net/per610a/home/mvp/mvp_db/hodost-lv/2017/2017_08_04_04_56/2017_08_04_21_54.mpg;Taro ASO.jpg;27869;27885;91169;1394;1395;1
/net/per610a/home/mvp/mvp_db/hodost-lv/2017/2017_08_04_04_56/2017_08_04_21_54.mpg;Taro ASO.jpg;30429;30469;91169;1522;1524;2
/net/per610a/home/mvp/mvp_db/hodost-lv/2017/2017_08_04_04_56/2017_08_04_21_54.mpg;Shinzo ABE.jpg;19933;20001;91169;997;1001;4
/net/per610a/home/mvp/mvp_db/hodost-lv/2017/2017_08_04_04_56/2017_08_04_21_54.mpg;Shinzo ABE.jpg;20253;20473;91169;1013;1024;11
/net/per610a/home/mvp/mvp_db/hodost-lv/2017/2017_08_04_04_56/2017_08_04_21_54.mpg;Shinzo ABE.jpg;20521;20597;91169;1027;1030;3
/net/per610a/home/mvp/mvp_db/hodost-lv/2017/2017_08_04_04_56/2017_08_04_21_54.mpg;Shinzo ABE.jpg;24141;24145;91169;1208;1208;0
/net/per610a/home/mvp/mvp_db/hodost-lv/2017/2017_08_04_04_56/2017_08_04_21_54.mpg;Shinzo ABE.jpg;27377;27417;91169;1370;1372;2
/net/per610a/home/mvp/mvp_db/hodost-lv/2017/2017_08_04_04_56/2017_08_04_21_54.mpg;Shinzo ABE.jpg;28089;28217;91169;1405;1412;7
/net/per610a/home/mvp/mvp_db/hodost-lv/2017/2017_08_04_04_56/2017_08_04_21_54.mpg;Shinzo ABE.jpg;30445;30553;91169;1523;1529;6
/net/per610a/home/mvp/mvp_db/hodost-lv/2017/2017_08_05_04_56/2017_08_05_20_54.mpg;Shinzo ABE.jpg;24305;24625;71989;1216;1232;16
/net/per610a/home/mvp/mvp_db/hodost-lv/2017/2017_08_07_04_56/2017_08_07_21_54.mpg;Shinzo ABE.jpg;27145;27337;91169;1358;1368;10
/net/per610a/home/mvp/mvp_db/hodost-lv/2017/2017_08_07_04_56/2017_08_07_21_54.mpg;Shinzo ABE.jpg;89865;89961;91169;4497;4502;5
/net/per610a/home/mvp/mvp_db/hodost-lv/2017/2017_08_07_04_56/2017_08_07_21_54.mpg;YUriko Koike.jpg;57485;57705;91169;2877;2888;11
/net/per610a/home/mvp/mvp_db/hodost-lv/2017/2017_08_09_04_56/2017_08_09_21_54.mpg;Shinzo ABE.jpg;20401;20981;91169;1021;1050;29
/net/per610a/home/mvp/mvp_db/hodost-lv/2017/2017_08_09_04_56/2017_08_09_21_54.mpg;Shinzo ABE.jpg;30013;30033;91169;1502;1503;1
/net/per610a/home/mvp/mvp_db/hodost-lv/2017/2017_08_09_04_56/2017_08_09_21_54.mpg;Shinzo ABE.jpg;51249;51393;91169;2565;2572;7
/net/per610a/home/mvp/mvp_db/hodost-lv/2017/2017_08_10_04_56/2017_08_10_21_54.mpg;Renho.jpg;53961;54225;91169;2700;2713;13
/net/per610a/home/mvp/mvp_db/hodost-lv/2017/2017_08_11_04_56/2017_08_11_21_54.mpg;Shinzo ABE.jpg;18221;18457;91169;911;923;12
/net/per610a/home/mvp/mvp_db/hodost-lv/2017/2017_08_12_04_56/2017_08_12_20_54.mpg;Shinzo ABE.jpg;15233;15393;71989;762;770;8
/net/per610a/home/mvp/mvp_db/hodost-lv/2017/2017_08_15_04_56/2017_08_15_21_54.mpg;Shinzo ABE.jpg;12417;12645;91169;621;632;11
/net/per610a/home/mvp/mvp_db/hodost-lv/2017/2017_08_15_04_56/2017_08_15_21_54.mpg;Shinzo ABE.jpg;31009;31941;91169;1551;1598;47
/net/per610a/home/mvp/mvp_db/hodost-lv/2017/2017_08_16_04_56/2017_08_16_21_54.mpg;Shinzo ABE.jpg;50877;50993;91169;2546;2552;6
/net/per610a/home/mvp/mvp_db/hodost-lv/2017/2017_08_19_04_56/2017_08_19_20_54.mpg;Taro Yamamoto.jpg;43877;44005;71981;2195;2202;7
/net/per610a/home/mvp/mvp_db/hodost-lv/2017/2017_08_20_04_56/2017_08_20_20_54.mpg;Shinzo ABE.jpg;67965;68065;71989;3401;3406;5
/net/per610a/home/mvp/mvp_db/hodost-lv/2017/2017_08_22_04_56/2017_08_22_21_54.mpg;YUriko Koike.jpg;38217;38505;91169;1912;1927;15
/net/per610a/home/mvp/mvp_db/hodost-lv/2017/2017_08_22_04_56/2017_08_22_21_54.mpg;YUriko Koike.jpg;40049;40353;91169;2004;2019;15
/net/per610a/home/mvp/mvp_db/hodost-lv/2017/2017_08_22_04_56/2017_08_22_21_54.mpg;YUriko Koike.jpg;41593;41621;91169;2081;2083;2
/net/per610a/home/mvp/mvp_db/hodost-lv/2017/2017_08_22_04_56/2017_08_22_21_54.mpg;YUriko Koike.jpg;42433;42613;91169;2123;2132;9
/net/per610a/home/mvp/mvp_db/hodost-lv/2017/2017_08_22_04_56/2017_08_22_21_54.mpg;YUriko Koike.jpg;42841;42969;91169;2144;2150;6
/net/per610a/home/mvp/mvp_db/hodost-lv/2017/2017_08_22_04_56/2017_08_22_21_54.mpg;YUriko Koike.jpg;45049;45269;91169;2254;2265;11
/net/per610a/home/mvp/mvp_db/hodost-lv/2017/2017_08_25_04_56/2017_08_25_21_54.mpg;Shinzo ABE.jpg;35745;35945;91161;1788;1798;10
/net/per610a/home/mvp/mvp_db/hodost-lv/2017/2017_08_25_04_56/2017_08_25_21_54.mpg;Shinzo ABE.jpg;36065;36125;91161;1804;1807;3
/net/per610a/home/mvp/mvp_db/hodost-lv/2017/2017_08_25_04_56/2017_08_25_21_54.mpg;Shintaro ISHIHARA.jpg;52269;52401;91161;2615;2622;7
/net/per610a/home/mvp/mvp_db/hodost-lv/2017/2017_08_25_04_56/2017_08_25_21_54.mpg;YUriko Koike.jpg;52477;52649;91161;2626;2634;8
/net/per610a/home/mvp/mvp_db/hodost-lv/2017/2017_08_25_04_56/2017_08_25_21_54.mpg;YUriko Koike.jpg;52841;53181;91161;2644;2661;17
/net/per610a/home/mvp/mvp_db/hodost-lv/2017/2017_08_25_04_56/2017_08_25_21_54.mpg;YUriko Koike.jpg;53329;53605;91161;2668;2682;14
/net/per610a/home/mvp/mvp_db/hodost-lv/2017/2017_08_27_04_56/2017_08_27_21_54.mpg;Shinzo ABE.jpg;35105;35817;79181;1756;1792;36
/net/per610a/home/mvp/mvp_db/hodost-lv/2017/2017_08_27_04_56/2017_08_27_21_54.mpg;YUriko Koike.jpg;70405;70553;79181;3522;3530;8
/net/per610a/home/mvp/mvp_db/hodost-lv/2017/2017_08_27_04_56/2017_08_27_21_54.mpg;YUriko Koike.jpg;74965;75149;79181;3751;3760;9
/net/per610a/home/mvp/mvp_db/hodost-lv/2017/2017_08_28_04_56/2017_08_28_21_54.mpg;Shinzo ABE.jpg;31029;31117;91169;1552;1557;5
/net/per610a/home/mvp/mvp_db/hodost-lv/2017/2017_08_28_04_56/2017_08_28_21_54.mpg;YUriko Koike.jpg;51237;51381;91169;2564;2571;7
/net/per610a/home/mvp/mvp_db/hodost-lv/2017/2017_08_29_04_56/2017_08_29_21_54.mpg;Shinzo ABE.jpg;9849;9873;91161;492;494;2
/net/per610a/home/mvp/mvp_db/hodost-lv/2017/2017_08_29_04_56/2017_08_29_21_54.mpg;Shinzo ABE.jpg;10345;11369;91161;517;568;51
/net/per610a/home/mvp/mvp_db/hodost-lv/2017/2017_08_29_04_56/2017_08_29_21_54.mpg;Shinzo ABE.jpg;38681;38773;91161;1935;1940;5
/net/per610a/home/mvp/mvp_db/hodost-lv/2017/2017_08_29_04_56/2017_08_29_21_54.mpg;Nariaki Nakayama.png;45945;46137;91161;2299;2308;9
/net/per610a/home/mvp/mvp_db/hodost-lv/2017/2017_08_29_04_56/2017_08_29_21_54.mpg;Nariaki Nakayama.png;47557;47757;91161;2379;2389;10
/net/per610a/home/mvp/mvp_db/hodost-lv/2017/2017_08_30_04_56/2017_08_30_21_54.mpg;Shinzo ABE.jpg;31889;32025;91169;1596;1602;6
/net/per610a/home/mvp/mvp_db/hodost-lv/2017/2017_08_30_04_56/2017_08_30_21_54.mpg;Taro ASO.jpg;46481;46757;91169;2326;2340;14
/net/per610a/home/mvp/mvp_db/hodost-lv/2017/2017_08_30_04_56/2017_08_30_21_54.mpg;Taro ASO.jpg;46829;46909;91169;2343;2347;4
/net/per610a/home/mvp/mvp_db/hodost-lv/2017/2017_08_30_04_56/2017_08_30_21_54.mpg;YUriko Koike.jpg;48877;48957;91169;2446;2450;4
/net/per610a/home/mvp/mvp_db/hodost-lv/2017/2017_08_31_04_56/2017_08_31_21_35.mpg;Shinzo ABE.jpg;61725;61805;113949;3089;3093;4
/net/per610a/home/mvp/mvp_db/hodost-lv/2017/2017_08_31_04_56/2017_08_31_21_35.mpg;Yukio EDANO.jpg;73341;73473;113949;3670;3677;7
/net/per610a/home/mvp/mvp_db/hodost-lv/2017/2017_08_31_04_56/2017_08_31_21_35.mpg;Yukio EDANO.jpg;73697;73773;113949;3688;3692;4
/net/per610a/home/mvp/mvp_db/hodost-lv/2017/2017_09_01_04_56/2017_09_01_21_54.mpg;Seiji MAEHARA.jpg;18309;18521;91161;916;926;10
/net/per610a/home/mvp/mvp_db/hodost-lv/2017/2017_09_01_04_56/2017_09_01_21_54.mpg;Seiji MAEHARA.jpg;28429;29377;91161;1422;1470;48
/net/per610a/home/mvp/mvp_db/hodost-lv/2017/2017_09_01_04_56/2017_09_01_21_54.mpg;Seiji MAEHARA.jpg;30393;30725;91161;1520;1537;17
/net/per610a/home/mvp/mvp_db/hodost-lv/2017/2017_09_01_04_56/2017_09_01_21_54.mpg;Seiji MAEHARA.jpg;31465;31477;91161;1574;1575;1
/net/per610a/home/mvp/mvp_db/hodost-lv/2017/2017_09_01_04_56/2017_09_01_21_54.mpg;Seiji MAEHARA.jpg;32041;32761;91161;1603;1639;36
/net/per610a/home/mvp/mvp_db/hodost-lv/2017/2017_09_01_04_56/2017_09_01_21_54.mpg;Seiji MAEHARA.jpg;32909;33393;91161;1646;1671;25
/net/per610a/home/mvp/mvp_db/hodost-lv/2017/2017_09_01_04_56/2017_09_01_21_54.mpg;Seiji MAEHARA.jpg;18641;18781;91161;932;939;7
/net/per610a/home/mvp/mvp_db/hodost-lv/2017/2017_09_01_04_56/2017_09_01_21_54.mpg;Seiji MAEHARA.jpg;21429;21933;91161;1072;1097;25
/net/per610a/home/mvp/mvp_db/hodost-lv/2017/2017_09_01_04_56/2017_09_01_21_54.mpg;Seiji MAEHARA.jpg;22241;22965;91161;1113;1149;36
/net/per610a/home/mvp/mvp_db/hodost-lv/2017/2017_09_01_04_56/2017_09_01_21_54.mpg;Seiji MAEHARA.jpg;23317;24657;91161;1166;1233;67
/net/per610a/home/mvp/mvp_db/hodost-lv/2017/2017_09_01_04_56/2017_09_01_21_54.mpg;Seiji MAEHARA.jpg;24801;24885;91161;1241;1245;4
/net/per610a/home/mvp/mvp_db/hodost-lv/2017/2017_09_01_04_56/2017_09_01_21_54.mpg;Seiji MAEHARA.jpg;25665;26037;91161;1284;1302;18
/net/per610a/home/mvp/mvp_db/hodost-lv/2017/2017_09_01_04_56/2017_09_01_21_54.mpg;Seiji MAEHARA.jpg;26125;26373;91161;1307;1319;12
/net/per610a/home/mvp/mvp_db/hodost-lv/2017/2017_09_01_04_56/2017_09_01_21_54.mpg;Seiji MAEHARA.jpg;26437;26573;91161;1322;1329;7
/net/per610a/home/mvp/mvp_db/hodost-lv/2017/2017_09_01_04_56/2017_09_01_21_54.mpg;Seiji MAEHARA.jpg;26841;27761;91161;1343;1389;46
/net/per610a/home/mvp/mvp_db/hodost-lv/2017/2017_09_01_04_56/2017_09_01_21_54.mpg;Seiji MAEHARA.jpg;27853;28245;91161;1393;1413;20
/net/per610a/home/mvp/mvp_db/hodost-lv/2017/2017_09_01_04_56/2017_09_01_21_54.mpg;Seiji MAEHARA.jpg;29565;29633;91161;1479;1482;3
/net/per610a/home/mvp/mvp_db/hodost-lv/2017/2017_09_01_04_56/2017_09_01_21_54.mpg;Seiji MAEHARA.jpg;29765;30069;91161;1489;1504;15
/net/per610a/home/mvp/mvp_db/hodost-lv/2017/2017_09_01_04_56/2017_09_01_21_54.mpg;Seiji MAEHARA.jpg;30805;31417;91161;1541;1572;31
/net/per610a/home/mvp/mvp_db/hodost-lv/2017/2017_09_01_04_56/2017_09_01_21_54.mpg;Seiji MAEHARA.jpg;31505;31873;91161;1576;1595;19
/net/per610a/home/mvp/mvp_db/hodost-lv/2017/2017_09_01_04_56/2017_09_01_21_54.mpg;Seiji MAEHARA.jpg;33453;33565;91161;1674;1679;5
/net/per610a/home/mvp/mvp_db/hodost-lv/2017/2017_09_01_04_56/2017_09_01_21_54.mpg;YUriko Koike.jpg;48969;49717;91161;2450;2488;38
/net/per610a/home/mvp/mvp_db/hodost-lv/2017/2017_09_05_04_56/2017_09_05_21_54.mpg;Shinzo ABE.jpg;21313;21445;91169;1066;1073;7
/net/per610a/home/mvp/mvp_db/hodost-lv/2017/2017_09_05_04_56/2017_09_05_21_54.mpg;Shinzo ABE.jpg;21617;21653;91169;1081;1083;2
/net/per610a/home/mvp/mvp_db/hodost-lv/2017/2017_09_05_04_56/2017_09_05_21_54.mpg;YUriko Koike.jpg;27821;28229;91169;1392;1412;20
/net/per610a/home/mvp/mvp_db/hodost-lv/2017/2017_09_05_04_56/2017_09_05_21_54.mpg;YUriko Koike.jpg;29473;29497;91169;1475;1476;1
/net/per610a/home/mvp/mvp_db/hodost-lv/2017/2017_09_05_04_56/2017_09_05_21_54.mpg;YUriko Koike.jpg;29565;29613;91169;1479;1482;3
/net/per610a/home/mvp/mvp_db/hodost-lv/2017/2017_09_05_04_56/2017_09_05_21_54.mpg;YUriko Koike.jpg;30729;31117;91169;1537;1557;20
/net/per610a/home/mvp/mvp_db/hodost-lv/2017/2017_09_05_04_56/2017_09_05_21_54.mpg;YUriko Koike.jpg;31521;31749;91169;1577;1589;12
/net/per610a/home/mvp/mvp_db/hodost-lv/2017/2017_09_05_04_56/2017_09_05_21_54.mpg;YUriko Koike.jpg;32281;32393;91169;1615;1621;6
/net/per610a/home/mvp/mvp_db/hodost-lv/2017/2017_09_05_04_56/2017_09_05_21_54.mpg;YUriko Koike.jpg;34941;35177;91169;1748;1760;12
/net/per610a/home/mvp/mvp_db/hodost-lv/2017/2017_09_05_04_56/2017_09_05_21_54.mpg;YUriko Koike.jpg;31753;32253;91169;1589;1614;25
/net/per610a/home/mvp/mvp_db/hodost-lv/2017/2017_09_05_04_56/2017_09_05_21_54.mpg;Shinzo ABE.jpg;55317;55541;91169;2768;2779;11
/net/per610a/home/mvp/mvp_db/hodost-lv/2017/2017_09_06_04_56/2017_09_06_21_54.mpg;Shinzo ABE.jpg;9209;9373;91169;460;469;9
/net/per610a/home/mvp/mvp_db/hodost-lv/2017/2017_09_06_04_56/2017_09_06_21_54.mpg;Shinzo ABE.jpg;55289;55317;91169;2767;2768;1
/net/per610a/home/mvp/mvp_db/hodost-lv/2017/2017_09_07_04_56/2017_09_07_21_54.mpg;Seiji MAEHARA.jpg;13717;14093;91169;686;705;19
/net/per610a/home/mvp/mvp_db/hodost-lv/2017/2017_09_07_04_56/2017_09_07_21_54.mpg;Seiji MAEHARA.jpg;17713;18001;91169;886;900;14
/net/per610a/home/mvp/mvp_db/hodost-lv/2017/2017_09_07_04_56/2017_09_07_21_54.mpg;Seiji MAEHARA.jpg;19517;19585;91169;976;980;4
/net/per610a/home/mvp/mvp_db/hodost-lv/2017/2017_09_07_04_56/2017_09_07_21_54.mpg;Shinzo ABE.jpg;26137;26221;91169;1308;1312;4
/net/per610a/home/mvp/mvp_db/hodost-lv/2017/2017_09_07_04_56/2017_09_07_21_54.mpg;Shinzo ABE.jpg;28953;29033;91169;1449;1453;4
/net/per610a/home/mvp/mvp_db/hodost-lv/2017/2017_09_08_04_56/2017_09_08_21_54.mpg;Junichiro KOIZUMI.jpg;19457;19513;91169;973;976;3
/net/per610a/home/mvp/mvp_db/hodost-lv/2017/2017_09_08_04_56/2017_09_08_21_54.mpg;Junichiro KOIZUMI.jpg;20221;20321;91169;1012;1017;5
/net/per610a/home/mvp/mvp_db/hodost-lv/2017/2017_09_08_04_56/2017_09_08_21_54.mpg;Junichiro KOIZUMI.jpg;24337;24657;91169;1218;1234;16
/net/per610a/home/mvp/mvp_db/hodost-lv/2017/2017_09_09_04_56/2017_09_09_20_54.mpg;Seiji MAEHARA.jpg;42281;42337;71989;2116;2118;2
/net/per610a/home/mvp/mvp_db/hodost-lv/2017/2017_09_09_04_56/2017_09_09_20_54.mpg;Seiji MAEHARA.jpg;42701;42777;71989;2137;2140;3
/net/per610a/home/mvp/mvp_db/hodost-lv/2017/2017_09_09_04_56/2017_09_09_20_54.mpg;Seiji MAEHARA.jpg;43185;43277;71989;2161;2165;4
/net/per610a/home/mvp/mvp_db/hodost-lv/2017/2017_09_09_04_56/2017_09_09_20_54.mpg;Seiji MAEHARA.jpg;47565;47693;71989;2380;2387;7
/net/per610a/home/mvp/mvp_db/hodost-lv/2017/2017_09_10_04_56/2017_09_10_20_54.mpg;Seiji MAEHARA.jpg;20841;20925;71989;1043;1047;4
/net/per610a/home/mvp/mvp_db/hodost-lv/2017/2017_09_10_04_56/2017_09_10_20_54.mpg;Seiji MAEHARA.jpg;21453;21473;71989;1073;1074;1
/net/per610a/home/mvp/mvp_db/hodost-lv/2017/2017_09_10_04_56/2017_09_10_20_54.mpg;Seiji MAEHARA.jpg;22361;22545;71989;1119;1128;9
/net/per610a/home/mvp/mvp_db/hodost-lv/2017/2017_09_11_04_56/2017_09_11_21_54.mpg;Shinzo ABE.jpg;17421;17521;91169;871;876;5
/net/per610a/home/mvp/mvp_db/hodost-lv/2017/2017_09_12_04_56/2017_09_12_21_54.mpg;Shinzo ABE.jpg;29805;29805;91169;1491;1491;0
/net/per610a/home/mvp/mvp_db/hodost-lv/2017/2017_09_12_04_56/2017_09_12_21_54.mpg;Shinzo ABE.jpg;31637;31685;91169;1583;1585;2
/net/per610a/home/mvp/mvp_db/hodost-lv/2017/2017_09_12_04_56/2017_09_12_21_54.mpg;Shinzo ABE.jpg;32165;32377;91169;1609;1620;11
/net/per610a/home/mvp/mvp_db/hodost-lv/2017/2017_09_12_04_56/2017_09_12_21_54.mpg;Shinzo ABE.jpg;32453;32785;91169;1624;1640;16
/net/per610a/home/mvp/mvp_db/hodost-lv/2017/2017_09_12_04_56/2017_09_12_21_54.mpg;Shinzo ABE.jpg;36625;36981;91169;1833;1850;17
/net/per610a/home/mvp/mvp_db/hodost-lv/2017/2017_09_13_04_56/2017_09_13_22_09.mpg;YUriko Koike.jpg;37341;37697;91169;1868;1886;18
/net/per610a/home/mvp/mvp_db/hodost-lv/2017/2017_09_13_04_56/2017_09_13_22_09.mpg;YUriko Koike.jpg;38409;38713;91169;1922;1937;15
/net/per610a/home/mvp/mvp_db/hodost-lv/2017/2017_09_13_04_56/2017_09_13_22_09.mpg;YUriko Koike.jpg;38749;38893;91169;1939;1946;7
/net/per610a/home/mvp/mvp_db/hodost-lv/2017/2017_09_13_04_56/2017_09_13_22_09.mpg;YUriko Koike.jpg;44401;44661;91169;2222;2235;13
/net/per610a/home/mvp/mvp_db/hodost-lv/2017/2017_09_13_04_56/2017_09_13_22_09.mpg;Seiji MAEHARA.jpg;74273;74393;91169;3717;3723;6
/net/per610a/home/mvp/mvp_db/hodost-lv/2017/2017_09_14_04_56/2017_09_14_22_09.mpg;Shinzo ABE.jpg;10925;11165;91169;546;558;12
/net/per610a/home/mvp/mvp_db/hodost-lv/2017/2017_09_14_04_56/2017_09_14_22_09.mpg;Shinzo ABE.jpg;11873;11909;91169;594;596;2
/net/per610a/home/mvp/mvp_db/hodost-lv/2017/2017_09_14_04_56/2017_09_14_22_09.mpg;Shinzo ABE.jpg;12817;12969;91169;641;649;8
/net/per610a/home/mvp/mvp_db/hodost-lv/2017/2017_09_14_04_56/2017_09_14_22_09.mpg;Shinzo ABE.jpg;13729;13757;91169;687;688;1
/net/per610a/home/mvp/mvp_db/hodost-lv/2017/2017_09_14_04_56/2017_09_14_22_09.mpg;Shinzo ABE.jpg;19609;20237;91169;981;1012;31
/net/per610a/home/mvp/mvp_db/hodost-lv/2017/2017_09_14_04_56/2017_09_14_22_09.mpg;Shinzo ABE.jpg;13409;13613;91169;671;681;10
/net/per610a/home/mvp/mvp_db/hodost-lv/2017/2017_09_14_04_56/2017_09_14_22_09.mpg;Shinzo ABE.jpg;18089;18277;91169;905;914;9
/net/per610a/home/mvp/mvp_db/hodost-lv/2017/2017_09_14_04_56/2017_09_14_22_09.mpg;Natsuo YAMAGUCHI.jpg;72629;72697;91169;3635;3638;3
/net/per610a/home/mvp/mvp_db/hodost-lv/2017/2017_09_14_04_56/2017_09_14_22_09.mpg;Natsuo YAMAGUCHI.jpg;72765;73165;91169;3641;3661;20
/net/per610a/home/mvp/mvp_db/hodost-lv/2017/2017_09_17_04_56/2017_09_17_20_54.mpg;Shinzo ABE.jpg;37489;37649;71989;1876;1884;8
/net/per610a/home/mvp/mvp_db/hodost-lv/2017/2017_09_17_04_56/2017_09_17_20_54.mpg;Shinzo ABE.jpg;41065;41249;71989;2055;2064;9
/net/per610a/home/mvp/mvp_db/hodost-lv/2017/2017_09_17_04_56/2017_09_17_20_54.mpg;Ichiro OZAWA.jpg;38089;38417;71989;1906;1922;16
/net/per610a/home/mvp/mvp_db/hodost-lv/2017/2017_09_17_04_56/2017_09_17_20_54.mpg;Ichiro OZAWA.jpg;44389;44581;71989;2221;2231;10
/net/per610a/home/mvp/mvp_db/hodost-lv/2017/2017_09_17_04_56/2017_09_17_20_54.mpg;Ichiro OZAWA.jpg;45021;45213;71989;2253;2262;9
/net/per610a/home/mvp/mvp_db/hodost-lv/2017/2017_09_18_04_56/2017_09_18_22_24.mpg;Shinzo ABE.jpg;9885;10125;91161;494;506;12
/net/per610a/home/mvp/mvp_db/hodost-lv/2017/2017_09_18_04_56/2017_09_18_22_24.mpg;Shinzo ABE.jpg;12373;12429;91161;619;621;2
/net/per610a/home/mvp/mvp_db/hodost-lv/2017/2017_09_18_04_56/2017_09_18_22_24.mpg;Shinzo ABE.jpg;12549;12861;91161;627;643;16
/net/per610a/home/mvp/mvp_db/hodost-lv/2017/2017_09_18_04_56/2017_09_18_22_24.mpg;Shinzo ABE.jpg;13001;13777;91161;650;689;39
/net/per610a/home/mvp/mvp_db/hodost-lv/2017/2017_09_18_04_56/2017_09_18_22_24.mpg;Shinzo ABE.jpg;22285;22405;91161;1115;1121;6
/net/per610a/home/mvp/mvp_db/hodost-lv/2017/2017_09_18_04_56/2017_09_18_22_24.mpg;YUriko Koike.jpg;11553;11909;91161;578;595;17
/net/per610a/home/mvp/mvp_db/hodost-lv/2017/2017_09_18_04_56/2017_09_18_22_24.mpg;Shinzo ABE.jpg;22249;22253;91161;1113;1113;0
/net/per610a/home/mvp/mvp_db/hodost-lv/2017/2017_09_18_04_56/2017_09_18_22_24.mpg;Shinzo ABE.jpg;25405;25805;91161;1271;1291;20
/net/per610a/home/mvp/mvp_db/hodost-lv/2017/2017_09_19_04_56/2017_09_19_21_54.mpg;Seiji MAEHARA.jpg;24461;24929;91169;1224;1247;23
/net/per610a/home/mvp/mvp_db/hodost-lv/2017/2017_09_20_04_56/2017_09_20_21_54.mpg;YUriko Koike.jpg;25781;26577;91169;1290;1330;40
/net/per610a/home/mvp/mvp_db/hodost-lv/2017/2017_09_20_04_56/2017_09_20_21_54.mpg;YUriko Koike.jpg;26653;26721;91169;1333;1337;4
/net/per610a/home/mvp/mvp_db/hodost-lv/2017/2017_09_20_04_56/2017_09_20_21_54.mpg;YUriko Koike.jpg;28293;28525;91169;1416;1427;11
/net/per610a/home/mvp/mvp_db/hodost-lv/2017/2017_09_20_04_56/2017_09_20_21_54.mpg;YUriko Koike.jpg;30325;30781;91169;1517;1540;23
/net/per610a/home/mvp/mvp_db/hodost-lv/2017/2017_09_20_04_56/2017_09_20_21_54.mpg;YUriko Koike.jpg;33649;33869;91169;1684;1695;11
/net/per610a/home/mvp/mvp_db/hodost-lv/2017/2017_09_20_04_56/2017_09_20_21_54.mpg;YUriko Koike.jpg;34081;34237;91169;1705;1713;8
/net/per610a/home/mvp/mvp_db/hodost-lv/2017/2017_09_20_04_56/2017_09_20_21_54.mpg;Sadakazu TANIGAKI.jpg;35737;36013;91169;1788;1802;14
/net/per610a/home/mvp/mvp_db/hodost-lv/2017/2017_09_21_04_56/2017_09_21_21_54.mpg;Shinzo ABE.jpg;4441;5105;91169;222;255;33
/net/per610a/home/mvp/mvp_db/hodost-lv/2017/2017_09_21_04_56/2017_09_21_21_54.mpg;Shinzo ABE.jpg;5681;5869;91169;284;293;9
/net/per610a/home/mvp/mvp_db/hodost-lv/2017/2017_09_21_04_56/2017_09_21_21_54.mpg;Shinzo ABE.jpg;6065;6101;91169;303;305;2
/net/per610a/home/mvp/mvp_db/hodost-lv/2017/2017_09_21_04_56/2017_09_21_21_54.mpg;Shinzo ABE.jpg;6165;6645;91169;308;332;24
/net/per610a/home/mvp/mvp_db/hodost-lv/2017/2017_09_21_04_56/2017_09_21_21_54.mpg;Shinzo ABE.jpg;25613;25717;91169;1281;1287;6
/net/per610a/home/mvp/mvp_db/hodost-lv/2017/2017_09_21_04_56/2017_09_21_21_54.mpg;YUriko Koike.jpg;16669;16801;91169;834;840;6
/net/per610a/home/mvp/mvp_db/hodost-lv/2017/2017_09_21_04_56/2017_09_21_21_54.mpg;YUriko Koike.jpg;16929;16997;91169;847;850;3
/net/per610a/home/mvp/mvp_db/hodost-lv/2017/2017_09_21_04_56/2017_09_21_21_54.mpg;Natsuo YAMAGUCHI.jpg;17309;17529;91169;866;877;11
/net/per610a/home/mvp/mvp_db/hodost-lv/2017/2017_09_21_04_56/2017_09_21_21_54.mpg;Sadakazu TANIGAKI.jpg;18445;18585;91169;923;930;7
/net/per610a/home/mvp/mvp_db/hodost-lv/2017/2017_09_22_04_56/2017_09_22_21_54.mpg;Shinzo ABE.jpg;36521;36805;91169;1827;1842;15
/net/per610a/home/mvp/mvp_db/hodost-lv/2017/2017_09_23_04_56/2017_09_23_20_54.mpg;Ichiro OZAWA.jpg;32685;32977;145109;1635;1650;15
/net/per610a/home/mvp/mvp_db/hodost-lv/2017/2017_09_25_04_56/2017_09_25_21_54.mpg;YUriko Koike.jpg;1613;1757;91169;80;87;7
/net/per610a/home/mvp/mvp_db/hodost-lv/2017/2017_09_25_04_56/2017_09_25_21_54.mpg;YUriko Koike.jpg;4373;4409;91169;218;220;2
/net/per610a/home/mvp/mvp_db/hodost-lv/2017/2017_09_25_04_56/2017_09_25_21_54.mpg;YUriko Koike.jpg;35237;35253;91169;1763;1764;1
/net/per610a/home/mvp/mvp_db/hodost-lv/2017/2017_09_25_04_56/2017_09_25_21_54.mpg;YUriko Koike.jpg;37541;37597;91169;1878;1881;3
/net/per610a/home/mvp/mvp_db/hodost-lv/2017/2017_09_25_04_56/2017_09_25_21_54.mpg;YUriko Koike.jpg;40437;46109;91169;2023;2307;284
/net/per610a/home/mvp/mvp_db/hodost-lv/2017/2017_09_25_04_56/2017_09_25_21_54.mpg;YUriko Koike.jpg;47433;54349;91169;2374;2720;346
/net/per610a/home/mvp/mvp_db/hodost-lv/2017/2017_09_25_04_56/2017_09_25_21_54.mpg;Seiji MAEHARA.jpg;7985;8857;91169;399;443;44
/net/per610a/home/mvp/mvp_db/hodost-lv/2017/2017_09_25_04_56/2017_09_25_21_54.mpg;Shinzo ABE.jpg;14797;14797;91169;740;740;0
/net/per610a/home/mvp/mvp_db/hodost-lv/2017/2017_09_25_04_56/2017_09_25_21_54.mpg;Shinzo ABE.jpg;15357;15369;91169;768;769;1
/net/per610a/home/mvp/mvp_db/hodost-lv/2017/2017_09_25_04_56/2017_09_25_21_54.mpg;Shinzo ABE.jpg;19281;19517;91169;965;976;11
/net/per610a/home/mvp/mvp_db/hodost-lv/2017/2017_09_25_04_56/2017_09_25_21_54.mpg;Shinzo ABE.jpg;20853;21089;91169;1043;1055;12
/net/per610a/home/mvp/mvp_db/hodost-lv/2017/2017_09_25_04_56/2017_09_25_21_54.mpg;Shinzo ABE.jpg;21297;21421;91169;1065;1072;7
/net/per610a/home/mvp/mvp_db/hodost-lv/2017/2017_09_25_04_56/2017_09_25_21_54.mpg;Shinzo ABE.jpg;21493;21557;91169;1075;1078;3
/net/per610a/home/mvp/mvp_db/hodost-lv/2017/2017_09_25_04_56/2017_09_25_21_54.mpg;Shinzo ABE.jpg;22253;22289;91169;1113;1115;2
/net/per610a/home/mvp/mvp_db/hodost-lv/2017/2017_09_25_04_56/2017_09_25_21_54.mpg;Shinzo ABE.jpg;22753;22853;91169;1138;1143;5
/net/per610a/home/mvp/mvp_db/hodost-lv/2017/2017_09_25_04_56/2017_09_25_21_54.mpg;Shinzo ABE.jpg;23129;23869;91169;1157;1194;37
/net/per610a/home/mvp/mvp_db/hodost-lv/2017/2017_09_25_04_56/2017_09_25_21_54.mpg;Shinzo ABE.jpg;24005;24121;91169;1201;1207;6
/net/per610a/home/mvp/mvp_db/hodost-lv/2017/2017_09_25_04_56/2017_09_25_21_54.mpg;Shinzo ABE.jpg;24353;24389;91169;1218;1220;2
/net/per610a/home/mvp/mvp_db/hodost-lv/2017/2017_09_25_04_56/2017_09_25_21_54.mpg;Shinzo ABE.jpg;24573;24673;91169;1229;1234;5
/net/per610a/home/mvp/mvp_db/hodost-lv/2017/2017_09_25_04_56/2017_09_25_21_54.mpg;Shinzo ABE.jpg;25113;25641;91169;1256;1283;27
/net/per610a/home/mvp/mvp_db/hodost-lv/2017/2017_09_25_04_56/2017_09_25_21_54.mpg;Shinzo ABE.jpg;25817;26173;91169;1292;1309;17
/net/per610a/home/mvp/mvp_db/hodost-lv/2017/2017_09_25_04_56/2017_09_25_21_54.mpg;Shinzo ABE.jpg;26581;26705;91169;1330;1336;6
/net/per610a/home/mvp/mvp_db/hodost-lv/2017/2017_09_25_04_56/2017_09_25_21_54.mpg;Shinzo ABE.jpg;26829;26873;91169;1342;1344;2
/net/per610a/home/mvp/mvp_db/hodost-lv/2017/2017_09_25_04_56/2017_09_25_21_54.mpg;Shinzo ABE.jpg;27813;28029;91169;1392;1402;10
/net/per610a/home/mvp/mvp_db/hodost-lv/2017/2017_09_25_04_56/2017_09_25_21_54.mpg;Shinzo ABE.jpg;28901;29269;91169;1446;1464;18
/net/per610a/home/mvp/mvp_db/hodost-lv/2017/2017_09_25_04_56/2017_09_25_21_54.mpg;Shinzo ABE.jpg;29357;29517;91169;1469;1477;8
/net/per610a/home/mvp/mvp_db/hodost-lv/2017/2017_09_25_04_56/2017_09_25_21_54.mpg;Shinzo ABE.jpg;29665;29757;91169;1484;1489;5
/net/per610a/home/mvp/mvp_db/hodost-lv/2017/2017_09_25_04_56/2017_09_25_21_54.mpg;Shinzo ABE.jpg;30149;30601;91169;1508;1531;23
/net/per610a/home/mvp/mvp_db/hodost-lv/2017/2017_09_25_04_56/2017_09_25_21_54.mpg;Shinzo ABE.jpg;30789;30977;91169;1540;1550;10
/net/per610a/home/mvp/mvp_db/hodost-lv/2017/2017_09_25_04_56/2017_09_25_21_54.mpg;Shinzo ABE.jpg;31121;31185;91169;1557;1560;3
/net/per610a/home/mvp/mvp_db/hodost-lv/2017/2017_09_25_04_56/2017_09_25_21_54.mpg;Shinzo ABE.jpg;31561;32001;91169;1579;1601;22
/net/per610a/home/mvp/mvp_db/hodost-lv/2017/2017_09_25_04_56/2017_09_25_21_54.mpg;Shinzo ABE.jpg;32141;32365;91169;1608;1619;11
/net/per610a/home/mvp/mvp_db/hodost-lv/2017/2017_09_25_04_56/2017_09_25_21_54.mpg;Shinzo ABE.jpg;32593;32629;91169;1631;1633;2
/net/per610a/home/mvp/mvp_db/hodost-lv/2017/2017_09_25_04_56/2017_09_25_21_54.mpg;Shinzo ABE.jpg;34277;34813;91169;1715;1742;27
/net/per610a/home/mvp/mvp_db/hodost-lv/2017/2017_09_25_04_56/2017_09_25_21_54.mpg;Shinzo ABE.jpg;34913;34985;91169;1747;1750;3
/net/per610a/home/mvp/mvp_db/hodost-lv/2017/2017_09_25_04_56/2017_09_25_21_54.mpg;Shinzo ABE.jpg;35069;35229;91169;1755;1763;8
/net/per610a/home/mvp/mvp_db/hodost-lv/2017/2017_09_25_04_56/2017_09_25_21_54.mpg;Shinzo ABE.jpg;35997;36273;91169;1801;1815;14
/net/per610a/home/mvp/mvp_db/hodost-lv/2017/2017_09_25_04_56/2017_09_25_21_54.mpg;Shinzo ABE.jpg;36441;36629;91169;1823;1833;10
/net/per610a/home/mvp/mvp_db/hodost-lv/2017/2017_09_25_04_56/2017_09_25_21_54.mpg;Shinzo ABE.jpg;37057;37429;91169;1854;1873;19
/net/per610a/home/mvp/mvp_db/hodost-lv/2017/2017_09_26_04_56/2017_09_26_21_54.mpg;YUriko Koike.jpg;1041;1241;91169;52;62;10
/net/per610a/home/mvp/mvp_db/hodost-lv/2017/2017_09_26_04_56/2017_09_26_21_54.mpg;YUriko Koike.jpg;5437;5453;91169;272;272;0
/net/per610a/home/mvp/mvp_db/hodost-lv/2017/2017_09_26_04_56/2017_09_26_21_54.mpg;YUriko Koike.jpg;11157;11329;91169;558;567;9
/net/per610a/home/mvp/mvp_db/hodost-lv/2017/2017_09_26_04_56/2017_09_26_21_54.mpg;YUriko Koike.jpg;11757;11861;91169;588;593;5
/net/per610a/home/mvp/mvp_db/hodost-lv/2017/2017_09_26_04_56/2017_09_26_21_54.mpg;YUriko Koike.jpg;16089;16125;91169;805;807;2
/net/per610a/home/mvp/mvp_db/hodost-lv/2017/2017_09_26_04_56/2017_09_26_21_54.mpg;Shinzo ABE.jpg;4733;5217;91169;236;261;25
/net/per610a/home/mvp/mvp_db/hodost-lv/2017/2017_09_26_04_56/2017_09_26_21_54.mpg;Shinzo ABE.jpg;5905;6033;91169;295;301;6
/net/per610a/home/mvp/mvp_db/hodost-lv/2017/2017_09_26_04_56/2017_09_26_21_54.mpg;Seiji MAEHARA.jpg;9345;9401;91169;467;470;3
/net/per610a/home/mvp/mvp_db/hodost-lv/2017/2017_09_26_04_56/2017_09_26_21_54.mpg;Seiji MAEHARA.jpg;11145;11329;91169;557;567;10
/net/per610a/home/mvp/mvp_db/hodost-lv/2017/2017_09_26_04_56/2017_09_26_21_54.mpg;Kazuo SHII.jpg;11185;11333;91169;559;567;8
/net/per610a/home/mvp/mvp_db/hodost-lv/2017/2017_09_26_04_56/2017_09_26_21_54.mpg;Ichiro OZAWA.jpg;11345;11533;91169;567;577;10
/net/per610a/home/mvp/mvp_db/hodost-lv/2017/2017_09_26_04_56/2017_09_26_21_54.mpg;YUriko Koike.jpg;16329;16513;91169;817;826;9
/net/per610a/home/mvp/mvp_db/hodost-lv/2017/2017_09_27_04_56/2017_09_27_21_54.mpg;YUriko Koike.jpg;653;1513;91169;32;75;43
/net/per610a/home/mvp/mvp_db/hodost-lv/2017/2017_09_27_04_56/2017_09_27_21_54.mpg;YUriko Koike.jpg;1789;1925;91169;89;96;7
/net/per610a/home/mvp/mvp_db/hodost-lv/2017/2017_09_27_04_56/2017_09_27_21_54.mpg;YUriko Koike.jpg;6109;6209;91169;305;310;5
/net/per610a/home/mvp/mvp_db/hodost-lv/2017/2017_09_27_04_56/2017_09_27_21_54.mpg;YUriko Koike.jpg;7569;7785;91169;378;389;11
/net/per610a/home/mvp/mvp_db/hodost-lv/2017/2017_09_27_04_56/2017_09_27_21_54.mpg;YUriko Koike.jpg;9057;9109;91169;453;455;2
/net/per610a/home/mvp/mvp_db/hodost-lv/2017/2017_09_27_04_56/2017_09_27_21_54.mpg;YUriko Koike.jpg;11557;11757;91169;578;588;10
/net/per610a/home/mvp/mvp_db/hodost-lv/2017/2017_09_27_04_56/2017_09_27_21_54.mpg;YUriko Koike.jpg;12821;12837;91169;641;642;1
/net/per610a/home/mvp/mvp_db/hodost-lv/2017/2017_09_27_04_56/2017_09_27_21_54.mpg;YUriko Koike.jpg;5157;5165;91169;258;258;0
/net/per610a/home/mvp/mvp_db/hodost-lv/2017/2017_09_27_04_56/2017_09_27_21_54.mpg;YUriko Koike.jpg;6913;6965;91169;345;348;3
/net/per610a/home/mvp/mvp_db/hodost-lv/2017/2017_09_27_04_56/2017_09_27_21_54.mpg;YUriko Koike.jpg;15877;15945;91169;794;798;4
/net/per610a/home/mvp/mvp_db/hodost-lv/2017/2017_09_27_04_56/2017_09_27_21_54.mpg;YUriko Koike.jpg;16425;16473;91169;822;824;2
/net/per610a/home/mvp/mvp_db/hodost-lv/2017/2017_09_27_04_56/2017_09_27_21_54.mpg;YUriko Koike.jpg;16537;17577;91169;827;879;52
/net/per610a/home/mvp/mvp_db/hodost-lv/2017/2017_09_27_04_56/2017_09_27_21_54.mpg;Kazuo SHII.jpg;15053;15597;91169;753;780;27
/net/per610a/home/mvp/mvp_db/hodost-lv/2017/2017_09_28_04_56/2017_09_28_21_54.mpg;Shinzo ABE.jpg;4469;4521;91169;223;226;3
/net/per610a/home/mvp/mvp_db/hodost-lv/2017/2017_09_28_04_56/2017_09_28_21_54.mpg;Shinzo ABE.jpg;4857;4961;91169;243;248;5
/net/per610a/home/mvp/mvp_db/hodost-lv/2017/2017_09_28_04_56/2017_09_28_21_54.mpg;Shinzo ABE.jpg;7033;7525;91169;352;376;24
/net/per610a/home/mvp/mvp_db/hodost-lv/2017/2017_09_28_04_56/2017_09_28_21_54.mpg;Ichiro OZAWA.jpg;6265;6973;91169;313;348;35
/net/per610a/home/mvp/mvp_db/hodost-lv/2017/2017_09_28_04_56/2017_09_28_21_54.mpg;Ichiro Matsui.jpeg;9017;9237;91169;451;462;11
/net/per610a/home/mvp/mvp_db/hodost-lv/2017/2017_09_28_04_56/2017_09_28_21_54.mpg;YUriko Koike.jpg;9445;9741;91169;472;487;15
/net/per610a/home/mvp/mvp_db/hodost-lv/2017/2017_09_28_04_56/2017_09_28_21_54.mpg;YUriko Koike.jpg;11853;12253;91169;593;613;20
/net/per610a/home/mvp/mvp_db/hodost-lv/2017/2017_09_28_04_56/2017_09_28_21_54.mpg;YUriko Koike.jpg;16141;16941;91169;807;847;40
/net/per610a/home/mvp/mvp_db/hodost-lv/2017/2017_09_28_04_56/2017_09_28_21_54.mpg;YUriko Koike.jpg;29753;30289;91169;1489;1515;26
/net/per610a/home/mvp/mvp_db/hodost-lv/2017/2017_09_28_04_56/2017_09_28_21_54.mpg;YUriko Koike.jpg;31065;31441;91169;1554;1573;19
/net/per610a/home/mvp/mvp_db/hodost-lv/2017/2017_09_28_04_56/2017_09_28_21_54.mpg;Seiji MAEHARA.jpg;9809;9921;91169;490;496;6
/net/per610a/home/mvp/mvp_db/hodost-lv/2017/2017_09_28_04_56/2017_09_28_21_54.mpg;Seiji MAEHARA.jpg;10005;10441;91169;500;522;22
/net/per610a/home/mvp/mvp_db/hodost-lv/2017/2017_09_28_04_56/2017_09_28_21_54.mpg;Seiji MAEHARA.jpg;11477;11765;91169;574;588;14
/net/per610a/home/mvp/mvp_db/hodost-lv/2017/2017_09_28_04_56/2017_09_28_21_54.mpg;Seiji MAEHARA.jpg;14805;14845;91169;740;742;2
/net/per610a/home/mvp/mvp_db/hodost-lv/2017/2017_09_28_04_56/2017_09_28_21_54.mpg;Taro ASO.jpg;18197;18853;91169;910;943;33
/net/per610a/home/mvp/mvp_db/hodost-lv/2017/2017_09_28_04_56/2017_09_28_21_54.mpg;Kazuo SHII.jpg;18909;20025;91169;946;1002;56
/net/per610a/home/mvp/mvp_db/hodost-lv/2017/2017_09_29_04_56/2017_09_29_21_54.mpg;Seiji MAEHARA.jpg;4989;5977;91161;249;299;50
/net/per610a/home/mvp/mvp_db/hodost-lv/2017/2017_09_29_04_56/2017_09_29_21_54.mpg;Seiji MAEHARA.jpg;26205;26641;91161;1311;1333;22
/net/per610a/home/mvp/mvp_db/hodost-lv/2017/2017_09_29_04_56/2017_09_29_21_54.mpg;Shinzo ABE.jpg;6117;6993;91161;306;349;43
/net/per610a/home/mvp/mvp_db/hodost-lv/2017/2017_09_29_04_56/2017_09_29_21_54.mpg;Yoshihiko Noda.jpg;7953;8365;91161;397;418;21
/net/per610a/home/mvp/mvp_db/hodost-lv/2017/2017_09_29_04_56/2017_09_29_21_54.mpg;Yoshihiko Noda.jpg;22301;22337;91161;1116;1117;1
/net/per610a/home/mvp/mvp_db/hodost-lv/2017/2017_09_29_04_56/2017_09_29_21_54.mpg;Yoshihiko Noda.jpg;22561;22777;91161;1129;1139;10
/net/per610a/home/mvp/mvp_db/hodost-lv/2017/2017_09_29_04_56/2017_09_29_21_54.mpg;Naoto KAN.jpg;7953;8081;91161;397;404;7
/net/per610a/home/mvp/mvp_db/hodost-lv/2017/2017_09_29_04_56/2017_09_29_21_54.mpg;Ichiro Matsui.jpeg;14973;15249;91161;749;763;14
/net/per610a/home/mvp/mvp_db/hodost-lv/2017/2017_09_30_04_56/2017_09_30_20_54.mpg;YUriko Koike.jpg;1333;1449;71981;66;72;6
/net/per610a/home/mvp/mvp_db/hodost-lv/2017/2017_09_30_04_56/2017_09_30_20_54.mpg;YUriko Koike.jpg;4037;4113;71981;202;205;3
/net/per610a/home/mvp/mvp_db/hodost-lv/2017/2017_09_30_04_56/2017_09_30_20_54.mpg;YUriko Koike.jpg;20009;20101;71981;1001;1005;4
/net/per610a/home/mvp/mvp_db/hodost-lv/2017/2017_09_30_04_56/2017_09_30_20_54.mpg;YUriko Koike.jpg;2529;2549;71981;126;127;1
/net/per610a/home/mvp/mvp_db/hodost-lv/2017/2017_09_30_04_56/2017_09_30_20_54.mpg;YUriko Koike.jpg;7373;7425;71981;368;371;3
/net/per610a/home/mvp/mvp_db/hodost-lv/2017/2017_09_30_04_56/2017_09_30_20_54.mpg;YUriko Koike.jpg;13389;13641;71981;669;682;13
/net/per610a/home/mvp/mvp_db/hodost-lv/2017/2017_09_30_04_56/2017_09_30_20_54.mpg;Yoshihiko Noda.jpg;10833;11133;71981;542;557;15
/net/per610a/home/mvp/mvp_db/hodost-lv/2017/2017_09_30_04_56/2017_09_30_20_54.mpg;Kazuo SHII.jpg;11137;11365;71981;557;568;11
/net/per610a/home/mvp/mvp_db/hodost-lv/2017/2017_09_30_04_56/2017_09_30_20_54.mpg;Shinzo ABE.jpg;11901;12297;71981;595;615;20
/net/per610a/home/mvp/mvp_db/hodost-lv/2017/2017_09_30_04_56/2017_09_30_20_54.mpg;Shinzo ABE.jpg;15709;15829;71981;786;792;6
/net/per610a/home/mvp/mvp_db/hodost-lv/2017/2017_09_30_04_56/2017_09_30_20_54.mpg;Ichiro OZAWA.jpg;13509;13997;71981;676;700;24
/net/per610a/home/mvp/mvp_db/hodost-lv/2017/2017_09_30_04_56/2017_09_30_20_54.mpg;Ichiro OZAWA.jpg;16833;16925;71981;842;846;4
/net/per610a/home/mvp/mvp_db/hodost-lv/2017/2017_09_30_04_56/2017_09_30_20_54.mpg;Masashi Nakano.jpg;14061;14533;71981;703;727;24
/net/per610a/home/mvp/mvp_db/hodost-lv/2017/2017_09_30_04_56/2017_09_30_20_54.mpg;Natsuo YAMAGUCHI.jpg;15709;15829;71981;786;792;6
/net/per610a/home/mvp/mvp_db/hodost-lv/2017/2017_10_01_04_56/2017_10_01_20_54.mpg;YUriko Koike.jpg;2693;3565;71989;134;178;44
/net/per610a/home/mvp/mvp_db/hodost-lv/2017/2017_10_01_04_56/2017_10_01_20_54.mpg;YUriko Koike.jpg;4517;4737;71989;226;237;11
/net/per610a/home/mvp/mvp_db/hodost-lv/2017/2017_10_01_04_56/2017_10_01_20_54.mpg;YUriko Koike.jpg;5857;5909;71989;293;295;2
/net/per610a/home/mvp/mvp_db/hodost-lv/2017/2017_10_01_04_56/2017_10_01_20_54.mpg;YUriko Koike.jpg;15037;15257;71989;752;763;11
/net/per610a/home/mvp/mvp_db/hodost-lv/2017/2017_10_01_04_56/2017_10_01_20_54.mpg;YUriko Koike.jpg;15913;16013;71989;796;801;5
/net/per610a/home/mvp/mvp_db/hodost-lv/2017/2017_10_01_04_56/2017_10_01_20_54.mpg;YUriko Koike.jpg;16241;16465;71989;812;824;12
/net/per610a/home/mvp/mvp_db/hodost-lv/2017/2017_10_01_04_56/2017_10_01_20_54.mpg;YUriko Koike.jpg;18845;19065;71989;943;954;11
/net/per610a/home/mvp/mvp_db/hodost-lv/2017/2017_10_01_04_56/2017_10_01_20_54.mpg;YUriko Koike.jpg;19181;19325;71989;959;967;8
/net/per610a/home/mvp/mvp_db/hodost-lv/2017/2017_10_01_04_56/2017_10_01_20_54.mpg;YUriko Koike.jpg;19765;19881;71989;989;995;6
/net/per610a/home/mvp/mvp_db/hodost-lv/2017/2017_10_01_04_56/2017_10_01_20_54.mpg;Masashi Nakano.jpg;12105;12493;71989;605;625;20
/net/per610a/home/mvp/mvp_db/hodost-lv/2017/2017_10_01_04_56/2017_10_01_20_54.mpg;Seiji MAEHARA.jpg;14541;14553;71989;727;728;1
/net/per610a/home/mvp/mvp_db/hodost-lv/2017/2017_10_01_04_56/2017_10_01_20_54.mpg;Seiji MAEHARA.jpg;17613;17785;71989;881;890;9
/net/per610a/home/mvp/mvp_db/hodost-lv/2017/2017_10_01_04_56/2017_10_01_20_54.mpg;Seiji MAEHARA.jpg;17913;18145;71989;896;908;12
/net/per610a/home/mvp/mvp_db/hodost-lv/2017/2017_10_01_04_56/2017_10_01_20_54.mpg;Shinzo ABE.jpg;15913;16057;71989;796;803;7
/net/per610a/home/mvp/mvp_db/hodost-lv/2017/2017_10_01_04_56/2017_10_01_20_54.mpg;Shinzo ABE.jpg;16241;16353;71989;812;818;6
/net/per610a/home/mvp/mvp_db/hodost-lv/2017/2017_10_01_04_56/2017_10_01_20_54.mpg;Shinzo ABE.jpg;18845;18977;71989;943;949;6
/net/per610a/home/mvp/mvp_db/hodost-lv/2017/2017_10_01_04_56/2017_10_01_20_54.mpg;Shinzo ABE.jpg;19181;19325;71989;959;967;8
/net/per610a/home/mvp/mvp_db/hodost-lv/2017/2017_10_01_04_56/2017_10_01_20_54.mpg;Shinzo ABE.jpg;19765;19829;71989;989;992;3
/net/per610a/home/mvp/mvp_db/hodost-lv/2017/2017_10_01_04_56/2017_10_01_20_54.mpg;Shinzo ABE.jpg;20185;20289;71989;1010;1015;5
/net/per610a/home/mvp/mvp_db/hodost-lv/2017/2017_10_01_04_56/2017_10_01_20_54.mpg;Shinzo ABE.jpg;20425;20465;71989;1022;1024;2
/net/per610a/home/mvp/mvp_db/hodost-lv/2017/2017_10_02_04_56/2017_10_02_21_54.mpg;YUriko Koike.jpg;12197;12209;91169;610;611;1
/net/per610a/home/mvp/mvp_db/hodost-lv/2017/2017_10_02_04_56/2017_10_02_21_54.mpg;YUriko Koike.jpg;19893;20037;91169;995;1002;7
/net/per610a/home/mvp/mvp_db/hodost-lv/2017/2017_10_02_04_56/2017_10_02_21_54.mpg;YUriko Koike.jpg;20221;20285;91169;1012;1015;3
/net/per610a/home/mvp/mvp_db/hodost-lv/2017/2017_10_02_04_56/2017_10_02_21_54.mpg;YUriko Koike.jpg;20737;21201;91169;1037;1061;24
/net/per610a/home/mvp/mvp_db/hodost-lv/2017/2017_10_02_04_56/2017_10_02_21_54.mpg;YUriko Koike.jpg;24837;24873;91169;1243;1244;1
/net/per610a/home/mvp/mvp_db/hodost-lv/2017/2017_10_02_04_56/2017_10_02_21_54.mpg;Yukio EDANO.jpg;13221;13597;91169;661;680;19
/net/per610a/home/mvp/mvp_db/hodost-lv/2017/2017_10_02_04_56/2017_10_02_21_54.mpg;Yukio EDANO.jpg;14881;15385;91169;744;770;26
/net/per610a/home/mvp/mvp_db/hodost-lv/2017/2017_10_02_04_56/2017_10_02_21_54.mpg;Shinzo ABE.jpg;22617;23177;91169;1131;1160;29
/net/per610a/home/mvp/mvp_db/hodost-lv/2017/2017_10_03_04_56/2017_10_03_21_54.mpg;Ichiro OZAWA.jpg;7109;7497;91161;355;375;20
/net/per610a/home/mvp/mvp_db/hodost-lv/2017/2017_10_03_04_56/2017_10_03_21_54.mpg;YUriko Koike.jpg;7841;8413;91161;392;421;29
/net/per610a/home/mvp/mvp_db/hodost-lv/2017/2017_10_03_04_56/2017_10_03_21_54.mpg;YUriko Koike.jpg;9341;9925;91161;467;496;29
/net/per610a/home/mvp/mvp_db/hodost-lv/2017/2017_10_03_04_56/2017_10_03_21_54.mpg;YUriko Koike.jpg;25521;25813;91161;1277;1291;14
/net/per610a/home/mvp/mvp_db/hodost-lv/2017/2017_10_03_04_56/2017_10_03_21_54.mpg;YUriko Koike.jpg;26061;26221;91161;1304;1312;8
/net/per610a/home/mvp/mvp_db/hodost-lv/2017/2017_10_03_04_56/2017_10_03_21_54.mpg;YUriko Koike.jpg;26893;27757;91161;1345;1389;44
/net/per610a/home/mvp/mvp_db/hodost-lv/2017/2017_10_03_04_56/2017_10_03_21_54.mpg;YUriko Koike.jpg;29257;29501;91161;1464;1476;12
/net/per610a/home/mvp/mvp_db/hodost-lv/2017/2017_10_03_04_56/2017_10_03_21_54.mpg;YUriko Koike.jpg;30545;30813;91161;1528;1541;13
/net/per610a/home/mvp/mvp_db/hodost-lv/2017/2017_10_03_04_56/2017_10_03_21_54.mpg;YUriko Koike.jpg;31029;31285;91161;1552;1565;13
/net/per610a/home/mvp/mvp_db/hodost-lv/2017/2017_10_03_04_56/2017_10_03_21_54.mpg;YUriko Koike.jpg;8605;8649;91161;430;432;2
/net/per610a/home/mvp/mvp_db/hodost-lv/2017/2017_10_03_04_56/2017_10_03_21_54.mpg;YUriko Koike.jpg;26461;26597;91161;1324;1331;7
/net/per610a/home/mvp/mvp_db/hodost-lv/2017/2017_10_03_04_56/2017_10_03_21_54.mpg;Ichiro Matsui.jpeg;10017;10433;91161;501;522;21
/net/per610a/home/mvp/mvp_db/hodost-lv/2017/2017_10_03_04_56/2017_10_03_21_54.mpg;Yukio EDANO.jpg;11425;11845;91161;571;592;21
/net/per610a/home/mvp/mvp_db/hodost-lv/2017/2017_10_03_04_56/2017_10_03_21_54.mpg;Kazuo SHII.jpg;11909;12397;91161;595;620;25
/net/per610a/home/mvp/mvp_db/hodost-lv/2017/2017_10_03_04_56/2017_10_03_21_54.mpg;Natsuo YAMAGUCHI.jpg;14609;15245;91161;731;762;31
/net/per610a/home/mvp/mvp_db/hodost-lv/2017/2017_10_03_04_56/2017_10_03_21_54.mpg;Seiji MAEHARA.jpg;20301;20601;91161;1015;1030;15
/net/per610a/home/mvp/mvp_db/hodost-lv/2017/2017_10_03_04_56/2017_10_03_21_54.mpg;YUriko Koike.jpg;20301;20601;91161;1015;1030;15
/net/per610a/home/mvp/mvp_db/hodost-lv/2017/2017_10_04_04_56/2017_10_04_21_54.mpg;YUriko Koike.jpg;1077;1429;91169;53;71;18
/net/per610a/home/mvp/mvp_db/hodost-lv/2017/2017_10_04_04_56/2017_10_04_21_54.mpg;Shinzo ABE.jpg;1497;1501;91169;74;75;1
/net/per610a/home/mvp/mvp_db/hodost-lv/2017/2017_10_04_04_56/2017_10_04_21_54.mpg;Shinzo ABE.jpg;4229;4857;91169;211;243;32
/net/per610a/home/mvp/mvp_db/hodost-lv/2017/2017_10_04_04_56/2017_10_04_21_54.mpg;Shinzo ABE.jpg;10533;10933;91169;527;547;20
/net/per610a/home/mvp/mvp_db/hodost-lv/2017/2017_10_04_04_56/2017_10_04_21_54.mpg;Yukio EDANO.jpg;5433;5689;91169;271;284;13
/net/per610a/home/mvp/mvp_db/hodost-lv/2017/2017_10_04_04_56/2017_10_04_21_54.mpg;Kazuo SHII.jpg;6245;6525;91169;312;326;14
/net/per610a/home/mvp/mvp_db/hodost-lv/2017/2017_10_04_04_56/2017_10_04_21_54.mpg;Kazuo SHII.jpg;13965;14497;91169;698;725;27
/net/per610a/home/mvp/mvp_db/hodost-lv/2017/2017_10_04_04_56/2017_10_04_21_54.mpg;Seiji Mataichi.jpg;6245;6369;91169;312;318;6
/net/per610a/home/mvp/mvp_db/hodost-lv/2017/2017_10_04_04_56/2017_10_04_21_54.mpg;Seiji Mataichi.jpg;13965;14093;91169;698;705;7
/net/per610a/home/mvp/mvp_db/hodost-lv/2017/2017_10_05_04_56/2017_10_05_21_54.mpg;Shizuka KAMEI.jpg;22881;23161;91169;1145;1159;14
/net/per610a/home/mvp/mvp_db/hodost-lv/2017/2017_10_05_04_56/2017_10_05_21_54.mpg;Shizuka KAMEI.jpg;23857;24221;91169;1194;1212;18
/net/per610a/home/mvp/mvp_db/hodost-lv/2017/2017_10_05_04_56/2017_10_05_21_54.mpg;Shizuka KAMEI.jpg;24777;25053;91169;1240;1253;13
/net/per610a/home/mvp/mvp_db/hodost-lv/2017/2017_10_05_04_56/2017_10_05_21_54.mpg;Shinzo ABE.jpg;25121;25149;91169;1257;1258;1
/net/per610a/home/mvp/mvp_db/hodost-lv/2017/2017_10_05_04_56/2017_10_05_21_54.mpg;Shinzo ABE.jpg;25777;25845;91169;1290;1293;3
/net/per610a/home/mvp/mvp_db/hodost-lv/2017/2017_10_05_04_56/2017_10_05_21_54.mpg;Shinzo ABE.jpg;25265;25441;91169;1264;1273;9
/net/per610a/home/mvp/mvp_db/hodost-lv/2017/2017_10_05_04_56/2017_10_05_21_54.mpg;YUriko Koike.jpg;26173;26321;91169;1309;1317;8
/net/per610a/home/mvp/mvp_db/hodost-lv/2017/2017_10_05_04_56/2017_10_05_21_54.mpg;YUriko Koike.jpg;26477;26501;91169;1325;1326;1
/net/per610a/home/mvp/mvp_db/hodost-lv/2017/2017_10_05_04_56/2017_10_05_21_54.mpg;YUriko Koike.jpg;26993;26993;91169;1350;1350;0
/net/per610a/home/mvp/mvp_db/hodost-lv/2017/2017_10_05_04_56/2017_10_05_21_54.mpg;YUriko Koike.jpg;27073;27317;91169;1355;1367;12
/net/per610a/home/mvp/mvp_db/hodost-lv/2017/2017_10_05_04_56/2017_10_05_21_54.mpg;YUriko Koike.jpg;28053;28093;91169;1404;1406;2
/net/per610a/home/mvp/mvp_db/hodost-lv/2017/2017_10_05_04_56/2017_10_05_21_54.mpg;YUriko Koike.jpg;37357;37413;91169;1869;1872;3
/net/per610a/home/mvp/mvp_db/hodost-lv/2017/2017_10_05_04_56/2017_10_05_21_54.mpg;YUriko Koike.jpg;37577;37817;91169;1880;1892;12
/net/per610a/home/mvp/mvp_db/hodost-lv/2017/2017_10_05_04_56/2017_10_05_21_54.mpg;Natsuo YAMAGUCHI.jpg;34549;34889;91169;1729;1746;17
/net/per610a/home/mvp/mvp_db/hodost-lv/2017/2017_10_05_04_56/2017_10_05_21_54.mpg;Natsuo YAMAGUCHI.jpg;35009;35333;91169;1752;1768;16
/net/per610a/home/mvp/mvp_db/hodost-lv/2017/2017_10_05_04_56/2017_10_05_21_54.mpg;Masashi Nakano.jpg;35873;36049;91169;1795;1804;9
/net/per610a/home/mvp/mvp_db/hodost-lv/2017/2017_10_06_04_56/2017_10_06_21_54.mpg;YUriko Koike.jpg;25417;25481;91161;1271;1275;4
/net/per610a/home/mvp/mvp_db/hodost-lv/2017/2017_10_06_04_56/2017_10_06_21_54.mpg;YUriko Koike.jpg;25681;25781;91161;1285;1290;5
/net/per610a/home/mvp/mvp_db/hodost-lv/2017/2017_10_06_04_56/2017_10_06_21_54.mpg;YUriko Koike.jpg;25965;26225;91161;1299;1312;13
/net/per610a/home/mvp/mvp_db/hodost-lv/2017/2017_10_06_04_56/2017_10_06_21_54.mpg;YUriko Koike.jpg;27965;28213;91161;1399;1411;12
/net/per610a/home/mvp/mvp_db/hodost-lv/2017/2017_10_06_04_56/2017_10_06_21_54.mpg;Yukio EDANO.jpg;28461;28737;91161;1424;1438;14
/net/per610a/home/mvp/mvp_db/hodost-lv/2017/2017_10_06_04_56/2017_10_06_21_54.mpg;Yukio EDANO.jpg;28833;29277;91161;1442;1465;23
/net/per610a/home/mvp/mvp_db/hodost-lv/2017/2017_10_07_04_56/2017_10_07_21_54.mpg;Shinzo ABE.jpg;1149;1261;73189;57;63;6
/net/per610a/home/mvp/mvp_db/hodost-lv/2017/2017_10_07_04_56/2017_10_07_21_54.mpg;Shinzo ABE.jpg;2385;2585;73189;119;129;10
/net/per610a/home/mvp/mvp_db/hodost-lv/2017/2017_10_07_04_56/2017_10_07_21_54.mpg;Shinzo ABE.jpg;12949;13069;73189;648;654;6
/net/per610a/home/mvp/mvp_db/hodost-lv/2017/2017_10_07_04_56/2017_10_07_21_54.mpg;Shinzo ABE.jpg;13849;13917;73189;693;696;3
/net/per610a/home/mvp/mvp_db/hodost-lv/2017/2017_10_07_04_56/2017_10_07_21_54.mpg;YUriko Koike.jpg;1857;2301;73189;92;115;23
/net/per610a/home/mvp/mvp_db/hodost-lv/2017/2017_10_07_04_56/2017_10_07_21_54.mpg;YUriko Koike.jpg;10481;10569;73189;524;528;4
/net/per610a/home/mvp/mvp_db/hodost-lv/2017/2017_10_07_04_56/2017_10_07_21_54.mpg;YUriko Koike.jpg;10693;10701;73189;535;535;0
/net/per610a/home/mvp/mvp_db/hodost-lv/2017/2017_10_07_04_56/2017_10_07_21_54.mpg;YUriko Koike.jpg;10837;10841;73189;542;542;0
/net/per610a/home/mvp/mvp_db/hodost-lv/2017/2017_10_07_04_56/2017_10_07_21_54.mpg;YUriko Koike.jpg;10909;11077;73189;545;554;9
/net/per610a/home/mvp/mvp_db/hodost-lv/2017/2017_10_07_04_56/2017_10_07_21_54.mpg;YUriko Koike.jpg;11785;12141;73189;589;607;18
/net/per610a/home/mvp/mvp_db/hodost-lv/2017/2017_10_07_04_56/2017_10_07_21_54.mpg;YUriko Koike.jpg;12949;13069;73189;648;654;6
/net/per610a/home/mvp/mvp_db/hodost-lv/2017/2017_10_07_04_56/2017_10_07_21_54.mpg;YUriko Koike.jpg;13849;13917;73189;693;696;3
/net/per610a/home/mvp/mvp_db/hodost-lv/2017/2017_10_07_04_56/2017_10_07_21_54.mpg;Kazuo SHII.jpg;4377;8405;73189;219;420;201
/net/per610a/home/mvp/mvp_db/hodost-lv/2017/2017_10_08_04_56/2017_10_08_20_54.mpg;Shinzo ABE.jpg;4981;5697;71989;249;285;36
/net/per610a/home/mvp/mvp_db/hodost-lv/2017/2017_10_08_04_56/2017_10_08_20_54.mpg;Shinzo ABE.jpg;7501;8017;71989;375;401;26
/net/per610a/home/mvp/mvp_db/hodost-lv/2017/2017_10_08_04_56/2017_10_08_20_54.mpg;Shinzo ABE.jpg;8437;8689;71989;422;434;12
/net/per610a/home/mvp/mvp_db/hodost-lv/2017/2017_10_08_04_56/2017_10_08_20_54.mpg;Shinzo ABE.jpg;12621;12685;71989;631;634;3
/net/per610a/home/mvp/mvp_db/hodost-lv/2017/2017_10_08_04_56/2017_10_08_20_54.mpg;Shinzo ABE.jpg;13097;13557;71989;655;678;23
/net/per610a/home/mvp/mvp_db/hodost-lv/2017/2017_10_08_04_56/2017_10_08_20_54.mpg;Shinzo ABE.jpg;14033;14661;71989;702;733;31
/net/per610a/home/mvp/mvp_db/hodost-lv/2017/2017_10_08_04_56/2017_10_08_20_54.mpg;Shinzo ABE.jpg;17813;18489;71989;891;925;34
/net/per610a/home/mvp/mvp_db/hodost-lv/2017/2017_10_08_04_56/2017_10_08_20_54.mpg;Shinzo ABE.jpg;19469;19881;71989;974;995;21
/net/per610a/home/mvp/mvp_db/hodost-lv/2017/2017_10_08_04_56/2017_10_08_20_54.mpg;Shinzo ABE.jpg;20801;20897;71989;1041;1045;4
/net/per610a/home/mvp/mvp_db/hodost-lv/2017/2017_10_08_04_56/2017_10_08_20_54.mpg;Shinzo ABE.jpg;21097;21453;71989;1055;1073;18
/net/per610a/home/mvp/mvp_db/hodost-lv/2017/2017_10_08_04_56/2017_10_08_20_54.mpg;Shinzo ABE.jpg;21729;21977;71989;1087;1099;12
/net/per610a/home/mvp/mvp_db/hodost-lv/2017/2017_10_08_04_56/2017_10_08_20_54.mpg;YUriko Koike.jpg;7065;7177;71989;353;359;6
/net/per610a/home/mvp/mvp_db/hodost-lv/2017/2017_10_08_04_56/2017_10_08_20_54.mpg;YUriko Koike.jpg;7309;7357;71989;365;368;3
/net/per610a/home/mvp/mvp_db/hodost-lv/2017/2017_10_08_04_56/2017_10_08_20_54.mpg;YUriko Koike.jpg;9561;11205;71989;478;560;82
/net/per610a/home/mvp/mvp_db/hodost-lv/2017/2017_10_08_04_56/2017_10_08_20_54.mpg;YUriko Koike.jpg;11373;11497;71989;569;575;6
/net/per610a/home/mvp/mvp_db/hodost-lv/2017/2017_10_08_04_56/2017_10_08_20_54.mpg;YUriko Koike.jpg;15885;15997;71989;795;800;5
/net/per610a/home/mvp/mvp_db/hodost-lv/2017/2017_10_08_04_56/2017_10_08_20_54.mpg;YUriko Koike.jpg;16173;18489;71989;809;925;116
/net/per610a/home/mvp/mvp_db/hodost-lv/2017/2017_10_08_04_56/2017_10_08_20_54.mpg;YUriko Koike.jpg;19469;19881;71989;974;995;21
/net/per610a/home/mvp/mvp_db/hodost-lv/2017/2017_10_08_04_56/2017_10_08_20_54.mpg;YUriko Koike.jpg;20801;20897;71989;1041;1045;4
/net/per610a/home/mvp/mvp_db/hodost-lv/2017/2017_10_08_04_56/2017_10_08_20_54.mpg;YUriko Koike.jpg;21097;21977;71989;1055;1099;44
/net/per610a/home/mvp/mvp_db/hodost-lv/2017/2017_10_08_04_56/2017_10_08_20_54.mpg;Kazuo SHII.jpg;8157;8421;71989;408;421;13
/net/per610a/home/mvp/mvp_db/hodost-lv/2017/2017_10_08_04_56/2017_10_08_20_54.mpg;Kazuo SHII.jpg;13641;14009;71989;682;701;19
/net/per610a/home/mvp/mvp_db/hodost-lv/2017/2017_10_08_04_56/2017_10_08_20_54.mpg;Kazuo SHII.jpg;18073;18489;71989;904;925;21
/net/per610a/home/mvp/mvp_db/hodost-lv/2017/2017_10_08_04_56/2017_10_08_20_54.mpg;Kazuo SHII.jpg;18673;18957;71989;934;948;14
/net/per610a/home/mvp/mvp_db/hodost-lv/2017/2017_10_08_04_56/2017_10_08_20_54.mpg;Kazuo SHII.jpg;19469;19881;71989;974;995;21
/net/per610a/home/mvp/mvp_db/hodost-lv/2017/2017_10_08_04_56/2017_10_08_20_54.mpg;Kazuo SHII.jpg;20801;20897;71989;1041;1045;4
/net/per610a/home/mvp/mvp_db/hodost-lv/2017/2017_10_08_04_56/2017_10_08_20_54.mpg;Kazuo SHII.jpg;21097;21453;71989;1055;1073;18
/net/per610a/home/mvp/mvp_db/hodost-lv/2017/2017_10_08_04_56/2017_10_08_20_54.mpg;Tadatomo Yoshida.jpg;8745;9125;71989;437;456;19
/net/per610a/home/mvp/mvp_db/hodost-lv/2017/2017_10_08_04_56/2017_10_08_20_54.mpg;Natsuo YAMAGUCHI.jpg;9313;9541;71989;466;477;11
/net/per610a/home/mvp/mvp_db/hodost-lv/2017/2017_10_08_04_56/2017_10_08_20_54.mpg;Natsuo YAMAGUCHI.jpg;15149;15345;71989;758;768;10
/net/per610a/home/mvp/mvp_db/hodost-lv/2017/2017_10_08_04_56/2017_10_08_20_54.mpg;Yukio EDANO.jpg;15417;15617;71989;771;781;10
/net/per610a/home/mvp/mvp_db/hodost-lv/2017/2017_10_08_04_56/2017_10_08_20_54.mpg;Yukio EDANO.jpg;18673;18853;71989;934;943;9
/net/per610a/home/mvp/mvp_db/hodost-lv/2017/2017_10_09_04_56/2017_10_09_21_54.mpg;YUriko Koike.jpg;25857;26189;91169;1294;1310;16
/net/per610a/home/mvp/mvp_db/hodost-lv/2017/2017_10_09_04_56/2017_10_09_21_54.mpg;YUriko Koike.jpg;26401;26501;91169;1321;1326;5
/net/per610a/home/mvp/mvp_db/hodost-lv/2017/2017_10_09_04_56/2017_10_09_21_54.mpg;YUriko Koike.jpg;26569;26617;91169;1329;1332;3
/net/per610a/home/mvp/mvp_db/hodost-lv/2017/2017_10_09_04_56/2017_10_09_21_54.mpg;YUriko Koike.jpg;26309;26449;91169;1316;1323;7
/net/per610a/home/mvp/mvp_db/hodost-lv/2017/2017_10_09_04_56/2017_10_09_21_54.mpg;Shinzo ABE.jpg;26557;26617;91169;1329;1332;3
/net/per610a/home/mvp/mvp_db/hodost-lv/2017/2017_10_09_04_56/2017_10_09_21_54.mpg;Shinzo ABE.jpg;27825;27833;91169;1392;1393;1
/net/per610a/home/mvp/mvp_db/hodost-lv/2017/2017_10_09_04_56/2017_10_09_21_54.mpg;Shinzo ABE.jpg;27973;28137;91169;1400;1408;8
/net/per610a/home/mvp/mvp_db/hodost-lv/2017/2017_10_09_04_56/2017_10_09_21_54.mpg;Shinzo ABE.jpg;28261;28653;91169;1414;1434;20
/net/per610a/home/mvp/mvp_db/hodost-lv/2017/2017_10_09_04_56/2017_10_09_21_54.mpg;Seiji Mataichi.jpg;29789;30605;91169;1490;1531;41
/net/per610a/home/mvp/mvp_db/hodost-lv/2017/2017_10_10_04_56/2017_10_10_21_54.mpg;Shinzo ABE.jpg;13509;14289;91169;676;715;39
/net/per610a/home/mvp/mvp_db/hodost-lv/2017/2017_10_10_04_56/2017_10_10_21_54.mpg;Kazuo SHII.jpg;15957;16589;91169;798;830;32
/net/per610a/home/mvp/mvp_db/hodost-lv/2017/2017_10_10_04_56/2017_10_10_21_54.mpg;Yukio EDANO.jpg;16709;17361;91169;836;868;32
/net/per610a/home/mvp/mvp_db/hodost-lv/2017/2017_10_10_04_56/2017_10_10_21_54.mpg;Masashi Nakano.jpg;18873;19217;91169;944;961;17
/net/per610a/home/mvp/mvp_db/hodost-lv/2017/2017_10_11_04_56/2017_10_11_21_54.mpg;Shinzo ABE.jpg;10281;11057;91169;514;553;39
/net/per610a/home/mvp/mvp_db/hodost-lv/2017/2017_10_11_04_56/2017_10_11_21_54.mpg;Shinzo ABE.jpg;11509;13429;91169;576;672;96
/net/per610a/home/mvp/mvp_db/hodost-lv/2017/2017_10_11_04_56/2017_10_11_21_54.mpg;Shinzo ABE.jpg;15441;15497;91169;772;775;3
/net/per610a/home/mvp/mvp_db/hodost-lv/2017/2017_10_11_04_56/2017_10_11_21_54.mpg;Shinzo ABE.jpg;15705;16545;91169;786;828;42
/net/per610a/home/mvp/mvp_db/hodost-lv/2017/2017_10_11_04_56/2017_10_11_21_54.mpg;Shinzo ABE.jpg;16653;17157;91169;833;858;25
/net/per610a/home/mvp/mvp_db/hodost-lv/2017/2017_10_11_04_56/2017_10_11_21_54.mpg;Shinzo ABE.jpg;17281;17709;91169;864;886;22
/net/per610a/home/mvp/mvp_db/hodost-lv/2017/2017_10_11_04_56/2017_10_11_21_54.mpg;Shinzo ABE.jpg;17813;18253;91169;891;913;22
/net/per610a/home/mvp/mvp_db/hodost-lv/2017/2017_10_11_04_56/2017_10_11_21_54.mpg;Shinzo ABE.jpg;20797;20953;91169;1040;1048;8
/net/per610a/home/mvp/mvp_db/hodost-lv/2017/2017_10_11_04_56/2017_10_11_21_54.mpg;Shinzo ABE.jpg;21189;21397;91169;1060;1070;10
/net/per610a/home/mvp/mvp_db/hodost-lv/2017/2017_10_11_04_56/2017_10_11_21_54.mpg;Shinzo ABE.jpg;21657;21749;91169;1083;1088;5
/net/per610a/home/mvp/mvp_db/hodost-lv/2017/2017_10_11_04_56/2017_10_11_21_54.mpg;Shinzo ABE.jpg;22401;22853;91169;1121;1143;22
/net/per610a/home/mvp/mvp_db/hodost-lv/2017/2017_10_11_04_56/2017_10_11_21_54.mpg;Shinzo ABE.jpg;24729;24905;91169;1237;1246;9
/net/per610a/home/mvp/mvp_db/hodost-lv/2017/2017_10_11_04_56/2017_10_11_21_54.mpg;Shinzo ABE.jpg;25033;25469;91169;1252;1274;22
/net/per610a/home/mvp/mvp_db/hodost-lv/2017/2017_10_11_04_56/2017_10_11_21_54.mpg;Shinzo ABE.jpg;26793;27057;91169;1340;1354;14
/net/per610a/home/mvp/mvp_db/hodost-lv/2017/2017_10_11_04_56/2017_10_11_21_54.mpg;Shinzo ABE.jpg;27221;27677;91169;1362;1385;23
/net/per610a/home/mvp/mvp_db/hodost-lv/2017/2017_10_11_04_56/2017_10_11_21_54.mpg;Shinzo ABE.jpg;27809;28045;91169;1391;1403;12
/net/per610a/home/mvp/mvp_db/hodost-lv/2017/2017_10_11_04_56/2017_10_11_21_54.mpg;Shinzo ABE.jpg;28117;28537;91169;1407;1428;21
/net/per610a/home/mvp/mvp_db/hodost-lv/2017/2017_10_11_04_56/2017_10_11_21_54.mpg;Shinzo ABE.jpg;30017;30341;91169;1502;1518;16
/net/per610a/home/mvp/mvp_db/hodost-lv/2017/2017_10_11_04_56/2017_10_11_21_54.mpg;Shinzo ABE.jpg;30473;30681;91169;1525;1535;10
/net/per610a/home/mvp/mvp_db/hodost-lv/2017/2017_10_11_04_56/2017_10_11_21_54.mpg;Shinzo ABE.jpg;31333;32485;91169;1568;1625;57
/net/per610a/home/mvp/mvp_db/hodost-lv/2017/2017_10_11_04_56/2017_10_11_21_54.mpg;Shinzo ABE.jpg;35693;36097;91169;1786;1806;20
/net/per610a/home/mvp/mvp_db/hodost-lv/2017/2017_10_11_04_56/2017_10_11_21_54.mpg;Shinzo ABE.jpg;38513;39033;91169;1927;1953;26
/net/per610a/home/mvp/mvp_db/hodost-lv/2017/2017_10_11_04_56/2017_10_11_21_54.mpg;Shinzo ABE.jpg;39209;40173;91169;1962;2010;48
/net/per610a/home/mvp/mvp_db/hodost-lv/2017/2017_10_11_04_56/2017_10_11_21_54.mpg;Shinzo ABE.jpg;40297;41141;91169;2016;2059;43
/net/per610a/home/mvp/mvp_db/hodost-lv/2017/2017_10_11_04_56/2017_10_11_21_54.mpg;Shinzo ABE.jpg;43205;43229;91169;2162;2163;1
/net/per610a/home/mvp/mvp_db/hodost-lv/2017/2017_10_11_04_56/2017_10_11_21_54.mpg;Shinzo ABE.jpg;43853;44821;91169;2194;2243;49
/net/per610a/home/mvp/mvp_db/hodost-lv/2017/2017_10_11_04_56/2017_10_11_21_54.mpg;Shinzo ABE.jpg;45037;45177;91169;2254;2261;7
/net/per610a/home/mvp/mvp_db/hodost-lv/2017/2017_10_11_04_56/2017_10_11_21_54.mpg;Shinzo ABE.jpg;49445;51625;91169;2474;2583;109
/net/per610a/home/mvp/mvp_db/hodost-lv/2017/2017_10_11_04_56/2017_10_11_21_54.mpg;Shinzo ABE.jpg;51745;52421;91169;2589;2623;34
/net/per610a/home/mvp/mvp_db/hodost-lv/2017/2017_10_11_04_56/2017_10_11_21_54.mpg;Shinzo ABE.jpg;52493;52665;91169;2627;2635;8
/net/per610a/home/mvp/mvp_db/hodost-lv/2017/2017_10_11_04_56/2017_10_11_21_54.mpg;Shinzo ABE.jpg;52981;53225;91169;2651;2663;12
/net/per610a/home/mvp/mvp_db/hodost-lv/2017/2017_10_11_04_56/2017_10_11_21_54.mpg;Shinzo ABE.jpg;53457;53593;91169;2675;2682;7
/net/per610a/home/mvp/mvp_db/hodost-lv/2017/2017_10_11_04_56/2017_10_11_21_54.mpg;Shinzo ABE.jpg;55741;56017;91169;2789;2803;14
/net/per610a/home/mvp/mvp_db/hodost-lv/2017/2017_10_11_04_56/2017_10_11_21_54.mpg;Shinzo ABE.jpg;56165;56849;91169;2811;2845;34
/net/per610a/home/mvp/mvp_db/hodost-lv/2017/2017_10_11_04_56/2017_10_11_21_54.mpg;Shinzo ABE.jpg;58125;58125;91169;2909;2909;0
/net/per610a/home/mvp/mvp_db/hodost-lv/2017/2017_10_11_04_56/2017_10_11_21_54.mpg;Shinzo ABE.jpg;58885;59165;91169;2947;2961;14
/net/per610a/home/mvp/mvp_db/hodost-lv/2017/2017_10_11_04_56/2017_10_11_21_54.mpg;Shinzo ABE.jpg;59893;59981;91169;2997;3002;5
/net/per610a/home/mvp/mvp_db/hodost-lv/2017/2017_10_11_04_56/2017_10_11_21_54.mpg;Shinzo ABE.jpg;60049;60293;91169;3005;3017;12
/net/per610a/home/mvp/mvp_db/hodost-lv/2017/2017_10_11_04_56/2017_10_11_21_54.mpg;Shinzo ABE.jpg;60385;60517;91169;3022;3028;6
/net/per610a/home/mvp/mvp_db/hodost-lv/2017/2017_10_11_04_56/2017_10_11_21_54.mpg;Shinzo ABE.jpg;64809;64965;91169;3243;3251;8
/net/per610a/home/mvp/mvp_db/hodost-lv/2017/2017_10_11_04_56/2017_10_11_21_54.mpg;Shinzo ABE.jpg;65213;65233;91169;3263;3264;1
/net/per610a/home/mvp/mvp_db/hodost-lv/2017/2017_10_11_04_56/2017_10_11_21_54.mpg;Shinzo ABE.jpg;65329;65929;91169;3269;3299;30
/net/per610a/home/mvp/mvp_db/hodost-lv/2017/2017_10_11_04_56/2017_10_11_21_54.mpg;Shinzo ABE.jpg;66033;66077;91169;3304;3307;3
/net/per610a/home/mvp/mvp_db/hodost-lv/2017/2017_10_11_04_56/2017_10_11_21_54.mpg;Shinzo ABE.jpg;66589;67097;91169;3332;3358;26
/net/per610a/home/mvp/mvp_db/hodost-lv/2017/2017_10_11_04_56/2017_10_11_21_54.mpg;Kazuo SHII.jpg;22313;22985;91169;1116;1150;34
/net/per610a/home/mvp/mvp_db/hodost-lv/2017/2017_10_11_04_56/2017_10_11_21_54.mpg;Kazuo SHII.jpg;23201;23461;91169;1161;1174;13
/net/per610a/home/mvp/mvp_db/hodost-lv/2017/2017_10_11_04_56/2017_10_11_21_54.mpg;Kazuo SHII.jpg;23565;23649;91169;1179;1183;4
/net/per610a/home/mvp/mvp_db/hodost-lv/2017/2017_10_11_04_56/2017_10_11_21_54.mpg;Kazuo SHII.jpg;43437;43561;91169;2174;2180;6
/net/per610a/home/mvp/mvp_db/hodost-lv/2017/2017_10_11_04_56/2017_10_11_21_54.mpg;Kazuo SHII.jpg;43689;44821;91169;2186;2243;57
/net/per610a/home/mvp/mvp_db/hodost-lv/2017/2017_10_11_04_56/2017_10_11_21_54.mpg;Kazuo SHII.jpg;56165;56977;91169;2811;2851;40
/net/per610a/home/mvp/mvp_db/hodost-lv/2017/2017_10_11_04_56/2017_10_11_21_54.mpg;Kazuo SHII.jpg;57141;57217;91169;2859;2863;4
/net/per610a/home/mvp/mvp_db/hodost-lv/2017/2017_10_11_04_56/2017_10_11_21_54.mpg;Yukio EDANO.jpg;23777;23853;91169;1190;1193;3
/net/per610a/home/mvp/mvp_db/hodost-lv/2017/2017_10_11_04_56/2017_10_11_21_54.mpg;Yukio EDANO.jpg;23965;24265;91169;1199;1214;15
/net/per610a/home/mvp/mvp_db/hodost-lv/2017/2017_10_11_04_56/2017_10_11_21_54.mpg;Yukio EDANO.jpg;55013;55341;91169;2753;2769;16
/net/per610a/home/mvp/mvp_db/hodost-lv/2017/2017_10_11_04_56/2017_10_11_21_54.mpg;Yukio EDANO.jpg;55445;55525;91169;2775;2779;4
/net/per610a/home/mvp/mvp_db/hodost-lv/2017/2017_10_11_04_56/2017_10_11_21_54.mpg;Yukio EDANO.jpg;55741;56017;91169;2789;2803;14
/net/per610a/home/mvp/mvp_db/hodost-lv/2017/2017_10_11_04_56/2017_10_11_21_54.mpg;Natsuo YAMAGUCHI.jpg;34741;34961;91169;1738;1749;11
/net/per610a/home/mvp/mvp_db/hodost-lv/2017/2017_10_11_04_56/2017_10_11_21_54.mpg;Natsuo YAMAGUCHI.jpg;54581;54701;91169;2731;2737;6
/net/per610a/home/mvp/mvp_db/hodost-lv/2017/2017_10_11_04_56/2017_10_11_21_54.mpg;Masashi Nakano.jpg;41213;41461;91169;2062;2075;13
/net/per610a/home/mvp/mvp_db/hodost-lv/2017/2017_10_12_04_56/2017_10_12_22_09.mpg;Shinzo ABE.jpg;71969;72241;91169;3602;3615;13
/net/per610a/home/mvp/mvp_db/hodost-lv/2017/2017_10_16_04_56/2017_10_16_21_54.mpg;Kazuo SHII.jpg;2989;3125;91169;149;156;7
/net/per610a/home/mvp/mvp_db/hodost-lv/2017/2017_10_16_04_56/2017_10_16_21_54.mpg;Kazuo SHII.jpg;18037;18113;91169;902;906;4
/net/per610a/home/mvp/mvp_db/hodost-lv/2017/2017_10_17_04_56/2017_10_17_21_54.mpg;YUriko Koike.jpg;40189;40353;91169;2011;2019;8
/net/per610a/home/mvp/mvp_db/hodost-lv/2017/2017_10_18_04_56/2017_10_18_22_24.mpg;Natsuo YAMAGUCHI.jpg;14665;14905;91169;733;745;12
/net/per610a/home/mvp/mvp_db/hodost-lv/2017/2017_10_18_04_56/2017_10_18_22_24.mpg;Natsuo YAMAGUCHI.jpg;18313;18393;91169;916;920;4
/net/per610a/home/mvp/mvp_db/hodost-lv/2017/2017_10_18_04_56/2017_10_18_22_24.mpg;Shinzo ABE.jpg;14665;14765;91169;733;738;5
/net/per610a/home/mvp/mvp_db/hodost-lv/2017/2017_10_18_04_56/2017_10_18_22_24.mpg;Shinzo ABE.jpg;18169;18309;91169;909;916;7
/net/per610a/home/mvp/mvp_db/hodost-lv/2017/2017_10_19_04_56/2017_10_19_22_09.mpg;Shinzo ABE.jpg;26993;27873;91169;1350;1395;45
/net/per610a/home/mvp/mvp_db/hodost-lv/2017/2017_10_20_04_56/2017_10_20_21_54.mpg;Masashi Nakano.jpg;21277;21425;91169;1064;1072;8
/net/per610a/home/mvp/mvp_db/hodost-lv/2017/2017_10_20_04_56/2017_10_20_21_54.mpg;Kyoko Nakayama.jpg;31461;31569;91169;1574;1580;6
/net/per610a/home/mvp/mvp_db/hodost-lv/2017/2017_10_20_04_56/2017_10_20_21_54.mpg;Kyoko Nakayama.jpg;35329;35401;91169;1768;1771;3
/net/per610a/home/mvp/mvp_db/hodost-lv/2017/2017_10_21_04_56/2017_10_21_21_30.mpg;Ichiro Matsui.jpeg;47917;48437;71989;2398;2424;26
/net/per610a/home/mvp/mvp_db/hodost-lv/2017/2017_10_23_04_56/2017_10_23_21_54.mpg;Shinzo ABE.jpg;14301;14393;91169;715;720;5
/net/per610a/home/mvp/mvp_db/hodost-lv/2017/2017_10_23_04_56/2017_10_23_21_54.mpg;Shinzo ABE.jpg;20689;20785;91169;1035;1040;5
/net/per610a/home/mvp/mvp_db/hodost-lv/2017/2017_10_23_04_56/2017_10_23_21_54.mpg;Shinzo ABE.jpg;21085;21525;91169;1055;1077;22
/net/per610a/home/mvp/mvp_db/hodost-lv/2017/2017_10_23_04_56/2017_10_23_21_54.mpg;Shinzo ABE.jpg;25969;26017;91169;1299;1302;3
/net/per610a/home/mvp/mvp_db/hodost-lv/2017/2017_10_23_04_56/2017_10_23_21_54.mpg;Shinzo ABE.jpg;26193;26457;91169;1310;1324;14
/net/per610a/home/mvp/mvp_db/hodost-lv/2017/2017_10_23_04_56/2017_10_23_21_54.mpg;Shinzo ABE.jpg;26589;26741;91169;1330;1338;8
/net/per610a/home/mvp/mvp_db/hodost-lv/2017/2017_10_23_04_56/2017_10_23_21_54.mpg;Shinzo ABE.jpg;37857;38109;91169;1894;1907;13
/net/per610a/home/mvp/mvp_db/hodost-lv/2017/2017_10_23_04_56/2017_10_23_21_54.mpg;Shinzo ABE.jpg;46977;47053;91169;2351;2354;3
/net/per610a/home/mvp/mvp_db/hodost-lv/2017/2017_10_23_04_56/2017_10_23_21_54.mpg;Shinzo ABE.jpg;14533;14597;91169;727;730;3
/net/per610a/home/mvp/mvp_db/hodost-lv/2017/2017_10_23_04_56/2017_10_23_21_54.mpg;Shinzo ABE.jpg;15565;15593;91169;779;780;1
/net/per610a/home/mvp/mvp_db/hodost-lv/2017/2017_10_23_04_56/2017_10_23_21_54.mpg;Shinzo ABE.jpg;15709;15713;91169;786;786;0
/net/per610a/home/mvp/mvp_db/hodost-lv/2017/2017_10_23_04_56/2017_10_23_21_54.mpg;Shinzo ABE.jpg;17865;18413;91169;894;921;27
/net/per610a/home/mvp/mvp_db/hodost-lv/2017/2017_10_23_04_56/2017_10_23_21_54.mpg;Shinzo ABE.jpg;18585;19229;91169;930;962;32
/net/per610a/home/mvp/mvp_db/hodost-lv/2017/2017_10_23_04_56/2017_10_23_21_54.mpg;Shinzo ABE.jpg;19361;19817;91169;969;991;22
/net/per610a/home/mvp/mvp_db/hodost-lv/2017/2017_10_23_04_56/2017_10_23_21_54.mpg;Shinzo ABE.jpg;19925;20013;91169;997;1001;4
/net/per610a/home/mvp/mvp_db/hodost-lv/2017/2017_10_23_04_56/2017_10_23_21_54.mpg;Shinzo ABE.jpg;20245;20257;91169;1013;1013;0
/net/per610a/home/mvp/mvp_db/hodost-lv/2017/2017_10_23_04_56/2017_10_23_21_54.mpg;Natsuo YAMAGUCHI.jpg;15377;15429;91169;769;772;3
/net/per610a/home/mvp/mvp_db/hodost-lv/2017/2017_10_23_04_56/2017_10_23_21_54.mpg;Natsuo YAMAGUCHI.jpg;15593;15937;91169;780;797;17
/net/per610a/home/mvp/mvp_db/hodost-lv/2017/2017_10_23_04_56/2017_10_23_21_54.mpg;Natsuo YAMAGUCHI.jpg;21685;23669;91169;1085;1184;99
/net/per610a/home/mvp/mvp_db/hodost-lv/2017/2017_10_23_04_56/2017_10_23_21_54.mpg;Yorihisa Matsuno.png;16545;16793;91169;828;840;12
/net/per610a/home/mvp/mvp_db/hodost-lv/2017/2017_10_23_04_56/2017_10_23_21_54.mpg;YUriko Koike.jpg;16989;17297;91169;850;865;15
/net/per610a/home/mvp/mvp_db/hodost-lv/2017/2017_10_23_04_56/2017_10_23_21_54.mpg;Yukio EDANO.jpg;27061;27073;91169;1354;1355;1
/net/per610a/home/mvp/mvp_db/hodost-lv/2017/2017_10_23_04_56/2017_10_23_21_54.mpg;Yukio EDANO.jpg;28329;28521;91169;1417;1427;10
/net/per610a/home/mvp/mvp_db/hodost-lv/2017/2017_10_23_04_56/2017_10_23_21_54.mpg;Yukio EDANO.jpg;28649;29253;91169;1433;1464;31
/net/per610a/home/mvp/mvp_db/hodost-lv/2017/2017_10_23_04_56/2017_10_23_21_54.mpg;Yukio EDANO.jpg;29489;30789;91169;1475;1540;65
/net/per610a/home/mvp/mvp_db/hodost-lv/2017/2017_10_23_04_56/2017_10_23_21_54.mpg;Yukio EDANO.jpg;31537;31749;91169;1578;1589;11
/net/per610a/home/mvp/mvp_db/hodost-lv/2017/2017_10_23_04_56/2017_10_23_21_54.mpg;Yukio EDANO.jpg;31997;32401;91169;1601;1621;20
/net/per610a/home/mvp/mvp_db/hodost-lv/2017/2017_10_23_04_56/2017_10_23_21_54.mpg;Yukio EDANO.jpg;32613;33761;91169;1632;1689;57
/net/per610a/home/mvp/mvp_db/hodost-lv/2017/2017_10_23_04_56/2017_10_23_21_54.mpg;Yukio EDANO.jpg;33957;34425;91169;1699;1722;23
/net/per610a/home/mvp/mvp_db/hodost-lv/2017/2017_10_23_04_56/2017_10_23_21_54.mpg;Yukio EDANO.jpg;35685;35877;91169;1786;1795;9
/net/per610a/home/mvp/mvp_db/hodost-lv/2017/2017_10_23_04_56/2017_10_23_21_54.mpg;Yukio EDANO.jpg;36417;36789;91169;1822;1841;19
/net/per610a/home/mvp/mvp_db/hodost-lv/2017/2017_10_23_04_56/2017_10_23_21_54.mpg;Yukio EDANO.jpg;36957;37273;91169;1849;1865;16
/net/per610a/home/mvp/mvp_db/hodost-lv/2017/2017_10_23_04_56/2017_10_23_21_54.mpg;Yukio EDANO.jpg;37473;37793;91169;1875;1891;16
/net/per610a/home/mvp/mvp_db/hodost-lv/2017/2017_10_23_04_56/2017_10_23_21_54.mpg;Yukio EDANO.jpg;38301;38777;91169;1916;1940;24
/net/per610a/home/mvp/mvp_db/hodost-lv/2017/2017_10_23_04_56/2017_10_23_21_54.mpg;Yukio EDANO.jpg;40273;40917;91169;2015;2047;32
/net/per610a/home/mvp/mvp_db/hodost-lv/2017/2017_10_23_04_56/2017_10_23_21_54.mpg;Yukio EDANO.jpg;41065;41313;91169;2055;2067;12
/net/per610a/home/mvp/mvp_db/hodost-lv/2017/2017_10_23_04_56/2017_10_23_21_54.mpg;Yukio EDANO.jpg;41545;42577;91169;2079;2130;51
/net/per610a/home/mvp/mvp_db/hodost-lv/2017/2017_10_24_04_56/2017_10_24_21_54.mpg;Yukio EDANO.jpg;25037;25153;91169;1253;1258;5
/net/per610a/home/mvp/mvp_db/hodost-lv/2017/2017_10_24_04_56/2017_10_24_21_54.mpg;Seiji MAEHARA.jpg;26121;26177;91169;1307;1310;3
/net/per610a/home/mvp/mvp_db/hodost-lv/2017/2017_10_24_04_56/2017_10_24_21_54.mpg;Seiji MAEHARA.jpg;26889;27057;91169;1345;1354;9
/net/per610a/home/mvp/mvp_db/hodost-lv/2017/2017_10_24_04_56/2017_10_24_21_54.mpg;Shinzo ABE.jpg;29585;30097;91169;1480;1506;26
/net/per610a/home/mvp/mvp_db/hodost-lv/2017/2017_10_25_04_56/2017_10_25_22_09.mpg;YUriko Koike.jpg;46213;46601;91161;2312;2332;20
/net/per610a/home/mvp/mvp_db/hodost-lv/2017/2017_10_26_04_56/2017_10_26_21_54.mpg;Shinzo ABE.jpg;25609;26321;91169;1281;1317;36
/net/per610a/home/mvp/mvp_db/hodost-lv/2017/2017_10_26_04_56/2017_10_26_21_54.mpg;Shinzo ABE.jpg;28001;28077;91169;1401;1405;4
/net/per610a/home/mvp/mvp_db/hodost-lv/2017/2017_10_26_04_56/2017_10_26_21_54.mpg;Shinzo ABE.jpg;28405;28465;91169;1421;1424;3
/net/per610a/home/mvp/mvp_db/hodost-lv/2017/2017_10_26_04_56/2017_10_26_21_54.mpg;Shinzo ABE.jpg;30825;30897;91169;1542;1546;4
/net/per610a/home/mvp/mvp_db/hodost-lv/2017/2017_10_26_04_56/2017_10_26_21_54.mpg;Shinzo ABE.jpg;27449;27917;91169;1373;1397;24
/net/per610a/home/mvp/mvp_db/hodost-lv/2017/2017_10_26_04_56/2017_10_26_21_54.mpg;Shinzo ABE.jpg;30541;30613;91169;1528;1532;4
/net/per610a/home/mvp/mvp_db/hodost-lv/2017/2017_10_27_04_56/2017_10_27_21_54.mpg;Taro ASO.jpg;17681;18113;91169;884;906;22
/net/per610a/home/mvp/mvp_db/hodost-lv/2017/2017_10_30_04_56/2017_10_30_21_54.mpg;Yoshihiko Noda.jpg;16221;16329;91169;811;817;6
/net/per610a/home/mvp/mvp_db/hodost-lv/2017/2017_10_30_04_56/2017_10_30_21_54.mpg;Yoshihiko Noda.jpg;16429;16525;91169;822;827;5
/net/per610a/home/mvp/mvp_db/hodost-lv/2017/2017_10_30_04_56/2017_10_30_21_54.mpg;Yukio EDANO.jpg;17257;17729;91169;863;887;24
/net/per610a/home/mvp/mvp_db/hodost-lv/2017/2017_10_31_04_56/2017_10_31_21_54.mpg;Kohei Otsuka.jpg;45021;45153;91169;2253;2259;6
/net/per610a/home/mvp/mvp_db/hodost-lv/2017/2017_10_31_04_56/2017_10_31_21_54.mpg;Kohei Otsuka.jpg;45577;45637;91169;2281;2284;3
/net/per610a/home/mvp/mvp_db/hodost-lv/2017/2017_10_31_04_56/2017_10_31_21_54.mpg;Kohei Otsuka.jpg;46997;47137;91169;2352;2359;7
/net/per610a/home/mvp/mvp_db/hodost-lv/2017/2017_11_02_04_56/2017_11_02_21_54.mpg;Shinzo ABE.jpg;1501;1637;91169;75;81;6
/net/per610a/home/mvp/mvp_db/hodost-lv/2017/2017_11_03_04_56/2017_11_03_21_54.mpg;Shinzo ABE.jpg;2437;2437;91161;121;121;0
/net/per610a/home/mvp/mvp_db/hodost-lv/2017/2017_11_03_04_56/2017_11_03_21_54.mpg;Shinzo ABE.jpg;5285;5357;91161;264;268;4
/net/per610a/home/mvp/mvp_db/hodost-lv/2017/2017_11_03_04_56/2017_11_03_21_54.mpg;Shinzo ABE.jpg;5777;5881;91161;289;294;5
/net/per610a/home/mvp/mvp_db/hodost-lv/2017/2017_11_03_04_56/2017_11_03_21_54.mpg;Shinzo ABE.jpg;6373;6385;91161;318;319;1
/net/per610a/home/mvp/mvp_db/hodost-lv/2017/2017_11_03_04_56/2017_11_03_21_54.mpg;Shinzo ABE.jpg;8681;8781;91161;434;439;5
/net/per610a/home/mvp/mvp_db/hodost-lv/2017/2017_11_03_04_56/2017_11_03_21_54.mpg;Shinzo ABE.jpg;8925;8981;91161;446;449;3
/net/per610a/home/mvp/mvp_db/hodost-lv/2017/2017_11_03_04_56/2017_11_03_21_54.mpg;Shinzo ABE.jpg;11089;11181;91161;554;559;5
/net/per610a/home/mvp/mvp_db/hodost-lv/2017/2017_11_05_04_56/2017_11_05_20_54.mpg;Shinzo ABE.jpg;5109;5145;149909;255;257;2
/net/per610a/home/mvp/mvp_db/hodost-lv/2017/2017_11_05_04_56/2017_11_05_20_54.mpg;Shinzo ABE.jpg;9809;9821;149909;490;491;1
/net/per610a/home/mvp/mvp_db/hodost-lv/2017/2017_11_05_04_56/2017_11_05_20_54.mpg;Shinzo ABE.jpg;9909;10273;149909;495;514;19
/net/per610a/home/mvp/mvp_db/hodost-lv/2017/2017_11_05_04_56/2017_11_05_20_54.mpg;Shinzo ABE.jpg;12425;12465;149909;621;623;2
/net/per610a/home/mvp/mvp_db/hodost-lv/2017/2017_11_05_04_56/2017_11_05_20_54.mpg;Shinzo ABE.jpg;14349;14381;149909;718;719;1
/net/per610a/home/mvp/mvp_db/hodost-lv/2017/2017_11_05_04_56/2017_11_05_20_54.mpg;Shinzo ABE.jpg;5561;5629;149909;278;281;3
/net/per610a/home/mvp/mvp_db/hodost-lv/2017/2017_11_05_04_56/2017_11_05_20_54.mpg;Shinzo ABE.jpg;14681;14729;149909;734;737;3
/net/per610a/home/mvp/mvp_db/hodost-lv/2017/2017_11_05_04_56/2017_11_05_20_54.mpg;Shinzo ABE.jpg;29433;29453;149909;1472;1473;1
/net/per610a/home/mvp/mvp_db/hodost-lv/2017/2017_11_05_04_56/2017_11_05_20_54.mpg;Shinzo ABE.jpg;132193;132281;149909;6615;6619;4
/net/per610a/home/mvp/mvp_db/hodost-lv/2017/2017_11_05_04_56/2017_11_05_20_54.mpg;Shinzo ABE.jpg;133105;133157;149909;6661;6663;2
/net/per610a/home/mvp/mvp_db/hodost-lv/2017/2017_11_05_04_56/2017_11_05_20_54.mpg;Shinzo ABE.jpg;5701;5733;149909;285;286;1
/net/per610a/home/mvp/mvp_db/hodost-lv/2017/2017_11_05_04_56/2017_11_05_20_54.mpg;Shinzo ABE.jpg;20777;20813;149909;1039;1041;2
/net/per610a/home/mvp/mvp_db/hodost-lv/2017/2017_11_05_04_56/2017_11_05_20_54.mpg;Shinzo ABE.jpg;42173;42205;149909;2110;2112;2
/net/per610a/home/mvp/mvp_db/hodost-lv/2017/2017_11_05_04_56/2017_11_05_20_54.mpg;YUriko Koike.jpg;58885;58945;149909;2946;2949;3
/net/per610a/home/mvp/mvp_db/hodost-lv/2017/2017_11_05_04_56/2017_11_05_20_54.mpg;YUriko Koike.jpg;59013;59249;149909;2953;2965;12
/net/per610a/home/mvp/mvp_db/hodost-lv/2017/2017_11_05_04_56/2017_11_05_20_54.mpg;YUriko Koike.jpg;59569;59609;149909;2981;2983;2
/net/per610a/home/mvp/mvp_db/hodost-lv/2017/2017_11_05_04_56/2017_11_05_20_54.mpg;YUriko Koike.jpg;61557;61941;149909;3080;3099;19
/net/per610a/home/mvp/mvp_db/hodost-lv/2017/2017_11_06_04_56/2017_11_06_21_54.mpg;Shinzo ABE.jpg;22813;22865;91169;1141;1144;3
/net/per610a/home/mvp/mvp_db/hodost-lv/2017/2017_11_06_04_56/2017_11_06_21_54.mpg;Shinzo ABE.jpg;28721;28773;91169;1437;1440;3
/net/per610a/home/mvp/mvp_db/hodost-lv/2017/2017_11_07_04_56/2017_11_07_21_54.mpg;Shinzo ABE.jpg;6657;6825;91169;333;341;8
/net/per610a/home/mvp/mvp_db/hodost-lv/2017/2017_11_08_04_56/2017_11_08_21_54.mpg;Shinzo ABE.jpg;47513;47561;91169;2378;2380;2
/net/per610a/home/mvp/mvp_db/hodost-lv/2017/2017_11_08_04_56/2017_11_08_21_54.mpg;Shinzo ABE.jpg;50821;50949;91169;2543;2549;6
/net/per610a/home/mvp/mvp_db/hodost-lv/2017/2017_11_13_04_56/2017_11_13_21_54.mpg;Shinzo ABE.jpg;21745;21797;91169;1088;1090;2
/net/per610a/home/mvp/mvp_db/hodost-lv/2017/2017_11_13_04_56/2017_11_13_21_54.mpg;Shinzo ABE.jpg;27517;27585;91169;1377;1380;3
/net/per610a/home/mvp/mvp_db/hodost-lv/2017/2017_11_14_04_56/2017_11_14_21_54.mpg;Shinzo ABE.jpg;26517;26605;91169;1327;1331;4
/net/per610a/home/mvp/mvp_db/hodost-lv/2017/2017_11_14_04_56/2017_11_14_21_54.mpg;Shinzo ABE.jpg;47389;48229;91169;2371;2413;42
/net/per610a/home/mvp/mvp_db/hodost-lv/2017/2017_11_14_04_56/2017_11_14_21_54.mpg;YUriko Koike.jpg;37149;37181;91169;1859;1860;1
/net/per610a/home/mvp/mvp_db/hodost-lv/2017/2017_11_14_04_56/2017_11_14_21_54.mpg;YUriko Koike.jpg;38773;39069;91169;1940;1955;15
/net/per610a/home/mvp/mvp_db/hodost-lv/2017/2017_11_17_04_56/2017_11_17_21_54.mpg;Shinzo ABE.jpg;55521;55617;91169;2778;2783;5
/net/per610a/home/mvp/mvp_db/hodost-lv/2017/2017_11_17_04_56/2017_11_17_21_54.mpg;Shinzo ABE.jpg;56361;57333;91169;2820;2869;49
/net/per610a/home/mvp/mvp_db/hodost-lv/2017/2017_11_18_04_56/2017_11_18_20_54.mpg;Masashi Nakano.jpg;32521;32681;71989;1627;1635;8
/net/per610a/home/mvp/mvp_db/hodost-lv/2017/2017_11_20_04_56/2017_11_20_21_54.mpg;Yukio EDANO.jpg;23945;23977;91169;1198;1200;2
/net/per610a/home/mvp/mvp_db/hodost-lv/2017/2017_11_20_04_56/2017_11_20_21_54.mpg;Yukio EDANO.jpg;24617;25185;91169;1232;1260;28
/net/per610a/home/mvp/mvp_db/hodost-lv/2017/2017_11_20_04_56/2017_11_20_21_54.mpg;Yukio EDANO.jpg;26757;27109;91169;1339;1356;17
/net/per610a/home/mvp/mvp_db/hodost-lv/2017/2017_11_20_04_56/2017_11_20_21_54.mpg;Yukio EDANO.jpg;31053;31097;91169;1554;1556;2
/net/per610a/home/mvp/mvp_db/hodost-lv/2017/2017_11_20_04_56/2017_11_20_21_54.mpg;Yuichiro Tamaki.png;23965;24333;91169;1199;1217;18
/net/per610a/home/mvp/mvp_db/hodost-lv/2017/2017_11_20_04_56/2017_11_20_21_54.mpg;Yuichiro Tamaki.png;24397;24397;91169;1221;1221;0
/net/per610a/home/mvp/mvp_db/hodost-lv/2017/2017_11_20_04_56/2017_11_20_21_54.mpg;Yuichiro Tamaki.png;27341;27613;91169;1368;1382;14
/net/per610a/home/mvp/mvp_db/hodost-lv/2017/2017_11_20_04_56/2017_11_20_21_54.mpg;Yuichiro Tamaki.png;28497;28741;91169;1426;1438;12
/net/per610a/home/mvp/mvp_db/hodost-lv/2017/2017_11_20_04_56/2017_11_20_21_54.mpg;Yuichiro Tamaki.png;31105;31381;91169;1556;1570;14
/net/per610a/home/mvp/mvp_db/hodost-lv/2017/2017_11_21_04_56/2017_11_21_21_54.mpg;Shinzo ABE.jpg;34965;35373;91169;1749;1770;21
/net/per610a/home/mvp/mvp_db/hodost-lv/2017/2017_11_21_04_56/2017_11_21_21_54.mpg;Shinzo ABE.jpg;53565;53689;91169;2680;2687;7
/net/per610a/home/mvp/mvp_db/hodost-lv/2017/2017_11_21_04_56/2017_11_21_21_54.mpg;Kyoko Nakayama.jpg;53117;53205;91169;2658;2662;4
/net/per610a/home/mvp/mvp_db/hodost-lv/2017/2017_11_21_04_56/2017_11_21_21_54.mpg;Kyoko Nakayama.jpg;53793;53905;91169;2692;2697;5
/net/per610a/home/mvp/mvp_db/hodost-lv/2017/2017_11_22_04_56/2017_11_22_21_54.mpg;Kohei Otsuka.jpg;12145;12989;91169;607;650;43
/net/per610a/home/mvp/mvp_db/hodost-lv/2017/2017_11_22_04_56/2017_11_22_21_54.mpg;Kohei Otsuka.jpg;85301;85353;91169;4269;4271;2
/net/per610a/home/mvp/mvp_db/hodost-lv/2017/2017_11_26_04_56/2017_11_26_20_54.mpg;Shinzo ABE.jpg;62293;62309;71989;3117;3118;1
/net/per610a/home/mvp/mvp_db/hodost-lv/2017/2017_11_26_04_56/2017_11_26_20_54.mpg;Shinzo ABE.jpg;62733;62793;71989;3139;3142;3
/net/per610a/home/mvp/mvp_db/hodost-lv/2017/2017_11_27_04_56/2017_11_27_21_54.mpg;Shinzo ABE.jpg;45217;45613;91169;2263;2282;19
/net/per610a/home/mvp/mvp_db/hodost-lv/2017/2017_11_27_04_56/2017_11_27_21_54.mpg;Kohei Otsuka.jpg;49021;49077;91169;2453;2456;3
/net/per610a/home/mvp/mvp_db/hodost-lv/2017/2017_11_27_04_56/2017_11_27_21_54.mpg;Kohei Otsuka.jpg;85497;85645;91169;4279;4286;7
/net/per610a/home/mvp/mvp_db/hodost-lv/2017/2017_11_28_04_56/2017_11_28_21_54.mpg;Shinzo ABE.jpg;62341;62489;91169;3120;3127;7
/net/per610a/home/mvp/mvp_db/hodost-lv/2017/2017_11_30_04_56/2017_11_30_21_54.mpg;Shinzo ABE.jpg;40373;40509;91169;2020;2027;7
/net/per610a/home/mvp/mvp_db/hodost-lv/2017/2017_12_01_04_56/2017_12_01_21_54.mpg;Shinzo ABE.jpg;2117;2189;91169;105;109;4
/net/per610a/home/mvp/mvp_db/hodost-lv/2017/2017_12_01_04_56/2017_12_01_21_54.mpg;Shinzo ABE.jpg;3537;3585;91169;177;179;2
/net/per610a/home/mvp/mvp_db/hodost-lv/2017/2017_12_01_04_56/2017_12_01_21_54.mpg;Shinzo ABE.jpg;6297;6369;91169;315;318;3
/net/per610a/home/mvp/mvp_db/hodost-lv/2017/2017_12_01_04_56/2017_12_01_21_54.mpg;Shinzo ABE.jpg;6581;7001;91169;329;350;21
/net/per610a/home/mvp/mvp_db/hodost-lv/2017/2017_12_02_04_56/2017_12_02_20_54.mpg;Shinzo ABE.jpg;30501;30793;71981;1526;1540;14
/net/per610a/home/mvp/mvp_db/hodost-lv/2017/2017_12_06_04_56/2017_12_06_21_54.mpg;Shinzo ABE.jpg;32721;32769;91169;1637;1640;3
/net/per610a/home/mvp/mvp_db/hodost-lv/2017/2017_12_06_04_56/2017_12_06_21_54.mpg;Shinzo ABE.jpg;32957;33009;91169;1649;1652;3
/net/per610a/home/mvp/mvp_db/hodost-lv/2017/2017_12_08_04_56/2017_12_08_21_54.mpg;Shinzo ABE.jpg;21197;21273;91161;1060;1064;4
/net/per610a/home/mvp/mvp_db/hodost-lv/2017/2017_12_08_04_56/2017_12_08_21_54.mpg;Shinzo ABE.jpg;21661;21713;91161;1083;1086;3
/net/per610a/home/mvp/mvp_db/hodost-lv/2017/2017_12_08_04_56/2017_12_08_21_54.mpg;Shinzo ABE.jpg;48945;49057;91161;2449;2454;5
/net/per610a/home/mvp/mvp_db/hodost-lv/2017/2017_12_13_04_56/2017_12_13_21_54.mpg;Renho.jpg;50821;50949;91169;2543;2549;6
/net/per610a/home/mvp/mvp_db/hodost-lv/2017/2017_12_19_04_56/2017_12_19_21_54.mpg;Shinzo ABE.jpg;44997;45409;91169;2252;2272;20
/net/per610a/home/mvp/mvp_db/hodost-lv/2017/2017_12_19_04_56/2017_12_19_21_54.mpg;Shinzo ABE.jpg;47225;47317;91169;2363;2368;5
/net/per610a/home/mvp/mvp_db/hodost-lv/2017/2017_12_19_04_56/2017_12_19_21_54.mpg;Shinzo ABE.jpg;47421;47621;91169;2373;2383;10
/net/per610a/home/mvp/mvp_db/hodost-lv/2017/2017_12_20_04_56/2017_12_20_21_54.mpg;Shinzo ABE.jpg;41833;42121;91169;2093;2108;15
/net/per610a/home/mvp/mvp_db/hodost-lv/2017/2017_12_20_04_56/2017_12_20_21_54.mpg;Shinzo ABE.jpg;43309;43353;91169;2167;2169;2
/net/per610a/home/mvp/mvp_db/hodost-lv/2017/2017_12_20_04_56/2017_12_20_21_54.mpg;Shinzo ABE.jpg;43469;43869;91169;2175;2195;20
/net/per610a/home/mvp/mvp_db/hodost-lv/2017/2017_12_20_04_56/2017_12_20_21_54.mpg;YUriko Koike.jpg;56509;56721;91169;2828;2838;10
/net/per610a/home/mvp/mvp_db/hodost-lv/2017/2017_12_26_04_56/2017_12_26_22_09.mpg;Shinzo ABE.jpg;32749;32797;91169;1639;1641;2
/net/per610a/home/mvp/mvp_db/hodost-lv/2017/2017_12_26_04_56/2017_12_26_22_09.mpg;Shinzo ABE.jpg;34709;35237;91169;1737;1763;26
/net/per610a/home/mvp/mvp_db/hodost-lv/2017/2017_12_26_04_56/2017_12_26_22_09.mpg;Shinzo ABE.jpg;35693;35969;91169;1786;1800;14
/net/per610a/home/mvp/mvp_db/hodost-lv/2017/2017_12_26_04_56/2017_12_26_22_09.mpg;Shinzo ABE.jpg;36393;36649;91169;1821;1834;13
/net/per610a/home/mvp/mvp_db/hodost-lv/2017/2017_12_26_04_56/2017_12_26_22_09.mpg;Shinzo ABE.jpg;36837;37001;91169;1843;1851;8
/net/per610a/home/mvp/mvp_db/hodost-lv/2017/2017_12_26_04_56/2017_12_26_22_09.mpg;Shinzo ABE.jpg;37073;37161;91169;1855;1859;4
/net/per610a/home/mvp/mvp_db/hodost-lv/2017/2017_12_26_04_56/2017_12_26_22_09.mpg;Shinzo ABE.jpg;40201;40581;91169;2012;2031;19
/net/per610a/home/mvp/mvp_db/hodost-lv/2017/2017_12_26_04_56/2017_12_26_22_09.mpg;Shinzo ABE.jpg;41097;41201;91169;2056;2062;6
/net/per610a/home/mvp/mvp_db/hodost-lv/2017/2017_12_26_04_56/2017_12_26_22_09.mpg;Shinzo ABE.jpg;36061;36137;91169;1804;1808;4
/net/per610a/home/mvp/mvp_db/hodost-lv/2018/2018_01_09_04_56/2018_01_09_21_54.mpg;Shinzo ABE.jpg;35149;35577;91169;1759;1780;21
/net/per610a/home/mvp/mvp_db/hodost-lv/2018/2018_01_10_04_56/2018_01_10_21_54.mpg;Junichiro KOIZUMI.jpg;35865;35913;91169;1795;1797;2
/net/per610a/home/mvp/mvp_db/hodost-lv/2018/2018_01_10_04_56/2018_01_10_21_54.mpg;Junichiro KOIZUMI.jpg;37169;37945;91169;1860;1899;39
/net/per610a/home/mvp/mvp_db/hodost-lv/2018/2018_01_10_04_56/2018_01_10_21_54.mpg;Junichiro KOIZUMI.jpg;38553;38877;91169;1929;1945;16
/net/per610a/home/mvp/mvp_db/hodost-lv/2018/2018_01_10_04_56/2018_01_10_21_54.mpg;Junichiro KOIZUMI.jpg;41197;41225;91169;2061;2063;2
/net/per610a/home/mvp/mvp_db/hodost-lv/2018/2018_01_10_04_56/2018_01_10_21_54.mpg;Junichiro KOIZUMI.jpg;41733;42113;91169;2088;2107;19
/net/per610a/home/mvp/mvp_db/hodost-lv/2018/2018_01_12_04_56/2018_01_12_21_54.mpg;Kohei Otsuka.jpg;15873;15953;91161;794;798;4
/net/per610a/home/mvp/mvp_db/hodost-lv/2018/2018_01_12_04_56/2018_01_12_21_54.mpg;Kohei Otsuka.jpg;28437;28625;91161;1423;1432;9
/net/per610a/home/mvp/mvp_db/hodost-lv/2018/2018_01_12_04_56/2018_01_12_21_54.mpg;Kohei Otsuka.jpg;48965;49069;91161;2450;2455;5
/net/per610a/home/mvp/mvp_db/hodost-lv/2018/2018_01_12_04_56/2018_01_12_21_54.mpg;Kohei Otsuka.jpg;60741;60749;91161;3039;3040;1
/net/per610a/home/mvp/mvp_db/hodost-lv/2018/2018_01_14_04_56/2018_01_14_22_54.mpg;Shinzo ABE.jpg;27285;27545;71981;1365;1378;13
/net/per610a/home/mvp/mvp_db/hodost-lv/2018/2018_01_14_04_56/2018_01_14_22_54.mpg;Shinzo ABE.jpg;29145;29217;71981;1458;1462;4
/net/per610a/home/mvp/mvp_db/hodost-lv/2018/2018_01_14_04_56/2018_01_14_22_54.mpg;Shinzo ABE.jpg;29925;29969;71981;1497;1499;2
/net/per610a/home/mvp/mvp_db/hodost-lv/2018/2018_01_14_04_56/2018_01_14_22_54.mpg;Shinzo ABE.jpg;30033;30085;71981;1502;1505;3
/net/per610a/home/mvp/mvp_db/hodost-lv/2018/2018_01_14_04_56/2018_01_14_22_54.mpg;Shinzo ABE.jpg;61753;61849;71981;3090;3094;4
/net/per610a/home/mvp/mvp_db/hodost-lv/2018/2018_01_14_04_56/2018_01_14_22_54.mpg;Shinzo ABE.jpg;68001;68157;71981;3402;3410;8
/net/per610a/home/mvp/mvp_db/hodost-lv/2018/2018_01_14_04_56/2018_01_14_22_54.mpg;Shinzo ABE.jpg;62453;62741;71981;3125;3139;14
/net/per610a/home/mvp/mvp_db/hodost-lv/2018/2018_01_15_04_56/2018_01_15_21_54.mpg;Yukio EDANO.jpg;40917;41501;91169;2047;2077;30
/net/per610a/home/mvp/mvp_db/hodost-lv/2018/2018_01_15_04_56/2018_01_15_21_54.mpg;Yuichiro Tamaki.png;43229;43613;91169;2163;2182;19
/net/per610a/home/mvp/mvp_db/hodost-lv/2018/2018_01_21_04_56/2018_01_21_22_15.mpg;Shinzo ABE.jpg;29137;29265;71989;1458;1464;6
/net/per610a/home/mvp/mvp_db/hodost-lv/2018/2018_01_21_04_56/2018_01_21_22_15.mpg;Shinzo ABE.jpg;29365;29729;71989;1469;1487;18
/net/per610a/home/mvp/mvp_db/hodost-lv/2018/2018_01_21_04_56/2018_01_21_22_15.mpg;Shinzo ABE.jpg;67393;67405;71989;3372;3373;1
/net/per610a/home/mvp/mvp_db/hodost-lv/2018/2018_01_22_04_56/2018_01_22_21_54.mpg;Shinzo ABE.jpg;36805;36893;91169;1842;1846;4
/net/per610a/home/mvp/mvp_db/hodost-lv/2018/2018_01_22_04_56/2018_01_22_21_54.mpg;Shinzo ABE.jpg;37493;37801;91169;1876;1891;15
/net/per610a/home/mvp/mvp_db/hodost-lv/2018/2018_01_22_04_56/2018_01_22_21_54.mpg;Shinzo ABE.jpg;37957;38297;91169;1899;1916;17
/net/per610a/home/mvp/mvp_db/hodost-lv/2018/2018_01_22_04_56/2018_01_22_21_54.mpg;Shinzo ABE.jpg;38417;38993;91169;1922;1951;29
/net/per610a/home/mvp/mvp_db/hodost-lv/2018/2018_01_22_04_56/2018_01_22_21_54.mpg;Shinzo ABE.jpg;39517;39929;91169;1977;1998;21
/net/per610a/home/mvp/mvp_db/hodost-lv/2018/2018_01_22_04_56/2018_01_22_21_54.mpg;Shinzo ABE.jpg;41097;41617;91169;2056;2082;26
/net/per610a/home/mvp/mvp_db/hodost-lv/2018/2018_01_22_04_56/2018_01_22_21_54.mpg;Shinzo ABE.jpg;41873;41877;91169;2095;2095;0
/net/per610a/home/mvp/mvp_db/hodost-lv/2018/2018_01_22_04_56/2018_01_22_21_54.mpg;Yukio EDANO.jpg;39013;39269;91169;1952;1965;13
/net/per610a/home/mvp/mvp_db/hodost-lv/2018/2018_01_24_04_56/2018_01_24_22_09.mpg;Shinzo ABE.jpg;33517;33561;91169;1677;1679;2
/net/per610a/home/mvp/mvp_db/hodost-lv/2018/2018_01_24_04_56/2018_01_24_22_09.mpg;Shinzo ABE.jpg;34945;35165;91169;1748;1760;12
/net/per610a/home/mvp/mvp_db/hodost-lv/2018/2018_01_24_04_56/2018_01_24_22_09.mpg;Shinzo ABE.jpg;40053;40217;91169;2004;2012;8
/net/per610a/home/mvp/mvp_db/hodost-lv/2018/2018_01_24_04_56/2018_01_24_22_09.mpg;Yuichiro Tamaki.png;37153;38025;91169;1859;1903;44
/net/per610a/home/mvp/mvp_db/hodost-lv/2018/2018_01_24_04_56/2018_01_24_22_09.mpg;Yuichiro Tamaki.png;38181;38781;91169;1910;1940;30
/net/per610a/home/mvp/mvp_db/hodost-lv/2018/2018_01_24_04_56/2018_01_24_22_09.mpg;Natsuo YAMAGUCHI.jpg;43309;43457;91169;2167;2175;8
/net/per610a/home/mvp/mvp_db/hodost-lv/2018/2018_01_25_04_56/2018_01_25_22_09.mpg;Shinzo ABE.jpg;27213;27425;91169;1362;1372;10
/net/per610a/home/mvp/mvp_db/hodost-lv/2018/2018_01_26_04_56/2018_01_26_21_54.mpg;Junichiro KOIZUMI.jpg;16225;16325;91169;812;817;5
/net/per610a/home/mvp/mvp_db/hodost-lv/2018/2018_01_26_04_56/2018_01_26_21_54.mpg;Kazuo SHII.jpg;54133;54577;91169;2709;2731;22
/net/per610a/home/mvp/mvp_db/hodost-lv/2018/2018_01_28_04_56/2018_01_28_20_54.mpg;Ichiro OZAWA.jpg;56801;56853;71989;2842;2845;3
/net/per610a/home/mvp/mvp_db/hodost-lv/2018/2018_01_28_04_56/2018_01_28_20_54.mpg;Ichiro OZAWA.jpg;57189;57541;71989;2862;2879;17
/net/per610a/home/mvp/mvp_db/hodost-lv/2018/2018_01_28_04_56/2018_01_28_20_54.mpg;Shinzo ABE.jpg;67697;67757;71989;3388;3391;3
/net/per610a/home/mvp/mvp_db/hodost-lv/2018/2018_01_28_04_56/2018_01_28_20_54.mpg;Shinzo ABE.jpg;67885;68097;71989;3397;3408;11
/net/per610a/home/mvp/mvp_db/hodost-lv/2018/2018_01_29_04_56/2018_01_29_21_54.mpg;Shinzo ABE.jpg;15517;15653;91169;776;783;7
/net/per610a/home/mvp/mvp_db/hodost-lv/2018/2018_01_29_04_56/2018_01_29_21_54.mpg;Kazuo SHII.jpg;17321;17649;91169;866;883;17
/net/per610a/home/mvp/mvp_db/hodost-lv/2018/2018_01_31_04_56/2018_01_31_22_09.mpg;Masashi Nakano.jpg;34693;34717;91169;1736;1737;1
/net/per610a/home/mvp/mvp_db/hodost-lv/2018/2018_01_31_04_56/2018_01_31_22_09.mpg;Masashi Nakano.jpg;35685;35925;91169;1786;1798;12
/net/per610a/home/mvp/mvp_db/hodost-lv/2018/2018_01_31_04_56/2018_01_31_22_09.mpg;Masashi Nakano.jpg;36557;36721;91169;1829;1837;8
/net/per610a/home/mvp/mvp_db/hodost-lv/2018/2018_01_31_04_56/2018_01_31_22_09.mpg;Shinzo ABE.jpg;37509;37725;91169;1877;1888;11
/net/per610a/home/mvp/mvp_db/hodost-lv/2018/2018_02_02_04_56/2018_02_02_21_54.mpg;Shinzo ABE.jpg;28045;28045;91169;1403;1403;0
/net/per610a/home/mvp/mvp_db/hodost-lv/2018/2018_02_02_04_56/2018_02_02_21_54.mpg;Shinzo ABE.jpg;28149;28197;91169;1408;1411;3
/net/per610a/home/mvp/mvp_db/hodost-lv/2018/2018_02_02_04_56/2018_02_02_21_54.mpg;Shinzo ABE.jpg;31565;31665;91169;1579;1584;5
/net/per610a/home/mvp/mvp_db/hodost-lv/2018/2018_02_04_04_56/2018_02_04_21_54.mpg;Shinzo ABE.jpg;24585;24681;71989;1230;1235;5
/net/per610a/home/mvp/mvp_db/hodost-lv/2018/2018_02_05_04_56/2018_02_05_21_54.mpg;Kenji Eda.jpg;34545;34833;91169;1728;1743;15
/net/per610a/home/mvp/mvp_db/hodost-lv/2018/2018_02_05_04_56/2018_02_05_21_54.mpg;Shinzo ABE.jpg;40213;40481;91169;2012;2026;14
/net/per610a/home/mvp/mvp_db/hodost-lv/2018/2018_02_07_04_56/2018_02_07_22_09.mpg;Shinzo ABE.jpg;52993;53037;91161;2651;2654;3
/net/per610a/home/mvp/mvp_db/hodost-lv/2018/2018_02_07_04_56/2018_02_07_22_09.mpg;Shinzo ABE.jpg;53885;53977;91161;2696;2701;5
/net/per610a/home/mvp/mvp_db/hodost-lv/2018/2018_02_08_04_56/2018_02_08_21_54.mpg;Kohei Otsuka.jpg;1645;1837;91169;82;91;9
/net/per610a/home/mvp/mvp_db/hodost-lv/2018/2018_02_08_04_56/2018_02_08_21_54.mpg;Kohei Otsuka.jpg;26637;27189;91169;1333;1360;27
/net/per610a/home/mvp/mvp_db/hodost-lv/2018/2018_02_08_04_56/2018_02_08_21_54.mpg;Kohei Otsuka.jpg;39489;40097;91169;1976;2006;30
/net/per610a/home/mvp/mvp_db/hodost-lv/2018/2018_02_08_04_56/2018_02_08_21_54.mpg;Kohei Otsuka.jpg;45709;45749;91169;2287;2289;2
/net/per610a/home/mvp/mvp_db/hodost-lv/2018/2018_02_08_04_56/2018_02_08_21_54.mpg;Kohei Otsuka.jpg;46193;46237;91169;2311;2314;3
/net/per610a/home/mvp/mvp_db/hodost-lv/2018/2018_02_08_04_56/2018_02_08_21_54.mpg;Kohei Otsuka.jpg;47425;47489;91169;2373;2376;3
/net/per610a/home/mvp/mvp_db/hodost-lv/2018/2018_02_08_04_56/2018_02_08_21_54.mpg;Kohei Otsuka.jpg;59621;59781;91169;2984;2992;8
/net/per610a/home/mvp/mvp_db/hodost-lv/2018/2018_02_08_04_56/2018_02_08_21_54.mpg;Kohei Otsuka.jpg;84945;85357;91169;4251;4272;21
/net/per610a/home/mvp/mvp_db/hodost-lv/2018/2018_02_08_04_56/2018_02_08_21_54.mpg;Kohei Otsuka.jpg;85789;85945;91169;4293;4301;8
/net/per610a/home/mvp/mvp_db/hodost-lv/2018/2018_02_10_04_56/2018_02_10_20_54.mpg;Shinzo ABE.jpg;24629;24797;89969;1232;1240;8
/net/per610a/home/mvp/mvp_db/hodost-lv/2018/2018_02_11_04_56/2018_02_11_20_54.mpg;Shinzo ABE.jpg;62985;63093;71989;3152;3157;5
/net/per610a/home/mvp/mvp_db/hodost-lv/2018/2018_02_12_04_56/2018_02_12_21_54.mpg;Shinzo ABE.jpg;27085;27241;91161;1355;1363;8
/net/per610a/home/mvp/mvp_db/hodost-lv/2018/2018_02_13_04_56/2018_02_13_21_54.mpg;Taro ASO.jpg;48237;48329;91169;2414;2418;4
/net/per610a/home/mvp/mvp_db/hodost-lv/2018/2018_02_13_04_56/2018_02_13_21_54.mpg;Taro ASO.jpg;51085;51165;91169;2556;2560;4
/net/per610a/home/mvp/mvp_db/hodost-lv/2018/2018_02_19_04_56/2018_02_19_21_54.mpg;Shinzo ABE.jpg;35841;36009;91161;1793;1802;9
/net/per610a/home/mvp/mvp_db/hodost-lv/2018/2018_02_19_04_56/2018_02_19_21_54.mpg;Shinzo ABE.jpg;36345;36413;91161;1818;1822;4
/net/per610a/home/mvp/mvp_db/hodost-lv/2018/2018_02_19_04_56/2018_02_19_21_54.mpg;Shinzo ABE.jpg;39725;39829;91161;1987;1993;6
/net/per610a/home/mvp/mvp_db/hodost-lv/2018/2018_02_21_04_56/2018_02_21_21_54.mpg;Shinzo ABE.jpg;40989;41061;91169;2051;2055;4
/net/per610a/home/mvp/mvp_db/hodost-lv/2018/2018_02_21_04_56/2018_02_21_21_54.mpg;Shinzo ABE.jpg;46217;46261;91169;2313;2315;2
/net/per610a/home/mvp/mvp_db/hodost-lv/2018/2018_02_21_04_56/2018_02_21_21_54.mpg;Shinzo ABE.jpg;45813;45913;91169;2292;2297;5
/net/per610a/home/mvp/mvp_db/hodost-lv/2018/2018_02_23_04_56/2018_02_23_21_54.mpg;Shinzo ABE.jpg;38649;39257;91161;1934;1964;30
/net/per610a/home/mvp/mvp_db/hodost-lv/2018/2018_02_28_04_56/2018_02_28_21_54.mpg;Shinzo ABE.jpg;17089;17285;91169;855;865;10
/net/per610a/home/mvp/mvp_db/hodost-lv/2018/2018_03_01_04_56/2018_03_01_22_04.mpg;Shinzo ABE.jpg;17141;17153;91161;857;858;1
/net/per610a/home/mvp/mvp_db/hodost-lv/2018/2018_03_01_04_56/2018_03_01_22_04.mpg;Shinzo ABE.jpg;30817;30957;91161;1542;1549;7
/net/per610a/home/mvp/mvp_db/hodost-lv/2018/2018_03_01_04_56/2018_03_01_22_04.mpg;Shinzo ABE.jpg;38893;39061;91161;1946;1954;8
/net/per610a/home/mvp/mvp_db/hodost-lv/2018/2018_03_02_04_56/2018_03_02_21_54.mpg;Shinzo ABE.jpg;23409;23697;91169;1171;1186;15
/net/per610a/home/mvp/mvp_db/hodost-lv/2018/2018_03_04_04_56/2018_03_04_20_54.mpg;Shinzo ABE.jpg;11445;11733;71989;572;587;15
/net/per610a/home/mvp/mvp_db/hodost-lv/2018/2018_03_04_04_56/2018_03_04_20_54.mpg;Shinzo ABE.jpg;22713;22761;71989;1136;1139;3
/net/per610a/home/mvp/mvp_db/hodost-lv/2018/2018_03_05_04_56/2018_03_05_21_54.mpg;Shinzo ABE.jpg;25181;25305;91169;1260;1266;6
/net/per610a/home/mvp/mvp_db/hodost-lv/2018/2018_03_05_04_56/2018_03_05_21_54.mpg;Shinzo ABE.jpg;27365;27533;91169;1369;1378;9
/net/per610a/home/mvp/mvp_db/hodost-lv/2018/2018_03_06_04_56/2018_03_06_21_54.mpg;Taro ASO.jpg;24213;24373;91169;1211;1219;8
/net/per610a/home/mvp/mvp_db/hodost-lv/2018/2018_03_06_04_56/2018_03_06_21_54.mpg;Taro ASO.jpg;26309;26365;91169;1316;1319;3
/net/per610a/home/mvp/mvp_db/hodost-lv/2018/2018_03_06_04_56/2018_03_06_21_54.mpg;Taro ASO.jpg;26877;27117;91169;1345;1357;12
/net/per610a/home/mvp/mvp_db/hodost-lv/2018/2018_03_06_04_56/2018_03_06_21_54.mpg;Taro ASO.jpg;27301;28125;91169;1366;1407;41
/net/per610a/home/mvp/mvp_db/hodost-lv/2018/2018_03_06_04_56/2018_03_06_21_54.mpg;Renho.jpg;26049;26181;91169;1303;1310;7
/net/per610a/home/mvp/mvp_db/hodost-lv/2018/2018_03_06_04_56/2018_03_06_21_54.mpg;Renho.jpg;31257;31493;91169;1564;1576;12
/net/per610a/home/mvp/mvp_db/hodost-lv/2018/2018_03_07_04_56/2018_03_07_21_54.mpg;Taro ASO.jpg;4061;4133;91169;203;206;3
/net/per610a/home/mvp/mvp_db/hodost-lv/2018/2018_03_07_04_56/2018_03_07_21_54.mpg;Taro ASO.jpg;6149;6301;91169;307;315;8
/net/per610a/home/mvp/mvp_db/hodost-lv/2018/2018_03_07_04_56/2018_03_07_21_54.mpg;Taro ASO.jpg;7429;7541;91169;371;377;6
/net/per610a/home/mvp/mvp_db/hodost-lv/2018/2018_03_07_04_56/2018_03_07_21_54.mpg;Junichiro KOIZUMI.jpg;31185;31341;91169;1560;1568;8
/net/per610a/home/mvp/mvp_db/hodost-lv/2018/2018_03_07_04_56/2018_03_07_21_54.mpg;Junichiro KOIZUMI.jpg;33185;33405;91169;1660;1671;11
/net/per610a/home/mvp/mvp_db/hodost-lv/2018/2018_03_07_04_56/2018_03_07_21_54.mpg;Junichiro KOIZUMI.jpg;33849;33869;91169;1694;1695;1
/net/per610a/home/mvp/mvp_db/hodost-lv/2018/2018_03_07_04_56/2018_03_07_21_54.mpg;Junichiro KOIZUMI.jpg;34329;34525;91169;1718;1727;9
/net/per610a/home/mvp/mvp_db/hodost-lv/2018/2018_03_07_04_56/2018_03_07_21_54.mpg;Junichiro KOIZUMI.jpg;34661;34925;91169;1734;1747;13
/net/per610a/home/mvp/mvp_db/hodost-lv/2018/2018_03_07_04_56/2018_03_07_21_54.mpg;Junichiro KOIZUMI.jpg;35017;35017;91169;1752;1752;0
/net/per610a/home/mvp/mvp_db/hodost-lv/2018/2018_03_07_04_56/2018_03_07_21_54.mpg;Junichiro KOIZUMI.jpg;35337;35893;91169;1768;1796;28
/net/per610a/home/mvp/mvp_db/hodost-lv/2018/2018_03_07_04_56/2018_03_07_21_54.mpg;Junichiro KOIZUMI.jpg;36469;37093;91169;1825;1856;31
/net/per610a/home/mvp/mvp_db/hodost-lv/2018/2018_03_07_04_56/2018_03_07_21_54.mpg;Junichiro KOIZUMI.jpg;37317;37377;91169;1867;1870;3
/net/per610a/home/mvp/mvp_db/hodost-lv/2018/2018_03_07_04_56/2018_03_07_21_54.mpg;Junichiro KOIZUMI.jpg;38425;38709;91169;1923;1937;14
/net/per610a/home/mvp/mvp_db/hodost-lv/2018/2018_03_07_04_56/2018_03_07_21_54.mpg;Junichiro KOIZUMI.jpg;38813;39301;91169;1942;1967;25
/net/per610a/home/mvp/mvp_db/hodost-lv/2018/2018_03_07_04_56/2018_03_07_21_54.mpg;Junichiro KOIZUMI.jpg;39789;39809;91169;1991;1992;1
/net/per610a/home/mvp/mvp_db/hodost-lv/2018/2018_03_07_04_56/2018_03_07_21_54.mpg;Junichiro KOIZUMI.jpg;44189;44345;91169;2211;2219;8
/net/per610a/home/mvp/mvp_db/hodost-lv/2018/2018_03_07_04_56/2018_03_07_21_54.mpg;Junichiro KOIZUMI.jpg;45017;45141;91169;2253;2259;6
/net/per610a/home/mvp/mvp_db/hodost-lv/2018/2018_03_07_04_56/2018_03_07_21_54.mpg;Junichiro KOIZUMI.jpg;45585;45849;91169;2281;2294;13
/net/per610a/home/mvp/mvp_db/hodost-lv/2018/2018_03_07_04_56/2018_03_07_21_54.mpg;Junichiro KOIZUMI.jpg;45941;46257;91169;2299;2315;16
/net/per610a/home/mvp/mvp_db/hodost-lv/2018/2018_03_09_04_56/2018_03_09_21_54.mpg;Taro ASO.jpg;1281;1285;91169;64;64;0
/net/per610a/home/mvp/mvp_db/hodost-lv/2018/2018_03_09_04_56/2018_03_09_21_54.mpg;Taro ASO.jpg;8029;8737;91169;401;437;36
/net/per610a/home/mvp/mvp_db/hodost-lv/2018/2018_03_09_04_56/2018_03_09_21_54.mpg;Taro ASO.jpg;8809;10753;91169;440;538;98
/net/per610a/home/mvp/mvp_db/hodost-lv/2018/2018_03_09_04_56/2018_03_09_21_54.mpg;Taro ASO.jpg;15749;16145;91169;788;808;20
/net/per610a/home/mvp/mvp_db/hodost-lv/2018/2018_03_09_04_56/2018_03_09_21_54.mpg;Shinzo ABE.jpg;12297;12393;91169;615;620;5
/net/per610a/home/mvp/mvp_db/hodost-lv/2018/2018_03_10_04_56/2018_03_10_20_54.mpg;Taro ASO.jpg;1453;1721;89969;72;86;14
/net/per610a/home/mvp/mvp_db/hodost-lv/2018/2018_03_10_04_56/2018_03_10_20_54.mpg;Taro ASO.jpg;1829;2045;89969;91;102;11
/net/per610a/home/mvp/mvp_db/hodost-lv/2018/2018_03_10_04_56/2018_03_10_20_54.mpg;Taro ASO.jpg;5329;5353;89969;266;267;1
/net/per610a/home/mvp/mvp_db/hodost-lv/2018/2018_03_10_04_56/2018_03_10_20_54.mpg;Taro ASO.jpg;16729;17009;89969;837;851;14
/net/per610a/home/mvp/mvp_db/hodost-lv/2018/2018_03_10_04_56/2018_03_10_20_54.mpg;Taro ASO.jpg;17257;17609;89969;863;881;18
/net/per610a/home/mvp/mvp_db/hodost-lv/2018/2018_03_10_04_56/2018_03_10_20_54.mpg;Shinzo ABE.jpg;18785;19113;89969;939;956;17
/net/per610a/home/mvp/mvp_db/hodost-lv/2018/2018_03_11_04_56/2018_03_11_20_54.mpg;Kazuo SHII.jpg;2085;2273;71989;104;113;9
/net/per610a/home/mvp/mvp_db/hodost-lv/2018/2018_03_11_04_56/2018_03_11_20_54.mpg;Shinzo ABE.jpg;5933;6001;71989;296;300;4
/net/per610a/home/mvp/mvp_db/hodost-lv/2018/2018_03_11_04_56/2018_03_11_20_54.mpg;Shinzo ABE.jpg;7593;8297;71989;380;415;35
/net/per610a/home/mvp/mvp_db/hodost-lv/2018/2018_03_11_04_56/2018_03_11_20_54.mpg;Shinzo ABE.jpg;19465;19569;71989;974;979;5
/net/per610a/home/mvp/mvp_db/hodost-lv/2018/2018_03_11_04_56/2018_03_11_20_54.mpg;Shinzo ABE.jpg;19669;19729;71989;984;987;3
/net/per610a/home/mvp/mvp_db/hodost-lv/2018/2018_03_11_04_56/2018_03_11_20_54.mpg;Shinzo ABE.jpg;21337;21401;71989;1067;1071;4
/net/per610a/home/mvp/mvp_db/hodost-lv/2018/2018_03_11_04_56/2018_03_11_20_54.mpg;Shinzo ABE.jpg;21501;21561;71989;1076;1079;3
/net/per610a/home/mvp/mvp_db/hodost-lv/2018/2018_03_11_04_56/2018_03_11_20_54.mpg;Shinzo ABE.jpg;23065;23125;71989;1154;1157;3
/net/per610a/home/mvp/mvp_db/hodost-lv/2018/2018_03_11_04_56/2018_03_11_20_54.mpg;Shinzo ABE.jpg;21833;21937;71989;1092;1097;5
/net/per610a/home/mvp/mvp_db/hodost-lv/2018/2018_03_11_04_56/2018_03_11_20_54.mpg;Shinzo ABE.jpg;22861;22965;71989;1144;1149;5
/net/per610a/home/mvp/mvp_db/hodost-lv/2018/2018_03_11_04_56/2018_03_11_20_54.mpg;Shinzo ABE.jpg;23393;23501;71989;1170;1176;6
/net/per610a/home/mvp/mvp_db/hodost-lv/2018/2018_03_12_04_56/2018_03_12_21_54.mpg;Taro ASO.jpg;17273;17301;91169;864;865;1
/net/per610a/home/mvp/mvp_db/hodost-lv/2018/2018_03_12_04_56/2018_03_12_21_54.mpg;Taro ASO.jpg;28397;28561;91169;1421;1429;8
/net/per610a/home/mvp/mvp_db/hodost-lv/2018/2018_03_12_04_56/2018_03_12_21_54.mpg;Shinzo ABE.jpg;18681;18685;91169;934;935;1
/net/per610a/home/mvp/mvp_db/hodost-lv/2018/2018_03_12_04_56/2018_03_12_21_54.mpg;Shinzo ABE.jpg;18897;19069;91169;945;954;9
/net/per610a/home/mvp/mvp_db/hodost-lv/2018/2018_03_12_04_56/2018_03_12_21_54.mpg;Shinzo ABE.jpg;19389;19405;91169;970;971;1
/net/per610a/home/mvp/mvp_db/hodost-lv/2018/2018_03_12_04_56/2018_03_12_21_54.mpg;Shinzo ABE.jpg;28397;28561;91169;1421;1429;8
/net/per610a/home/mvp/mvp_db/hodost-lv/2018/2018_03_12_04_56/2018_03_12_21_54.mpg;Shinzo ABE.jpg;32797;33725;91169;1641;1687;46
/net/per610a/home/mvp/mvp_db/hodost-lv/2018/2018_03_13_04_56/2018_03_13_21_54.mpg;Taro ASO.jpg;1833;2077;91169;91;103;12
/net/per610a/home/mvp/mvp_db/hodost-lv/2018/2018_03_13_04_56/2018_03_13_21_54.mpg;Taro ASO.jpg;5885;6153;91169;294;307;13
/net/per610a/home/mvp/mvp_db/hodost-lv/2018/2018_03_13_04_56/2018_03_13_21_54.mpg;Taro ASO.jpg;6357;7017;91169;318;351;33
/net/per610a/home/mvp/mvp_db/hodost-lv/2018/2018_03_13_04_56/2018_03_13_21_54.mpg;Taro ASO.jpg;12789;12849;91169;640;643;3
/net/per610a/home/mvp/mvp_db/hodost-lv/2018/2018_03_13_04_56/2018_03_13_21_54.mpg;Ichiro OZAWA.jpg;7637;8681;91169;382;434;52
/net/per610a/home/mvp/mvp_db/hodost-lv/2018/2018_03_13_04_56/2018_03_13_21_54.mpg;Yukio EDANO.jpg;10681;11901;91169;534;595;61
/net/per610a/home/mvp/mvp_db/hodost-lv/2018/2018_03_15_04_56/2018_03_15_22_09.mpg;Shinzo ABE.jpg;1409;1889;91169;70;94;24
/net/per610a/home/mvp/mvp_db/hodost-lv/2018/2018_03_15_04_56/2018_03_15_22_09.mpg;Shinzo ABE.jpg;3925;4029;91169;196;201;5
/net/per610a/home/mvp/mvp_db/hodost-lv/2018/2018_03_15_04_56/2018_03_15_22_09.mpg;Shinzo ABE.jpg;15045;15129;91169;753;757;4
/net/per610a/home/mvp/mvp_db/hodost-lv/2018/2018_03_15_04_56/2018_03_15_22_09.mpg;Shinzo ABE.jpg;15193;15217;91169;760;761;1
/net/per610a/home/mvp/mvp_db/hodost-lv/2018/2018_03_15_04_56/2018_03_15_22_09.mpg;Shinzo ABE.jpg;15325;15393;91169;767;770;3
/net/per610a/home/mvp/mvp_db/hodost-lv/2018/2018_03_16_04_56/2018_03_16_21_54.mpg;Taro ASO.jpg;1233;1405;91161;61;70;9
/net/per610a/home/mvp/mvp_db/hodost-lv/2018/2018_03_16_04_56/2018_03_16_21_54.mpg;Taro ASO.jpg;5045;5481;91161;252;274;22
/net/per610a/home/mvp/mvp_db/hodost-lv/2018/2018_03_16_04_56/2018_03_16_21_54.mpg;Taro ASO.jpg;5721;6093;91161;286;304;18
/net/per610a/home/mvp/mvp_db/hodost-lv/2018/2018_03_16_04_56/2018_03_16_21_54.mpg;Taro ASO.jpg;8749;8865;91161;437;443;6
/net/per610a/home/mvp/mvp_db/hodost-lv/2018/2018_03_16_04_56/2018_03_16_21_54.mpg;Taro ASO.jpg;9025;9309;91161;451;465;14
/net/per610a/home/mvp/mvp_db/hodost-lv/2018/2018_03_16_04_56/2018_03_16_21_54.mpg;Taro ASO.jpg;13061;13105;91161;653;655;2
/net/per610a/home/mvp/mvp_db/hodost-lv/2018/2018_03_16_04_56/2018_03_16_21_54.mpg;Shinzo ABE.jpg;21989;22093;91161;1100;1105;5
/net/per610a/home/mvp/mvp_db/hodost-lv/2018/2018_03_16_04_56/2018_03_16_21_54.mpg;Shinzo ABE.jpg;22301;22377;91161;1116;1119;3
/net/per610a/home/mvp/mvp_db/hodost-lv/2018/2018_03_19_04_56/2018_03_19_21_54.mpg;Shinzo ABE.jpg;617;649;91161;30;32;2
/net/per610a/home/mvp/mvp_db/hodost-lv/2018/2018_03_19_04_56/2018_03_19_21_54.mpg;Shinzo ABE.jpg;921;925;91161;46;46;0
/net/per610a/home/mvp/mvp_db/hodost-lv/2018/2018_03_19_04_56/2018_03_19_21_54.mpg;Shinzo ABE.jpg;4677;4717;91161;234;236;2
/net/per610a/home/mvp/mvp_db/hodost-lv/2018/2018_03_19_04_56/2018_03_19_21_54.mpg;Shinzo ABE.jpg;12041;12237;91161;602;612;10
/net/per610a/home/mvp/mvp_db/hodost-lv/2018/2018_03_19_04_56/2018_03_19_21_54.mpg;Shinzo ABE.jpg;15997;16149;91161;800;808;8
/net/per610a/home/mvp/mvp_db/hodost-lv/2018/2018_03_19_04_56/2018_03_19_21_54.mpg;Shinzo ABE.jpg;22237;22541;91161;1112;1128;16
/net/per610a/home/mvp/mvp_db/hodost-lv/2018/2018_03_19_04_56/2018_03_19_21_54.mpg;Shinzo ABE.jpg;23157;23237;91161;1158;1162;4
/net/per610a/home/mvp/mvp_db/hodost-lv/2018/2018_03_19_04_56/2018_03_19_21_54.mpg;Shinzo ABE.jpg;1993;1993;91161;99;99;0
/net/per610a/home/mvp/mvp_db/hodost-lv/2018/2018_03_19_04_56/2018_03_19_21_54.mpg;Shinzo ABE.jpg;23421;23489;91161;1172;1175;3
/net/per610a/home/mvp/mvp_db/hodost-lv/2018/2018_03_21_04_56/2018_03_21_22_19.mpg;YUriko Koike.jpg;18761;18901;91169;938;945;7
/net/per610a/home/mvp/mvp_db/hodost-lv/2018/2018_03_21_04_56/2018_03_21_22_19.mpg;YUriko Koike.jpg;19029;19245;91169;952;963;11
/net/per610a/home/mvp/mvp_db/hodost-lv/2018/2018_03_22_04_56/2018_03_22_21_54.mpg;Shinzo ABE.jpg;12057;12145;91169;603;607;4
/net/per610a/home/mvp/mvp_db/hodost-lv/2018/2018_03_22_04_56/2018_03_22_21_54.mpg;Shinzo ABE.jpg;19969;20373;91169;999;1019;20
/net/per610a/home/mvp/mvp_db/hodost-lv/2018/2018_03_22_04_56/2018_03_22_21_54.mpg;Shinzo ABE.jpg;21085;21237;91169;1055;1062;7
/net/per610a/home/mvp/mvp_db/hodost-lv/2018/2018_03_22_04_56/2018_03_22_21_54.mpg;Shinzo ABE.jpg;21321;21321;91169;1067;1067;0
/net/per610a/home/mvp/mvp_db/hodost-lv/2018/2018_03_22_04_56/2018_03_22_21_54.mpg;Shinzo ABE.jpg;42625;42769;91169;2133;2140;7
/net/per610a/home/mvp/mvp_db/hodost-lv/2018/2018_03_22_04_56/2018_03_22_21_54.mpg;Shinzo ABE.jpg;42893;42929;91169;2146;2148;2
/net/per610a/home/mvp/mvp_db/hodost-lv/2018/2018_03_26_04_56/2018_03_26_21_54.mpg;Shinzo ABE.jpg;4753;5029;91161;237;251;14
/net/per610a/home/mvp/mvp_db/hodost-lv/2018/2018_03_26_04_56/2018_03_26_21_54.mpg;Shinzo ABE.jpg;7989;8021;91161;399;401;2
/net/per610a/home/mvp/mvp_db/hodost-lv/2018/2018_03_26_04_56/2018_03_26_21_54.mpg;Shinzo ABE.jpg;9029;9049;91161;451;452;1
/net/per610a/home/mvp/mvp_db/hodost-lv/2018/2018_03_26_04_56/2018_03_26_21_54.mpg;Shinzo ABE.jpg;9193;9285;91161;460;464;4
/net/per610a/home/mvp/mvp_db/hodost-lv/2018/2018_03_26_04_56/2018_03_26_21_54.mpg;Shinzo ABE.jpg;9393;9613;91161;470;481;11
/net/per610a/home/mvp/mvp_db/hodost-lv/2018/2018_03_26_04_56/2018_03_26_21_54.mpg;Ichiro OZAWA.jpg;10105;10977;91161;505;549;44
/net/per610a/home/mvp/mvp_db/hodost-lv/2018/2018_03_28_04_56/2018_03_28_21_54.mpg;Kohei Otsuka.jpg;11929;12029;91169;597;602;5
/net/per610a/home/mvp/mvp_db/hodost-lv/2018/2018_03_28_04_56/2018_03_28_21_54.mpg;Kohei Otsuka.jpg;27465;27653;91169;1374;1384;10
/net/per610a/home/mvp/mvp_db/hodost-lv/2018/2018_03_28_04_56/2018_03_28_21_54.mpg;Kohei Otsuka.jpg;32497;32657;91169;1626;1634;8
/net/per610a/home/mvp/mvp_db/hodost-lv/2018/2018_03_28_04_56/2018_03_28_21_54.mpg;Kohei Otsuka.jpg;41125;41161;91169;2058;2060;2
/net/per610a/home/mvp/mvp_db/hodost-lv/2018/2018_03_28_04_56/2018_03_28_21_54.mpg;Kohei Otsuka.jpg;48509;49185;91169;2427;2461;34
/net/per610a/home/mvp/mvp_db/hodost-lv/2018/2018_03_28_04_56/2018_03_28_21_54.mpg;Kohei Otsuka.jpg;60525;60565;91169;3029;3031;2
/net/per610a/home/mvp/mvp_db/hodost-lv/2018/2018_03_28_04_56/2018_03_28_21_54.mpg;Kohei Otsuka.jpg;85353;85413;91169;4271;4274;3
/net/per610a/home/mvp/mvp_db/hodost-lv/2018/2018_03_28_04_56/2018_03_28_21_54.mpg;Kohei Otsuka.jpg;85893;85909;91169;4298;4299;1
/net/per610a/home/mvp/mvp_db/hodost-lv/2018/2018_03_28_04_56/2018_03_28_21_54.mpg;Shinzo ABE.jpg;16957;17061;91169;848;853;5
/net/per610a/home/mvp/mvp_db/hodost-lv/2018/2018_03_29_04_56/2018_03_29_21_54.mpg;Taro ASO.jpg;21169;21589;91169;1059;1080;21
/net/per610a/home/mvp/mvp_db/hodost-lv/2018/2018_03_29_04_56/2018_03_29_21_54.mpg;Taro ASO.jpg;22769;22801;91169;1139;1141;2
/net/per610a/home/mvp/mvp_db/hodost-lv/2018/2018_03_29_04_56/2018_03_29_21_54.mpg;Taro ASO.jpg;24741;24741;91169;1238;1238;0
/net/per610a/home/mvp/mvp_db/hodost-lv/2018/2018_03_29_04_56/2018_03_29_21_54.mpg;Taro ASO.jpg;25317;25317;91169;1267;1267;0
/net/per610a/home/mvp/mvp_db/hodost-lv/2018/2018_03_29_04_56/2018_03_29_21_54.mpg;Taro ASO.jpg;28037;28289;91169;1403;1415;12
/net/per610a/home/mvp/mvp_db/hodost-lv/2018/2018_03_29_04_56/2018_03_29_21_54.mpg;Yuichiro Tamaki.png;21869;22645;91169;1094;1133;39
/net/per610a/home/mvp/mvp_db/hodost-lv/2018/2018_03_29_04_56/2018_03_29_21_54.mpg;Taro ASO.jpg;26189;26277;91169;1310;1315;5
/net/per610a/home/mvp/mvp_db/hodost-lv/2018/2018_03_29_04_56/2018_03_29_21_54.mpg;Taro ASO.jpg;28317;28389;91169;1417;1420;3
/net/per610a/home/mvp/mvp_db/hodost-lv/2018/2018_03_31_04_56/2018_03_31_20_54.mpg;Kohei Otsuka.jpg;92677;92949;143921;4638;4651;13
/net/per610a/home/mvp/mvp_db/hodost-lv/2018/2018_03_31_04_56/2018_03_31_20_54.mpg;Kohei Otsuka.jpg;93061;93245;143921;4657;4666;9
/net/per610a/home/mvp/mvp_db/hodost-lv/2018/2018_03_31_04_56/2018_03_31_20_54.mpg;Kohei Otsuka.jpg;93521;93601;143921;4680;4684;4
/net/per610a/home/mvp/mvp_db/hodost-lv/2018/2018_03_31_04_56/2018_03_31_20_54.mpg;Kohei Otsuka.jpg;94425;94481;143921;4725;4728;3
/net/per610a/home/mvp/mvp_db/hodost-lv/2018/2018_03_31_04_56/2018_03_31_20_54.mpg;Kohei Otsuka.jpg;94749;94933;143921;4742;4751;9
/net/per610a/home/mvp/mvp_db/hodost-lv/2018/2018_04_03_04_56/2018_04_03_21_54.mpg;Junichiro KOIZUMI.jpg;9629;9925;91169;481;496;15
/net/per610a/home/mvp/mvp_db/hodost-lv/2018/2018_04_04_04_56/2018_04_04_21_54.mpg;Yasuo FUKUDA.jpg;33157;33309;91169;1659;1667;8
/net/per610a/home/mvp/mvp_db/hodost-lv/2018/2018_04_05_04_56/2018_04_05_21_54.mpg;Taro ASO.jpg;27609;27773;91169;1381;1390;9
/net/per610a/home/mvp/mvp_db/hodost-lv/2018/2018_04_05_04_56/2018_04_05_21_54.mpg;Shinzo ABE.jpg;28197;28309;91169;1411;1416;5
/net/per610a/home/mvp/mvp_db/hodost-lv/2018/2018_04_05_04_56/2018_04_05_21_54.mpg;Shinzo ABE.jpg;29693;29777;91169;1486;1490;4
/net/per610a/home/mvp/mvp_db/hodost-lv/2018/2018_04_05_04_56/2018_04_05_21_54.mpg;Shinzo ABE.jpg;33037;33097;91169;1653;1656;3
/net/per610a/home/mvp/mvp_db/hodost-lv/2018/2018_04_05_04_56/2018_04_05_21_54.mpg;Shinzo ABE.jpg;34045;34189;91169;1703;1711;8
/net/per610a/home/mvp/mvp_db/hodost-lv/2018/2018_04_05_04_56/2018_04_05_21_54.mpg;Shinzo ABE.jpg;34345;34409;91169;1718;1722;4
/net/per610a/home/mvp/mvp_db/hodost-lv/2018/2018_04_05_04_56/2018_04_05_21_54.mpg;Yasuo FUKUDA.jpg;33581;33993;91169;1680;1701;21
/net/per610a/home/mvp/mvp_db/hodost-lv/2018/2018_04_06_04_56/2018_04_06_21_54.mpg;Taro ASO.jpg;19649;20205;91169;983;1011;28
/net/per610a/home/mvp/mvp_db/hodost-lv/2018/2018_04_06_04_56/2018_04_06_21_54.mpg;Shinzo ABE.jpg;56429;56497;91169;2824;2827;3
/net/per610a/home/mvp/mvp_db/hodost-lv/2018/2018_04_06_04_56/2018_04_06_21_54.mpg;Shinzo ABE.jpg;56629;56701;91169;2834;2837;3
/net/per610a/home/mvp/mvp_db/hodost-lv/2018/2018_04_10_04_56/2018_04_10_21_54.mpg;Shinzo ABE.jpg;2321;2357;55201;116;117;1
/net/per610a/home/mvp/mvp_db/hodost-lv/2018/2018_04_10_04_56/2018_04_10_21_54.mpg;Shinzo ABE.jpg;8101;8397;55201;405;420;15
/net/per610a/home/mvp/mvp_db/hodost-lv/2018/2018_04_10_04_56/2018_04_10_21_54.mpg;Shinzo ABE.jpg;11653;11761;55201;583;588;5
/net/per610a/home/mvp/mvp_db/hodost-lv/2018/2018_04_10_04_56/2018_04_10_21_54.mpg;Shinzo ABE.jpg;11309;11413;55201;565;571;6
/net/per610a/home/mvp/mvp_db/hodost-lv/2018/2018_04_11_04_56/2018_04_11_22_09.mpg;Shinzo ABE.jpg;14505;14601;91161;725;730;5
/net/per610a/home/mvp/mvp_db/hodost-lv/2018/2018_04_11_04_56/2018_04_11_22_09.mpg;Shinzo ABE.jpg;19869;19949;91161;994;998;4
/net/per610a/home/mvp/mvp_db/hodost-lv/2018/2018_04_11_04_56/2018_04_11_22_09.mpg;Shinzo ABE.jpg;20069;20121;91161;1004;1006;2
/net/per610a/home/mvp/mvp_db/hodost-lv/2018/2018_04_11_04_56/2018_04_11_22_09.mpg;Shinzo ABE.jpg;20473;20625;91161;1024;1032;8
/net/per610a/home/mvp/mvp_db/hodost-lv/2018/2018_04_11_04_56/2018_04_11_22_09.mpg;Shinzo ABE.jpg;20637;20901;91161;1032;1045;13
/net/per610a/home/mvp/mvp_db/hodost-lv/2018/2018_04_11_04_56/2018_04_11_22_09.mpg;Shinzo ABE.jpg;22893;23105;91161;1145;1156;11
/net/per610a/home/mvp/mvp_db/hodost-lv/2018/2018_04_11_04_56/2018_04_11_22_09.mpg;Shinzo ABE.jpg;27149;27217;91161;1358;1362;4
/net/per610a/home/mvp/mvp_db/hodost-lv/2018/2018_04_11_04_56/2018_04_11_22_09.mpg;Shinzo ABE.jpg;28441;28629;91161;1423;1432;9
/net/per610a/home/mvp/mvp_db/hodost-lv/2018/2018_04_11_04_56/2018_04_11_22_09.mpg;Shinzo ABE.jpg;30661;30929;91161;1534;1547;13
/net/per610a/home/mvp/mvp_db/hodost-lv/2018/2018_04_01_04_56/2018_04_01_16_30.mpg;Shinzo ABE.jpg;26133;26273;107949;1307;1314;7
/net/per610a/home/mvp/mvp_db/hodost-lv/2018/2018_04_01_04_56/2018_04_01_16_30.mpg;Shinzo ABE.jpg;28165;28233;107949;1409;1412;3
/net/per610a/home/mvp/mvp_db/hodost-lv/2018/2018_04_01_04_56/2018_04_01_16_30.mpg;Shinzo ABE.jpg;28369;28369;107949;1419;1419;0
/net/per610a/home/mvp/mvp_db/hodost-lv/2018/2018_04_01_04_56/2018_04_01_16_30.mpg;Shinzo ABE.jpg;103289;103373;107949;5168;5173;5
/net/per610a/home/mvp/mvp_db/hodost-lv/2018/2018_04_12_04_56/2018_04_12_21_54.mpg;Shinzo ABE.jpg;23773;24149;91169;1189;1208;19
/net/per610a/home/mvp/mvp_db/hodost-lv/2018/2018_04_12_04_56/2018_04_12_21_54.mpg;Ichiro OZAWA.jpg;47997;48185;91169;2402;2411;9
/net/per610a/home/mvp/mvp_db/hodost-lv/2018/2018_01_07_04_56/2018_01_07_23_10.mpg;Shinzo ABE.jpg;38913;39473;83981;1947;1975;28
/net/per610a/home/mvp/mvp_db/hodost-lv/2018/2018_01_07_04_56/2018_01_07_23_10.mpg;Shinzo ABE.jpg;73929;73933;83981;3699;3700;1
/net/per610a/home/mvp/mvp_db/hodost-lv/2018/2018_01_07_04_56/2018_01_07_23_10.mpg;Shinzo ABE.jpg;78529;79189;83981;3930;3963;33
/net/per610a/home/mvp/mvp_db/hodost-lv/2018/2018_03_24_04_56/2018_03_24_23_10.mpg;Shinzo ABE.jpg;2609;2745;71989;130;137;7
/net/per610a/home/mvp/mvp_db/hodost-lv/2018/2018_03_24_04_56/2018_03_24_23_10.mpg;Shinzo ABE.jpg;10193;10193;71989;510;510;0
/net/per610a/home/mvp/mvp_db/hodost-lv/2018/2018_03_24_04_56/2018_03_24_23_10.mpg;Shinzo ABE.jpg;15365;15457;71989;769;773;4
/net/per610a/home/mvp/mvp_db/hodost-lv/2018/2018_03_24_04_56/2018_03_24_23_10.mpg;Shinzo ABE.jpg;16069;16113;71989;804;806;2
/net/per610a/home/mvp/mvp_db/hodost-lv/2018/2018_03_24_04_56/2018_03_24_23_10.mpg;Shinzo ABE.jpg;16233;16277;71989;812;814;2
/net/per610a/home/mvp/mvp_db/hodost-lv/2018/2018_03_24_04_56/2018_03_24_23_10.mpg;Shinzo ABE.jpg;16341;16601;71989;817;830;13
/net/per610a/home/mvp/mvp_db/hodost-lv/2018/2018_03_24_04_56/2018_03_24_23_10.mpg;Shinzo ABE.jpg;17545;17653;71989;878;883;5
/net/per610a/home/mvp/mvp_db/hodost-lv/2018/2018_03_24_04_56/2018_03_24_23_10.mpg;Shinzo ABE.jpg;19429;19461;71989;972;974;2
/net/per610a/home/mvp/mvp_db/hodost-lv/2018/2018_03_24_04_56/2018_03_24_23_10.mpg;Shinzo ABE.jpg;21069;21233;71989;1054;1062;8
/net/per610a/home/mvp/mvp_db/hodost-lv/2018/2018_03_24_04_56/2018_03_24_23_10.mpg;Shinzo ABE.jpg;7753;7965;71989;388;398;10
/net/per610a/home/mvp/mvp_db/hodost-lv/2018/2018_03_24_04_56/2018_03_24_23_10.mpg;Shinzo ABE.jpg;20589;20721;71989;1030;1037;7
/net/per610a/home/mvp/mvp_db/hodost-lv/2018/2018_03_24_04_56/2018_03_24_23_10.mpg;Shinzo ABE.jpg;20813;21065;71989;1041;1054;13
/net/per610a/home/mvp/mvp_db/hodost-lv/2018/2018_03_25_04_56/2018_03_25_23_10.mpg;Shinzo ABE.jpg;973;1189;71981;48;59;11
/net/per610a/home/mvp/mvp_db/hodost-lv/2018/2018_03_25_04_56/2018_03_25_23_10.mpg;Shinzo ABE.jpg;1293;1409;71981;64;70;6
/net/per610a/home/mvp/mvp_db/hodost-lv/2018/2018_03_25_04_56/2018_03_25_23_10.mpg;Shinzo ABE.jpg;1609;2525;71981;80;126;46
/net/per610a/home/mvp/mvp_db/hodost-lv/2018/2018_03_25_04_56/2018_03_25_23_10.mpg;Shinzo ABE.jpg;14965;15213;71981;748;761;13
/net/per610a/home/mvp/mvp_db/hodost-lv/2018/2018_03_25_04_56/2018_03_25_23_10.mpg;Shinzo ABE.jpg;63177;63269;71981;3161;3166;5
/net/per610a/home/mvp/mvp_db/hodost-lv/2018/2018_03_25_04_56/2018_03_25_23_10.mpg;Shinzo ABE.jpg;67597;67613;71981;3382;3383;1
/net/per610a/home/mvp/mvp_db/hodost-lv/2018/2018_03_25_04_56/2018_03_25_23_10.mpg;Kazuo SHII.jpg;12417;12925;71981;621;646;25
/net/per610a/home/mvp/mvp_db/hodost-lv/2018/2018_04_13_04_56/2018_04_13_21_54.mpg;Shinzo ABE.jpg;12669;13093;55209;634;655;21
/net/per610a/home/mvp/mvp_db/hodost-lv/2018/2018_04_13_04_56/2018_04_13_21_54.mpg;Shinzo ABE.jpg;13113;13257;55209;656;663;7
/net/per610a/home/mvp/mvp_db/hodost-lv/2018/2018_04_14_04_56/2018_04_14_20_54.mpg;Shinzo ABE.jpg;3109;3173;91161;155;158;3
/net/per610a/home/mvp/mvp_db/hodost-lv/2018/2018_04_14_04_56/2018_04_14_20_54.mpg;Shinzo ABE.jpg;66093;66141;91161;3307;3309;2
/net/per610a/home/mvp/mvp_db/hodost-lv/2018/2018_04_15_04_56/2018_04_15_16_30.mpg;Shinzo ABE.jpg;29517;29549;107949;1477;1478;1
/net/per610a/home/mvp/mvp_db/hodost-lv/2018/2018_04_15_04_56/2018_04_15_16_30.mpg;Shinzo ABE.jpg;29781;29857;107949;1490;1494;4
/net/per610a/home/mvp/mvp_db/hodost-lv/2018/2018_04_15_04_56/2018_04_15_16_30.mpg;Shinzo ABE.jpg;29985;29985;107949;1500;1500;0
/net/per610a/home/mvp/mvp_db/hodost-lv/2018/2018_04_15_04_56/2018_04_15_16_30.mpg;Shinzo ABE.jpg;103881;103889;107949;5198;5198;0
/net/per610a/home/mvp/mvp_db/hodost-lv/2018/2018_04_15_04_56/2018_04_15_16_30.mpg;Shinzo ABE.jpg;30065;30289;107949;1504;1515;11
/net/per610a/home/mvp/mvp_db/hodost-lv/2018/2018_04_15_04_56/2018_04_15_16_30.mpg;Shinzo ABE.jpg;61101;61433;107949;3057;3074;17
/net/per610a/home/mvp/mvp_db/hodost-lv/2018/2018_04_15_04_56/2018_04_15_16_30.mpg;Shinzo ABE.jpg;61749;61765;107949;3090;3090;0
/net/per610a/home/mvp/mvp_db/hodost-lv/2018/2018_04_15_04_56/2018_04_15_16_30.mpg;Shinzo ABE.jpg;61865;61897;107949;3095;3097;2
/net/per610a/home/mvp/mvp_db/hodost-lv/2018/2018_04_15_04_56/2018_04_15_16_30.mpg;Taro ASO.jpg;61101;61433;107949;3057;3074;17
/net/per610a/home/mvp/mvp_db/hodost-lv/2018/2018_04_15_04_56/2018_04_15_16_30.mpg;Taro ASO.jpg;62017;62037;107949;3103;3104;1
/net/per610a/home/mvp/mvp_db/hodost-lv/2018/2018_04_15_04_56/2018_04_15_16_30.mpg;Taro ASO.jpg;62769;63141;107949;3141;3159;18
/net/per610a/home/mvp/mvp_db/hodost-lv/2018/2018_04_16_04_56/2018_04_16_21_54.mpg;Taro ASO.jpg;10421;10701;91169;521;535;14
/net/per610a/home/mvp/mvp_db/hodost-lv/2018/2018_04_16_04_56/2018_04_16_21_54.mpg;Taro ASO.jpg;10765;12105;91169;538;605;67
/net/per610a/home/mvp/mvp_db/hodost-lv/2018/2018_04_16_04_56/2018_04_16_21_54.mpg;Taro ASO.jpg;16765;16993;91169;839;850;11
/net/per610a/home/mvp/mvp_db/hodost-lv/2018/2018_04_16_04_56/2018_04_16_21_54.mpg;Taro ASO.jpg;12321;12497;91169;616;625;9
/net/per610a/home/mvp/mvp_db/hodost-lv/2018/2018_04_16_04_56/2018_04_16_21_54.mpg;Taro ASO.jpg;14009;14065;91169;701;703;2
/net/per610a/home/mvp/mvp_db/hodost-lv/2018/2018_04_16_04_56/2018_04_16_21_54.mpg;Taro ASO.jpg;16661;16745;91169;833;838;5
/net/per610a/home/mvp/mvp_db/hodost-lv/2018/2018_04_16_04_56/2018_04_16_21_54.mpg;Junichiro KOIZUMI.jpg;23009;23465;91169;1151;1174;23
/net/per610a/home/mvp/mvp_db/hodost-lv/2018/2018_04_16_04_56/2018_04_16_21_54.mpg;Shinzo ABE.jpg;49337;49529;91169;2469;2478;9
/net/per610a/home/mvp/mvp_db/hodost-lv/2018/2018_04_17_04_56/2018_04_17_21_54.mpg;Taro ASO.jpg;1081;1541;91169;54;77;23
/net/per610a/home/mvp/mvp_db/hodost-lv/2018/2018_04_17_04_56/2018_04_17_21_54.mpg;Taro ASO.jpg;5541;7245;91169;277;362;85
/net/per610a/home/mvp/mvp_db/hodost-lv/2018/2018_04_17_04_56/2018_04_17_21_54.mpg;Ichiro OZAWA.jpg;10221;10541;91169;511;527;16
/net/per610a/home/mvp/mvp_db/hodost-lv/2018/2018_04_17_04_56/2018_04_17_21_54.mpg;Yukio EDANO.jpg;10617;11213;91169;531;561;30
/net/per610a/home/mvp/mvp_db/hodost-lv/2018/2018_04_17_04_56/2018_04_17_21_54.mpg;Shinzo ABE.jpg;37941;38173;91169;1898;1910;12
/net/per610a/home/mvp/mvp_db/hodost-lv/2018/2018_04_17_04_56/2018_04_17_21_54.mpg;Shinzo ABE.jpg;38385;38385;91169;1921;1921;0
/net/per610a/home/mvp/mvp_db/hodost-lv/2018/2018_04_17_04_56/2018_04_17_21_54.mpg;Shinzo ABE.jpg;44229;44509;91169;2213;2227;14
/net/per610a/home/mvp/mvp_db/hodost-lv/2018/2018_04_18_04_56/2018_04_18_21_54.mpg;Taro ASO.jpg;12613;12629;91169;631;632;1
/net/per610a/home/mvp/mvp_db/hodost-lv/2018/2018_04_18_04_56/2018_04_18_21_54.mpg;Taro ASO.jpg;13009;13245;91169;651;662;11
/net/per610a/home/mvp/mvp_db/hodost-lv/2018/2018_04_18_04_56/2018_04_18_21_54.mpg;Taro ASO.jpg;13885;14405;91169;694;720;26
/net/per610a/home/mvp/mvp_db/hodost-lv/2018/2018_04_18_04_56/2018_04_18_21_54.mpg;Taro ASO.jpg;15193;15537;91169;760;777;17
/net/per610a/home/mvp/mvp_db/hodost-lv/2018/2018_04_18_04_56/2018_04_18_21_54.mpg;Taro ASO.jpg;21085;21505;91169;1055;1076;21
/net/per610a/home/mvp/mvp_db/hodost-lv/2018/2018_04_18_04_56/2018_04_18_21_54.mpg;Taro ASO.jpg;23721;24041;91169;1187;1203;16
/net/per610a/home/mvp/mvp_db/hodost-lv/2018/2018_04_19_04_56/2018_04_19_22_09.mpg;Taro ASO.jpg;10889;11025;91169;544;551;7
/net/per610a/home/mvp/mvp_db/hodost-lv/2018/2018_04_19_04_56/2018_04_19_22_09.mpg;Taro ASO.jpg;11113;11329;91169;556;567;11
/net/per610a/home/mvp/mvp_db/hodost-lv/2018/2018_04_19_04_56/2018_04_19_22_09.mpg;Shinzo ABE.jpg;15933;16009;91169;797;801;4
/net/per610a/home/mvp/mvp_db/hodost-lv/2018/2018_04_19_04_56/2018_04_19_22_09.mpg;Shinzo ABE.jpg;16377;16477;91169;819;824;5
/net/per610a/home/mvp/mvp_db/hodost-lv/2018/2018_04_19_04_56/2018_04_19_22_09.mpg;Shinzo ABE.jpg;17717;17969;91169;886;899;13
/net/per610a/home/mvp/mvp_db/hodost-lv/2018/2018_04_19_04_56/2018_04_19_22_09.mpg;Shinzo ABE.jpg;18489;19417;91169;925;971;46
/net/per610a/home/mvp/mvp_db/hodost-lv/2018/2018_04_19_04_56/2018_04_19_22_09.mpg;Shinzo ABE.jpg;19873;20545;91169;994;1028;34
/net/per610a/home/mvp/mvp_db/hodost-lv/2018/2018_04_19_04_56/2018_04_19_22_09.mpg;Shinzo ABE.jpg;23373;23497;91169;1169;1176;7
/net/per610a/home/mvp/mvp_db/hodost-lv/2018/2018_04_19_04_56/2018_04_19_22_09.mpg;Shinzo ABE.jpg;24017;24037;91169;1202;1203;1
/net/per610a/home/mvp/mvp_db/hodost-lv/2018/2018_04_20_04_56/2018_04_20_21_54.mpg;Taro ASO.jpg;1665;1809;91161;83;90;7
/net/per610a/home/mvp/mvp_db/hodost-lv/2018/2018_04_20_04_56/2018_04_20_21_54.mpg;Taro ASO.jpg;4593;4765;91161;229;238;9
/net/per610a/home/mvp/mvp_db/hodost-lv/2018/2018_04_20_04_56/2018_04_20_21_54.mpg;Taro ASO.jpg;4897;5461;91161;245;273;28
/net/per610a/home/mvp/mvp_db/hodost-lv/2018/2018_04_20_04_56/2018_04_20_21_54.mpg;Renho.jpg;6845;7393;91161;342;369;27
/net/per610a/home/mvp/mvp_db/hodost-lv/2018/2018_04_20_04_56/2018_04_20_21_54.mpg;Shinzo ABE.jpg;16237;16469;91161;812;824;12
/net/per610a/home/mvp/mvp_db/hodost-lv/2018/2018_04_20_04_56/2018_04_20_21_54.mpg;Shinzo ABE.jpg;16537;16545;91161;827;827;0
/net/per610a/home/mvp/mvp_db/hodost-lv/2018/2018_04_20_04_56/2018_04_20_21_54.mpg;Shinzo ABE.jpg;37453;37477;91161;1874;1875;1
/net/per610a/home/mvp/mvp_db/hodost-lv/2018/2018_04_20_04_56/2018_04_20_21_54.mpg;Ichiro Matsui.jpeg;19393;19709;91161;970;986;16
/net/per610a/home/mvp/mvp_db/hodost-lv/2018/2018_04_21_04_56/2018_04_21_20_54.mpg;Taro ASO.jpg;19961;20073;91161;998;1004;6
/net/per610a/home/mvp/mvp_db/hodost-lv/2018/2018_04_21_04_56/2018_04_21_20_54.mpg;Taro ASO.jpg;20641;20733;91161;1032;1037;5
/net/per610a/home/mvp/mvp_db/hodost-lv/2018/2018_04_21_04_56/2018_04_21_20_54.mpg;Yukio EDANO.jpg;20137;20649;91161;1007;1033;26
/net/per610a/home/mvp/mvp_db/hodost-lv/2018/2018_04_21_04_56/2018_04_21_20_54.mpg;Shinzo ABE.jpg;64177;64217;91161;3211;3213;2
/net/per610a/home/mvp/mvp_db/hodost-lv/2018/2018_04_21_04_56/2018_04_21_20_54.mpg;Shinzo ABE.jpg;67541;67641;91161;3379;3384;5
/net/per610a/home/mvp/mvp_db/hodost-lv/2018/2018_04_21_04_56/2018_04_21_20_54.mpg;Shinzo ABE.jpg;68117;68121;91161;3408;3409;1
/net/per610a/home/mvp/mvp_db/hodost-lv/2018/2018_04_21_04_56/2018_04_21_20_54.mpg;Junichiro KOIZUMI.jpg;67405;67473;91161;3373;3376;3
/net/per610a/home/mvp/mvp_db/hodost-lv/2018/2018_04_21_04_56/2018_04_21_20_54.mpg;Junichiro KOIZUMI.jpg;76229;76445;91161;3814;3825;11
/net/per610a/home/mvp/mvp_db/hodost-lv/2018/2018_04_22_04_56/2018_04_22_16_30.mpg;Shinzo ABE.jpg;79769;80125;107949;3991;4009;18
/net/per610a/home/mvp/mvp_db/hodost-lv/2018/2018_04_22_04_56/2018_04_22_16_30.mpg;Shinzo ABE.jpg;80797;80805;107949;4043;4043;0
/net/per610a/home/mvp/mvp_db/hodost-lv/2018/2018_04_22_04_56/2018_04_22_16_30.mpg;Shinzo ABE.jpg;103613;103653;107949;5185;5187;2
/net/per610a/home/mvp/mvp_db/hodost-lv/2018/2018_04_22_04_56/2018_04_22_16_30.mpg;Shinzo ABE.jpg;103985;104025;107949;5203;5205;2
/net/per610a/home/mvp/mvp_db/hodost-lv/2018/2018_04_22_04_56/2018_04_22_16_30.mpg;Taro ASO.jpg;102757;102805;107949;5142;5144;2
/net/per610a/home/mvp/mvp_db/hodost-lv/2018/2018_04_22_04_56/2018_04_22_16_30.mpg;Taro ASO.jpg;104029;104133;107949;5205;5211;6
/net/per610a/home/mvp/mvp_db/hodost-lv/2018/2018_04_23_04_56/2018_04_23_21_54.mpg;Shinzo ABE.jpg;10365;10645;91161;518;532;14
/net/per610a/home/mvp/mvp_db/hodost-lv/2018/2018_04_23_04_56/2018_04_23_21_54.mpg;Shinzo ABE.jpg;21481;21481;91161;1074;1074;0
/net/per610a/home/mvp/mvp_db/hodost-lv/2018/2018_04_23_04_56/2018_04_23_21_54.mpg;Shinzo ABE.jpg;21561;21601;91161;1078;1080;2
/net/per610a/home/mvp/mvp_db/hodost-lv/2018/2018_04_23_04_56/2018_04_23_21_54.mpg;Shinzo ABE.jpg;21829;21829;91161;1092;1092;0
/net/per610a/home/mvp/mvp_db/hodost-lv/2018/2018_04_23_04_56/2018_04_23_21_54.mpg;Shinzo ABE.jpg;22085;22561;91161;1105;1129;24
/net/per610a/home/mvp/mvp_db/hodost-lv/2018/2018_04_23_04_56/2018_04_23_21_54.mpg;Shinzo ABE.jpg;23301;23745;91161;1166;1188;22
/net/per610a/home/mvp/mvp_db/hodost-lv/2018/2018_04_23_04_56/2018_04_23_21_54.mpg;Shinzo ABE.jpg;33765;33929;91161;1689;1697;8
/net/per610a/home/mvp/mvp_db/hodost-lv/2018/2018_04_23_04_56/2018_04_23_21_54.mpg;Taro ASO.jpg;23853;24057;91161;1193;1203;10
/net/per610a/home/mvp/mvp_db/hodost-lv/2018/2018_04_24_04_56/2018_04_24_21_54.mpg;Taro ASO.jpg;4433;4649;91169;221;232;11
/net/per610a/home/mvp/mvp_db/hodost-lv/2018/2018_04_24_04_56/2018_04_24_21_54.mpg;Taro ASO.jpg;14589;14637;91169;730;732;2
/net/per610a/home/mvp/mvp_db/hodost-lv/2018/2018_04_24_04_56/2018_04_24_21_54.mpg;Shinzo ABE.jpg;5689;6053;91169;284;302;18
/net/per610a/home/mvp/mvp_db/hodost-lv/2018/2018_04_24_04_56/2018_04_24_21_54.mpg;YUriko Koike.jpg;36817;36877;91169;1842;1845;3
/net/per610a/home/mvp/mvp_db/hodost-lv/2018/2018_04_24_04_56/2018_04_24_21_54.mpg;YUriko Koike.jpg;40445;40553;91169;2024;2029;5
/net/per610a/home/mvp/mvp_db/hodost-lv/2018/2018_04_24_04_56/2018_04_24_21_54.mpg;YUriko Koike.jpg;42261;42281;91169;2115;2116;1
/net/per610a/home/mvp/mvp_db/hodost-lv/2018/2018_04_24_04_56/2018_04_24_21_54.mpg;YUriko Koike.jpg;43321;43721;91169;2168;2188;20
/net/per610a/home/mvp/mvp_db/hodost-lv/2018/2018_04_24_04_56/2018_04_24_21_54.mpg;YUriko Koike.jpg;44573;44585;91169;2230;2231;1
/net/per610a/home/mvp/mvp_db/hodost-lv/2018/2018_04_24_04_56/2018_04_24_21_54.mpg;YUriko Koike.jpg;44709;44749;91169;2237;2239;2
/net/per610a/home/mvp/mvp_db/hodost-lv/2018/2018_04_24_04_56/2018_04_24_21_54.mpg;Kohei Otsuka.jpg;60865;61065;91169;3046;3056;10
/net/per610a/home/mvp/mvp_db/hodost-lv/2018/2018_04_24_04_56/2018_04_24_21_54.mpg;Kohei Otsuka.jpg;61473;61525;91169;3076;3079;3
/net/per610a/home/mvp/mvp_db/hodost-lv/2018/2018_04_25_04_56/2018_04_25_21_54.mpg;Natsuo YAMAGUCHI.jpg;1909;2157;91169;95;107;12
/net/per610a/home/mvp/mvp_db/hodost-lv/2018/2018_04_25_04_56/2018_04_25_21_54.mpg;Natsuo YAMAGUCHI.jpg;4925;5221;91169;246;261;15
/net/per610a/home/mvp/mvp_db/hodost-lv/2018/2018_04_25_04_56/2018_04_25_21_54.mpg;Shinzo ABE.jpg;2789;2889;91169;139;144;5
/net/per610a/home/mvp/mvp_db/hodost-lv/2018/2018_04_25_04_56/2018_04_25_21_54.mpg;Shinzo ABE.jpg;3721;3761;91169;186;188;2
/net/per610a/home/mvp/mvp_db/hodost-lv/2018/2018_04_25_04_56/2018_04_25_21_54.mpg;Shinzo ABE.jpg;9825;9905;91169;491;495;4
/net/per610a/home/mvp/mvp_db/hodost-lv/2018/2018_04_25_04_56/2018_04_25_21_54.mpg;Shinzo ABE.jpg;13713;13749;91169;686;688;2
/net/per610a/home/mvp/mvp_db/hodost-lv/2018/2018_04_25_04_56/2018_04_25_21_54.mpg;Shinzo ABE.jpg;2925;3029;91169;146;151;5
/net/per610a/home/mvp/mvp_db/hodost-lv/2018/2018_04_25_04_56/2018_04_25_21_54.mpg;Shinzo ABE.jpg;13757;14189;91169;688;710;22
/net/per610a/home/mvp/mvp_db/hodost-lv/2018/2018_04_25_04_56/2018_04_25_21_54.mpg;Yukio EDANO.jpg;10037;10941;91169;502;547;45
/net/per610a/home/mvp/mvp_db/hodost-lv/2018/2018_04_25_04_56/2018_04_25_21_54.mpg;YUriko Koike.jpg;53345;53985;91169;2669;2701;32
/net/per610a/home/mvp/mvp_db/hodost-lv/2018/2018_04_26_04_56/2018_04_26_21_54.mpg;Shinzo ABE.jpg;18825;19117;91169;942;956;14
/net/per610a/home/mvp/mvp_db/hodost-lv/2018/2018_04_26_04_56/2018_04_26_21_54.mpg;Shinzo ABE.jpg;20745;20825;91169;1038;1042;4
/net/per610a/home/mvp/mvp_db/hodost-lv/2018/2018_04_26_04_56/2018_04_26_21_54.mpg;Shinzo ABE.jpg;27937;27945;91169;1398;1398;0
/net/per610a/home/mvp/mvp_db/hodost-lv/2018/2018_04_28_04_56/2018_04_28_20_54.mpg;Shinzo ABE.jpg;14897;15389;91161;745;770;25
/net/per610a/home/mvp/mvp_db/hodost-lv/2018/2018_04_28_04_56/2018_04_28_20_54.mpg;Shinzo ABE.jpg;17113;17261;91161;856;863;7
/net/per610a/home/mvp/mvp_db/hodost-lv/2018/2018_04_28_04_56/2018_04_28_20_54.mpg;Shinzo ABE.jpg;17737;18061;91161;887;903;16
/net/per610a/home/mvp/mvp_db/hodost-lv/2018/2018_04_28_04_56/2018_04_28_20_54.mpg;Shinzo ABE.jpg;18229;18309;91161;912;916;4
/net/per610a/home/mvp/mvp_db/hodost-lv/2018/2018_04_28_04_56/2018_04_28_20_54.mpg;Shinzo ABE.jpg;18425;18845;91161;922;943;21
/net/per610a/home/mvp/mvp_db/hodost-lv/2018/2018_04_28_04_56/2018_04_28_20_54.mpg;Masashi Nakano.jpg;68853;68953;91161;3445;3450;5
/net/per610a/home/mvp/mvp_db/hodost-lv/2018/2018_04_29_04_56/2018_04_29_16_30.mpg;Shinzo ABE.jpg;873;977;107949;43;48;5
/net/per610a/home/mvp/mvp_db/hodost-lv/2018/2018_04_29_04_56/2018_04_29_16_30.mpg;Shinzo ABE.jpg;1837;2289;107949;91;114;23
/net/per610a/home/mvp/mvp_db/hodost-lv/2018/2018_04_29_04_56/2018_04_29_16_30.mpg;Shinzo ABE.jpg;53585;53585;107949;2681;2681;0
/net/per610a/home/mvp/mvp_db/hodost-lv/2018/2018_04_29_04_56/2018_04_29_16_30.mpg;Shinzo ABE.jpg;55125;55221;107949;2758;2763;5
/net/per610a/home/mvp/mvp_db/hodost-lv/2018/2018_04_29_04_56/2018_04_29_16_30.mpg;Shinzo ABE.jpg;56037;56181;107949;2804;2811;7
/net/per610a/home/mvp/mvp_db/hodost-lv/2018/2018_04_29_04_56/2018_04_29_16_30.mpg;Shinzo ABE.jpg;81585;81813;107949;4082;4094;12
/net/per610a/home/mvp/mvp_db/hodost-lv/2018/2018_04_29_04_56/2018_04_29_16_30.mpg;Shinzo ABE.jpg;53621;53861;107949;2683;2695;12
/net/per610a/home/mvp/mvp_db/hodost-lv/2018/2018_04_29_04_56/2018_04_29_16_30.mpg;Shinzo ABE.jpg;55085;55113;107949;2756;2757;1
/net/per610a/home/mvp/mvp_db/hodost-lv/2018/2018_04_29_04_56/2018_04_29_16_30.mpg;Shinzo ABE.jpg;104193;104237;107949;5214;5216;2
/net/per610a/home/mvp/mvp_db/hodost-lv/2018/2018_04_30_04_56/2018_04_30_21_54.mpg;Shinzo ABE.jpg;24353;24573;91161;1218;1229;11
/net/per610a/home/mvp/mvp_db/hodost-lv/2018/2018_04_30_04_56/2018_04_30_21_54.mpg;Shinzo ABE.jpg;24653;24749;91161;1233;1238;5
/net/per610a/home/mvp/mvp_db/hodost-lv/2018/2018_04_30_04_56/2018_04_30_21_54.mpg;Shinzo ABE.jpg;26921;27465;91161;1347;1374;27
/net/per610a/home/mvp/mvp_db/hodost-lv/2018/2018_04_30_04_56/2018_04_30_21_54.mpg;Shinzo ABE.jpg;27777;28345;91161;1390;1418;28
/net/per610a/home/mvp/mvp_db/hodost-lv/2018/2018_04_30_04_56/2018_04_30_21_54.mpg;Shinzo ABE.jpg;29653;29765;91161;1483;1489;6
/net/per610a/home/mvp/mvp_db/hodost-lv/2018/2018_04_30_04_56/2018_04_30_21_54.mpg;Shinzo ABE.jpg;46241;46581;91161;2314;2331;17
/net/per610a/home/mvp/mvp_db/hodost-lv/2018/2018_05_01_04_56/2018_05_01_21_54.mpg;Shinzo ABE.jpg;85825;86141;91169;4295;4311;16
/net/per610a/home/mvp/mvp_db/hodost-lv/2018/2018_05_03_04_56/2018_05_03_21_54.mpg;Shinzo ABE.jpg;9489;9489;91169;474;474;0
/net/per610a/home/mvp/mvp_db/hodost-lv/2018/2018_05_03_04_56/2018_05_03_21_54.mpg;Shinzo ABE.jpg;10413;10413;91169;521;521;0
/net/per610a/home/mvp/mvp_db/hodost-lv/2018/2018_05_03_04_56/2018_05_03_21_54.mpg;Shinzo ABE.jpg;10489;11177;91169;524;559;35
/net/per610a/home/mvp/mvp_db/hodost-lv/2018/2018_05_03_04_56/2018_05_03_21_54.mpg;Shinzo ABE.jpg;12145;12417;91169;607;621;14
/net/per610a/home/mvp/mvp_db/hodost-lv/2018/2018_05_03_04_56/2018_05_03_21_54.mpg;Shinzo ABE.jpg;12917;13041;91169;646;652;6
/net/per610a/home/mvp/mvp_db/hodost-lv/2018/2018_05_03_04_56/2018_05_03_21_54.mpg;Shinzo ABE.jpg;13133;13233;91169;657;662;5
/net/per610a/home/mvp/mvp_db/hodost-lv/2018/2018_05_03_04_56/2018_05_03_21_54.mpg;Shinzo ABE.jpg;23813;23905;91169;1191;1196;5
/net/per610a/home/mvp/mvp_db/hodost-lv/2018/2018_05_03_04_56/2018_05_03_21_54.mpg;Yukio EDANO.jpg;14725;15801;91169;736;790;54
/net/per610a/home/mvp/mvp_db/hodost-lv/2018/2018_05_03_04_56/2018_05_03_21_54.mpg;Takeo Hiranuma.jpeg;29417;29689;91169;1472;1485;13
/net/per610a/home/mvp/mvp_db/hodost-lv/2018/2018_05_04_04_56/2018_05_04_21_54.mpg;Shinzo ABE.jpg;53073;53709;91161;2655;2687;32
/net/per610a/home/mvp/mvp_db/hodost-lv/2018/2018_05_04_04_56/2018_05_04_21_54.mpg;Shinzo ABE.jpg;53893;54101;91161;2696;2707;11
/net/per610a/home/mvp/mvp_db/hodost-lv/2018/2018_05_06_04_56/2018_05_06_16_30.mpg;Shinzo ABE.jpg;103749;103841;107949;5191;5196;5
/net/per610a/home/mvp/mvp_db/hodost-lv/2018/2018_05_06_04_56/2018_05_06_16_30.mpg;Shinzo ABE.jpg;103921;103993;107949;5200;5204;4
/net/per610a/home/mvp/mvp_db/hodost-lv/2018/2018_05_07_04_56/2018_05_07_21_54.mpg;Taro ASO.jpg;15041;15585;91169;752;780;28
/net/per610a/home/mvp/mvp_db/hodost-lv/2018/2018_05_07_04_56/2018_05_07_21_54.mpg;Taro ASO.jpg;15665;16357;91169;784;818;34
/net/per610a/home/mvp/mvp_db/hodost-lv/2018/2018_05_07_04_56/2018_05_07_21_54.mpg;Taro ASO.jpg;20705;20937;91169;1036;1047;11
/net/per610a/home/mvp/mvp_db/hodost-lv/2018/2018_05_07_04_56/2018_05_07_21_54.mpg;Taro ASO.jpg;21125;21317;91169;1057;1066;9
/net/per610a/home/mvp/mvp_db/hodost-lv/2018/2018_05_08_04_56/2018_05_08_21_54.mpg;Shinzo ABE.jpg;32897;32925;91169;1646;1647;1
/net/per610a/home/mvp/mvp_db/hodost-lv/2018/2018_05_08_04_56/2018_05_08_21_54.mpg;Shinzo ABE.jpg;38205;38369;91169;1912;1920;8
/net/per610a/home/mvp/mvp_db/hodost-lv/2018/2018_05_08_04_56/2018_05_08_21_54.mpg;Taro ASO.jpg;35097;35201;91169;1756;1761;5
/net/per610a/home/mvp/mvp_db/hodost-lv/2018/2018_05_08_04_56/2018_05_08_21_54.mpg;Taro ASO.jpg;35361;36189;91169;1769;1811;42
/net/per610a/home/mvp/mvp_db/hodost-lv/2018/2018_05_09_04_56/2018_05_09_21_54.mpg;Shinzo ABE.jpg;28173;28297;91169;1410;1416;6
/net/per610a/home/mvp/mvp_db/hodost-lv/2018/2018_05_09_04_56/2018_05_09_21_54.mpg;Shinzo ABE.jpg;29705;29785;91169;1486;1490;4
/net/per610a/home/mvp/mvp_db/hodost-lv/2018/2018_05_09_04_56/2018_05_09_21_54.mpg;Shinzo ABE.jpg;33977;34169;91169;1700;1710;10
/net/per610a/home/mvp/mvp_db/hodost-lv/2018/2018_05_09_04_56/2018_05_09_21_54.mpg;Taro ASO.jpg;37169;38445;91169;1860;1924;64
/net/per610a/home/mvp/mvp_db/hodost-lv/2018/2018_05_10_04_56/2018_05_10_21_54.mpg;Shinzo ABE.jpg;3597;3657;91169;180;183;3
/net/per610a/home/mvp/mvp_db/hodost-lv/2018/2018_05_10_04_56/2018_05_10_21_54.mpg;Shinzo ABE.jpg;15277;15357;91169;764;768;4
/net/per610a/home/mvp/mvp_db/hodost-lv/2018/2018_05_10_04_56/2018_05_10_21_54.mpg;Shinzo ABE.jpg;39545;39689;91169;1979;1986;7
/net/per610a/home/mvp/mvp_db/hodost-lv/2018/2018_05_10_04_56/2018_05_10_21_54.mpg;Kenji Eda.jpg;6921;7269;91169;346;363;17
/net/per610a/home/mvp/mvp_db/hodost-lv/2018/2018_05_10_04_56/2018_05_10_21_54.mpg;Kenji Eda.jpg;7609;7609;91169;380;380;0
/net/per610a/home/mvp/mvp_db/hodost-lv/2018/2018_05_10_04_56/2018_05_10_21_54.mpg;Kenji Eda.jpg;7921;7949;91169;396;397;1
/net/per610a/home/mvp/mvp_db/hodost-lv/2018/2018_05_10_04_56/2018_05_10_21_54.mpg;Kenji Eda.jpg;8073;8125;91169;404;406;2
/net/per610a/home/mvp/mvp_db/hodost-lv/2018/2018_05_12_04_56/2018_05_12_20_54.mpg;Shinzo ABE.jpg;40657;40705;91169;2034;2037;3
/net/per610a/home/mvp/mvp_db/hodost-lv/2018/2018_05_12_04_56/2018_05_12_20_54.mpg;Shinzo ABE.jpg;41001;41129;91169;2052;2058;6
/net/per610a/home/mvp/mvp_db/hodost-lv/2018/2018_05_13_04_56/2018_05_13_16_30.mpg;Shinzo ABE.jpg;29177;29189;107949;1460;1460;0
/net/per610a/home/mvp/mvp_db/hodost-lv/2018/2018_05_13_04_56/2018_05_13_16_30.mpg;Shinzo ABE.jpg;75117;75117;107949;3759;3759;0
/net/per610a/home/mvp/mvp_db/hodost-lv/2018/2018_05_13_04_56/2018_05_13_16_30.mpg;Shinzo ABE.jpg;99225;99325;107949;4965;4970;5
/net/per610a/home/mvp/mvp_db/hodost-lv/2018/2018_05_13_04_56/2018_05_13_16_30.mpg;Shinzo ABE.jpg;104249;104469;107949;5216;5227;11
/net/per610a/home/mvp/mvp_db/hodost-lv/2018/2018_05_13_04_56/2018_05_13_16_30.mpg;Yukio EDANO.jpg;98285;99189;107949;4918;4963;45
/net/per610a/home/mvp/mvp_db/hodost-lv/2018/2018_05_14_04_56/2018_05_14_21_54.mpg;Shinzo ABE.jpg;22993;22993;91169;1150;1150;0
/net/per610a/home/mvp/mvp_db/hodost-lv/2018/2018_05_14_04_56/2018_05_14_21_54.mpg;Shinzo ABE.jpg;24153;24153;91169;1208;1208;0
/net/per610a/home/mvp/mvp_db/hodost-lv/2018/2018_05_14_04_56/2018_05_14_21_54.mpg;Shinzo ABE.jpg;24785;24953;91169;1240;1248;8
/net/per610a/home/mvp/mvp_db/hodost-lv/2018/2018_05_15_04_56/2018_05_15_21_54.mpg;Shinzo ABE.jpg;35853;35937;91169;1794;1798;4
/net/per610a/home/mvp/mvp_db/hodost-lv/2018/2018_05_15_04_56/2018_05_15_21_54.mpg;Shinzo ABE.jpg;39197;39209;91169;1961;1962;1
/net/per610a/home/mvp/mvp_db/hodost-lv/2018/2018_05_16_04_56/2018_05_16_21_54.mpg;Taro ASO.jpg;37665;37821;91169;1885;1892;7
/net/per610a/home/mvp/mvp_db/hodost-lv/2018/2018_05_17_04_56/2018_05_17_21_54.mpg;Shinzo ABE.jpg;29205;29333;91169;1461;1468;7
/net/per610a/home/mvp/mvp_db/hodost-lv/2018/2018_05_17_04_56/2018_05_17_21_54.mpg;Shinzo ABE.jpg;29421;29553;91169;1472;1479;7
/net/per610a/home/mvp/mvp_db/hodost-lv/2018/2018_05_17_04_56/2018_05_17_21_54.mpg;Shinzo ABE.jpg;29737;29865;91169;1488;1494;6
/net/per610a/home/mvp/mvp_db/hodost-lv/2018/2018_05_17_04_56/2018_05_17_21_54.mpg;Shinzo ABE.jpg;31661;31661;91169;1584;1584;0
/net/per610a/home/mvp/mvp_db/hodost-lv/2018/2018_05_17_04_56/2018_05_17_21_54.mpg;Shinzo ABE.jpg;31725;31741;91169;1587;1588;1
/net/per610a/home/mvp/mvp_db/hodost-lv/2018/2018_05_17_04_56/2018_05_17_21_54.mpg;Shinzo ABE.jpg;31797;31981;91169;1591;1600;9
/net/per610a/home/mvp/mvp_db/hodost-lv/2018/2018_05_21_04_56/2018_05_21_21_54.mpg;Shinzo ABE.jpg;681;897;91169;34;44;10
/net/per610a/home/mvp/mvp_db/hodost-lv/2018/2018_05_21_04_56/2018_05_21_21_54.mpg;Shinzo ABE.jpg;989;1049;91169;49;52;3
/net/per610a/home/mvp/mvp_db/hodost-lv/2018/2018_05_21_04_56/2018_05_21_21_54.mpg;Shinzo ABE.jpg;1865;2177;91169;93;108;15
/net/per610a/home/mvp/mvp_db/hodost-lv/2018/2018_05_21_04_56/2018_05_21_21_54.mpg;Shinzo ABE.jpg;2653;2705;91169;132;135;3
/net/per610a/home/mvp/mvp_db/hodost-lv/2018/2018_05_21_04_56/2018_05_21_21_54.mpg;Shinzo ABE.jpg;8825;9125;91169;441;456;15
/net/per610a/home/mvp/mvp_db/hodost-lv/2018/2018_05_21_04_56/2018_05_21_21_54.mpg;Shinzo ABE.jpg;10669;10885;91169;533;544;11
/net/per610a/home/mvp/mvp_db/hodost-lv/2018/2018_05_21_04_56/2018_05_21_21_54.mpg;Shinzo ABE.jpg;2621;2645;91169;131;132;1
/net/per610a/home/mvp/mvp_db/hodost-lv/2018/2018_05_21_04_56/2018_05_21_21_54.mpg;Shinzo ABE.jpg;9657;9709;91169;483;485;2
/net/per610a/home/mvp/mvp_db/hodost-lv/2018/2018_05_21_04_56/2018_05_21_21_54.mpg;Shinzo ABE.jpg;15185;15189;91169;760;760;0
/net/per610a/home/mvp/mvp_db/hodost-lv/2018/2018_05_21_04_56/2018_05_21_21_54.mpg;Ichiro OZAWA.jpg;15773;16753;91169;789;838;49
/net/per610a/home/mvp/mvp_db/hodost-lv/2018/2018_05_21_04_56/2018_05_21_21_54.mpg;Shinzo ABE.jpg;23389;23513;91169;1170;1176;6
/net/per610a/home/mvp/mvp_db/hodost-lv/2018/2018_05_22_04_56/2018_05_22_21_54.mpg;Shinzo ABE.jpg;29413;29501;91169;1472;1476;4
/net/per610a/home/mvp/mvp_db/hodost-lv/2018/2018_05_22_04_56/2018_05_22_21_54.mpg;Shinzo ABE.jpg;30669;30833;91169;1534;1543;9
/net/per610a/home/mvp/mvp_db/hodost-lv/2018/2018_05_22_04_56/2018_05_22_21_54.mpg;Shinzo ABE.jpg;36293;36429;91169;1816;1823;7
/net/per610a/home/mvp/mvp_db/hodost-lv/2018/2018_05_22_04_56/2018_05_22_21_54.mpg;Shinzo ABE.jpg;37041;37149;91169;1853;1859;6
/net/per610a/home/mvp/mvp_db/hodost-lv/2018/2018_05_24_04_56/2018_05_24_21_54.mpg;Shinzo ABE.jpg;15245;15401;91169;763;770;7
/net/per610a/home/mvp/mvp_db/hodost-lv/2018/2018_05_24_04_56/2018_05_24_21_54.mpg;Shinzo ABE.jpg;15481;15701;91169;774;785;11
/net/per610a/home/mvp/mvp_db/hodost-lv/2018/2018_05_24_04_56/2018_05_24_21_54.mpg;Shinzo ABE.jpg;15985;16113;91169;800;806;6
/net/per610a/home/mvp/mvp_db/hodost-lv/2018/2018_05_24_04_56/2018_05_24_21_54.mpg;Taro ASO.jpg;21937;22093;91169;1097;1105;8
/net/per610a/home/mvp/mvp_db/hodost-lv/2018/2018_05_25_04_56/2018_05_25_21_54.mpg;Taro ASO.jpg;13809;14845;91161;691;742;51
/net/per610a/home/mvp/mvp_db/hodost-lv/2018/2018_05_27_04_56/2018_05_27_16_30.mpg;Ichiro Matsui.jpeg;36609;36669;107949;1831;1834;3
/net/per610a/home/mvp/mvp_db/hodost-lv/2018/2018_05_27_04_56/2018_05_27_16_30.mpg;Ichiro Matsui.jpeg;46365;46949;107949;2320;2349;29
/net/per610a/home/mvp/mvp_db/hodost-lv/2018/2018_05_27_04_56/2018_05_27_16_30.mpg;Ichiro Matsui.jpeg;85161;85365;107949;4261;4271;10
/net/per610a/home/mvp/mvp_db/hodost-lv/2018/2018_05_28_04_56/2018_05_28_21_54.mpg;Shinzo ABE.jpg;25485;25601;91161;1275;1281;6
/net/per610a/home/mvp/mvp_db/hodost-lv/2018/2018_05_28_04_56/2018_05_28_21_54.mpg;Shinzo ABE.jpg;25981;25981;91161;1300;1300;0
/net/per610a/home/mvp/mvp_db/hodost-lv/2018/2018_05_28_04_56/2018_05_28_21_54.mpg;Shinzo ABE.jpg;28633;28633;91161;1432;1432;0
/net/per610a/home/mvp/mvp_db/hodost-lv/2018/2018_05_28_04_56/2018_05_28_21_54.mpg;Shinzo ABE.jpg;28881;29021;91161;1445;1452;7
/net/per610a/home/mvp/mvp_db/hodost-lv/2018/2018_05_30_04_56/2018_05_30_22_24.mpg;Yukio EDANO.jpg;23861;24201;91169;1194;1211;17
/net/per610a/home/mvp/mvp_db/hodost-lv/2018/2018_05_30_04_56/2018_05_30_22_24.mpg;Shinzo ABE.jpg;27549;27709;91169;1378;1386;8
/net/per610a/home/mvp/mvp_db/hodost-lv/2018/2018_05_31_04_56/2018_05_31_22_09.mpg;Shinzo ABE.jpg;13541;13733;91169;677;687;10
/net/per610a/home/mvp/mvp_db/hodost-lv/2018/2018_05_31_04_56/2018_05_31_22_09.mpg;Taro ASO.jpg;33177;33789;91169;1660;1691;31
/net/per610a/home/mvp/mvp_db/hodost-lv/2018/2018_05_31_04_56/2018_05_31_22_09.mpg;Yukio EDANO.jpg;35961;36441;91169;1799;1823;24
/net/per610a/home/mvp/mvp_db/hodost-lv/2018/2018_06_03_04_56/2018_06_03_16_30.mpg;Shinzo ABE.jpg;28485;28649;107949;1425;1433;8
/net/per610a/home/mvp/mvp_db/hodost-lv/2018/2018_06_03_04_56/2018_06_03_16_30.mpg;Shinzo ABE.jpg;28717;28801;107949;1437;1441;4
/net/per610a/home/mvp/mvp_db/hodost-lv/2018/2018_06_03_04_56/2018_06_03_16_30.mpg;Shinzo ABE.jpg;103593;103697;107949;5184;5189;5
/net/per610a/home/mvp/mvp_db/hodost-lv/2018/2018_06_03_04_56/2018_06_03_16_30.mpg;Shinzo ABE.jpg;28653;28705;107949;1433;1436;3
/net/per610a/home/mvp/mvp_db/hodost-lv/2018/2018_06_03_04_56/2018_06_03_16_30.mpg;Shinzo ABE.jpg;103473;103525;107949;5178;5180;2
/net/per610a/home/mvp/mvp_db/hodost-lv/2018/2018_06_03_04_56/2018_06_03_16_30.mpg;Shinzo ABE.jpg;103709;103725;107949;5189;5190;1
/net/per610a/home/mvp/mvp_db/hodost-lv/2018/2018_06_03_04_56/2018_06_03_16_30.mpg;Shinzo ABE.jpg;104217;104301;107949;5215;5219;4
/net/per610a/home/mvp/mvp_db/hodost-lv/2018/2018_06_04_04_56/2018_06_04_21_54.mpg;Taro ASO.jpg;4465;4957;91161;223;248;25
/net/per610a/home/mvp/mvp_db/hodost-lv/2018/2018_06_04_04_56/2018_06_04_21_54.mpg;Taro ASO.jpg;14397;15269;91161;720;764;44
/net/per610a/home/mvp/mvp_db/hodost-lv/2018/2018_06_04_04_56/2018_06_04_21_54.mpg;Taro ASO.jpg;16961;18761;91161;848;938;90
/net/per610a/home/mvp/mvp_db/hodost-lv/2018/2018_06_04_04_56/2018_06_04_21_54.mpg;Shinzo ABE.jpg;51553;51833;91161;2579;2593;14
/net/per610a/home/mvp/mvp_db/hodost-lv/2018/2018_06_05_04_56/2018_06_05_21_54.mpg;Taro ASO.jpg;31941;32057;91169;1598;1604;6
/net/per610a/home/mvp/mvp_db/hodost-lv/2018/2018_06_05_04_56/2018_06_05_21_54.mpg;Taro ASO.jpg;32121;32273;91169;1607;1615;8
/net/per610a/home/mvp/mvp_db/hodost-lv/2018/2018_06_05_04_56/2018_06_05_21_54.mpg;Taro ASO.jpg;33189;33257;91169;1661;1664;3
/net/per610a/home/mvp/mvp_db/hodost-lv/2018/2018_06_05_04_56/2018_06_05_21_54.mpg;Taro ASO.jpg;34189;34289;91169;1711;1716;5
/net/per610a/home/mvp/mvp_db/hodost-lv/2018/2018_06_05_04_56/2018_06_05_21_54.mpg;Ichiro OZAWA.jpg;42605;42653;91169;2132;2134;2
/net/per610a/home/mvp/mvp_db/hodost-lv/2018/2018_06_05_04_56/2018_06_05_21_54.mpg;Ichiro OZAWA.jpg;42721;42797;91169;2138;2141;3
/net/per610a/home/mvp/mvp_db/hodost-lv/2018/2018_06_07_04_56/2018_06_07_22_09.mpg;Shinzo ABE.jpg;3577;3941;91169;179;197;18
/net/per610a/home/mvp/mvp_db/hodost-lv/2018/2018_06_07_04_56/2018_06_07_22_09.mpg;Shinzo ABE.jpg;15061;15249;91169;753;763;10
/net/per610a/home/mvp/mvp_db/hodost-lv/2018/2018_06_07_04_56/2018_06_07_22_09.mpg;Shinzo ABE.jpg;35701;35749;91169;1786;1789;3
/net/per610a/home/mvp/mvp_db/hodost-lv/2018/2018_06_07_04_56/2018_06_07_22_09.mpg;Shinzo ABE.jpg;4669;4717;91169;233;236;3
/net/per610a/home/mvp/mvp_db/hodost-lv/2018/2018_06_07_04_56/2018_06_07_22_09.mpg;Shinzo ABE.jpg;31533;31705;91169;1578;1586;8
/net/per610a/home/mvp/mvp_db/hodost-lv/2018/2018_06_07_04_56/2018_06_07_22_09.mpg;Shinzo ABE.jpg;35177;35561;91169;1760;1779;19
/net/per610a/home/mvp/mvp_db/hodost-lv/2018/2018_06_08_04_56/2018_06_08_21_54.mpg;Shinzo ABE.jpg;3937;3965;91161;197;198;1
/net/per610a/home/mvp/mvp_db/hodost-lv/2018/2018_06_08_04_56/2018_06_08_21_54.mpg;Shinzo ABE.jpg;4093;4449;91161;204;222;18
/net/per610a/home/mvp/mvp_db/hodost-lv/2018/2018_06_08_04_56/2018_06_08_21_54.mpg;Shinzo ABE.jpg;7469;7565;91161;373;378;5
/net/per610a/home/mvp/mvp_db/hodost-lv/2018/2018_06_08_04_56/2018_06_08_21_54.mpg;Shinzo ABE.jpg;7737;8085;91161;387;404;17
/net/per610a/home/mvp/mvp_db/hodost-lv/2018/2018_06_08_04_56/2018_06_08_21_54.mpg;Shinzo ABE.jpg;8889;8929;91161;444;446;2
/net/per610a/home/mvp/mvp_db/hodost-lv/2018/2018_06_08_04_56/2018_06_08_21_54.mpg;Shinzo ABE.jpg;9541;9541;91161;477;477;0
/net/per610a/home/mvp/mvp_db/hodost-lv/2018/2018_06_08_04_56/2018_06_08_21_54.mpg;Shinzo ABE.jpg;12937;13093;91161;647;655;8
/net/per610a/home/mvp/mvp_db/hodost-lv/2018/2018_06_08_04_56/2018_06_08_21_54.mpg;Shinzo ABE.jpg;13421;13885;91161;671;694;23
/net/per610a/home/mvp/mvp_db/hodost-lv/2018/2018_06_08_04_56/2018_06_08_21_54.mpg;Shinzo ABE.jpg;13961;14773;91161;698;739;41
/net/per610a/home/mvp/mvp_db/hodost-lv/2018/2018_06_08_04_56/2018_06_08_21_54.mpg;Shinzo ABE.jpg;13077;13173;91161;654;659;5
/net/per610a/home/mvp/mvp_db/hodost-lv/2018/2018_06_08_04_56/2018_06_08_21_54.mpg;Taro ASO.jpg;24157;24273;91161;1208;1214;6
/net/per610a/home/mvp/mvp_db/hodost-lv/2018/2018_06_10_04_56/2018_06_10_16_30.mpg;Shinzo ABE.jpg;40745;40817;107949;2038;2042;4
/net/per610a/home/mvp/mvp_db/hodost-lv/2018/2018_06_10_04_56/2018_06_10_16_30.mpg;Shinzo ABE.jpg;41165;41233;107949;2059;2063;4
/net/per610a/home/mvp/mvp_db/hodost-lv/2018/2018_06_10_04_56/2018_06_10_16_30.mpg;Shinzo ABE.jpg;41389;41445;107949;2071;2073;2
/net/per610a/home/mvp/mvp_db/hodost-lv/2018/2018_06_11_04_56/2018_06_11_21_54.mpg;Shinzo ABE.jpg;14817;14925;91169;741;746;5
/net/per610a/home/mvp/mvp_db/hodost-lv/2018/2018_06_12_04_56/2018_06_12_21_00.mpg;Shinzo ABE.jpg;21797;21881;155909;1090;1095;5
/net/per610a/home/mvp/mvp_db/hodost-lv/2018/2018_06_12_04_56/2018_06_12_21_00.mpg;Shinzo ABE.jpg;21965;22201;155909;1099;1111;12
/net/per610a/home/mvp/mvp_db/hodost-lv/2018/2018_06_12_04_56/2018_06_12_21_00.mpg;Shinzo ABE.jpg;22305;22473;155909;1116;1124;8
/net/per610a/home/mvp/mvp_db/hodost-lv/2018/2018_06_12_04_56/2018_06_12_21_00.mpg;Shinzo ABE.jpg;23589;23785;155909;1180;1190;10
/net/per610a/home/mvp/mvp_db/hodost-lv/2018/2018_06_12_04_56/2018_06_12_21_00.mpg;Shinzo ABE.jpg;86929;90061;155909;4350;4507;157
/net/per610a/home/mvp/mvp_db/hodost-lv/2018/2018_06_13_04_56/2018_06_13_22_09.mpg;Shinzo ABE.jpg;15569;16061;91169;779;803;24
/net/per610a/home/mvp/mvp_db/hodost-lv/2018/2018_06_17_04_56/2018_06_17_16_30.mpg;Shinzo ABE.jpg;21849;21933;107949;1093;1097;4
/net/per610a/home/mvp/mvp_db/hodost-lv/2018/2018_06_18_04_56/2018_06_18_21_54.mpg;Shinzo ABE.jpg;48457;48701;91169;2425;2437;12
/net/per610a/home/mvp/mvp_db/hodost-lv/2018/2018_06_19_04_56/2018_06_19_21_54.mpg;Shinzo ABE.jpg;2001;2149;91169;100;107;7
/net/per610a/home/mvp/mvp_db/hodost-lv/2018/2018_06_19_04_56/2018_06_19_21_54.mpg;Shinzo ABE.jpg;2701;3013;91169;135;150;15
/net/per610a/home/mvp/mvp_db/hodost-lv/2018/2018_06_19_04_56/2018_06_19_21_54.mpg;Shinzo ABE.jpg;5449;5553;91169;272;277;5
/net/per610a/home/mvp/mvp_db/hodost-lv/2018/2018_06_19_04_56/2018_06_19_21_54.mpg;Shinzo ABE.jpg;14381;14457;91169;719;723;4
/net/per610a/home/mvp/mvp_db/hodost-lv/2018/2018_06_19_04_56/2018_06_19_21_54.mpg;Shinzo ABE.jpg;19397;19453;91169;970;973;3
/net/per610a/home/mvp/mvp_db/hodost-lv/2018/2018_06_19_04_56/2018_06_19_21_54.mpg;Shinzo ABE.jpg;19585;19741;91169;980;988;8
/net/per610a/home/mvp/mvp_db/hodost-lv/2018/2018_06_21_04_56/2018_06_21_21_54.mpg;Taro ASO.jpg;4469;5009;91169;223;250;27
/net/per610a/home/mvp/mvp_db/hodost-lv/2018/2018_06_23_04_56/2018_06_23_20_54.mpg;Shinzo ABE.jpg;63169;63257;91161;3161;3165;4
/net/per610a/home/mvp/mvp_db/hodost-lv/2018/2018_06_23_04_56/2018_06_23_20_54.mpg;Shinzo ABE.jpg;76933;76953;91161;3849;3850;1
/net/per610a/home/mvp/mvp_db/hodost-lv/2018/2018_06_23_04_56/2018_06_23_20_54.mpg;Shinzo ABE.jpg;77825;77845;91161;3894;3895;1
/net/per610a/home/mvp/mvp_db/hodost-lv/2018/2018_06_24_04_56/2018_06_24_16_30.mpg;Shinzo ABE.jpg;60953;61009;107949;3050;3053;3
/net/per610a/home/mvp/mvp_db/hodost-lv/2018/2018_06_24_04_56/2018_06_24_16_30.mpg;Shinzo ABE.jpg;102045;102069;107949;5106;5107;1
/net/per610a/home/mvp/mvp_db/hodost-lv/2018/2018_06_25_04_56/2018_06_25_21_54.mpg;Shinzo ABE.jpg;23825;24005;91169;1192;1201;9
/net/per610a/home/mvp/mvp_db/hodost-lv/2018/2018_06_27_04_56/2018_06_27_21_54.mpg;Shinzo ABE.jpg;25569;25681;91169;1279;1285;6
/net/per610a/home/mvp/mvp_db/hodost-lv/2018/2018_06_27_04_56/2018_06_27_21_54.mpg;Shinzo ABE.jpg;26437;26493;91169;1323;1325;2
/net/per610a/home/mvp/mvp_db/hodost-lv/2018/2018_06_27_04_56/2018_06_27_21_54.mpg;Shinzo ABE.jpg;28121;28141;91169;1407;1408;1
/net/per610a/home/mvp/mvp_db/hodost-lv/2018/2018_06_27_04_56/2018_06_27_21_54.mpg;Shinzo ABE.jpg;28441;28545;91169;1423;1428;5
/net/per610a/home/mvp/mvp_db/hodost-lv/2018/2018_06_27_04_56/2018_06_27_21_54.mpg;Shinzo ABE.jpg;28721;28721;91169;1437;1437;0
/net/per610a/home/mvp/mvp_db/hodost-lv/2018/2018_06_27_04_56/2018_06_27_21_54.mpg;Shinzo ABE.jpg;29217;29473;91169;1462;1475;13
/net/per610a/home/mvp/mvp_db/hodost-lv/2018/2018_06_27_04_56/2018_06_27_21_54.mpg;Shinzo ABE.jpg;29561;29581;91169;1479;1480;1
/net/per610a/home/mvp/mvp_db/hodost-lv/2018/2018_06_28_04_56/2018_06_28_21_54.mpg;Kohei Otsuka.jpg;27081;27289;91169;1355;1365;10
/net/per610a/home/mvp/mvp_db/hodost-lv/2018/2018_06_28_04_56/2018_06_28_21_54.mpg;Kohei Otsuka.jpg;35665;35993;91169;1785;1801;16
/net/per610a/home/mvp/mvp_db/hodost-lv/2018/2018_06_28_04_56/2018_06_28_21_54.mpg;Kohei Otsuka.jpg;40433;40477;91169;2023;2025;2
/net/per610a/home/mvp/mvp_db/hodost-lv/2018/2018_06_28_04_56/2018_06_28_21_54.mpg;Kohei Otsuka.jpg;48517;48637;91169;2428;2434;6
/net/per610a/home/mvp/mvp_db/hodost-lv/2018/2018_06_28_04_56/2018_06_28_21_54.mpg;Kohei Otsuka.jpg;70749;70749;91169;3540;3540;0
/net/per610a/home/mvp/mvp_db/hodost-lv/2018/2018_06_28_04_56/2018_06_28_21_54.mpg;Kohei Otsuka.jpg;71193;71393;91169;3563;3573;10
/net/per610a/home/mvp/mvp_db/hodost-lv/2018/2018_06_28_04_56/2018_06_28_21_54.mpg;Kohei Otsuka.jpg;77373;77449;91169;3872;3876;4
/net/per610a/home/mvp/mvp_db/hodost-lv/2018/2018_06_28_04_56/2018_06_28_21_54.mpg;Kohei Otsuka.jpg;86065;86129;91169;4307;4310;3
/net/per610a/home/mvp/mvp_db/hodost-lv/2018/2018_06_28_04_56/2018_06_28_21_54.mpg;Shinzo ABE.jpg;35237;35473;91169;1763;1775;12
/net/per610a/home/mvp/mvp_db/hodost-lv/2018/2018_07_04_04_56/2018_07_04_21_54.mpg;Toru Hashimoto.jpg;57617;57901;91169;2883;2897;14
/net/per610a/home/mvp/mvp_db/hodost-lv/2018/2018_07_10_04_56/2018_07_10_21_54.mpg;Takenori KANZAKI.jpg;48729;48829;91169;2438;2443;5
/net/per610a/home/mvp/mvp_db/hodost-lv/2018/2018_07_15_04_56/2018_07_15_16_30.mpg;Shinzo ABE.jpg;19413;19677;107949;971;984;13
/net/per610a/home/mvp/mvp_db/hodost-lv/2018/2018_07_15_04_56/2018_07_15_16_30.mpg;Shinzo ABE.jpg;27489;27545;107949;1375;1378;3
/net/per610a/home/mvp/mvp_db/hodost-lv/2018/2018_07_15_04_56/2018_07_15_16_30.mpg;Shinzo ABE.jpg;27657;27785;107949;1384;1390;6
/net/per610a/home/mvp/mvp_db/hodost-lv/2018/2018_07_17_04_56/2018_07_17_21_54.mpg;Shinzo ABE.jpg;27077;27441;91169;1355;1373;18
/net/per610a/home/mvp/mvp_db/hodost-lv/2018/2018_07_17_04_56/2018_07_17_21_54.mpg;Shinzo ABE.jpg;28197;28301;91169;1411;1416;5
/net/per610a/home/mvp/mvp_db/hodost-lv/2018/2018_07_17_04_56/2018_07_17_21_54.mpg;Shinzo ABE.jpg;29025;29173;91169;1452;1460;8
/net/per610a/home/mvp/mvp_db/hodost-lv/2018/2018_07_17_04_56/2018_07_17_21_54.mpg;Shinzo ABE.jpg;53485;53713;91169;2676;2688;12
/net/per610a/home/mvp/mvp_db/hodost-lv/2018/2018_07_18_04_56/2018_07_18_22_09.mpg;Kyoko Nakayama.jpg;37133;37305;91169;1858;1867;9
/net/per610a/home/mvp/mvp_db/hodost-lv/2018/2018_07_20_04_56/2018_07_20_21_54.mpg;Kohei Otsuka.jpg;14905;15257;91169;745;763;18
/net/per610a/home/mvp/mvp_db/hodost-lv/2018/2018_07_20_04_56/2018_07_20_21_54.mpg;Kohei Otsuka.jpg;33593;33597;91169;1681;1681;0
/net/per610a/home/mvp/mvp_db/hodost-lv/2018/2018_07_20_04_56/2018_07_20_21_54.mpg;Kohei Otsuka.jpg;85893;86037;91169;4298;4306;8
/net/per610a/home/mvp/mvp_db/hodost-lv/2018/2018_07_20_04_56/2018_07_20_21_54.mpg;Yukio EDANO.jpg;36561;36561;91169;1829;1829;0
/net/per610a/home/mvp/mvp_db/hodost-lv/2018/2018_07_20_04_56/2018_07_20_21_54.mpg;Yukio EDANO.jpg;42405;42613;91169;2122;2132;10
/net/per610a/home/mvp/mvp_db/hodost-lv/2018/2018_07_20_04_56/2018_07_20_21_54.mpg;Shinzo ABE.jpg;36765;36909;91169;1840;1847;7
/net/per610a/home/mvp/mvp_db/hodost-lv/2018/2018_07_20_04_56/2018_07_20_21_54.mpg;Shinzo ABE.jpg;37621;37673;91169;1882;1885;3
/net/per610a/home/mvp/mvp_db/hodost-lv/2018/2018_07_20_04_56/2018_07_20_21_54.mpg;Shinzo ABE.jpg;47137;47145;91169;2359;2359;0
/net/per610a/home/mvp/mvp_db/hodost-lv/2018/2018_07_20_04_56/2018_07_20_21_54.mpg;Shinzo ABE.jpg;47217;47273;91169;2363;2366;3
/net/per610a/home/mvp/mvp_db/hodost-lv/2018/2018_07_20_04_56/2018_07_20_21_54.mpg;Shinzo ABE.jpg;47345;49173;91169;2369;2461;92
/net/per610a/home/mvp/mvp_db/hodost-lv/2018/2018_07_22_04_56/2018_07_22_16_30.mpg;Shinzo ABE.jpg;103597;103697;107949;5184;5189;5
/net/per610a/home/mvp/mvp_db/hodost-lv/2018/2018_07_22_04_56/2018_07_22_16_30.mpg;Shinzo ABE.jpg;103789;103825;107949;5193;5195;2
/net/per610a/home/mvp/mvp_db/hodost-lv/2018/2018_07_25_04_56/2018_07_25_21_54.mpg;Kohei Otsuka.jpg;10729;10781;91169;536;539;3
/net/per610a/home/mvp/mvp_db/hodost-lv/2018/2018_07_25_04_56/2018_07_25_21_54.mpg;Kohei Otsuka.jpg;14825;14829;91169;741;742;1
/net/per610a/home/mvp/mvp_db/hodost-lv/2018/2018_07_25_04_56/2018_07_25_21_54.mpg;Kohei Otsuka.jpg;33489;33537;91169;1676;1678;2
/net/per610a/home/mvp/mvp_db/hodost-lv/2018/2018_07_25_04_56/2018_07_25_21_54.mpg;Kohei Otsuka.jpg;36317;36661;91169;1817;1834;17
/net/per610a/home/mvp/mvp_db/hodost-lv/2018/2018_07_25_04_56/2018_07_25_21_54.mpg;Kohei Otsuka.jpg;53117;53381;91169;2658;2671;13
/net/per610a/home/mvp/mvp_db/hodost-lv/2018/2018_07_25_04_56/2018_07_25_21_54.mpg;Kohei Otsuka.jpg;59717;59837;91169;2988;2994;6
/net/per610a/home/mvp/mvp_db/hodost-lv/2018/2018_07_25_04_56/2018_07_25_21_54.mpg;Kohei Otsuka.jpg;84193;84249;91169;4213;4216;3
/net/per610a/home/mvp/mvp_db/hodost-lv/2018/2018_07_25_04_56/2018_07_25_21_54.mpg;Kohei Otsuka.jpg;85657;85729;91169;4287;4290;3
/net/per610a/home/mvp/mvp_db/hodost-lv/2018/2018_07_25_04_56/2018_07_25_21_54.mpg;Kohei Otsuka.jpg;86061;86229;91169;4307;4315;8
/net/per610a/home/mvp/mvp_db/hodost-lv/2018/2018_07_27_04_56/2018_07_27_21_54.mpg;Taro ASO.jpg;30265;31009;91169;1514;1551;37
/net/per610a/home/mvp/mvp_db/hodost-lv/2018/2018_07_27_04_56/2018_07_27_21_54.mpg;Taro ASO.jpg;33113;33581;91169;1657;1680;23
/net/per610a/home/mvp/mvp_db/hodost-lv/2018/2018_07_27_04_56/2018_07_27_21_54.mpg;Masashi Nakano.jpg;79393;79509;91169;3973;3979;6
/net/per610a/home/mvp/mvp_db/hodost-lv/2018/2018_07_27_04_56/2018_07_27_21_54.mpg;Masashi Nakano.jpg;79945;80013;91169;4001;4004;3
/net/per610a/home/mvp/mvp_db/hodost-lv/2018/2018_07_27_04_56/2018_07_27_21_54.mpg;Masashi Nakano.jpg;80201;80533;91169;4014;4030;16
/net/per610a/home/mvp/mvp_db/hodost-lv/2018/2018_07_29_04_56/2018_07_29_16_30.mpg;Shinzo ABE.jpg;64501;64681;107949;3227;3236;9
/net/per610a/home/mvp/mvp_db/hodost-lv/2018/2018_07_30_04_56/2018_07_30_21_54.mpg;Kohei Otsuka.jpg;57201;57249;91169;2862;2865;3
/net/per610a/home/mvp/mvp_db/hodost-lv/2018/2018_07_30_04_56/2018_07_30_21_54.mpg;Kohei Otsuka.jpg;81937;82193;91169;4100;4113;13
/net/per610a/home/mvp/mvp_db/hodost-lv/2018/2018_07_30_04_56/2018_07_30_21_54.mpg;Kohei Otsuka.jpg;85965;86257;91169;4302;4317;15
/net/per610a/home/mvp/mvp_db/hodost-lv/2018/2018_07_31_04_56/2018_07_31_21_54.mpg;YUriko Koike.jpg;52461;52789;91169;2625;2642;17
/net/per610a/home/mvp/mvp_db/hodost-lv/2018/2018_08_01_04_56/2018_08_01_21_54.mpg;Shinzo ABE.jpg;42257;42349;91169;2114;2119;5
/net/per610a/home/mvp/mvp_db/hodost-lv/2018/2018_08_02_04_56/2018_08_02_21_54.mpg;Kohei Otsuka.jpg;17801;17817;91169;890;891;1
/net/per610a/home/mvp/mvp_db/hodost-lv/2018/2018_08_02_04_56/2018_08_02_21_54.mpg;Kohei Otsuka.jpg;17893;17893;91169;895;895;0
/net/per610a/home/mvp/mvp_db/hodost-lv/2018/2018_08_02_04_56/2018_08_02_21_54.mpg;Kohei Otsuka.jpg;33233;33301;91169;1663;1666;3
/net/per610a/home/mvp/mvp_db/hodost-lv/2018/2018_08_02_04_56/2018_08_02_21_54.mpg;Kohei Otsuka.jpg;39909;40189;91169;1997;2011;14
/net/per610a/home/mvp/mvp_db/hodost-lv/2018/2018_08_02_04_56/2018_08_02_21_54.mpg;Kohei Otsuka.jpg;42629;42629;91169;2133;2133;0
/net/per610a/home/mvp/mvp_db/hodost-lv/2018/2018_08_02_04_56/2018_08_02_21_54.mpg;Kohei Otsuka.jpg;46177;46413;91169;2311;2322;11
/net/per610a/home/mvp/mvp_db/hodost-lv/2018/2018_08_02_04_56/2018_08_02_21_54.mpg;Kohei Otsuka.jpg;86005;86253;91169;4304;4316;12
/net/per610a/home/mvp/mvp_db/hodost-lv/2018/2018_08_02_04_56/2018_08_02_21_54.mpg;Shinzo ABE.jpg;29493;29629;91169;1476;1482;6
/net/per610a/home/mvp/mvp_db/hodost-lv/2018/2018_08_03_04_56/2018_08_03_21_54.mpg;Kohei Otsuka.jpg;26661;26785;91161;1334;1340;6
/net/per610a/home/mvp/mvp_db/hodost-lv/2018/2018_08_03_04_56/2018_08_03_21_54.mpg;Kohei Otsuka.jpg;27505;27605;91161;1376;1381;5
/net/per610a/home/mvp/mvp_db/hodost-lv/2018/2018_08_03_04_56/2018_08_03_21_54.mpg;Kohei Otsuka.jpg;28781;28837;91161;1440;1443;3
/net/per610a/home/mvp/mvp_db/hodost-lv/2018/2018_08_03_04_56/2018_08_03_21_54.mpg;Kohei Otsuka.jpg;32921;33069;91161;1647;1654;7
/net/per610a/home/mvp/mvp_db/hodost-lv/2018/2018_08_03_04_56/2018_08_03_21_54.mpg;Kohei Otsuka.jpg;38721;38745;91161;1937;1938;1
/net/per610a/home/mvp/mvp_db/hodost-lv/2018/2018_08_03_04_56/2018_08_03_21_54.mpg;Kohei Otsuka.jpg;40061;40141;91161;2004;2008;4
/net/per610a/home/mvp/mvp_db/hodost-lv/2018/2018_08_03_04_56/2018_08_03_21_54.mpg;Kohei Otsuka.jpg;45881;45949;91161;2296;2299;3
/net/per610a/home/mvp/mvp_db/hodost-lv/2018/2018_08_03_04_56/2018_08_03_21_54.mpg;Kohei Otsuka.jpg;85917;86105;91161;4299;4308;9
/net/per610a/home/mvp/mvp_db/hodost-lv/2018/2018_08_03_04_56/2018_08_03_21_54.mpg;Kohei Otsuka.jpg;86193;86237;91161;4313;4315;2
/net/per610a/home/mvp/mvp_db/hodost-lv/2018/2018_08_03_04_56/2018_08_03_21_54.mpg;Shinzo ABE.jpg;36769;37057;91161;1840;1854;14
/net/per610a/home/mvp/mvp_db/hodost-lv/2018/2018_08_05_04_56/2018_08_05_16_30.mpg;Shinzo ABE.jpg;27905;28165;107949;1396;1409;13
/net/per610a/home/mvp/mvp_db/hodost-lv/2018/2018_08_05_04_56/2018_08_05_16_30.mpg;Shinzo ABE.jpg;28417;28573;107949;1422;1429;7
/net/per610a/home/mvp/mvp_db/hodost-lv/2018/2018_08_05_04_56/2018_08_05_16_30.mpg;Junichiro KOIZUMI.jpg;104261;104361;107949;5217;5222;5
/net/per610a/home/mvp/mvp_db/hodost-lv/2018/2018_08_07_04_56/2018_08_07_21_54.mpg;Taro ASO.jpg;29825;30109;91169;1492;1506;14
/net/per610a/home/mvp/mvp_db/hodost-lv/2018/2018_08_07_04_56/2018_08_07_21_54.mpg;Shinzo ABE.jpg;50725;50753;91169;2538;2540;2
/net/per610a/home/mvp/mvp_db/hodost-lv/2018/2018_08_07_04_56/2018_08_07_21_54.mpg;Shinzo ABE.jpg;50909;51017;91169;2547;2553;6
/net/per610a/home/mvp/mvp_db/hodost-lv/2018/2018_08_07_04_56/2018_08_07_21_54.mpg;Shinzo ABE.jpg;51141;51425;91169;2559;2573;14
/net/per610a/home/mvp/mvp_db/hodost-lv/2018/2018_08_09_04_56/2018_08_09_21_54.mpg;Shinzo ABE.jpg;11429;11981;91169;572;599;27
/net/per610a/home/mvp/mvp_db/hodost-lv/2018/2018_08_09_04_56/2018_08_09_21_54.mpg;Shinzo ABE.jpg;12053;12201;91169;603;610;7
/net/per610a/home/mvp/mvp_db/hodost-lv/2018/2018_08_09_04_56/2018_08_09_21_54.mpg;Shinzo ABE.jpg;32757;32841;91169;1639;1643;4
/net/per610a/home/mvp/mvp_db/hodost-lv/2018/2018_08_11_04_56/2018_08_11_20_54.mpg;Shinzo ABE.jpg;31353;31385;91161;1569;1570;1
/net/per610a/home/mvp/mvp_db/hodost-lv/2018/2018_08_11_04_56/2018_08_11_20_54.mpg;Shinzo ABE.jpg;31461;31625;91161;1574;1582;8
/net/per610a/home/mvp/mvp_db/hodost-lv/2018/2018_08_15_04_56/2018_08_15_21_54.mpg;Kyoko Nakayama.jpg;10045;10141;91169;502;507;5
/net/per610a/home/mvp/mvp_db/hodost-lv/2018/2018_08_15_04_56/2018_08_15_21_54.mpg;Kyoko Nakayama.jpg;14081;14105;91169;704;705;1
/net/per610a/home/mvp/mvp_db/hodost-lv/2018/2018_08_15_04_56/2018_08_15_21_54.mpg;Kyoko Nakayama.jpg;14173;14181;91169;709;709;0
/net/per610a/home/mvp/mvp_db/hodost-lv/2018/2018_08_16_04_56/2018_08_16_21_54.mpg;Shinzo ABE.jpg;29533;29909;91169;1478;1496;18
/net/per610a/home/mvp/mvp_db/hodost-lv/2018/2018_08_16_04_56/2018_08_16_21_54.mpg;Shinzo ABE.jpg;30021;30129;91169;1502;1507;5
/net/per610a/home/mvp/mvp_db/hodost-lv/2018/2018_08_16_04_56/2018_08_16_21_54.mpg;Shinzo ABE.jpg;32669;32765;91169;1635;1639;4
/net/per610a/home/mvp/mvp_db/hodost-lv/2018/2018_08_16_04_56/2018_08_16_21_54.mpg;Shinzo ABE.jpg;35225;35809;91169;1763;1792;29
/net/per610a/home/mvp/mvp_db/hodost-lv/2018/2018_08_19_04_56/2018_08_19_16_30.mpg;Shinzo ABE.jpg;103237;103353;107949;5166;5172;6
/net/per610a/home/mvp/mvp_db/hodost-lv/2018/2018_08_19_04_56/2018_08_19_16_30.mpg;Shinzo ABE.jpg;103465;103713;107949;5177;5190;13
/net/per610a/home/mvp/mvp_db/hodost-lv/2018/2018_08_19_04_56/2018_08_19_16_30.mpg;Shinzo ABE.jpg;103949;104373;107949;5201;5223;22
/net/per610a/home/mvp/mvp_db/hodost-lv/2018/2018_08_20_04_56/2018_08_20_21_54.mpg;Shinzo ABE.jpg;60529;60665;91169;3029;3036;7
/net/per610a/home/mvp/mvp_db/hodost-lv/2018/2018_08_22_04_56/2018_08_22_21_54.mpg;Shinzo ABE.jpg;52997;53105;91169;2652;2657;5
/net/per610a/home/mvp/mvp_db/hodost-lv/2018/2018_08_26_04_56/2018_08_26_16_30.mpg;Shinzo ABE.jpg;20133;20661;107949;1007;1033;26
/net/per610a/home/mvp/mvp_db/hodost-lv/2018/2018_08_26_04_56/2018_08_26_16_30.mpg;Shinzo ABE.jpg;23829;23921;107949;1192;1197;5
/net/per610a/home/mvp/mvp_db/hodost-lv/2018/2018_08_26_04_56/2018_08_26_16_30.mpg;Shinzo ABE.jpg;25109;25217;107949;1256;1261;5
/net/per610a/home/mvp/mvp_db/hodost-lv/2018/2018_08_26_04_56/2018_08_26_16_30.mpg;Shinzo ABE.jpg;29929;29997;107949;1497;1501;4
/net/per610a/home/mvp/mvp_db/hodost-lv/2018/2018_08_27_04_56/2018_08_27_21_54.mpg;Shinzo ABE.jpg;28789;28865;91169;1440;1444;4
/net/per610a/home/mvp/mvp_db/hodost-lv/2018/2018_08_27_04_56/2018_08_27_21_54.mpg;Shinzo ABE.jpg;29265;29461;91169;1464;1474;10
/net/per610a/home/mvp/mvp_db/hodost-lv/2018/2018_08_27_04_56/2018_08_27_21_54.mpg;Shinzo ABE.jpg;30245;30765;91169;1513;1539;26
/net/per610a/home/mvp/mvp_db/hodost-lv/2018/2018_08_27_04_56/2018_08_27_21_54.mpg;Shinzo ABE.jpg;31593;31621;91169;1581;1582;1
/net/per610a/home/mvp/mvp_db/hodost-lv/2018/2018_08_27_04_56/2018_08_27_21_54.mpg;Shinzo ABE.jpg;35953;36305;91169;1799;1817;18
/net/per610a/home/mvp/mvp_db/hodost-lv/2018/2018_08_28_04_56/2018_08_28_21_54.mpg;Taro ASO.jpg;14393;14977;91169;720;749;29
/net/per610a/home/mvp/mvp_db/hodost-lv/2018/2018_08_28_04_56/2018_08_28_21_54.mpg;Taro ASO.jpg;20297;20577;91169;1015;1029;14
/net/per610a/home/mvp/mvp_db/hodost-lv/2018/2018_08_29_04_56/2018_08_29_21_54.mpg;Shinzo ABE.jpg;26077;26729;91169;1305;1337;32
/net/per610a/home/mvp/mvp_db/hodost-lv/2018/2018_09_02_04_56/2018_09_02_16_30.mpg;Shinzo ABE.jpg;58117;58165;107949;2908;2910;2
/net/per610a/home/mvp/mvp_db/hodost-lv/2018/2018_09_02_04_56/2018_09_02_16_30.mpg;Shinzo ABE.jpg;59201;59317;107949;2962;2968;6
/net/per610a/home/mvp/mvp_db/hodost-lv/2018/2018_09_03_04_56/2018_09_03_21_54.mpg;Shinzo ABE.jpg;40325;40721;91169;2018;2038;20
/net/per610a/home/mvp/mvp_db/hodost-lv/2018/2018_09_03_04_56/2018_09_03_21_54.mpg;Shinzo ABE.jpg;43469;43617;91169;2175;2183;8
/net/per610a/home/mvp/mvp_db/hodost-lv/2018/2018_09_03_04_56/2018_09_03_21_54.mpg;Shinzo ABE.jpg;44645;44657;91169;2234;2235;1
/net/per610a/home/mvp/mvp_db/hodost-lv/2018/2018_09_05_04_56/2018_09_05_21_54.mpg;Kohei Otsuka.jpg;33029;33201;91169;1653;1661;8
/net/per610a/home/mvp/mvp_db/hodost-lv/2018/2018_09_05_04_56/2018_09_05_21_54.mpg;Kohei Otsuka.jpg;40925;41225;91169;2048;2063;15
/net/per610a/home/mvp/mvp_db/hodost-lv/2018/2018_09_05_04_56/2018_09_05_21_54.mpg;Kohei Otsuka.jpg;45981;46093;91169;2301;2306;5
/net/per610a/home/mvp/mvp_db/hodost-lv/2018/2018_09_05_04_56/2018_09_05_21_54.mpg;Kohei Otsuka.jpg;53869;53961;91169;2696;2700;4
/net/per610a/home/mvp/mvp_db/hodost-lv/2018/2018_09_05_04_56/2018_09_05_21_54.mpg;Kohei Otsuka.jpg;57389;57537;91169;2872;2879;7
/net/per610a/home/mvp/mvp_db/hodost-lv/2018/2018_09_05_04_56/2018_09_05_21_54.mpg;Taro ASO.jpg;35145;35529;91169;1759;1778;19
/net/per610a/home/mvp/mvp_db/hodost-lv/2018/2018_09_05_04_56/2018_09_05_21_54.mpg;Shinzo ABE.jpg;43565;43793;91169;2180;2191;11
/net/per610a/home/mvp/mvp_db/hodost-lv/2018/2018_09_05_04_56/2018_09_05_21_54.mpg;Shinzo ABE.jpg;44417;44597;91169;2223;2232;9
/net/per610a/home/mvp/mvp_db/hodost-lv/2018/2018_09_06_04_56/2018_09_06_22_09.mpg;Kohei Otsuka.jpg;14177;14229;91169;709;712;3
/net/per610a/home/mvp/mvp_db/hodost-lv/2018/2018_09_06_04_56/2018_09_06_22_09.mpg;Kohei Otsuka.jpg;16813;16869;91169;841;844;3
/net/per610a/home/mvp/mvp_db/hodost-lv/2018/2018_09_06_04_56/2018_09_06_22_09.mpg;Kohei Otsuka.jpg;37821;37877;91169;1892;1895;3
/net/per610a/home/mvp/mvp_db/hodost-lv/2018/2018_09_06_04_56/2018_09_06_22_09.mpg;Kohei Otsuka.jpg;38101;38217;91169;1906;1912;6
/net/per610a/home/mvp/mvp_db/hodost-lv/2018/2018_09_06_04_56/2018_09_06_22_09.mpg;Kohei Otsuka.jpg;41521;41629;91169;2078;2083;5
/net/per610a/home/mvp/mvp_db/hodost-lv/2018/2018_09_06_04_56/2018_09_06_22_09.mpg;Kohei Otsuka.jpg;43841;43981;91169;2194;2201;7
/net/per610a/home/mvp/mvp_db/hodost-lv/2018/2018_09_06_04_56/2018_09_06_22_09.mpg;Kohei Otsuka.jpg;44905;45065;91169;2247;2255;8
/net/per610a/home/mvp/mvp_db/hodost-lv/2018/2018_09_06_04_56/2018_09_06_22_09.mpg;Kohei Otsuka.jpg;47481;47529;91169;2376;2378;2
/net/per610a/home/mvp/mvp_db/hodost-lv/2018/2018_09_06_04_56/2018_09_06_22_09.mpg;Kohei Otsuka.jpg;57329;57613;91169;2869;2883;14
/net/per610a/home/mvp/mvp_db/hodost-lv/2018/2018_09_06_04_56/2018_09_06_22_09.mpg;Kohei Otsuka.jpg;81449;81693;91169;4076;4088;12
/net/per610a/home/mvp/mvp_db/hodost-lv/2018/2018_09_06_04_56/2018_09_06_22_09.mpg;Kohei Otsuka.jpg;83429;83533;91169;4175;4180;5
/net/per610a/home/mvp/mvp_db/hodost-lv/2018/2018_09_06_04_56/2018_09_06_22_09.mpg;Kohei Otsuka.jpg;84845;84997;91169;4246;4254;8
/net/per610a/home/mvp/mvp_db/hodost-lv/2018/2018_09_06_04_56/2018_09_06_22_09.mpg;Kohei Otsuka.jpg;85757;86245;91169;4292;4316;24
/net/per610a/home/mvp/mvp_db/hodost-lv/2018/2018_09_06_04_56/2018_09_06_22_09.mpg;Shinzo ABE.jpg;81221;81445;91169;4065;4076;11
/net/per610a/home/mvp/mvp_db/hodost-lv/2018/2018_09_10_04_56/2018_09_10_21_54.mpg;Shinzo ABE.jpg;16853;16905;91161;843;845;2
/net/per610a/home/mvp/mvp_db/hodost-lv/2018/2018_09_10_04_56/2018_09_10_21_54.mpg;Shinzo ABE.jpg;17033;17229;91161;852;862;10
/net/per610a/home/mvp/mvp_db/hodost-lv/2018/2018_09_10_04_56/2018_09_10_21_54.mpg;Shinzo ABE.jpg;17825;17841;91161;892;892;0
/net/per610a/home/mvp/mvp_db/hodost-lv/2018/2018_09_10_04_56/2018_09_10_21_54.mpg;Shinzo ABE.jpg;17929;18233;91161;897;912;15
/net/per610a/home/mvp/mvp_db/hodost-lv/2018/2018_09_10_04_56/2018_09_10_21_54.mpg;Shinzo ABE.jpg;18345;18597;91161;918;930;12
/net/per610a/home/mvp/mvp_db/hodost-lv/2018/2018_09_10_04_56/2018_09_10_21_54.mpg;Shinzo ABE.jpg;19269;19849;91161;964;993;29
/net/per610a/home/mvp/mvp_db/hodost-lv/2018/2018_09_10_04_56/2018_09_10_21_54.mpg;Shinzo ABE.jpg;19925;20441;91161;997;1022;25
/net/per610a/home/mvp/mvp_db/hodost-lv/2018/2018_09_10_04_56/2018_09_10_21_54.mpg;Shinzo ABE.jpg;21845;21929;91161;1093;1097;4
/net/per610a/home/mvp/mvp_db/hodost-lv/2018/2018_09_10_04_56/2018_09_10_21_54.mpg;Shinzo ABE.jpg;25161;25217;91161;1259;1261;2
/net/per610a/home/mvp/mvp_db/hodost-lv/2018/2018_09_10_04_56/2018_09_10_21_54.mpg;Shinzo ABE.jpg;25997;26153;91161;1300;1308;8
/net/per610a/home/mvp/mvp_db/hodost-lv/2018/2018_09_10_04_56/2018_09_10_21_54.mpg;Shinzo ABE.jpg;50321;50449;91161;2518;2524;6
/net/per610a/home/mvp/mvp_db/hodost-lv/2018/2018_09_12_04_56/2018_09_12_22_09.mpg;Shinzo ABE.jpg;34297;34529;91161;1716;1727;11
/net/per610a/home/mvp/mvp_db/hodost-lv/2018/2018_09_12_04_56/2018_09_12_22_09.mpg;Shinzo ABE.jpg;36573;36637;91161;1830;1833;3
/net/per610a/home/mvp/mvp_db/hodost-lv/2018/2018_09_12_04_56/2018_09_12_22_09.mpg;Shinzo ABE.jpg;37453;37517;91161;1874;1877;3
/net/per610a/home/mvp/mvp_db/hodost-lv/2018/2018_09_12_04_56/2018_09_12_22_09.mpg;Shinzo ABE.jpg;38369;38385;91161;1920;1920;0
/net/per610a/home/mvp/mvp_db/hodost-lv/2018/2018_09_12_04_56/2018_09_12_22_09.mpg;Shinzo ABE.jpg;38489;38537;91161;1926;1928;2
/net/per610a/home/mvp/mvp_db/hodost-lv/2018/2018_09_12_04_56/2018_09_12_22_09.mpg;Shinzo ABE.jpg;39237;39337;91161;1963;1968;5
/net/per610a/home/mvp/mvp_db/hodost-lv/2018/2018_09_12_04_56/2018_09_12_22_09.mpg;Kohei Otsuka.jpg;43165;43205;91161;2160;2162;2
/net/per610a/home/mvp/mvp_db/hodost-lv/2018/2018_09_12_04_56/2018_09_12_22_09.mpg;Kohei Otsuka.jpg;78485;78629;91161;3927;3934;7
/net/per610a/home/mvp/mvp_db/hodost-lv/2018/2018_09_12_04_56/2018_09_12_22_09.mpg;Kohei Otsuka.jpg;85745;85789;91161;4290;4293;3
/net/per610a/home/mvp/mvp_db/hodost-lv/2018/2018_09_13_04_56/2018_09_13_21_54.mpg;Shinzo ABE.jpg;23501;23933;91169;1176;1197;21
/net/per610a/home/mvp/mvp_db/hodost-lv/2018/2018_09_13_04_56/2018_09_13_21_54.mpg;Shinzo ABE.jpg;24205;24485;91169;1211;1225;14
/net/per610a/home/mvp/mvp_db/hodost-lv/2018/2018_09_13_04_56/2018_09_13_21_54.mpg;Shinzo ABE.jpg;24885;25093;91169;1245;1255;10
/net/per610a/home/mvp/mvp_db/hodost-lv/2018/2018_09_13_04_56/2018_09_13_21_54.mpg;Shinzo ABE.jpg;26685;26705;91169;1335;1336;1
/net/per610a/home/mvp/mvp_db/hodost-lv/2018/2018_09_13_04_56/2018_09_13_21_54.mpg;Shinzo ABE.jpg;27721;27725;91169;1387;1387;0
/net/per610a/home/mvp/mvp_db/hodost-lv/2018/2018_09_13_04_56/2018_09_13_21_54.mpg;Shinzo ABE.jpg;27833;27909;91169;1393;1396;3
/net/per610a/home/mvp/mvp_db/hodost-lv/2018/2018_09_14_04_56/2018_09_14_21_54.mpg;Shinzo ABE.jpg;2169;2433;91161;108;121;13
/net/per610a/home/mvp/mvp_db/hodost-lv/2018/2018_09_14_04_56/2018_09_14_21_54.mpg;Shinzo ABE.jpg;2685;2757;91161;134;137;3
/net/per610a/home/mvp/mvp_db/hodost-lv/2018/2018_09_14_04_56/2018_09_14_21_54.mpg;Shinzo ABE.jpg;5445;5517;91161;272;276;4
/net/per610a/home/mvp/mvp_db/hodost-lv/2018/2018_09_14_04_56/2018_09_14_21_54.mpg;Shinzo ABE.jpg;5613;5861;91161;280;293;13
/net/per610a/home/mvp/mvp_db/hodost-lv/2018/2018_09_14_04_56/2018_09_14_21_54.mpg;Shinzo ABE.jpg;6729;7121;91161;336;356;20
/net/per610a/home/mvp/mvp_db/hodost-lv/2018/2018_09_14_04_56/2018_09_14_21_54.mpg;Shinzo ABE.jpg;7277;7457;91161;364;373;9
/net/per610a/home/mvp/mvp_db/hodost-lv/2018/2018_09_14_04_56/2018_09_14_21_54.mpg;Shinzo ABE.jpg;8253;8565;91161;413;428;15
/net/per610a/home/mvp/mvp_db/hodost-lv/2018/2018_09_14_04_56/2018_09_14_21_54.mpg;Shinzo ABE.jpg;9621;9725;91161;481;486;5
/net/per610a/home/mvp/mvp_db/hodost-lv/2018/2018_09_14_04_56/2018_09_14_21_54.mpg;Shinzo ABE.jpg;10237;10541;91161;512;527;15
/net/per610a/home/mvp/mvp_db/hodost-lv/2018/2018_09_14_04_56/2018_09_14_21_54.mpg;Shinzo ABE.jpg;10749;10953;91161;537;548;11
/net/per610a/home/mvp/mvp_db/hodost-lv/2018/2018_09_14_04_56/2018_09_14_21_54.mpg;Shinzo ABE.jpg;12429;12465;91161;621;623;2
/net/per610a/home/mvp/mvp_db/hodost-lv/2018/2018_09_14_04_56/2018_09_14_21_54.mpg;Shinzo ABE.jpg;12933;13029;91161;647;652;5
/net/per610a/home/mvp/mvp_db/hodost-lv/2018/2018_09_17_04_56/2018_09_17_21_54.mpg;Shinzo ABE.jpg;1645;1709;91161;82;85;3
/net/per610a/home/mvp/mvp_db/hodost-lv/2018/2018_09_17_04_56/2018_09_17_21_54.mpg;Shinzo ABE.jpg;4817;4913;91161;241;245;4
/net/per610a/home/mvp/mvp_db/hodost-lv/2018/2018_09_17_04_56/2018_09_17_21_54.mpg;Shinzo ABE.jpg;19001;19077;91161;950;954;4
/net/per610a/home/mvp/mvp_db/hodost-lv/2018/2018_09_17_04_56/2018_09_17_21_54.mpg;Shinzo ABE.jpg;19837;22213;91161;992;1111;119
/net/per610a/home/mvp/mvp_db/hodost-lv/2018/2018_09_17_04_56/2018_09_17_21_54.mpg;Shinzo ABE.jpg;23189;25277;91161;1160;1264;104
/net/per610a/home/mvp/mvp_db/hodost-lv/2018/2018_09_17_04_56/2018_09_17_21_54.mpg;Shinzo ABE.jpg;25429;26845;91161;1272;1343;71
/net/per610a/home/mvp/mvp_db/hodost-lv/2018/2018_09_17_04_56/2018_09_17_21_54.mpg;Shinzo ABE.jpg;27169;30737;91161;1359;1538;179
/net/per610a/home/mvp/mvp_db/hodost-lv/2018/2018_09_17_04_56/2018_09_17_21_54.mpg;Shinzo ABE.jpg;30865;30929;91161;1544;1547;3
/net/per610a/home/mvp/mvp_db/hodost-lv/2018/2018_09_17_04_56/2018_09_17_21_54.mpg;Shinzo ABE.jpg;31521;31901;91161;1577;1596;19
/net/per610a/home/mvp/mvp_db/hodost-lv/2018/2018_09_17_04_56/2018_09_17_21_54.mpg;Shinzo ABE.jpg;31989;32377;91161;1600;1620;20
/net/per610a/home/mvp/mvp_db/hodost-lv/2018/2018_09_17_04_56/2018_09_17_21_54.mpg;Shinzo ABE.jpg;34481;36505;91161;1725;1826;101
/net/per610a/home/mvp/mvp_db/hodost-lv/2018/2018_09_17_04_56/2018_09_17_21_54.mpg;Shinzo ABE.jpg;37177;38141;91161;1860;1908;48
/net/per610a/home/mvp/mvp_db/hodost-lv/2018/2018_09_17_04_56/2018_09_17_21_54.mpg;Shinzo ABE.jpg;38229;38797;91161;1913;1941;28
/net/per610a/home/mvp/mvp_db/hodost-lv/2018/2018_09_17_04_56/2018_09_17_21_54.mpg;Shinzo ABE.jpg;39085;40721;91161;1955;2037;82
/net/per610a/home/mvp/mvp_db/hodost-lv/2018/2018_09_17_04_56/2018_09_17_21_54.mpg;Shinzo ABE.jpg;40825;41021;91161;2043;2052;9
/net/per610a/home/mvp/mvp_db/hodost-lv/2018/2018_09_17_04_56/2018_09_17_21_54.mpg;Shinzo ABE.jpg;41553;44489;91161;2079;2226;147
/net/per610a/home/mvp/mvp_db/hodost-lv/2018/2018_09_17_04_56/2018_09_17_21_54.mpg;Shinzo ABE.jpg;45697;45713;91161;2286;2287;1
/net/per610a/home/mvp/mvp_db/hodost-lv/2018/2018_09_17_04_56/2018_09_17_21_54.mpg;Shinzo ABE.jpg;46945;47217;91161;2349;2362;13
/net/per610a/home/mvp/mvp_db/hodost-lv/2018/2018_09_17_04_56/2018_09_17_21_54.mpg;Shinzo ABE.jpg;47669;48073;91161;2385;2405;20
/net/per610a/home/mvp/mvp_db/hodost-lv/2018/2018_09_17_04_56/2018_09_17_21_54.mpg;Shinzo ABE.jpg;48177;48245;91161;2410;2414;4
/net/per610a/home/mvp/mvp_db/hodost-lv/2018/2018_09_17_04_56/2018_09_17_21_54.mpg;Shinzo ABE.jpg;48745;50485;91161;2439;2526;87
/net/per610a/home/mvp/mvp_db/hodost-lv/2018/2018_09_17_04_56/2018_09_17_21_54.mpg;Shinzo ABE.jpg;51309;52601;91161;2567;2632;65
/net/per610a/home/mvp/mvp_db/hodost-lv/2018/2018_09_17_04_56/2018_09_17_21_54.mpg;Shinzo ABE.jpg;53601;53741;91161;2682;2689;7
/net/per610a/home/mvp/mvp_db/hodost-lv/2018/2018_09_17_04_56/2018_09_17_21_54.mpg;Shinzo ABE.jpg;53889;54049;91161;2696;2704;8
/net/per610a/home/mvp/mvp_db/hodost-lv/2018/2018_09_17_04_56/2018_09_17_21_54.mpg;Shinzo ABE.jpg;54137;54833;91161;2709;2744;35
/net/per610a/home/mvp/mvp_db/hodost-lv/2018/2018_09_17_04_56/2018_09_17_21_54.mpg;Shinzo ABE.jpg;54921;55925;91161;2748;2798;50
/net/per610a/home/mvp/mvp_db/hodost-lv/2018/2018_09_17_04_56/2018_09_17_21_54.mpg;Shinzo ABE.jpg;56041;56873;91161;2804;2846;42
/net/per610a/home/mvp/mvp_db/hodost-lv/2018/2018_09_17_04_56/2018_09_17_21_54.mpg;Shinzo ABE.jpg;56953;57033;91161;2850;2854;4
/net/per610a/home/mvp/mvp_db/hodost-lv/2018/2018_09_17_04_56/2018_09_17_21_54.mpg;Kohei Otsuka.jpg;11297;11341;91161;565;567;2
/net/per610a/home/mvp/mvp_db/hodost-lv/2018/2018_09_17_04_56/2018_09_17_21_54.mpg;Kohei Otsuka.jpg;11709;11905;91161;585;595;10
/net/per610a/home/mvp/mvp_db/hodost-lv/2018/2018_09_17_04_56/2018_09_17_21_54.mpg;Kohei Otsuka.jpg;20905;21929;91161;1046;1097;51
/net/per610a/home/mvp/mvp_db/hodost-lv/2018/2018_09_17_04_56/2018_09_17_21_54.mpg;Kohei Otsuka.jpg;57121;57189;91161;2858;2861;3
/net/per610a/home/mvp/mvp_db/hodost-lv/2018/2018_09_18_04_56/2018_09_18_21_54.mpg;Taro ASO.jpg;35289;35465;91169;1766;1775;9
/net/per610a/home/mvp/mvp_db/hodost-lv/2018/2018_09_18_04_56/2018_09_18_21_54.mpg;Taro ASO.jpg;37925;38285;91169;1898;1916;18
/net/per610a/home/mvp/mvp_db/hodost-lv/2018/2018_09_18_04_56/2018_09_18_21_54.mpg;Taro ASO.jpg;40977;41033;91169;2050;2053;3
/net/per610a/home/mvp/mvp_db/hodost-lv/2018/2018_09_18_04_56/2018_09_18_21_54.mpg;Taro ASO.jpg;43593;43837;91169;2181;2194;13
/net/per610a/home/mvp/mvp_db/hodost-lv/2018/2018_09_18_04_56/2018_09_18_21_54.mpg;Taro ASO.jpg;44033;44033;91169;2203;2203;0
/net/per610a/home/mvp/mvp_db/hodost-lv/2018/2018_09_18_04_56/2018_09_18_21_54.mpg;Taro ASO.jpg;44149;44197;91169;2209;2212;3
/net/per610a/home/mvp/mvp_db/hodost-lv/2018/2018_09_18_04_56/2018_09_18_21_54.mpg;Taro ASO.jpg;44261;44477;91169;2215;2226;11
/net/per610a/home/mvp/mvp_db/hodost-lv/2018/2018_09_18_04_56/2018_09_18_21_54.mpg;Taro ASO.jpg;44941;45041;91169;2249;2254;5
/net/per610a/home/mvp/mvp_db/hodost-lv/2018/2018_09_19_04_56/2018_09_19_21_54.mpg;Shinzo ABE.jpg;43393;43685;91169;2171;2186;15
/net/per610a/home/mvp/mvp_db/hodost-lv/2018/2018_09_19_04_56/2018_09_19_21_54.mpg;Shinzo ABE.jpg;43849;43969;91169;2194;2200;6
/net/per610a/home/mvp/mvp_db/hodost-lv/2018/2018_09_20_04_56/2018_09_20_21_54.mpg;Shinzo ABE.jpg;15433;16613;91169;772;831;59
/net/per610a/home/mvp/mvp_db/hodost-lv/2018/2018_09_20_04_56/2018_09_20_21_54.mpg;Shinzo ABE.jpg;16737;16769;91169;837;839;2
/net/per610a/home/mvp/mvp_db/hodost-lv/2018/2018_09_20_04_56/2018_09_20_21_54.mpg;Taro ASO.jpg;21205;21549;91169;1061;1078;17
/net/per610a/home/mvp/mvp_db/hodost-lv/2018/2018_09_20_04_56/2018_09_20_21_54.mpg;Taro ASO.jpg;21845;22165;91169;1093;1109;16
/net/per610a/home/mvp/mvp_db/hodost-lv/2018/2018_09_20_04_56/2018_09_20_21_54.mpg;Taro ASO.jpg;22229;22577;91169;1112;1129;17
/net/per610a/home/mvp/mvp_db/hodost-lv/2018/2018_09_20_04_56/2018_09_20_21_54.mpg;Taro ASO.jpg;22753;22913;91169;1138;1146;8
/net/per610a/home/mvp/mvp_db/hodost-lv/2018/2018_09_20_04_56/2018_09_20_21_54.mpg;Taro ASO.jpg;23109;23173;91169;1156;1159;3
/net/per610a/home/mvp/mvp_db/hodost-lv/2018/2018_09_21_04_56/2018_09_21_21_54.mpg;Taro ASO.jpg;9641;10921;91169;482;546;64
/net/per610a/home/mvp/mvp_db/hodost-lv/2018/2018_09_21_04_56/2018_09_21_21_54.mpg;Taro ASO.jpg;11249;11997;91169;563;600;37
/net/per610a/home/mvp/mvp_db/hodost-lv/2018/2018_09_21_04_56/2018_09_21_21_54.mpg;Shinzo ABE.jpg;14289;14685;91169;715;734;19
/net/per610a/home/mvp/mvp_db/hodost-lv/2018/2018_09_21_04_56/2018_09_21_21_54.mpg;Kohei Otsuka.jpg;14693;14857;91169;735;743;8
/net/per610a/home/mvp/mvp_db/hodost-lv/2018/2018_09_21_04_56/2018_09_21_21_54.mpg;Kohei Otsuka.jpg;21257;21269;91169;1063;1064;1
/net/per610a/home/mvp/mvp_db/hodost-lv/2018/2018_09_21_04_56/2018_09_21_21_54.mpg;Kohei Otsuka.jpg;43641;43641;91169;2184;2184;0
/net/per610a/home/mvp/mvp_db/hodost-lv/2018/2018_09_21_04_56/2018_09_21_21_54.mpg;Kohei Otsuka.jpg;45013;45221;91169;2252;2263;11
/net/per610a/home/mvp/mvp_db/hodost-lv/2018/2018_09_21_04_56/2018_09_21_21_54.mpg;Kohei Otsuka.jpg;46609;46765;91169;2332;2340;8
/net/per610a/home/mvp/mvp_db/hodost-lv/2018/2018_09_23_04_56/2018_09_23_16_30.mpg;Shinzo ABE.jpg;63017;63017;107949;3153;3153;0
/net/per610a/home/mvp/mvp_db/hodost-lv/2018/2018_09_23_04_56/2018_09_23_16_30.mpg;Shinzo ABE.jpg;65009;65137;107949;3253;3259;6
/net/per610a/home/mvp/mvp_db/hodost-lv/2018/2018_09_23_04_56/2018_09_23_16_30.mpg;Shinzo ABE.jpg;79745;80253;107949;3990;4016;26
/net/per610a/home/mvp/mvp_db/hodost-lv/2018/2018_09_23_04_56/2018_09_23_16_30.mpg;Shinzo ABE.jpg;80565;80649;107949;4031;4035;4
/net/per610a/home/mvp/mvp_db/hodost-lv/2018/2018_09_23_04_56/2018_09_23_16_30.mpg;Shinzo ABE.jpg;85757;85897;107949;4291;4298;7
/net/per610a/home/mvp/mvp_db/hodost-lv/2018/2018_09_23_04_56/2018_09_23_16_30.mpg;Shinzo ABE.jpg;103589;103629;107949;5183;5185;2
/net/per610a/home/mvp/mvp_db/hodost-lv/2018/2018_09_24_04_56/2018_09_24_21_54.mpg;Shinzo ABE.jpg;18717;18889;91169;936;945;9
/net/per610a/home/mvp/mvp_db/hodost-lv/2018/2018_09_24_04_56/2018_09_24_21_54.mpg;Shinzo ABE.jpg;23717;23845;91169;1187;1193;6
/net/per610a/home/mvp/mvp_db/hodost-lv/2018/2018_09_26_04_56/2018_09_26_21_54.mpg;Shinzo ABE.jpg;37449;37825;91169;1874;1893;19
/net/per610a/home/mvp/mvp_db/hodost-lv/2018/2018_09_26_04_56/2018_09_26_21_54.mpg;Shinzo ABE.jpg;37929;38385;91169;1898;1921;23
/net/per610a/home/mvp/mvp_db/hodost-lv/2018/2018_09_26_04_56/2018_09_26_21_54.mpg;Shinzo ABE.jpg;39189;39217;91169;1961;1962;1
/net/per610a/home/mvp/mvp_db/hodost-lv/2018/2018_09_27_04_56/2018_09_27_21_54.mpg;Shinzo ABE.jpg;15497;15629;91169;775;782;7
/net/per610a/home/mvp/mvp_db/hodost-lv/2018/2018_09_27_04_56/2018_09_27_21_54.mpg;Shinzo ABE.jpg;16277;16361;91169;814;818;4
/net/per610a/home/mvp/mvp_db/hodost-lv/2018/2018_09_27_04_56/2018_09_27_21_54.mpg;Shinzo ABE.jpg;17585;17833;91169;880;892;12
/net/per610a/home/mvp/mvp_db/hodost-lv/2018/2018_09_27_04_56/2018_09_27_21_54.mpg;Shinzo ABE.jpg;18057;18533;91169;903;927;24
/net/per610a/home/mvp/mvp_db/hodost-lv/2018/2018_09_27_04_56/2018_09_27_21_54.mpg;Shinzo ABE.jpg;20565;20873;91169;1029;1044;15
/net/per610a/home/mvp/mvp_db/hodost-lv/2018/2018_09_27_04_56/2018_09_27_21_54.mpg;Shinzo ABE.jpg;21645;21693;91169;1083;1085;2
/net/per610a/home/mvp/mvp_db/hodost-lv/2018/2018_09_27_04_56/2018_09_27_21_54.mpg;Shinzo ABE.jpg;26693;26873;91169;1335;1344;9
/net/per610a/home/mvp/mvp_db/hodost-lv/2018/2018_09_27_04_56/2018_09_27_21_54.mpg;Shinzo ABE.jpg;33533;34037;91169;1678;1703;25
/net/per610a/home/mvp/mvp_db/hodost-lv/2018/2018_09_27_04_56/2018_09_27_21_54.mpg;Shinzo ABE.jpg;35253;35705;91169;1764;1787;23
/net/per610a/home/mvp/mvp_db/hodost-lv/2018/2018_09_30_04_56/2018_09_30_16_30.mpg;Shinzo ABE.jpg;102241;102397;107949;5116;5124;8
/net/per610a/home/mvp/mvp_db/hodost-lv/2018/2018_10_01_04_56/2018_10_01_21_54.mpg;Shinzo ABE.jpg;34733;34945;97161;1738;1748;10
/net/per610a/home/mvp/mvp_db/hodost-lv/2018/2018_10_02_04_56/2018_10_02_21_54.mpg;Shinzo ABE.jpg;1445;1729;97161;72;86;14
/net/per610a/home/mvp/mvp_db/hodost-lv/2018/2018_10_02_04_56/2018_10_02_21_54.mpg;Shinzo ABE.jpg;1805;1865;97161;90;93;3
/net/per610a/home/mvp/mvp_db/hodost-lv/2018/2018_10_02_04_56/2018_10_02_21_54.mpg;Shinzo ABE.jpg;6137;6537;97161;307;327;20
/net/per610a/home/mvp/mvp_db/hodost-lv/2018/2018_10_02_04_56/2018_10_02_21_54.mpg;Shinzo ABE.jpg;2009;2045;97161;100;102;2
/net/per610a/home/mvp/mvp_db/hodost-lv/2018/2018_10_02_04_56/2018_10_02_21_54.mpg;Shinzo ABE.jpg;10889;10957;97161;544;548;4
/net/per610a/home/mvp/mvp_db/hodost-lv/2018/2018_10_05_04_56/2018_10_05_21_54.mpg;Taro ASO.jpg;31617;31729;91169;1582;1588;6
/net/per610a/home/mvp/mvp_db/hodost-lv/2018/2018_10_05_04_56/2018_10_05_21_54.mpg;Taro ASO.jpg;31797;31849;91169;1591;1594;3
/net/per610a/home/mvp/mvp_db/hodost-lv/2018/2018_10_05_04_56/2018_10_05_21_54.mpg;Taro ASO.jpg;33741;34241;91169;1688;1713;25
/net/per610a/home/mvp/mvp_db/hodost-lv/2018/2018_10_07_04_56/2018_10_07_16_30.mpg;Shinzo ABE.jpg;14029;14189;107949;702;710;8
/net/per610a/home/mvp/mvp_db/hodost-lv/2018/2018_10_07_04_56/2018_10_07_16_30.mpg;Shinzo ABE.jpg;29729;29825;107949;1487;1492;5
/net/per610a/home/mvp/mvp_db/hodost-lv/2018/2018_10_07_04_56/2018_10_07_16_30.mpg;Shinzo ABE.jpg;29921;30017;107949;1497;1502;5
/net/per610a/home/mvp/mvp_db/hodost-lv/2018/2018_10_09_04_56/2018_10_09_21_54.mpg;Kohei Otsuka.jpg;56893;56973;97169;2847;2851;4
/net/per610a/home/mvp/mvp_db/hodost-lv/2018/2018_10_09_04_56/2018_10_09_21_54.mpg;Kohei Otsuka.jpg;57105;57293;97169;2857;2867;10
/net/per610a/home/mvp/mvp_db/hodost-lv/2018/2018_10_09_04_56/2018_10_09_21_54.mpg;Kohei Otsuka.jpg;63381;63549;97169;3172;3180;8
/net/per610a/home/mvp/mvp_db/hodost-lv/2018/2018_10_09_04_56/2018_10_09_21_54.mpg;Kohei Otsuka.jpg;91849;91913;97169;4596;4599;3
/net/per610a/home/mvp/mvp_db/hodost-lv/2018/2018_10_08_04_56/2018_10_08_21_54.mpg;Kohei Otsuka.jpg;14209;14313;97161;711;716;5
/net/per610a/home/mvp/mvp_db/hodost-lv/2018/2018_10_08_04_56/2018_10_08_21_54.mpg;Kohei Otsuka.jpg;14793;14809;97161;740;741;1
/net/per610a/home/mvp/mvp_db/hodost-lv/2018/2018_10_08_04_56/2018_10_08_21_54.mpg;Kohei Otsuka.jpg;57653;57805;97161;2884;2892;8
/net/per610a/home/mvp/mvp_db/hodost-lv/2018/2018_10_08_04_56/2018_10_08_21_54.mpg;Shinzo ABE.jpg;18373;18629;97161;919;932;13
/net/per610a/home/mvp/mvp_db/hodost-lv/2018/2018_10_08_04_56/2018_10_08_21_54.mpg;Shinzo ABE.jpg;19357;19741;97161;968;987;19
/net/per610a/home/mvp/mvp_db/hodost-lv/2018/2018_10_08_04_56/2018_10_08_21_54.mpg;Shinzo ABE.jpg;20241;20485;97161;1012;1025;13
/net/per610a/home/mvp/mvp_db/hodost-lv/2018/2018_10_12_04_56/2018_10_12_21_37.mpg;Shinzo ABE.jpg;9709;9961;111541;485;498;13
/net/per610a/home/mvp/mvp_db/hodost-lv/2018/2018_10_12_04_56/2018_10_12_21_37.mpg;Shinzo ABE.jpg;13805;13857;111541;690;693;3
/net/per610a/home/mvp/mvp_db/hodost-lv/2018/2018_10_12_04_56/2018_10_12_21_37.mpg;Shinzo ABE.jpg;16001;16105;111541;800;805;5
/net/per610a/home/mvp/mvp_db/hodost-lv/2018/2018_10_12_04_56/2018_10_12_21_37.mpg;Shinzo ABE.jpg;16225;16441;111541;811;822;11
/net/per610a/home/mvp/mvp_db/hodost-lv/2018/2018_10_12_04_56/2018_10_12_21_37.mpg;Shinzo ABE.jpg;17021;17317;111541;851;866;15
/net/per610a/home/mvp/mvp_db/hodost-lv/2018/2018_10_13_04_56/2018_10_13_20_54.mpg;YUriko Koike.jpg;26329;26753;91161;1317;1338;21
/net/per610a/home/mvp/mvp_db/hodost-lv/2018/2018_10_13_04_56/2018_10_13_20_54.mpg;Junichiro KOIZUMI.jpg;27657;27757;91161;1384;1389;5
/net/per610a/home/mvp/mvp_db/hodost-lv/2018/2018_10_13_04_56/2018_10_13_20_54.mpg;Junichiro KOIZUMI.jpg;28153;28809;91161;1408;1441;33
/net/per610a/home/mvp/mvp_db/hodost-lv/2018/2018_10_14_04_56/2018_10_14_17_30.mpg;Shinzo ABE.jpg;12809;12905;36021;640;645;5
/net/per610a/home/mvp/mvp_db/hodost-lv/2018/2018_10_15_04_56/2018_10_15_21_54.mpg;Shinzo ABE.jpg;2041;2089;97161;102;104;2
/net/per610a/home/mvp/mvp_db/hodost-lv/2018/2018_10_15_04_56/2018_10_15_21_54.mpg;Shinzo ABE.jpg;4777;4889;97161;239;244;5
/net/per610a/home/mvp/mvp_db/hodost-lv/2018/2018_10_15_04_56/2018_10_15_21_54.mpg;Shinzo ABE.jpg;9361;9801;97161;468;490;22
/net/per610a/home/mvp/mvp_db/hodost-lv/2018/2018_10_15_04_56/2018_10_15_21_54.mpg;Shinzo ABE.jpg;9893;10537;97161;495;527;32
/net/per610a/home/mvp/mvp_db/hodost-lv/2018/2018_10_15_04_56/2018_10_15_21_54.mpg;Taro ASO.jpg;13269;13453;97161;663;673;10
/net/per610a/home/mvp/mvp_db/hodost-lv/2018/2018_10_15_04_56/2018_10_15_21_54.mpg;Yukio EDANO.jpg;13897;14309;97161;695;716;21
/net/per610a/home/mvp/mvp_db/hodost-lv/2018/2018_10_16_04_56/2018_10_16_21_37.mpg;Taro ASO.jpg;46693;46993;117549;2336;2351;15
/net/per610a/home/mvp/mvp_db/hodost-lv/2018/2018_10_16_04_56/2018_10_16_21_37.mpg;Taro ASO.jpg;47501;47733;117549;2377;2388;11
/net/per610a/home/mvp/mvp_db/hodost-lv/2018/2018_10_16_04_56/2018_10_16_21_37.mpg;Taro ASO.jpg;48325;48489;117549;2418;2426;8
/net/per610a/home/mvp/mvp_db/hodost-lv/2018/2018_10_16_04_56/2018_10_16_21_37.mpg;Shinzo ABE.jpg;52673;53193;117549;2636;2662;26
/net/per610a/home/mvp/mvp_db/hodost-lv/2018/2018_10_17_04_56/2018_10_17_22_24.mpg;YUriko Koike.jpg;6129;6445;97161;306;322;16
/net/per610a/home/mvp/mvp_db/hodost-lv/2018/2018_10_17_04_56/2018_10_17_22_24.mpg;Ichiro Matsui.jpeg;9017;9321;97161;451;466;15
/net/per610a/home/mvp/mvp_db/hodost-lv/2018/2018_10_18_04_56/2018_10_18_22_09.mpg;Shinzo ABE.jpg;6289;6449;97161;314;322;8
/net/per610a/home/mvp/mvp_db/hodost-lv/2018/2018_10_18_04_56/2018_10_18_22_09.mpg;Shinzo ABE.jpg;6529;7469;97161;326;373;47
/net/per610a/home/mvp/mvp_db/hodost-lv/2018/2018_10_18_04_56/2018_10_18_22_09.mpg;Shinzo ABE.jpg;38921;38949;97161;1947;1949;2
/net/per610a/home/mvp/mvp_db/hodost-lv/2018/2018_10_18_04_56/2018_10_18_22_09.mpg;Shinzo ABE.jpg;39725;39741;97161;1987;1988;1
/net/per610a/home/mvp/mvp_db/hodost-lv/2018/2018_10_21_04_56/2018_10_21_16_00.mpg;Shinzo ABE.jpg;42309;42425;143921;2117;2123;6
/net/per610a/home/mvp/mvp_db/hodost-lv/2018/2018_10_21_04_56/2018_10_21_16_00.mpg;Shinzo ABE.jpg;48869;48869;143921;2445;2445;0
/net/per610a/home/mvp/mvp_db/hodost-lv/2018/2018_10_21_04_56/2018_10_21_16_00.mpg;Shinzo ABE.jpg;49145;49937;143921;2459;2499;40
/net/per610a/home/mvp/mvp_db/hodost-lv/2018/2018_10_21_04_56/2018_10_21_16_00.mpg;Shinzo ABE.jpg;50249;50453;143921;2514;2525;11
/net/per610a/home/mvp/mvp_db/hodost-lv/2018/2018_10_21_04_56/2018_10_21_16_00.mpg;Shinzo ABE.jpg;54561;54769;143921;2730;2741;11
/net/per610a/home/mvp/mvp_db/hodost-lv/2018/2018_10_21_04_56/2018_10_21_16_00.mpg;Shinzo ABE.jpg;54989;55069;143921;2752;2756;4
/net/per610a/home/mvp/mvp_db/hodost-lv/2018/2018_10_24_04_56/2018_10_24_22_09.mpg;Shinzo ABE.jpg;26849;26957;97161;1343;1348;5
/net/per610a/home/mvp/mvp_db/hodost-lv/2018/2018_10_24_04_56/2018_10_24_22_09.mpg;Shinzo ABE.jpg;30017;30197;97161;1502;1511;9
/net/per610a/home/mvp/mvp_db/hodost-lv/2018/2018_10_24_04_56/2018_10_24_22_09.mpg;Shinzo ABE.jpg;30857;31481;97161;1544;1575;31
/net/per610a/home/mvp/mvp_db/hodost-lv/2018/2018_10_24_04_56/2018_10_24_22_09.mpg;Shinzo ABE.jpg;31913;32497;97161;1596;1626;30
/net/per610a/home/mvp/mvp_db/hodost-lv/2018/2018_10_24_04_56/2018_10_24_22_09.mpg;Shinzo ABE.jpg;33233;33769;97161;1663;1689;26
/net/per610a/home/mvp/mvp_db/hodost-lv/2018/2018_10_24_04_56/2018_10_24_22_09.mpg;Yukio EDANO.jpg;34385;35077;97161;1720;1755;35
/net/per610a/home/mvp/mvp_db/hodost-lv/2018/2018_10_24_04_56/2018_10_24_22_09.mpg;Kazuo SHII.jpg;35133;35581;97161;1758;1780;22
/net/per610a/home/mvp/mvp_db/hodost-lv/2018/2018_10_25_04_56/2018_10_25_21_54.mpg;Taro ASO.jpg;43897;44913;97161;2196;2247;51
/net/per610a/home/mvp/mvp_db/hodost-lv/2018/2018_10_25_04_56/2018_10_25_21_54.mpg;Taro ASO.jpg;48521;48785;97161;2428;2441;13
/net/per610a/home/mvp/mvp_db/hodost-lv/2018/2018_10_25_04_56/2018_10_25_21_54.mpg;Shinzo ABE.jpg;58341;58797;97161;2919;2942;23
/net/per610a/home/mvp/mvp_db/hodost-lv/2018/2018_10_25_04_56/2018_10_25_21_54.mpg;Shinzo ABE.jpg;58969;59105;97161;2950;2957;7
/net/per610a/home/mvp/mvp_db/hodost-lv/2018/2018_10_26_04_56/2018_10_26_21_54.mpg;YUriko Koike.jpg;52381;52561;91169;2621;2630;9
/net/per610a/home/mvp/mvp_db/hodost-lv/2018/2018_10_28_04_56/2018_10_28_17_30.mpg;Shinzo ABE.jpg;26761;26817;36029;1339;1342;3
/net/per610a/home/mvp/mvp_db/hodost-lv/2018/2018_10_29_04_56/2018_10_29_21_54.mpg;Shinzo ABE.jpg;15301;15389;43221;765;770;5
/net/per610a/home/mvp/mvp_db/hodost-lv/2018/2018_10_30_04_56/2018_10_30_21_54.mpg;Shinzo ABE.jpg;1609;1769;97161;80;88;8
/net/per610a/home/mvp/mvp_db/hodost-lv/2018/2018_10_30_04_56/2018_10_30_21_54.mpg;Shinzo ABE.jpg;10057;10577;97161;503;529;26
/net/per610a/home/mvp/mvp_db/hodost-lv/2018/2018_10_30_04_56/2018_10_30_21_54.mpg;Shinzo ABE.jpg;18317;18697;97161;916;935;19
/net/per610a/home/mvp/mvp_db/hodost-lv/2018/2018_10_30_04_56/2018_10_30_21_54.mpg;Shinzo ABE.jpg;22045;22169;97161;1103;1109;6
/net/per610a/home/mvp/mvp_db/hodost-lv/2018/2018_10_30_04_56/2018_10_30_21_54.mpg;Shinzo ABE.jpg;29717;29769;97161;1487;1489;2
/net/per610a/home/mvp/mvp_db/hodost-lv/2018/2018_10_31_04_56/2018_10_31_21_54.mpg;Shinzo ABE.jpg;17777;17813;43209;889;891;2
/net/per610a/home/mvp/mvp_db/hodost-lv/2018/2018_10_31_04_56/2018_10_31_21_54.mpg;Shinzo ABE.jpg;18057;18061;43209;903;903;0
/net/per610a/home/mvp/mvp_db/hodost-lv/2018/2018_10_31_04_56/2018_10_31_21_54.mpg;Shinzo ABE.jpg;18205;18301;43209;910;915;5
/net/per610a/home/mvp/mvp_db/hodost-lv/2018/2018_10_31_04_56/2018_10_31_21_54.mpg;Shinzo ABE.jpg;21185;21533;43209;1060;1077;17
/net/per610a/home/mvp/mvp_db/hodost-lv/2018/2018_10_31_04_56/2018_10_31_21_54.mpg;Natsuo YAMAGUCHI.jpg;18501;19037;43209;925;952;27
/net/per610a/home/mvp/mvp_db/hodost-lv/2018/2018_11_04_04_56/2018_11_04_16_30.mpg;Shinzo ABE.jpg;26029;26165;107949;1302;1309;7
/net/per610a/home/mvp/mvp_db/hodost-lv/2018/2018_11_04_04_56/2018_11_04_16_30.mpg;Shinzo ABE.jpg;26265;26293;107949;1314;1315;1
/net/per610a/home/mvp/mvp_db/hodost-lv/2018/2018_11_08_04_56/2018_11_08_21_54.mpg;Shinzo ABE.jpg;19781;20097;97161;989;1005;16
/net/per610a/home/mvp/mvp_db/hodost-lv/2018/2018_11_10_04_56/2018_11_10_20_54.mpg;Renho.jpg;10453;10553;91161;523;528;5
/net/per610a/home/mvp/mvp_db/hodost-lv/2018/2018_11_13_04_56/2018_11_13_21_54.mpg;Shinzo ABE.jpg;19533;19969;97169;977;999;22
/net/per610a/home/mvp/mvp_db/hodost-lv/2018/2018_11_13_04_56/2018_11_13_21_54.mpg;Shinzo ABE.jpg;30157;30169;97169;1509;1509;0
/net/per610a/home/mvp/mvp_db/hodost-lv/2018/2018_11_13_04_56/2018_11_13_21_54.mpg;Shinzo ABE.jpg;34005;34021;97169;1701;1702;1
/net/per610a/home/mvp/mvp_db/hodost-lv/2018/2018_11_13_04_56/2018_11_13_21_54.mpg;Shinzo ABE.jpg;36393;36649;97169;1821;1834;13
/net/per610a/home/mvp/mvp_db/hodost-lv/2018/2018_11_13_04_56/2018_11_13_21_54.mpg;Shinzo ABE.jpg;37985;38341;97169;1901;1918;17
/net/per610a/home/mvp/mvp_db/hodost-lv/2018/2018_11_13_04_56/2018_11_13_21_54.mpg;Shinzo ABE.jpg;38765;38877;97169;1940;1945;5
/net/per610a/home/mvp/mvp_db/hodost-lv/2018/2018_11_13_04_56/2018_11_13_21_54.mpg;Shinzo ABE.jpg;41993;42425;97169;2101;2123;22
/net/per610a/home/mvp/mvp_db/hodost-lv/2018/2018_11_14_04_56/2018_11_14_21_54.mpg;Shinzo ABE.jpg;25961;25969;97169;1299;1299;0
/net/per610a/home/mvp/mvp_db/hodost-lv/2018/2018_11_14_04_56/2018_11_14_21_54.mpg;Shinzo ABE.jpg;32313;33021;97169;1617;1652;35
/net/per610a/home/mvp/mvp_db/hodost-lv/2018/2018_11_14_04_56/2018_11_14_21_54.mpg;Shinzo ABE.jpg;26429;26741;97169;1322;1338;16
/net/per610a/home/mvp/mvp_db/hodost-lv/2018/2018_11_15_04_56/2018_11_15_21_54.mpg;Shinzo ABE.jpg;23957;24093;97161;1198;1205;7
/net/per610a/home/mvp/mvp_db/hodost-lv/2018/2018_11_15_04_56/2018_11_15_21_54.mpg;Shinzo ABE.jpg;26325;26525;97161;1317;1327;10
/net/per610a/home/mvp/mvp_db/hodost-lv/2018/2018_11_15_04_56/2018_11_15_21_54.mpg;Shinzo ABE.jpg;26709;26797;97161;1336;1340;4
/net/per610a/home/mvp/mvp_db/hodost-lv/2018/2018_11_15_04_56/2018_11_15_21_54.mpg;Shinzo ABE.jpg;26881;26993;97161;1345;1350;5
/net/per610a/home/mvp/mvp_db/hodost-lv/2018/2018_11_16_04_56/2018_11_16_21_54.mpg;Shinzo ABE.jpg;24229;24341;91169;1212;1218;6
/net/per610a/home/mvp/mvp_db/hodost-lv/2018/2018_11_16_04_56/2018_11_16_21_54.mpg;Shinzo ABE.jpg;27633;28053;91169;1383;1404;21
/net/per610a/home/mvp/mvp_db/hodost-lv/2018/2018_11_16_04_56/2018_11_16_21_54.mpg;Shinzo ABE.jpg;28181;28317;91169;1410;1417;7
/net/per610a/home/mvp/mvp_db/hodost-lv/2018/2018_11_16_04_56/2018_11_16_21_54.mpg;Shinzo ABE.jpg;30465;30881;91169;1524;1545;21
/net/per610a/home/mvp/mvp_db/hodost-lv/2018/2018_11_16_04_56/2018_11_16_21_54.mpg;Shinzo ABE.jpg;31577;31689;91169;1580;1586;6
/net/per610a/home/mvp/mvp_db/hodost-lv/2018/2018_11_16_04_56/2018_11_16_21_54.mpg;Shinzo ABE.jpg;32525;32581;91169;1627;1630;3
/net/per610a/home/mvp/mvp_db/hodost-lv/2018/2018_11_16_04_56/2018_11_16_21_54.mpg;Shinzo ABE.jpg;32777;32841;91169;1640;1643;3
/net/per610a/home/mvp/mvp_db/hodost-lv/2018/2018_11_18_04_56/2018_11_18_16_30.mpg;Shinzo ABE.jpg;16497;16605;107949;825;830;5
/net/per610a/home/mvp/mvp_db/hodost-lv/2018/2018_11_18_04_56/2018_11_18_16_30.mpg;Shinzo ABE.jpg;42725;42773;107949;2138;2140;2
/net/per610a/home/mvp/mvp_db/hodost-lv/2018/2018_11_18_04_56/2018_11_18_16_30.mpg;Shinzo ABE.jpg;38813;38857;107949;1942;1944;2
/net/per610a/home/mvp/mvp_db/hodost-lv/2018/2018_11_18_04_56/2018_11_18_16_30.mpg;Shinzo ABE.jpg;42237;42561;107949;2113;2129;16
/net/per610a/home/mvp/mvp_db/hodost-lv/2018/2018_11_18_04_56/2018_11_18_16_30.mpg;Shinzo ABE.jpg;42985;43277;107949;2151;2165;14
/net/per610a/home/mvp/mvp_db/hodost-lv/2018/2018_11_21_04_56/2018_11_21_21_54.mpg;Shinzo ABE.jpg;39813;40237;97161;1992;2013;21
/net/per610a/home/mvp/mvp_db/hodost-lv/2018/2018_11_21_04_56/2018_11_21_21_54.mpg;Shinzo ABE.jpg;42677;42845;97161;2135;2143;8
/net/per610a/home/mvp/mvp_db/hodost-lv/2018/2018_11_22_04_56/2018_11_22_21_54.mpg;Kohei Otsuka.jpg;11001;11109;97161;550;555;5
/net/per610a/home/mvp/mvp_db/hodost-lv/2018/2018_11_22_04_56/2018_11_22_21_54.mpg;Kohei Otsuka.jpg;64509;64701;97161;3228;3237;9
/net/per610a/home/mvp/mvp_db/hodost-lv/2018/2018_11_22_04_56/2018_11_22_21_54.mpg;Kohei Otsuka.jpg;70229;70301;97161;3514;3517;3
/net/per610a/home/mvp/mvp_db/hodost-lv/2018/2018_11_22_04_56/2018_11_22_21_54.mpg;Shinzo ABE.jpg;30425;30545;97161;1522;1528;6
/net/per610a/home/mvp/mvp_db/hodost-lv/2018/2018_11_22_04_56/2018_11_22_21_54.mpg;Shinzo ABE.jpg;33657;34381;97161;1684;1720;36
/net/per610a/home/mvp/mvp_db/hodost-lv/2018/2018_11_22_04_56/2018_11_22_21_54.mpg;Shinzo ABE.jpg;37929;38073;97161;1897;1905;8
/net/per610a/home/mvp/mvp_db/hodost-lv/2018/2018_11_23_04_56/2018_11_23_21_54.mpg;Shinzo ABE.jpg;12613;12725;91161;631;636;5
/net/per610a/home/mvp/mvp_db/hodost-lv/2018/2018_11_24_04_56/2018_11_24_20_54.mpg;Shinzo ABE.jpg;3465;3553;91169;173;177;4
/net/per610a/home/mvp/mvp_db/hodost-lv/2018/2018_11_26_04_56/2018_11_26_21_54.mpg;Shinzo ABE.jpg;31285;31321;97161;1565;1567;2
/net/per610a/home/mvp/mvp_db/hodost-lv/2018/2018_11_26_04_56/2018_11_26_21_54.mpg;Shinzo ABE.jpg;55409;55433;97161;2772;2773;1
/net/per610a/home/mvp/mvp_db/hodost-lv/2018/2018_11_26_04_56/2018_11_26_21_54.mpg;Shinzo ABE.jpg;55725;55817;97161;2788;2793;5
/net/per610a/home/mvp/mvp_db/hodost-lv/2018/2018_11_26_04_56/2018_11_26_21_54.mpg;Taro ASO.jpg;37301;37521;97161;1866;1877;11
/net/per610a/home/mvp/mvp_db/hodost-lv/2018/2018_11_27_04_56/2018_11_27_21_54.mpg;Ichiro OZAWA.jpg;11249;11801;97161;562;590;28
/net/per610a/home/mvp/mvp_db/hodost-lv/2018/2018_11_28_04_56/2018_11_28_21_54.mpg;Shinzo ABE.jpg;48349;48385;97161;2419;2421;2
/net/per610a/home/mvp/mvp_db/hodost-lv/2018/2018_11_28_04_56/2018_11_28_21_54.mpg;Shinzo ABE.jpg;49565;49937;97161;2480;2498;18
/net/per610a/home/mvp/mvp_db/hodost-lv/2018/2018_11_28_04_56/2018_11_28_21_54.mpg;Shinzo ABE.jpg;70025;70073;97161;3504;3506;2
/net/per610a/home/mvp/mvp_db/hodost-lv/2018/2018_11_29_04_56/2018_11_29_21_54.mpg;Yasuo FUKUDA.jpg;2169;3445;97161;108;172;64
/net/per610a/home/mvp/mvp_db/hodost-lv/2018/2018_11_29_04_56/2018_11_29_21_54.mpg;Shinzo ABE.jpg;57173;57557;97161;2860;2880;20
/net/per610a/home/mvp/mvp_db/hodost-lv/2018/2018_11_30_04_56/2018_11_30_21_54.mpg;Yukio HATOYAMA.jpg;52661;52801;91169;2635;2642;7
/net/per610a/home/mvp/mvp_db/hodost-lv/2018/2018_12_01_04_56/2018_12_01_20_54.mpg;Shinzo ABE.jpg;1385;1453;91169;69;72;3
/net/per610a/home/mvp/mvp_db/hodost-lv/2018/2018_12_01_04_56/2018_12_01_20_54.mpg;Shinzo ABE.jpg;80561;80705;91169;4032;4039;7
/net/per610a/home/mvp/mvp_db/hodost-lv/2018/2018_12_01_04_56/2018_12_01_20_54.mpg;Shinzo ABE.jpg;84377;84505;91169;4223;4229;6
/net/per610a/home/mvp/mvp_db/hodost-lv/2018/2018_12_01_04_56/2018_12_01_20_54.mpg;Shinzo ABE.jpg;84509;84645;91169;4229;4236;7
/net/per610a/home/mvp/mvp_db/hodost-lv/2018/2018_12_02_04_56/2018_12_02_16_30.mpg;Shinzo ABE.jpg;30925;31017;107949;1547;1552;5
/net/per610a/home/mvp/mvp_db/hodost-lv/2018/2018_12_02_04_56/2018_12_02_16_30.mpg;Shinzo ABE.jpg;31113;31277;107949;1556;1565;9
/net/per610a/home/mvp/mvp_db/hodost-lv/2018/2018_12_02_04_56/2018_12_02_16_30.mpg;Shinzo ABE.jpg;74545;74581;107949;3730;3732;2
/net/per610a/home/mvp/mvp_db/hodost-lv/2018/2018_12_02_04_56/2018_12_02_16_30.mpg;Shinzo ABE.jpg;75381;75417;107949;3772;3774;2
/net/per610a/home/mvp/mvp_db/hodost-lv/2018/2018_12_02_04_56/2018_12_02_16_30.mpg;Shinzo ABE.jpg;78613;78653;107949;3933;3935;2
/net/per610a/home/mvp/mvp_db/hodost-lv/2018/2018_12_03_04_56/2018_12_03_21_54.mpg;Shinzo ABE.jpg;45073;45137;97161;2255;2258;3
/net/per610a/home/mvp/mvp_db/hodost-lv/2018/2018_12_03_04_56/2018_12_03_21_54.mpg;Shinzo ABE.jpg;54929;55029;97161;2748;2753;5
/net/per610a/home/mvp/mvp_db/hodost-lv/2018/2018_12_05_04_56/2018_12_05_21_54.mpg;Kohei Otsuka.jpg;297;617;97161;14;30;16
/net/per610a/home/mvp/mvp_db/hodost-lv/2018/2018_12_05_04_56/2018_12_05_21_54.mpg;Kohei Otsuka.jpg;1281;1397;97161;64;69;5
/net/per610a/home/mvp/mvp_db/hodost-lv/2018/2018_12_05_04_56/2018_12_05_21_54.mpg;Kohei Otsuka.jpg;16721;16793;97161;836;840;4
/net/per610a/home/mvp/mvp_db/hodost-lv/2018/2018_12_05_04_56/2018_12_05_21_54.mpg;Kohei Otsuka.jpg;39577;39849;97161;1980;1994;14
/net/per610a/home/mvp/mvp_db/hodost-lv/2018/2018_12_05_04_56/2018_12_05_21_54.mpg;Kohei Otsuka.jpg;58373;58569;97161;2921;2930;9
/net/per610a/home/mvp/mvp_db/hodost-lv/2018/2018_12_05_04_56/2018_12_05_21_54.mpg;Kohei Otsuka.jpg;64577;64769;97161;3231;3241;10
/net/per610a/home/mvp/mvp_db/hodost-lv/2018/2018_12_05_04_56/2018_12_05_21_54.mpg;Shinzo ABE.jpg;18253;18709;97161;913;936;23
/net/per610a/home/mvp/mvp_db/hodost-lv/2018/2018_12_05_04_56/2018_12_05_21_54.mpg;Shinzo ABE.jpg;36497;36601;97161;1826;1831;5
/net/per610a/home/mvp/mvp_db/hodost-lv/2018/2018_12_05_04_56/2018_12_05_21_54.mpg;Yuichiro Tamaki.png;20665;21017;97161;1034;1051;17
/net/per610a/home/mvp/mvp_db/hodost-lv/2018/2018_12_06_04_56/2018_12_06_21_54.mpg;Shinzo ABE.jpg;32321;32321;97161;1617;1617;0
/net/per610a/home/mvp/mvp_db/hodost-lv/2018/2018_12_06_04_56/2018_12_06_21_54.mpg;Shinzo ABE.jpg;35045;35165;97161;1753;1759;6
/net/per610a/home/mvp/mvp_db/hodost-lv/2018/2018_12_06_04_56/2018_12_06_21_54.mpg;Shinzo ABE.jpg;38529;38761;97161;1928;1939;11
/net/per610a/home/mvp/mvp_db/hodost-lv/2018/2018_12_06_04_56/2018_12_06_21_54.mpg;Shinzo ABE.jpg;35433;35629;97161;1773;1782;9
/net/per610a/home/mvp/mvp_db/hodost-lv/2018/2018_12_06_04_56/2018_12_06_21_54.mpg;Shinzo ABE.jpg;39985;40009;97161;2000;2002;2
/net/per610a/home/mvp/mvp_db/hodost-lv/2018/2018_12_07_04_56/2018_12_07_21_54.mpg;Shinzo ABE.jpg;32161;32209;91169;1609;1612;3
/net/per610a/home/mvp/mvp_db/hodost-lv/2018/2018_12_07_04_56/2018_12_07_21_54.mpg;Shinzo ABE.jpg;85645;85945;91169;4286;4301;15
/net/per610a/home/mvp/mvp_db/hodost-lv/2018/2018_12_11_04_56/2018_12_11_21_54.mpg;Shinzo ABE.jpg;22673;22873;97161;1134;1144;10
/net/per610a/home/mvp/mvp_db/hodost-lv/2018/2018_12_11_04_56/2018_12_11_21_54.mpg;Shinzo ABE.jpg;56913;57113;97161;2847;2857;10
/net/per610a/home/mvp/mvp_db/hodost-lv/2018/2018_12_16_04_56/2018_12_16_16_30.mpg;YUriko Koike.jpg;43657;43945;107949;2184;2199;15
/net/per610a/home/mvp/mvp_db/hodost-lv/2018/2018_12_18_04_56/2018_12_18_21_54.mpg;Taro ASO.jpg;27257;27733;97169;1364;1387;23
/net/per610a/home/mvp/mvp_db/hodost-lv/2018/2018_12_18_04_56/2018_12_18_21_54.mpg;Shinzo ABE.jpg;28393;28485;97169;1420;1425;5
/net/per610a/home/mvp/mvp_db/hodost-lv/2018/2018_12_22_04_56/2018_12_22_21_54.mpg;Ichiro OZAWA.jpg;34477;34829;91169;1725;1743;18
/net/per610a/home/mvp/mvp_db/hodost-lv/2018/2018_12_23_04_56/2018_12_23_16_30.mpg;Shinzo ABE.jpg;25753;25757;107949;1288;1288;0
/net/per610a/home/mvp/mvp_db/hodost-lv/2018/2018_12_23_04_56/2018_12_23_16_30.mpg;Shinzo ABE.jpg;103521;103693;107949;5180;5189;9
/net/per610a/home/mvp/mvp_db/hodost-lv/2018/2018_12_23_04_56/2018_12_23_16_30.mpg;Shinzo ABE.jpg;104073;104237;107949;5208;5216;8
/net/per610a/home/mvp/mvp_db/hodost-lv/2018/2018_12_25_04_56/2018_12_25_21_54.mpg;Shinzo ABE.jpg;24061;24189;97169;1204;1210;6
/net/per610a/home/mvp/mvp_db/hodost-lv/2018/2018_12_25_04_56/2018_12_25_21_54.mpg;Shinzo ABE.jpg;24437;24645;97169;1222;1233;11
/net/per610a/home/mvp/mvp_db/hodost-lv/2018/2018_12_26_04_56/2018_12_26_21_54.mpg;Shinzo ABE.jpg;35597;36001;97161;1781;1801;20
/net/per610a/home/mvp/mvp_db/hodost-lv/2018/2018_12_26_04_56/2018_12_26_21_54.mpg;Shinzo ABE.jpg;42797;43265;97161;2141;2165;24
/net/per610a/home/mvp/mvp_db/hodost-lv/2018/2018_12_26_04_56/2018_12_26_21_54.mpg;Shinzo ABE.jpg;45429;45457;97161;2273;2274;1
/net/per610a/home/mvp/mvp_db/hodost-lv/2019/2019_01_06_04_56/2019_01_06_16_30.mpg;Shinzo ABE.jpg;31621;31753;107949;1582;1588;6
/net/per610a/home/mvp/mvp_db/hodost-lv/2019/2019_01_06_04_56/2019_01_06_16_30.mpg;Shinzo ABE.jpg;103909;103969;107949;5199;5202;3
/net/per610a/home/mvp/mvp_db/hodost-lv/2019/2019_01_08_04_56/2019_01_08_21_54.mpg;Shinzo ABE.jpg;28669;28973;97161;1434;1449;15
/net/per610a/home/mvp/mvp_db/hodost-lv/2019/2019_01_08_04_56/2019_01_08_21_54.mpg;Shinzo ABE.jpg;40077;40221;97161;2005;2012;7
/net/per610a/home/mvp/mvp_db/hodost-lv/2019/2019_01_08_04_56/2019_01_08_21_54.mpg;Shinzo ABE.jpg;40329;40949;97161;2018;2049;31
/net/per610a/home/mvp/mvp_db/hodost-lv/2019/2019_01_08_04_56/2019_01_08_21_54.mpg;Shinzo ABE.jpg;55101;55301;97161;2757;2767;10
/net/per610a/home/mvp/mvp_db/hodost-lv/2019/2019_01_08_04_56/2019_01_08_21_54.mpg;Shinzo ABE.jpg;55641;55693;97161;2784;2786;2
/net/per610a/home/mvp/mvp_db/hodost-lv/2019/2019_01_08_04_56/2019_01_08_21_54.mpg;Shinzo ABE.jpg;55809;56033;97161;2792;2803;11
/net/per610a/home/mvp/mvp_db/hodost-lv/2019/2019_01_08_04_56/2019_01_08_21_54.mpg;Toranosuke Katayama.jpg;48565;49157;97161;2430;2459;29
/net/per610a/home/mvp/mvp_db/hodost-lv/2019/2019_01_08_04_56/2019_01_08_21_54.mpg;Yoshihiko Noda.jpg;53433;53645;97161;2673;2684;11
/net/per610a/home/mvp/mvp_db/hodost-lv/2019/2019_01_08_04_56/2019_01_08_21_54.mpg;Yoshihiko Noda.jpg;53933;54065;97161;2698;2705;7
/net/per610a/home/mvp/mvp_db/hodost-lv/2019/2019_01_08_04_56/2019_01_08_21_54.mpg;Yoshihiko Noda.jpg;54721;54793;97161;2738;2741;3
/net/per610a/home/mvp/mvp_db/hodost-lv/2019/2019_01_09_04_56/2019_01_09_21_56.mpg;Kohei Otsuka.jpg;14785;14797;94761;739;740;1
/net/per610a/home/mvp/mvp_db/hodost-lv/2019/2019_01_09_04_56/2019_01_09_21_56.mpg;Kohei Otsuka.jpg;14917;14937;94761;746;747;1
/net/per610a/home/mvp/mvp_db/hodost-lv/2019/2019_01_09_04_56/2019_01_09_21_56.mpg;Kohei Otsuka.jpg;55773;56029;94761;2790;2803;13
/net/per610a/home/mvp/mvp_db/hodost-lv/2019/2019_01_09_04_56/2019_01_09_21_56.mpg;Kohei Otsuka.jpg;56925;57157;94761;2848;2860;12
/net/per610a/home/mvp/mvp_db/hodost-lv/2019/2019_01_09_04_56/2019_01_09_21_56.mpg;Kohei Otsuka.jpg;63609;63789;94761;3183;3192;9
/net/per610a/home/mvp/mvp_db/hodost-lv/2019/2019_01_10_04_56/2019_01_10_21_54.mpg;Shinzo ABE.jpg;15433;15889;97161;772;795;23
/net/per610a/home/mvp/mvp_db/hodost-lv/2019/2019_01_10_04_56/2019_01_10_21_54.mpg;Shinzo ABE.jpg;24177;24301;97161;1209;1216;7
/net/per610a/home/mvp/mvp_db/hodost-lv/2019/2019_01_10_04_56/2019_01_10_21_54.mpg;Toru Hashimoto.jpg;45501;46025;97161;2276;2303;27
/net/per610a/home/mvp/mvp_db/hodost-lv/2019/2019_01_11_04_56/2019_01_11_21_54.mpg;YUriko Koike.jpg;10497;10865;91169;525;543;18
/net/per610a/home/mvp/mvp_db/hodost-lv/2019/2019_01_12_04_56/2019_01_12_21_54.mpg;Shinzo ABE.jpg;52661;52753;91169;2635;2640;5
/net/per610a/home/mvp/mvp_db/hodost-lv/2019/2019_01_15_04_56/2019_01_15_21_54.mpg;Kohei Otsuka.jpg;58001;58117;97161;2902;2908;6
/net/per610a/home/mvp/mvp_db/hodost-lv/2019/2019_01_18_04_56/2019_01_18_21_54.mpg;Shinzo ABE.jpg;12385;12553;91169;619;628;9
/net/per610a/home/mvp/mvp_db/hodost-lv/2019/2019_01_18_04_56/2019_01_18_21_54.mpg;Taro ASO.jpg;12633;12893;91169;632;645;13
/net/per610a/home/mvp/mvp_db/hodost-lv/2019/2019_01_20_04_56/2019_01_20_16_30.mpg;YUriko Koike.jpg;53789;53885;107949;2691;2696;5
/net/per610a/home/mvp/mvp_db/hodost-lv/2019/2019_01_20_04_56/2019_01_20_16_30.mpg;YUriko Koike.jpg;56985;57145;107949;2851;2859;8
/net/per610a/home/mvp/mvp_db/hodost-lv/2019/2019_01_21_04_56/2019_01_21_21_56.mpg;Shinzo ABE.jpg;53277;53545;94761;2666;2679;13
/net/per610a/home/mvp/mvp_db/hodost-lv/2019/2019_01_21_04_56/2019_01_21_21_56.mpg;Shinzo ABE.jpg;53613;53625;94761;2682;2683;1
/net/per610a/home/mvp/mvp_db/hodost-lv/2019/2019_01_22_04_56/2019_01_22_21_54.mpg;Shinzo ABE.jpg;13985;13985;97169;699;699;0
/net/per610a/home/mvp/mvp_db/hodost-lv/2019/2019_01_22_04_56/2019_01_22_21_54.mpg;Shinzo ABE.jpg;14449;14465;97169;723;723;0
/net/per610a/home/mvp/mvp_db/hodost-lv/2019/2019_01_22_04_56/2019_01_22_21_54.mpg;Shinzo ABE.jpg;23753;23797;97169;1188;1190;2
/net/per610a/home/mvp/mvp_db/hodost-lv/2019/2019_01_22_04_56/2019_01_22_21_54.mpg;Shinzo ABE.jpg;24385;24449;97169;1220;1223;3
/net/per610a/home/mvp/mvp_db/hodost-lv/2019/2019_01_22_04_56/2019_01_22_21_54.mpg;Shinzo ABE.jpg;27777;27777;97169;1390;1390;0
/net/per610a/home/mvp/mvp_db/hodost-lv/2019/2019_01_22_04_56/2019_01_22_21_54.mpg;Shinzo ABE.jpg;92009;92057;97169;4604;4607;3
/net/per610a/home/mvp/mvp_db/hodost-lv/2019/2019_01_23_04_56/2019_01_23_21_54.mpg;Shinzo ABE.jpg;17013;17033;97169;851;852;1
/net/per610a/home/mvp/mvp_db/hodost-lv/2019/2019_01_23_04_56/2019_01_23_21_54.mpg;Shinzo ABE.jpg;35773;35793;97169;1790;1791;1
/net/per610a/home/mvp/mvp_db/hodost-lv/2019/2019_01_23_04_56/2019_01_23_21_54.mpg;Shinzo ABE.jpg;39513;39601;97169;1977;1981;4
/net/per610a/home/mvp/mvp_db/hodost-lv/2019/2019_01_23_04_56/2019_01_23_21_54.mpg;Shinzo ABE.jpg;37865;37961;97169;1895;1899;4
/net/per610a/home/mvp/mvp_db/hodost-lv/2019/2019_01_23_04_56/2019_01_23_21_54.mpg;Shinzo ABE.jpg;39857;39929;97169;1994;1998;4
/net/per610a/home/mvp/mvp_db/hodost-lv/2019/2019_01_25_04_56/2019_01_25_21_54.mpg;Ichiro OZAWA.jpg;25489;25505;91169;1275;1276;1
/net/per610a/home/mvp/mvp_db/hodost-lv/2019/2019_01_25_04_56/2019_01_25_21_54.mpg;Ichiro OZAWA.jpg;25609;25693;91169;1281;1285;4
/net/per610a/home/mvp/mvp_db/hodost-lv/2019/2019_01_25_04_56/2019_01_25_21_54.mpg;Ichiro OZAWA.jpg;26961;27029;91169;1349;1352;3
/net/per610a/home/mvp/mvp_db/hodost-lv/2019/2019_01_25_04_56/2019_01_25_21_54.mpg;Ichiro OZAWA.jpg;32585;32705;91169;1630;1636;6
/net/per610a/home/mvp/mvp_db/hodost-lv/2019/2019_01_25_04_56/2019_01_25_21_54.mpg;Yuichiro Tamaki.png;28041;28313;91169;1403;1417;14
/net/per610a/home/mvp/mvp_db/hodost-lv/2019/2019_01_25_04_56/2019_01_25_21_54.mpg;Yuichiro Tamaki.png;28889;28921;91169;1445;1447;2
/net/per610a/home/mvp/mvp_db/hodost-lv/2019/2019_01_25_04_56/2019_01_25_21_54.mpg;Yuichiro Tamaki.png;32769;32769;91169;1640;1640;0
/net/per610a/home/mvp/mvp_db/hodost-lv/2019/2019_01_25_04_56/2019_01_25_21_54.mpg;Yuichiro Tamaki.png;34009;34193;91169;1702;1711;9
/net/per610a/home/mvp/mvp_db/hodost-lv/2019/2019_01_25_04_56/2019_01_25_21_54.mpg;Yuichiro Tamaki.png;35721;35885;91169;1787;1796;9
/net/per610a/home/mvp/mvp_db/hodost-lv/2019/2019_01_25_04_56/2019_01_25_21_54.mpg;Yuichiro Tamaki.png;36313;36409;91169;1817;1822;5
/net/per610a/home/mvp/mvp_db/hodost-lv/2019/2019_01_25_04_56/2019_01_25_21_54.mpg;Yuichiro Tamaki.png;42085;42257;91169;2106;2114;8
/net/per610a/home/mvp/mvp_db/hodost-lv/2019/2019_01_25_04_56/2019_01_25_21_54.mpg;Yukio EDANO.jpg;38601;38797;91169;1931;1941;10
/net/per610a/home/mvp/mvp_db/hodost-lv/2019/2019_01_25_04_56/2019_01_25_21_54.mpg;Yukio EDANO.jpg;39809;39989;91169;1992;2001;9
/net/per610a/home/mvp/mvp_db/hodost-lv/2019/2019_01_25_04_56/2019_01_25_21_54.mpg;Yukio EDANO.jpg;40989;41001;91169;2051;2052;1
/net/per610a/home/mvp/mvp_db/hodost-lv/2019/2019_01_25_04_56/2019_01_25_21_54.mpg;Yukio EDANO.jpg;41509;41653;91169;2077;2084;7
/net/per610a/home/mvp/mvp_db/hodost-lv/2019/2019_01_25_04_56/2019_01_25_21_54.mpg;Yukio EDANO.jpg;42233;42365;91169;2113;2120;7
/net/per610a/home/mvp/mvp_db/hodost-lv/2019/2019_01_25_04_56/2019_01_25_21_54.mpg;Shinzo ABE.jpg;40169;40317;91169;2010;2017;7
/net/per610a/home/mvp/mvp_db/hodost-lv/2019/2019_01_27_04_56/2019_01_27_16_30.mpg;Shinzo ABE.jpg;24493;24513;107949;1225;1226;1
/net/per610a/home/mvp/mvp_db/hodost-lv/2019/2019_01_27_04_56/2019_01_27_16_30.mpg;Shinzo ABE.jpg;27941;28057;107949;1398;1404;6
/net/per610a/home/mvp/mvp_db/hodost-lv/2019/2019_01_27_04_56/2019_01_27_16_30.mpg;Shinzo ABE.jpg;31841;31877;107949;1593;1595;2
/net/per610a/home/mvp/mvp_db/hodost-lv/2019/2019_01_27_04_56/2019_01_27_16_30.mpg;Shinzo ABE.jpg;32065;32073;107949;1604;1605;1
/net/per610a/home/mvp/mvp_db/hodost-lv/2019/2019_01_27_04_56/2019_01_27_16_30.mpg;Shinzo ABE.jpg;104153;104217;107949;5212;5215;3
/net/per610a/home/mvp/mvp_db/hodost-lv/2019/2019_01_28_04_56/2019_01_28_21_54.mpg;Yukio EDANO.jpg;26165;26565;73181;1309;1329;20
/net/per610a/home/mvp/mvp_db/hodost-lv/2019/2019_01_28_04_56/2019_01_28_21_54.mpg;Yukio EDANO.jpg;26669;26725;73181;1334;1337;3
/net/per610a/home/mvp/mvp_db/hodost-lv/2019/2019_01_28_04_56/2019_01_28_21_54.mpg;Yuichiro Tamaki.png;26733;26833;73181;1337;1342;5
/net/per610a/home/mvp/mvp_db/hodost-lv/2019/2019_01_29_04_56/2019_01_29_21_54.mpg;Seiji MAEHARA.jpg;73185;73273;97169;3662;3667;5
/net/per610a/home/mvp/mvp_db/hodost-lv/2019/2019_01_29_04_56/2019_01_29_21_54.mpg;Seiji MAEHARA.jpg;73769;74449;97169;3691;3725;34
/net/per610a/home/mvp/mvp_db/hodost-lv/2019/2019_01_29_04_56/2019_01_29_21_54.mpg;Seiji MAEHARA.jpg;75745;75805;97169;3790;3793;3
/net/per610a/home/mvp/mvp_db/hodost-lv/2019/2019_01_29_04_56/2019_01_29_21_54.mpg;Seiji MAEHARA.jpg;77213;77473;97169;3864;3877;13
/net/per610a/home/mvp/mvp_db/hodost-lv/2019/2019_01_31_04_56/2019_01_31_21_54.mpg;Shinzo ABE.jpg;33357;33457;97161;1669;1674;5
/net/per610a/home/mvp/mvp_db/hodost-lv/2019/2019_02_02_04_56/2019_02_02_20_54.mpg;Shinzo ABE.jpg;66733;66745;91169;3339;3340;1
/net/per610a/home/mvp/mvp_db/hodost-lv/2019/2019_02_02_04_56/2019_02_02_20_54.mpg;Shinzo ABE.jpg;72885;73137;91169;3647;3660;13
/net/per610a/home/mvp/mvp_db/hodost-lv/2019/2019_02_04_04_56/2019_02_04_21_54.mpg;Shinzo ABE.jpg;32157;32233;97161;1609;1612;3
/net/per610a/home/mvp/mvp_db/hodost-lv/2019/2019_02_04_04_56/2019_02_04_21_54.mpg;Shinzo ABE.jpg;39097;39285;97161;1956;1965;9
/net/per610a/home/mvp/mvp_db/hodost-lv/2019/2019_02_04_04_56/2019_02_04_21_54.mpg;Taro ASO.jpg;52897;53077;97161;2647;2656;9
/net/per610a/home/mvp/mvp_db/hodost-lv/2019/2019_02_05_04_56/2019_02_05_21_54.mpg;Shinzo ABE.jpg;16661;16729;97161;833;837;4
/net/per610a/home/mvp/mvp_db/hodost-lv/2019/2019_02_05_04_56/2019_02_05_21_54.mpg;Shinzo ABE.jpg;21149;21253;97161;1058;1063;5
/net/per610a/home/mvp/mvp_db/hodost-lv/2019/2019_02_05_04_56/2019_02_05_21_54.mpg;Shinzo ABE.jpg;21341;21429;97161;1067;1072;5
/net/per610a/home/mvp/mvp_db/hodost-lv/2019/2019_02_05_04_56/2019_02_05_21_54.mpg;Shinzo ABE.jpg;23645;23785;97161;1183;1190;7
/net/per610a/home/mvp/mvp_db/hodost-lv/2019/2019_02_05_04_56/2019_02_05_21_54.mpg;Shinzo ABE.jpg;24749;24861;97161;1238;1244;6
/net/per610a/home/mvp/mvp_db/hodost-lv/2019/2019_02_05_04_56/2019_02_05_21_54.mpg;Shinzo ABE.jpg;24937;25149;97161;1247;1258;11
/net/per610a/home/mvp/mvp_db/hodost-lv/2019/2019_02_05_04_56/2019_02_05_21_54.mpg;Shinzo ABE.jpg;25245;25493;97161;1263;1275;12
/net/per610a/home/mvp/mvp_db/hodost-lv/2019/2019_02_05_04_56/2019_02_05_21_54.mpg;Shinzo ABE.jpg;29717;29749;97161;1487;1488;1
/net/per610a/home/mvp/mvp_db/hodost-lv/2019/2019_02_05_04_56/2019_02_05_21_54.mpg;Taro ASO.jpg;26861;27117;97161;1344;1356;12
/net/per610a/home/mvp/mvp_db/hodost-lv/2019/2019_02_07_04_56/2019_02_07_21_54.mpg;Shinzo ABE.jpg;19473;19521;97161;974;976;2
/net/per610a/home/mvp/mvp_db/hodost-lv/2019/2019_02_07_04_56/2019_02_07_21_54.mpg;Shinzo ABE.jpg;19593;19709;97161;980;986;6
/net/per610a/home/mvp/mvp_db/hodost-lv/2019/2019_02_07_04_56/2019_02_07_21_54.mpg;Shinzo ABE.jpg;49617;49625;97161;2482;2483;1
/net/per610a/home/mvp/mvp_db/hodost-lv/2019/2019_02_07_04_56/2019_02_07_21_54.mpg;Shinzo ABE.jpg;45741;45833;97161;2288;2293;5
/net/per610a/home/mvp/mvp_db/hodost-lv/2019/2019_02_08_04_56/2019_02_08_21_54.mpg;Shinzo ABE.jpg;50093;50153;91169;2507;2510;3
/net/per610a/home/mvp/mvp_db/hodost-lv/2019/2019_02_08_04_56/2019_02_08_21_54.mpg;Shinzo ABE.jpg;50237;50321;91169;2514;2518;4
/net/per610a/home/mvp/mvp_db/hodost-lv/2019/2019_02_09_04_56/2019_02_09_20_54.mpg;Shinzo ABE.jpg;73537;73601;91169;3680;3683;3
/net/per610a/home/mvp/mvp_db/hodost-lv/2019/2019_02_09_04_56/2019_02_09_20_54.mpg;Shinzo ABE.jpg;73689;73797;91169;3688;3693;5
/net/per610a/home/mvp/mvp_db/hodost-lv/2019/2019_02_10_04_56/2019_02_10_16_30.mpg;Shinzo ABE.jpg;77997;78481;107949;3903;3927;24
/net/per610a/home/mvp/mvp_db/hodost-lv/2019/2019_02_10_04_56/2019_02_10_16_30.mpg;Shinzo ABE.jpg;78653;78821;107949;3935;3944;9
/net/per610a/home/mvp/mvp_db/hodost-lv/2019/2019_02_10_04_56/2019_02_10_16_30.mpg;Shinzo ABE.jpg;79017;79165;107949;3954;3961;7
/net/per610a/home/mvp/mvp_db/hodost-lv/2019/2019_02_14_04_56/2019_02_14_21_54.mpg;Kohei Otsuka.jpg;19377;19389;97161;969;970;1
/net/per610a/home/mvp/mvp_db/hodost-lv/2019/2019_02_14_04_56/2019_02_14_21_54.mpg;Kohei Otsuka.jpg;49429;49481;97161;2473;2476;3
/net/per610a/home/mvp/mvp_db/hodost-lv/2019/2019_02_14_04_56/2019_02_14_21_54.mpg;Kohei Otsuka.jpg;60173;60345;97161;3011;3019;8
/net/per610a/home/mvp/mvp_db/hodost-lv/2019/2019_02_14_04_56/2019_02_14_21_54.mpg;Kohei Otsuka.jpg;65805;65937;97161;3292;3299;7
/net/per610a/home/mvp/mvp_db/hodost-lv/2019/2019_02_16_04_56/2019_02_16_20_54.mpg;Shinzo ABE.jpg;1621;1829;91169;81;91;10
/net/per610a/home/mvp/mvp_db/hodost-lv/2019/2019_02_16_04_56/2019_02_16_20_54.mpg;Shinzo ABE.jpg;3221;3397;91169;161;170;9
/net/per610a/home/mvp/mvp_db/hodost-lv/2019/2019_02_16_04_56/2019_02_16_20_54.mpg;Shinzo ABE.jpg;86361;86761;91169;4322;4342;20
/net/per610a/home/mvp/mvp_db/hodost-lv/2019/2019_02_17_04_56/2019_02_17_16_30.mpg;Shinzo ABE.jpg;50141;50201;107949;2509;2512;3
/net/per610a/home/mvp/mvp_db/hodost-lv/2019/2019_02_17_04_56/2019_02_17_16_30.mpg;Shinzo ABE.jpg;50269;50337;107949;2515;2518;3
/net/per610a/home/mvp/mvp_db/hodost-lv/2019/2019_02_17_04_56/2019_02_17_16_30.mpg;Shinzo ABE.jpg;103533;103653;107949;5181;5187;6
/net/per610a/home/mvp/mvp_db/hodost-lv/2019/2019_02_18_04_56/2019_02_18_21_54.mpg;Shinzo ABE.jpg;1653;1709;97161;82;85;3
/net/per610a/home/mvp/mvp_db/hodost-lv/2019/2019_02_18_04_56/2019_02_18_21_54.mpg;Shinzo ABE.jpg;7901;7901;97161;395;395;0
/net/per610a/home/mvp/mvp_db/hodost-lv/2019/2019_02_18_04_56/2019_02_18_21_54.mpg;Shinzo ABE.jpg;11345;11473;97161;567;574;7
/net/per610a/home/mvp/mvp_db/hodost-lv/2019/2019_02_18_04_56/2019_02_18_21_54.mpg;Shinzo ABE.jpg;16065;16305;97161;803;815;12
/net/per610a/home/mvp/mvp_db/hodost-lv/2019/2019_02_18_04_56/2019_02_18_21_54.mpg;Shinzo ABE.jpg;17517;17581;97161;876;879;3
/net/per610a/home/mvp/mvp_db/hodost-lv/2019/2019_02_18_04_56/2019_02_18_21_54.mpg;Shinzo ABE.jpg;17733;17765;97161;887;888;1
/net/per610a/home/mvp/mvp_db/hodost-lv/2019/2019_02_18_04_56/2019_02_18_21_54.mpg;Kohei Otsuka.jpg;57565;57761;97161;2880;2890;10
/net/per610a/home/mvp/mvp_db/hodost-lv/2019/2019_02_18_04_56/2019_02_18_21_54.mpg;Kohei Otsuka.jpg;64009;64181;97161;3203;3211;8
/net/per610a/home/mvp/mvp_db/hodost-lv/2019/2019_02_19_04_56/2019_02_19_21_54.mpg;Shinzo ABE.jpg;28569;28617;97161;1429;1432;3
/net/per610a/home/mvp/mvp_db/hodost-lv/2019/2019_02_19_04_56/2019_02_19_21_54.mpg;Shinzo ABE.jpg;31225;31373;97161;1562;1569;7
/net/per610a/home/mvp/mvp_db/hodost-lv/2019/2019_02_19_04_56/2019_02_19_21_54.mpg;Shinzo ABE.jpg;34177;34261;97161;1710;1714;4
/net/per610a/home/mvp/mvp_db/hodost-lv/2019/2019_02_20_04_56/2019_02_20_21_54.mpg;Shinzo ABE.jpg;18809;18909;97169;941;946;5
/net/per610a/home/mvp/mvp_db/hodost-lv/2019/2019_02_20_04_56/2019_02_20_21_54.mpg;Shinzo ABE.jpg;91549;91997;97169;4581;4604;23
/net/per610a/home/mvp/mvp_db/hodost-lv/2019/2019_02_23_04_56/2019_02_23_20_54.mpg;Shinzo ABE.jpg;36505;36625;91161;1826;1832;6
/net/per610a/home/mvp/mvp_db/hodost-lv/2019/2019_02_24_04_56/2019_02_24_16_30.mpg;Ichiro OZAWA.jpg;74329;74397;107949;3719;3722;3
/net/per610a/home/mvp/mvp_db/hodost-lv/2019/2019_02_24_04_56/2019_02_24_16_30.mpg;Ichiro OZAWA.jpg;74597;74729;107949;3732;3739;7
/net/per610a/home/mvp/mvp_db/hodost-lv/2019/2019_02_24_04_56/2019_02_24_16_30.mpg;Shinzo ABE.jpg;103793;103849;107949;5194;5196;2
/net/per610a/home/mvp/mvp_db/hodost-lv/2019/2019_02_24_04_56/2019_02_24_16_30.mpg;Shinzo ABE.jpg;104101;104177;107949;5209;5213;4
/net/per610a/home/mvp/mvp_db/hodost-lv/2019/2019_02_25_04_56/2019_02_25_21_54.mpg;Shinzo ABE.jpg;19117;19765;97161;956;989;33
/net/per610a/home/mvp/mvp_db/hodost-lv/2019/2019_02_25_04_56/2019_02_25_21_54.mpg;Shinzo ABE.jpg;28789;28909;97161;1440;1446;6
/net/per610a/home/mvp/mvp_db/hodost-lv/2019/2019_02_26_04_56/2019_02_26_21_54.mpg;Toru Hashimoto.jpg;44689;44753;97169;2236;2239;3
/net/per610a/home/mvp/mvp_db/hodost-lv/2019/2019_02_26_04_56/2019_02_26_21_54.mpg;Toru Hashimoto.jpg;44905;44917;97169;2247;2247;0
/net/per610a/home/mvp/mvp_db/hodost-lv/2019/2019_02_26_04_56/2019_02_26_21_54.mpg;Toru Hashimoto.jpg;45153;45349;97169;2259;2269;10
/net/per610a/home/mvp/mvp_db/hodost-lv/2019/2019_03_02_04_56/2019_03_02_20_54.mpg;Shinzo ABE.jpg;19713;19985;91161;986;1000;14
/net/per610a/home/mvp/mvp_db/hodost-lv/2019/2019_03_02_04_56/2019_03_02_20_54.mpg;Shinzo ABE.jpg;24461;24709;91161;1224;1236;12
/net/per610a/home/mvp/mvp_db/hodost-lv/2019/2019_03_03_04_56/2019_03_03_16_30.mpg;Shinzo ABE.jpg;102437;102565;107949;5126;5132;6
/net/per610a/home/mvp/mvp_db/hodost-lv/2019/2019_03_04_04_56/2019_03_04_21_54.mpg;YUriko Koike.jpg;13997;14345;97161;700;717;17
/net/per610a/home/mvp/mvp_db/hodost-lv/2019/2019_03_04_04_56/2019_03_04_21_54.mpg;YUriko Koike.jpg;15813;15829;97161;791;792;1
/net/per610a/home/mvp/mvp_db/hodost-lv/2019/2019_03_04_04_56/2019_03_04_21_54.mpg;YUriko Koike.jpg;15157;15365;97161;758;768;10
/net/per610a/home/mvp/mvp_db/hodost-lv/2019/2019_03_04_04_56/2019_03_04_21_54.mpg;YUriko Koike.jpg;23293;23313;97161;1165;1166;1
/net/per610a/home/mvp/mvp_db/hodost-lv/2019/2019_03_04_04_56/2019_03_04_21_54.mpg;YUriko Koike.jpg;23433;23973;97161;1172;1199;27
/net/per610a/home/mvp/mvp_db/hodost-lv/2019/2019_03_04_04_56/2019_03_04_21_54.mpg;YUriko Koike.jpg;24377;24497;97161;1219;1225;6
/net/per610a/home/mvp/mvp_db/hodost-lv/2019/2019_03_04_04_56/2019_03_04_21_54.mpg;YUriko Koike.jpg;24621;24621;97161;1232;1232;0
/net/per610a/home/mvp/mvp_db/hodost-lv/2019/2019_03_04_04_56/2019_03_04_21_54.mpg;YUriko Koike.jpg;25069;25125;97161;1254;1257;3
/net/per610a/home/mvp/mvp_db/hodost-lv/2019/2019_03_04_04_56/2019_03_04_21_54.mpg;YUriko Koike.jpg;25425;25577;97161;1272;1279;7
/net/per610a/home/mvp/mvp_db/hodost-lv/2019/2019_03_04_04_56/2019_03_04_21_54.mpg;YUriko Koike.jpg;26101;26613;97161;1306;1331;25
/net/per610a/home/mvp/mvp_db/hodost-lv/2019/2019_03_04_04_56/2019_03_04_21_54.mpg;YUriko Koike.jpg;26685;26765;97161;1335;1339;4
/net/per610a/home/mvp/mvp_db/hodost-lv/2019/2019_03_04_04_56/2019_03_04_21_54.mpg;Kohei Otsuka.jpg;25033;25037;97161;1252;1252;0
/net/per610a/home/mvp/mvp_db/hodost-lv/2019/2019_03_04_04_56/2019_03_04_21_54.mpg;Kohei Otsuka.jpg;26717;26717;97161;1336;1336;0
/net/per610a/home/mvp/mvp_db/hodost-lv/2019/2019_03_04_04_56/2019_03_04_21_54.mpg;Kohei Otsuka.jpg;26949;26989;97161;1348;1350;2
/net/per610a/home/mvp/mvp_db/hodost-lv/2019/2019_03_04_04_56/2019_03_04_21_54.mpg;Kohei Otsuka.jpg;55793;55821;97161;2791;2793;2
/net/per610a/home/mvp/mvp_db/hodost-lv/2019/2019_03_04_04_56/2019_03_04_21_54.mpg;Kohei Otsuka.jpg;55921;56049;97161;2798;2804;6
/net/per610a/home/mvp/mvp_db/hodost-lv/2019/2019_03_04_04_56/2019_03_04_21_54.mpg;Ichiro OZAWA.jpg;30213;30769;97161;1511;1539;28
/net/per610a/home/mvp/mvp_db/hodost-lv/2019/2019_03_05_04_56/2019_03_05_21_54.mpg;Shinzo ABE.jpg;36441;36605;97169;1823;1831;8
/net/per610a/home/mvp/mvp_db/hodost-lv/2019/2019_03_06_04_56/2019_03_06_21_54.mpg;Taro ASO.jpg;39861;40073;97161;1994;2005;11
/net/per610a/home/mvp/mvp_db/hodost-lv/2019/2019_03_07_04_56/2019_03_07_21_54.mpg;Shinzo ABE.jpg;9833;10101;97161;492;505;13
/net/per610a/home/mvp/mvp_db/hodost-lv/2019/2019_03_07_04_56/2019_03_07_21_54.mpg;Shinzo ABE.jpg;12285;12377;97161;614;619;5
/net/per610a/home/mvp/mvp_db/hodost-lv/2019/2019_03_07_04_56/2019_03_07_21_54.mpg;Shinzo ABE.jpg;12465;12609;97161;623;630;7
/net/per610a/home/mvp/mvp_db/hodost-lv/2019/2019_03_07_04_56/2019_03_07_21_54.mpg;Shinzo ABE.jpg;60373;60517;97161;3021;3028;7
/net/per610a/home/mvp/mvp_db/hodost-lv/2019/2019_03_07_04_56/2019_03_07_21_54.mpg;Ichiro OZAWA.jpg;19405;19641;97161;971;982;11
/net/per610a/home/mvp/mvp_db/hodost-lv/2019/2019_03_08_04_56/2019_03_08_21_54.mpg;Shinzo ABE.jpg;41749;41865;91161;2089;2095;6
/net/per610a/home/mvp/mvp_db/hodost-lv/2019/2019_03_11_04_56/2019_03_11_21_54.mpg;Yoshihiko Noda.jpg;36213;36317;97161;1812;1817;5
/net/per610a/home/mvp/mvp_db/hodost-lv/2019/2019_03_12_04_56/2019_03_12_21_54.mpg;Shinzo ABE.jpg;47641;47737;97161;2383;2388;5
/net/per610a/home/mvp/mvp_db/hodost-lv/2019/2019_03_12_04_56/2019_03_12_21_54.mpg;Ichiro OZAWA.jpg;48133;48137;97161;2408;2408;0
/net/per610a/home/mvp/mvp_db/hodost-lv/2019/2019_03_12_04_56/2019_03_12_21_54.mpg;Ichiro OZAWA.jpg;48477;48873;97161;2425;2445;20
/net/per610a/home/mvp/mvp_db/hodost-lv/2019/2019_03_14_04_56/2019_03_14_22_09.mpg;Shinzo ABE.jpg;29265;29349;97161;1464;1468;4
/net/per610a/home/mvp/mvp_db/hodost-lv/2019/2019_03_14_04_56/2019_03_14_22_09.mpg;Shinzo ABE.jpg;34729;34737;97161;1737;1738;1
/net/per610a/home/mvp/mvp_db/hodost-lv/2019/2019_03_14_04_56/2019_03_14_22_09.mpg;YUriko Koike.jpg;87301;87333;97161;4368;4370;2
/net/per610a/home/mvp/mvp_db/hodost-lv/2019/2019_03_14_04_56/2019_03_14_22_09.mpg;YUriko Koike.jpg;87417;87513;97161;4374;4379;5
/net/per610a/home/mvp/mvp_db/hodost-lv/2019/2019_03_14_04_56/2019_03_14_22_09.mpg;YUriko Koike.jpg;87693;87697;97161;4388;4388;0
/net/per610a/home/mvp/mvp_db/hodost-lv/2019/2019_03_16_04_56/2019_03_16_20_54.mpg;YUriko Koike.jpg;67685;67821;91169;3387;3394;7
/net/per610a/home/mvp/mvp_db/hodost-lv/2019/2019_03_17_04_56/2019_03_17_16_30.mpg;Shinzo ABE.jpg;102289;102353;107949;5118;5121;3
/net/per610a/home/mvp/mvp_db/hodost-lv/2019/2019_03_17_04_56/2019_03_17_16_30.mpg;Shinzo ABE.jpg;103713;103793;107949;5190;5194;4
/net/per610a/home/mvp/mvp_db/hodost-lv/2019/2019_03_17_04_56/2019_03_17_16_30.mpg;Shinzo ABE.jpg;104081;104241;107949;5208;5216;8
/net/per610a/home/mvp/mvp_db/hodost-lv/2019/2019_03_19_04_56/2019_03_19_21_54.mpg;Shinzo ABE.jpg;37881;38213;97161;1895;1912;17
/net/per610a/home/mvp/mvp_db/hodost-lv/2019/2019_03_20_04_56/2019_03_20_22_09.mpg;Shinzo ABE.jpg;27757;27837;97161;1388;1392;4
/net/per610a/home/mvp/mvp_db/hodost-lv/2019/2019_03_20_04_56/2019_03_20_22_09.mpg;Shinzo ABE.jpg;28797;28993;97161;1441;1450;9
/net/per610a/home/mvp/mvp_db/hodost-lv/2019/2019_03_20_04_56/2019_03_20_22_09.mpg;Shinzo ABE.jpg;87445;87509;97161;4375;4379;4
/net/per610a/home/mvp/mvp_db/hodost-lv/2019/2019_03_21_04_56/2019_03_21_21_54.mpg;Kazuo SHII.jpg;46793;47257;97161;2341;2364;23
/net/per610a/home/mvp/mvp_db/hodost-lv/2019/2019_03_24_04_56/2019_03_24_16_30.mpg;Shinzo ABE.jpg;104097;104165;107949;5209;5212;3
/net/per610a/home/mvp/mvp_db/hodost-lv/2019/2019_03_24_04_56/2019_03_24_16_30.mpg;Shinzo ABE.jpg;104229;104229;107949;5215;5215;0
/net/per610a/home/mvp/mvp_db/hodost-lv/2019/2019_03_24_04_56/2019_03_24_16_30.mpg;Shinzo ABE.jpg;104409;104473;107949;5224;5228;4
/net/per610a/home/mvp/mvp_db/hodost-lv/2019/2019_03_25_04_56/2019_03_25_21_54.mpg;Shinzo ABE.jpg;14765;14797;97161;738;740;2
/net/per610a/home/mvp/mvp_db/hodost-lv/2019/2019_03_25_04_56/2019_03_25_21_54.mpg;Shinzo ABE.jpg;15053;15089;97161;753;755;2
/net/per610a/home/mvp/mvp_db/hodost-lv/2019/2019_03_25_04_56/2019_03_25_21_54.mpg;Shinzo ABE.jpg;31505;31597;97161;1576;1581;5
/net/per610a/home/mvp/mvp_db/hodost-lv/2019/2019_03_26_04_56/2019_03_26_21_54.mpg;Shinzo ABE.jpg;39769;39905;97161;1990;1996;6
/net/per610a/home/mvp/mvp_db/hodost-lv/2019/2019_03_27_04_56/2019_03_27_21_54.mpg;Kohei Otsuka.jpg;9113;9589;97169;456;479;23
/net/per610a/home/mvp/mvp_db/hodost-lv/2019/2019_03_27_04_56/2019_03_27_21_54.mpg;Kohei Otsuka.jpg;16337;16397;97169;817;820;3
/net/per610a/home/mvp/mvp_db/hodost-lv/2019/2019_03_27_04_56/2019_03_27_21_54.mpg;Kohei Otsuka.jpg;64209;64361;97169;3213;3221;8
/net/per610a/home/mvp/mvp_db/hodost-lv/2019/2019_03_27_04_56/2019_03_27_21_54.mpg;Kohei Otsuka.jpg;70925;71109;97169;3549;3558;9
/net/per610a/home/mvp/mvp_db/hodost-lv/2019/2019_03_27_04_56/2019_03_27_21_54.mpg;Shinzo ABE.jpg;27373;27705;97169;1369;1386;17
/net/per610a/home/mvp/mvp_db/hodost-lv/2019/2019_03_27_04_56/2019_03_27_21_54.mpg;Shinzo ABE.jpg;32725;32901;97169;1637;1646;9
/net/per610a/home/mvp/mvp_db/hodost-lv/2019/2019_03_27_04_56/2019_03_27_21_54.mpg;Shinzo ABE.jpg;37165;37269;97169;1859;1865;6
/net/per610a/home/mvp/mvp_db/hodost-lv/2019/2019_03_27_04_56/2019_03_27_21_54.mpg;Shinzo ABE.jpg;37737;37817;97169;1888;1892;4
/net/per610a/home/mvp/mvp_db/hodost-lv/2019/2019_03_27_04_56/2019_03_27_21_54.mpg;Shinzo ABE.jpg;43833;43857;97169;2193;2194;1
/net/per610a/home/mvp/mvp_db/hodost-lv/2019/2019_03_27_04_56/2019_03_27_21_54.mpg;Shinzo ABE.jpg;50545;50609;97169;2529;2532;3
/net/per610a/home/mvp/mvp_db/hodost-lv/2019/2019_03_27_04_56/2019_03_27_21_54.mpg;Shinzo ABE.jpg;50709;50713;97169;2537;2538;1
/net/per610a/home/mvp/mvp_db/hodost-lv/2019/2019_03_27_04_56/2019_03_27_21_54.mpg;Taro ASO.jpg;50545;50609;97169;2529;2532;3
/net/per610a/home/mvp/mvp_db/hodost-lv/2019/2019_03_27_04_56/2019_03_27_21_54.mpg;Taro ASO.jpg;50821;50853;97169;2543;2545;2
/net/per610a/home/mvp/mvp_db/hodost-lv/2019/2019_03_31_04_56/2019_03_31_16_30.mpg;Shinzo ABE.jpg;49125;49577;107949;2458;2480;22
/net/per610a/home/mvp/mvp_db/hodost-lv/2019/2019_03_31_04_56/2019_03_31_16_30.mpg;Shinzo ABE.jpg;104325;104329;107949;5220;5220;0
/net/per610a/home/mvp/mvp_db/hodost-lv/2019/2019_04_01_04_56/2019_04_01_21_54.mpg;Shinzo ABE.jpg;6193;6321;97161;309;316;7
/net/per610a/home/mvp/mvp_db/hodost-lv/2019/2019_04_01_04_56/2019_04_01_21_54.mpg;Shinzo ABE.jpg;8025;8137;97161;401;407;6
/net/per610a/home/mvp/mvp_db/hodost-lv/2019/2019_04_01_04_56/2019_04_01_21_54.mpg;Shinzo ABE.jpg;25669;26681;97161;1284;1335;51
/net/per610a/home/mvp/mvp_db/hodost-lv/2019/2019_04_01_04_56/2019_04_01_21_54.mpg;Shinzo ABE.jpg;27913;28497;97161;1396;1426;30
/net/per610a/home/mvp/mvp_db/hodost-lv/2019/2019_04_01_04_56/2019_04_01_21_54.mpg;Shinzo ABE.jpg;41349;41601;97161;2069;2081;12
/net/per610a/home/mvp/mvp_db/hodost-lv/2019/2019_04_01_04_56/2019_04_01_21_54.mpg;Shinzo ABE.jpg;41749;41845;97161;2089;2093;4
/net/per610a/home/mvp/mvp_db/hodost-lv/2019/2019_04_01_04_56/2019_04_01_21_54.mpg;Kohei Otsuka.jpg;43849;43957;97161;2194;2199;5
/net/per610a/home/mvp/mvp_db/hodost-lv/2019/2019_04_01_04_56/2019_04_01_21_54.mpg;Kohei Otsuka.jpg;65005;65181;97161;3252;3261;9
/net/per610a/home/mvp/mvp_db/hodost-lv/2019/2019_04_01_04_56/2019_04_01_21_54.mpg;Kohei Otsuka.jpg;71221;71273;97161;3563;3566;3
/net/per610a/home/mvp/mvp_db/hodost-lv/2019/2019_04_02_04_56/2019_04_02_21_54.mpg;Shinzo ABE.jpg;39369;39481;97169;1970;1975;5
/net/per610a/home/mvp/mvp_db/hodost-lv/2019/2019_04_02_04_56/2019_04_02_21_54.mpg;Shinzo ABE.jpg;41117;41161;97169;2057;2059;2
/net/per610a/home/mvp/mvp_db/hodost-lv/2019/2019_04_03_04_56/2019_04_03_21_54.mpg;Kohei Otsuka.jpg;16161;16161;97169;808;808;0
/net/per610a/home/mvp/mvp_db/hodost-lv/2019/2019_04_03_04_56/2019_04_03_21_54.mpg;Kohei Otsuka.jpg;25965;26413;97169;1299;1321;22
/net/per610a/home/mvp/mvp_db/hodost-lv/2019/2019_04_03_04_56/2019_04_03_21_54.mpg;Kohei Otsuka.jpg;38061;38161;97169;1904;1909;5
/net/per610a/home/mvp/mvp_db/hodost-lv/2019/2019_04_03_04_56/2019_04_03_21_54.mpg;Kohei Otsuka.jpg;38257;38309;97169;1914;1917;3
/net/per610a/home/mvp/mvp_db/hodost-lv/2019/2019_04_03_04_56/2019_04_03_21_54.mpg;Kohei Otsuka.jpg;38693;38809;97169;1936;1942;6
/net/per610a/home/mvp/mvp_db/hodost-lv/2019/2019_04_03_04_56/2019_04_03_21_54.mpg;Kohei Otsuka.jpg;58481;58669;97169;2926;2936;10
/net/per610a/home/mvp/mvp_db/hodost-lv/2019/2019_04_03_04_56/2019_04_03_21_54.mpg;Kohei Otsuka.jpg;64805;64957;97169;3243;3250;7
/net/per610a/home/mvp/mvp_db/hodost-lv/2019/2019_04_05_04_56/2019_04_05_21_54.mpg;Shinzo ABE.jpg;6917;6945;91169;346;347;1
/net/per610a/home/mvp/mvp_db/hodost-lv/2019/2019_04_05_04_56/2019_04_05_21_54.mpg;Shinzo ABE.jpg;7069;7161;91169;353;358;5
/net/per610a/home/mvp/mvp_db/hodost-lv/2019/2019_04_05_04_56/2019_04_05_21_54.mpg;Shinzo ABE.jpg;8825;9589;91169;441;479;38
/net/per610a/home/mvp/mvp_db/hodost-lv/2019/2019_04_06_04_56/2019_04_06_21_54.mpg;Junichiro KOIZUMI.jpg;34433;34721;91169;1723;1737;14
/net/per610a/home/mvp/mvp_db/hodost-lv/2019/2019_04_08_04_56/2019_04_08_21_54.mpg;Taro ASO.jpg;10709;11125;97161;535;556;21
/net/per610a/home/mvp/mvp_db/hodost-lv/2019/2019_04_08_04_56/2019_04_08_21_54.mpg;Taro ASO.jpg;15797;16041;97161;790;802;12
/net/per610a/home/mvp/mvp_db/hodost-lv/2019/2019_04_08_04_56/2019_04_08_21_54.mpg;Taro ASO.jpg;16657;16949;97161;833;848;15
/net/per610a/home/mvp/mvp_db/hodost-lv/2019/2019_04_08_04_56/2019_04_08_21_54.mpg;Shinzo ABE.jpg;14333;14381;97161;717;719;2
/net/per610a/home/mvp/mvp_db/hodost-lv/2019/2019_04_08_04_56/2019_04_08_21_54.mpg;Shinzo ABE.jpg;22309;22405;97161;1116;1121;5
/net/per610a/home/mvp/mvp_db/hodost-lv/2019/2019_04_08_04_56/2019_04_08_21_54.mpg;Shinzo ABE.jpg;27489;28029;97161;1375;1402;27
/net/per610a/home/mvp/mvp_db/hodost-lv/2019/2019_04_08_04_56/2019_04_08_21_54.mpg;Shinzo ABE.jpg;28145;28477;97161;1408;1425;17
/net/per610a/home/mvp/mvp_db/hodost-lv/2019/2019_04_08_04_56/2019_04_08_21_54.mpg;Shinzo ABE.jpg;28657;28845;97161;1434;1443;9
/net/per610a/home/mvp/mvp_db/hodost-lv/2019/2019_04_08_04_56/2019_04_08_21_54.mpg;Shinzo ABE.jpg;29285;29549;97161;1465;1478;13
/net/per610a/home/mvp/mvp_db/hodost-lv/2019/2019_04_09_04_56/2019_04_09_21_54.mpg;Taro ASO.jpg;21569;22117;97169;1079;1106;27
/net/per610a/home/mvp/mvp_db/hodost-lv/2019/2019_04_09_04_56/2019_04_09_21_54.mpg;Taro ASO.jpg;24869;25509;97169;1244;1276;32
/net/per610a/home/mvp/mvp_db/hodost-lv/2019/2019_04_10_04_56/2019_04_10_22_09.mpg;Shinzo ABE.jpg;3197;7249;97161;159;362;203
/net/per610a/home/mvp/mvp_db/hodost-lv/2019/2019_04_10_04_56/2019_04_10_22_09.mpg;Shinzo ABE.jpg;11601;12105;97161;580;605;25
/net/per610a/home/mvp/mvp_db/hodost-lv/2019/2019_04_10_04_56/2019_04_10_22_09.mpg;Shinzo ABE.jpg;24113;24349;97161;1206;1218;12
/net/per610a/home/mvp/mvp_db/hodost-lv/2019/2019_04_11_04_56/2019_04_11_22_09.mpg;Shinzo ABE.jpg;11213;11665;97161;561;583;22
/net/per610a/home/mvp/mvp_db/hodost-lv/2019/2019_04_11_04_56/2019_04_11_22_09.mpg;Shinzo ABE.jpg;20037;20217;97161;1002;1011;9
/net/per610a/home/mvp/mvp_db/hodost-lv/2019/2019_04_11_04_56/2019_04_11_22_09.mpg;Natsuo YAMAGUCHI.jpg;13773;14201;97161;689;710;21
/net/per610a/home/mvp/mvp_db/hodost-lv/2019/2019_04_13_04_56/2019_04_13_20_54.mpg;Shinzo ABE.jpg;81757;81957;91169;4091;4101;10
/net/per610a/home/mvp/mvp_db/hodost-lv/2019/2019_04_14_04_56/2019_04_14_16_30.mpg;Taro ASO.jpg;31401;31565;107949;1571;1579;8
/net/per610a/home/mvp/mvp_db/hodost-lv/2019/2019_04_14_04_56/2019_04_14_16_30.mpg;Taro ASO.jpg;31657;31709;107949;1584;1586;2
/net/per610a/home/mvp/mvp_db/hodost-lv/2019/2019_04_15_04_56/2019_04_15_21_54.mpg;Shinzo ABE.jpg;39125;39237;97161;1957;1963;6
/net/per610a/home/mvp/mvp_db/hodost-lv/2019/2019_04_15_04_56/2019_04_15_21_54.mpg;Shinzo ABE.jpg;44037;44193;97161;2203;2211;8
/net/per610a/home/mvp/mvp_db/hodost-lv/2019/2019_04_17_04_56/2019_04_17_21_54.mpg;YUriko Koike.jpg;51993;52069;97161;2601;2605;4
/net/per610a/home/mvp/mvp_db/hodost-lv/2019/2019_04_17_04_56/2019_04_17_21_54.mpg;YUriko Koike.jpg;55705;55813;97161;2787;2792;5
/net/per610a/home/mvp/mvp_db/hodost-lv/2019/2019_04_19_04_56/2019_04_19_21_54.mpg;Taro ASO.jpg;48477;48993;91169;2426;2452;26
/net/per610a/home/mvp/mvp_db/hodost-lv/2019/2019_04_19_04_56/2019_04_19_21_54.mpg;Shinzo ABE.jpg;49025;49277;91169;2453;2466;13
/net/per610a/home/mvp/mvp_db/hodost-lv/2019/2019_04_21_04_56/2019_04_21_16_30.mpg;Shinzo ABE.jpg;103717;103809;107949;5190;5194;4
/net/per610a/home/mvp/mvp_db/hodost-lv/2019/2019_04_21_04_56/2019_04_21_16_30.mpg;Shinzo ABE.jpg;103933;104033;107949;5201;5206;5
/net/per610a/home/mvp/mvp_db/hodost-lv/2019/2019_04_21_04_56/2019_04_21_16_30.mpg;Shinzo ABE.jpg;104137;104161;107949;5211;5212;1
/net/per610a/home/mvp/mvp_db/hodost-lv/2019/2019_04_21_04_56/2019_04_21_16_30.mpg;Shinzo ABE.jpg;104513;104621;107949;5230;5235;5
/net/per610a/home/mvp/mvp_db/hodost-lv/2019/2019_04_22_04_56/2019_04_22_21_54.mpg;Ichiro OZAWA.jpg;31481;32069;97161;1575;1604;29
/net/per610a/home/mvp/mvp_db/hodost-lv/2019/2019_04_22_04_56/2019_04_22_21_54.mpg;Ichiro OZAWA.jpg;34165;34489;97161;1709;1725;16
/net/per610a/home/mvp/mvp_db/hodost-lv/2019/2019_04_22_04_56/2019_04_22_21_54.mpg;Shinzo ABE.jpg;33705;33769;97161;1686;1689;3
/net/per610a/home/mvp/mvp_db/hodost-lv/2019/2019_04_23_04_56/2019_04_23_21_54.mpg;Junichiro KOIZUMI.jpg;29429;29545;97161;1472;1478;6
/net/per610a/home/mvp/mvp_db/hodost-lv/2019/2019_04_24_04_56/2019_04_24_21_54.mpg;Shinzo ABE.jpg;52177;52421;97161;2610;2623;13
/net/per610a/home/mvp/mvp_db/hodost-lv/2019/2019_04_26_04_56/2019_04_26_21_54.mpg;Ichiro OZAWA.jpg;44169;44569;91169;2210;2230;20
/net/per610a/home/mvp/mvp_db/hodost-lv/2019/2019_04_26_04_56/2019_04_26_21_54.mpg;Yukio EDANO.jpg;45165;46069;91169;2260;2305;45
/net/per610a/home/mvp/mvp_db/hodost-lv/2019/2019_04_26_04_56/2019_04_26_21_54.mpg;Yukio EDANO.jpg;48441;48497;91169;2424;2427;3
/net/per610a/home/mvp/mvp_db/hodost-lv/2019/2019_04_27_04_56/2019_04_27_20_54.mpg;Shinzo ABE.jpg;69853;70013;91169;3496;3504;8
/net/per610a/home/mvp/mvp_db/hodost-lv/2019/2019_04_28_04_56/2019_04_28_16_30.mpg;Shinzo ABE.jpg;32553;32629;107949;1629;1632;3
/net/per610a/home/mvp/mvp_db/hodost-lv/2019/2019_04_28_04_56/2019_04_28_16_30.mpg;Shinzo ABE.jpg;32749;33073;107949;1638;1655;17
/net/per610a/home/mvp/mvp_db/hodost-lv/2019/2019_04_28_04_56/2019_04_28_16_30.mpg;Shinzo ABE.jpg;103449;103493;107949;5176;5179;3
/net/per610a/home/mvp/mvp_db/hodost-lv/2019/2019_04_28_04_56/2019_04_28_16_30.mpg;Shinzo ABE.jpg;103737;103941;107949;5191;5201;10
/net/per610a/home/mvp/mvp_db/hodost-lv/2019/2019_04_28_04_56/2019_04_28_16_30.mpg;Shinzo ABE.jpg;104085;104153;107949;5208;5212;4
/net/per610a/home/mvp/mvp_db/hodost-lv/2019/2019_04_30_04_56/2019_04_30_21_54.mpg;Kyoko Nakayama.jpg;8969;10661;175089;448;533;85
/net/per610a/home/mvp/mvp_db/hodost-lv/2019/2019_04_30_04_56/2019_04_30_21_54.mpg;Kyoko Nakayama.jpg;166025;167685;175089;8309;8392;83
/net/per610a/home/mvp/mvp_db/hodost-lv/2019/2019_05_01_04_56/2019_05_01_21_54.mpg;Kohei Otsuka.jpg;14061;14193;97169;703;710;7
/net/per610a/home/mvp/mvp_db/hodost-lv/2019/2019_05_01_04_56/2019_05_01_21_54.mpg;Kohei Otsuka.jpg;15885;15957;97169;794;798;4
/net/per610a/home/mvp/mvp_db/hodost-lv/2019/2019_05_01_04_56/2019_05_01_21_54.mpg;Kohei Otsuka.jpg;17329;17341;97169;867;867;0
/net/per610a/home/mvp/mvp_db/hodost-lv/2019/2019_05_01_04_56/2019_05_01_21_54.mpg;Kohei Otsuka.jpg;48361;48517;97169;2420;2428;8
/net/per610a/home/mvp/mvp_db/hodost-lv/2019/2019_05_01_04_56/2019_05_01_21_54.mpg;Kohei Otsuka.jpg;64689;64865;97169;3237;3246;9
/net/per610a/home/mvp/mvp_db/hodost-lv/2019/2019_05_01_04_56/2019_05_01_21_54.mpg;Junichiro KOIZUMI.jpg;44417;44913;97169;2222;2247;25
/net/per610a/home/mvp/mvp_db/hodost-lv/2019/2019_05_02_04_56/2019_05_02_21_54.mpg;Shinzo ABE.jpg;56093;56117;97161;2806;2808;2
/net/per610a/home/mvp/mvp_db/hodost-lv/2019/2019_05_02_04_56/2019_05_02_21_54.mpg;Shinzo ABE.jpg;56517;56557;97161;2828;2830;2
/net/per610a/home/mvp/mvp_db/hodost-lv/2019/2019_05_02_04_56/2019_05_02_21_54.mpg;Shinzo ABE.jpg;56625;56821;97161;2833;2843;10
/net/per610a/home/mvp/mvp_db/hodost-lv/2019/2019_05_02_04_56/2019_05_02_21_54.mpg;Shinzo ABE.jpg;57913;57965;97161;2898;2900;2
/net/per610a/home/mvp/mvp_db/hodost-lv/2019/2019_05_03_04_56/2019_05_03_21_54.mpg;Shinzo ABE.jpg;2069;2289;91169;103;114;11
/net/per610a/home/mvp/mvp_db/hodost-lv/2019/2019_05_03_04_56/2019_05_03_21_54.mpg;Shinzo ABE.jpg;5957;6325;91169;298;316;18
/net/per610a/home/mvp/mvp_db/hodost-lv/2019/2019_05_03_04_56/2019_05_03_21_54.mpg;Shinzo ABE.jpg;6589;7197;91169;329;360;31
/net/per610a/home/mvp/mvp_db/hodost-lv/2019/2019_05_03_04_56/2019_05_03_21_54.mpg;Shinzo ABE.jpg;9597;9917;91169;480;496;16
/net/per610a/home/mvp/mvp_db/hodost-lv/2019/2019_05_03_04_56/2019_05_03_21_54.mpg;Shinzo ABE.jpg;10053;10137;91169;503;507;4
/net/per610a/home/mvp/mvp_db/hodost-lv/2019/2019_05_03_04_56/2019_05_03_21_54.mpg;Shinzo ABE.jpg;10313;10905;91169;516;545;29
/net/per610a/home/mvp/mvp_db/hodost-lv/2019/2019_05_03_04_56/2019_05_03_21_54.mpg;Shinzo ABE.jpg;11517;11557;91169;576;578;2
/net/per610a/home/mvp/mvp_db/hodost-lv/2019/2019_05_05_04_56/2019_05_05_16_30.mpg;Shinzo ABE.jpg;103277;104345;107949;5168;5221;53
/net/per610a/home/mvp/mvp_db/hodost-lv/2019/2019_05_06_04_56/2019_05_06_21_54.mpg;Shinzo ABE.jpg;35929;36017;97161;1797;1802;5
/net/per610a/home/mvp/mvp_db/hodost-lv/2019/2019_05_06_04_56/2019_05_06_21_54.mpg;Shinzo ABE.jpg;37225;37333;97161;1862;1868;6
/net/per610a/home/mvp/mvp_db/hodost-lv/2019/2019_05_06_04_56/2019_05_06_21_54.mpg;Shinzo ABE.jpg;37413;37549;97161;1872;1878;6
/net/per610a/home/mvp/mvp_db/hodost-lv/2019/2019_05_06_04_56/2019_05_06_21_54.mpg;Shinzo ABE.jpg;37617;37617;97161;1882;1882;0
/net/per610a/home/mvp/mvp_db/hodost-lv/2019/2019_05_06_04_56/2019_05_06_21_54.mpg;Shinzo ABE.jpg;37689;37697;97161;1885;1886;1
/net/per610a/home/mvp/mvp_db/hodost-lv/2019/2019_05_06_04_56/2019_05_06_21_54.mpg;Shinzo ABE.jpg;39017;39469;97161;1952;1975;23
/net/per610a/home/mvp/mvp_db/hodost-lv/2019/2019_05_06_04_56/2019_05_06_21_54.mpg;Shinzo ABE.jpg;39545;40013;97161;1978;2002;24
/net/per610a/home/mvp/mvp_db/hodost-lv/2019/2019_05_07_04_56/2019_05_07_21_54.mpg;Shinzo ABE.jpg;26577;27245;97169;1330;1363;33
/net/per610a/home/mvp/mvp_db/hodost-lv/2019/2019_05_07_04_56/2019_05_07_21_54.mpg;Shinzo ABE.jpg;34709;34805;97169;1737;1741;4
/net/per610a/home/mvp/mvp_db/hodost-lv/2019/2019_05_07_04_56/2019_05_07_21_54.mpg;Shinzo ABE.jpg;37673;39133;97169;1885;1958;73
/net/per610a/home/mvp/mvp_db/hodost-lv/2019/2019_05_07_04_56/2019_05_07_21_54.mpg;Shinzo ABE.jpg;39393;39893;97169;1971;1996;25
/net/per610a/home/mvp/mvp_db/hodost-lv/2019/2019_05_07_04_56/2019_05_07_21_54.mpg;Shinzo ABE.jpg;40793;41113;97169;2041;2057;16
/net/per610a/home/mvp/mvp_db/hodost-lv/2019/2019_05_07_04_56/2019_05_07_21_54.mpg;Shinzo ABE.jpg;41529;41673;97169;2078;2085;7
/net/per610a/home/mvp/mvp_db/hodost-lv/2019/2019_05_07_04_56/2019_05_07_21_54.mpg;Shinzo ABE.jpg;43169;43337;97169;2160;2168;8
/net/per610a/home/mvp/mvp_db/hodost-lv/2019/2019_05_07_04_56/2019_05_07_21_54.mpg;Shinzo ABE.jpg;42557;42873;97169;2129;2145;16
/net/per610a/home/mvp/mvp_db/hodost-lv/2019/2019_05_07_04_56/2019_05_07_21_54.mpg;Shinzo ABE.jpg;45769;46217;97169;2290;2313;23
/net/per610a/home/mvp/mvp_db/hodost-lv/2019/2019_05_08_04_56/2019_05_08_21_54.mpg;Shinzo ABE.jpg;41545;41637;97169;2079;2083;4
/net/per610a/home/mvp/mvp_db/hodost-lv/2019/2019_05_09_04_56/2019_05_09_21_54.mpg;Shinzo ABE.jpg;1657;1877;97161;82;93;11
/net/per610a/home/mvp/mvp_db/hodost-lv/2019/2019_05_09_04_56/2019_05_09_21_54.mpg;Shinzo ABE.jpg;2053;2241;97161;102;112;10
/net/per610a/home/mvp/mvp_db/hodost-lv/2019/2019_05_09_04_56/2019_05_09_21_54.mpg;Shinzo ABE.jpg;6273;6729;97161;313;336;23
/net/per610a/home/mvp/mvp_db/hodost-lv/2019/2019_05_09_04_56/2019_05_09_21_54.mpg;Shinzo ABE.jpg;6917;7077;97161;346;354;8
/net/per610a/home/mvp/mvp_db/hodost-lv/2019/2019_05_09_04_56/2019_05_09_21_54.mpg;Kohei Otsuka.jpg;7377;7405;97161;369;370;1
/net/per610a/home/mvp/mvp_db/hodost-lv/2019/2019_05_09_04_56/2019_05_09_21_54.mpg;Kohei Otsuka.jpg;37377;37525;97161;1870;1877;7
/net/per610a/home/mvp/mvp_db/hodost-lv/2019/2019_05_09_04_56/2019_05_09_21_54.mpg;Kohei Otsuka.jpg;37841;37897;97161;1893;1896;3
/net/per610a/home/mvp/mvp_db/hodost-lv/2019/2019_05_09_04_56/2019_05_09_21_54.mpg;Kohei Otsuka.jpg;54925;55005;97161;2748;2752;4
/net/per610a/home/mvp/mvp_db/hodost-lv/2019/2019_05_09_04_56/2019_05_09_21_54.mpg;Kohei Otsuka.jpg;57145;57301;97161;2859;2867;8
/net/per610a/home/mvp/mvp_db/hodost-lv/2019/2019_05_09_04_56/2019_05_09_21_54.mpg;Kohei Otsuka.jpg;63613;63717;97161;3183;3188;5
/net/per610a/home/mvp/mvp_db/hodost-lv/2019/2019_05_10_04_56/2019_05_10_21_54.mpg;Shinzo ABE.jpg;19881;19973;91169;995;999;4
/net/per610a/home/mvp/mvp_db/hodost-lv/2019/2019_05_13_04_56/2019_05_13_21_54.mpg;Shinzo ABE.jpg;2705;2789;97161;135;139;4
/net/per610a/home/mvp/mvp_db/hodost-lv/2019/2019_05_13_04_56/2019_05_13_21_54.mpg;Shinzo ABE.jpg;20921;21005;97161;1046;1051;5
/net/per610a/home/mvp/mvp_db/hodost-lv/2019/2019_05_13_04_56/2019_05_13_21_54.mpg;Shinzo ABE.jpg;21241;21497;97161;1062;1075;13
/net/per610a/home/mvp/mvp_db/hodost-lv/2019/2019_05_13_04_56/2019_05_13_21_54.mpg;Shinzo ABE.jpg;7181;7213;97161;359;360;1
/net/per610a/home/mvp/mvp_db/hodost-lv/2019/2019_05_13_04_56/2019_05_13_21_54.mpg;Shinzo ABE.jpg;7893;8261;97161;394;413;19
/net/per610a/home/mvp/mvp_db/hodost-lv/2019/2019_05_13_04_56/2019_05_13_21_54.mpg;Shinzo ABE.jpg;21573;21741;97161;1079;1087;8
/net/per610a/home/mvp/mvp_db/hodost-lv/2019/2019_05_15_04_56/2019_05_15_21_54.mpg;Renho.jpg;42293;42449;97161;2116;2124;8
/net/per610a/home/mvp/mvp_db/hodost-lv/2019/2019_05_15_04_56/2019_05_15_21_54.mpg;Renho.jpg;45597;45833;97161;2281;2293;12
/net/per610a/home/mvp/mvp_db/hodost-lv/2019/2019_05_15_04_56/2019_05_15_21_54.mpg;Shinzo ABE.jpg;46585;46973;97161;2331;2350;19
/net/per610a/home/mvp/mvp_db/hodost-lv/2019/2019_05_15_04_56/2019_05_15_21_54.mpg;Shinzo ABE.jpg;54953;55109;97161;2749;2757;8
/net/per610a/home/mvp/mvp_db/hodost-lv/2019/2019_05_16_04_56/2019_05_16_21_54.mpg;Ichiro Matsui.jpeg;27009;27377;97161;1351;1369;18
/net/per610a/home/mvp/mvp_db/hodost-lv/2019/2019_05_18_04_56/2019_05_18_20_54.mpg;Ichiro Matsui.jpeg;47449;47621;91169;2374;2383;9
/net/per610a/home/mvp/mvp_db/hodost-lv/2019/2019_05_18_04_56/2019_05_18_20_54.mpg;Shinzo ABE.jpg;50673;51005;91169;2536;2552;16
/net/per610a/home/mvp/mvp_db/hodost-lv/2019/2019_05_20_04_56/2019_05_20_21_54.mpg;Shinzo ABE.jpg;32573;32645;97161;1629;1633;4
/net/per610a/home/mvp/mvp_db/hodost-lv/2019/2019_05_20_04_56/2019_05_20_21_54.mpg;Shinzo ABE.jpg;38177;38757;97161;1910;1939;29
/net/per610a/home/mvp/mvp_db/hodost-lv/2019/2019_05_20_04_56/2019_05_20_21_54.mpg;Shinzo ABE.jpg;43337;43477;97161;2168;2175;7
/net/per610a/home/mvp/mvp_db/hodost-lv/2019/2019_05_20_04_56/2019_05_20_21_54.mpg;Shinzo ABE.jpg;34733;34981;97161;1738;1750;12
/net/per610a/home/mvp/mvp_db/hodost-lv/2019/2019_05_20_04_56/2019_05_20_21_54.mpg;Shinzo ABE.jpg;35109;35305;97161;1756;1766;10
/net/per610a/home/mvp/mvp_db/hodost-lv/2019/2019_05_20_04_56/2019_05_20_21_54.mpg;Shinzo ABE.jpg;43073;43273;97161;2155;2165;10
/net/per610a/home/mvp/mvp_db/hodost-lv/2019/2019_05_22_04_56/2019_05_22_22_24.mpg;Shinzo ABE.jpg;25257;25461;97161;1263;1274;11
/net/per610a/home/mvp/mvp_db/hodost-lv/2019/2019_05_22_04_56/2019_05_22_22_24.mpg;Shinzo ABE.jpg;27005;27581;97161;1351;1380;29
/net/per610a/home/mvp/mvp_db/hodost-lv/2019/2019_05_22_04_56/2019_05_22_22_24.mpg;Yuichiro Tamaki.png;27641;27881;97161;1383;1395;12
/net/per610a/home/mvp/mvp_db/hodost-lv/2019/2019_05_22_04_56/2019_05_22_22_24.mpg;Junichiro KOIZUMI.jpg;28589;28689;97161;1430;1435;5
/net/per610a/home/mvp/mvp_db/hodost-lv/2019/2019_05_23_04_56/2019_05_23_22_24.mpg;Kohei Otsuka.jpg;42249;42305;97161;2114;2116;2
/net/per610a/home/mvp/mvp_db/hodost-lv/2019/2019_05_23_04_56/2019_05_23_22_24.mpg;Kohei Otsuka.jpg;47649;47669;97161;2384;2385;1
/net/per610a/home/mvp/mvp_db/hodost-lv/2019/2019_05_23_04_56/2019_05_23_22_24.mpg;Kohei Otsuka.jpg;71745;71749;97161;3590;3590;0
/net/per610a/home/mvp/mvp_db/hodost-lv/2019/2019_05_23_04_56/2019_05_23_22_24.mpg;Kohei Otsuka.jpg;71961;72081;97161;3600;3606;6
/net/per610a/home/mvp/mvp_db/hodost-lv/2019/2019_05_24_04_56/2019_05_24_22_24.mpg;Shinzo ABE.jpg;26929;27029;91169;1347;1352;5
/net/per610a/home/mvp/mvp_db/hodost-lv/2019/2019_05_26_04_56/2019_05_26_16_30.mpg;Shinzo ABE.jpg;15925;16057;107949;796;803;7
/net/per610a/home/mvp/mvp_db/hodost-lv/2019/2019_05_27_04_56/2019_05_27_21_54.mpg;Shinzo ABE.jpg;13981;14185;97161;699;709;10
/net/per610a/home/mvp/mvp_db/hodost-lv/2019/2019_05_27_04_56/2019_05_27_21_54.mpg;Shinzo ABE.jpg;16737;17493;97161;837;875;38
/net/per610a/home/mvp/mvp_db/hodost-lv/2019/2019_05_27_04_56/2019_05_27_21_54.mpg;Shinzo ABE.jpg;18645;18761;97161;933;938;5
/net/per610a/home/mvp/mvp_db/hodost-lv/2019/2019_05_27_04_56/2019_05_27_21_54.mpg;Shinzo ABE.jpg;18889;19249;97161;945;963;18
/net/per610a/home/mvp/mvp_db/hodost-lv/2019/2019_05_27_04_56/2019_05_27_21_54.mpg;Shinzo ABE.jpg;19321;19645;97161;966;983;17
/net/per610a/home/mvp/mvp_db/hodost-lv/2019/2019_05_27_04_56/2019_05_27_21_54.mpg;Shinzo ABE.jpg;14657;14737;97161;733;737;4
/net/per610a/home/mvp/mvp_db/hodost-lv/2019/2019_05_28_04_56/2019_05_28_21_54.mpg;Shinzo ABE.jpg;61581;61645;97161;3081;3084;3
/net/per610a/home/mvp/mvp_db/hodost-lv/2019/2019_05_28_04_56/2019_05_28_21_54.mpg;Shinzo ABE.jpg;63781;63853;97161;3191;3195;4
/net/per610a/home/mvp/mvp_db/hodost-lv/2019/2019_05_29_04_56/2019_05_29_21_54.mpg;Shinzo ABE.jpg;27605;27941;97161;1381;1398;17
/net/per610a/home/mvp/mvp_db/hodost-lv/2019/2019_05_29_04_56/2019_05_29_21_54.mpg;Yukio EDANO.jpg;54281;54537;97161;2716;2729;13
/net/per610a/home/mvp/mvp_db/hodost-lv/2019/2019_05_29_04_56/2019_05_29_21_54.mpg;Yukio EDANO.jpg;54969;55013;97161;2750;2752;2
/net/per610a/home/mvp/mvp_db/hodost-lv/2019/2019_05_29_04_56/2019_05_29_21_54.mpg;Yukio EDANO.jpg;54561;54649;97161;2730;2734;4
/net/per610a/home/mvp/mvp_db/hodost-lv/2019/2019_05_29_04_56/2019_05_29_21_54.mpg;Yukio EDANO.jpg;55941;56049;97161;2799;2804;5
/net/per610a/home/mvp/mvp_db/hodost-lv/2019/2019_05_30_04_56/2019_05_30_21_54.mpg;Shinzo ABE.jpg;53181;53413;97161;2661;2672;11
/net/per610a/home/mvp/mvp_db/hodost-lv/2019/2019_05_30_04_56/2019_05_30_21_54.mpg;Shinzo ABE.jpg;56061;56117;97161;2805;2808;3
/net/per610a/home/mvp/mvp_db/hodost-lv/2019/2019_05_30_04_56/2019_05_30_21_54.mpg;Shinzo ABE.jpg;56229;56377;97161;2813;2821;8
/net/per610a/home/mvp/mvp_db/hodost-lv/2019/2019_05_30_04_56/2019_05_30_21_54.mpg;Shinzo ABE.jpg;56665;57281;97161;2835;2866;31
/net/per610a/home/mvp/mvp_db/hodost-lv/2019/2019_05_30_04_56/2019_05_30_21_54.mpg;Shinzo ABE.jpg;57697;57877;97161;2887;2896;9
/net/per610a/home/mvp/mvp_db/hodost-lv/2019/2019_05_30_04_56/2019_05_30_21_54.mpg;Shinzo ABE.jpg;58677;58961;97161;2936;2950;14
/net/per610a/home/mvp/mvp_db/hodost-lv/2019/2019_06_02_04_56/2019_06_02_16_30.mpg;Shinzo ABE.jpg;31885;32217;107949;1595;1612;17
/net/per610a/home/mvp/mvp_db/hodost-lv/2019/2019_06_02_04_56/2019_06_02_16_30.mpg;Shinzo ABE.jpg;102625;102837;107949;5135;5146;11
/net/per610a/home/mvp/mvp_db/hodost-lv/2019/2019_06_03_04_56/2019_06_03_21_54.mpg;Shinzo ABE.jpg;45937;46205;97161;2298;2312;14
/net/per610a/home/mvp/mvp_db/hodost-lv/2019/2019_06_04_04_56/2019_06_04_21_54.mpg;Taro ASO.jpg;26357;27689;97169;1319;1385;66
/net/per610a/home/mvp/mvp_db/hodost-lv/2019/2019_06_05_04_56/2019_06_05_21_54.mpg;Yoshihiko Noda.jpg;24869;25177;97169;1244;1260;16
/net/per610a/home/mvp/mvp_db/hodost-lv/2019/2019_06_05_04_56/2019_06_05_21_54.mpg;Taro ASO.jpg;29525;29713;97169;1477;1487;10
/net/per610a/home/mvp/mvp_db/hodost-lv/2019/2019_06_05_04_56/2019_06_05_21_54.mpg;Shinzo ABE.jpg;29525;29713;97169;1477;1487;10
/net/per610a/home/mvp/mvp_db/hodost-lv/2019/2019_06_05_04_56/2019_06_05_21_54.mpg;Shinzo ABE.jpg;29825;30073;97169;1492;1505;13
/net/per610a/home/mvp/mvp_db/hodost-lv/2019/2019_06_06_04_56/2019_06_06_21_54.mpg;Shinzo ABE.jpg;15429;15553;97161;772;778;6
/net/per610a/home/mvp/mvp_db/hodost-lv/2019/2019_06_06_04_56/2019_06_06_21_54.mpg;Shinzo ABE.jpg;16241;16417;97161;812;821;9
/net/per610a/home/mvp/mvp_db/hodost-lv/2019/2019_06_06_04_56/2019_06_06_21_54.mpg;Shinzo ABE.jpg;35529;35881;97161;1777;1795;18
/net/per610a/home/mvp/mvp_db/hodost-lv/2019/2019_06_06_04_56/2019_06_06_21_54.mpg;Taro ASO.jpg;34165;34705;97161;1709;1736;27
/net/per610a/home/mvp/mvp_db/hodost-lv/2019/2019_06_07_04_56/2019_06_07_21_54.mpg;Shinzo ABE.jpg;39285;39573;91169;1966;1980;14
/net/per610a/home/mvp/mvp_db/hodost-lv/2019/2019_06_07_04_56/2019_06_07_21_54.mpg;Shinzo ABE.jpg;40341;40405;91169;2019;2022;3
/net/per610a/home/mvp/mvp_db/hodost-lv/2019/2019_06_07_04_56/2019_06_07_21_54.mpg;Taro ASO.jpg;45509;46661;91169;2277;2335;58
/net/per610a/home/mvp/mvp_db/hodost-lv/2019/2019_06_10_04_56/2019_06_10_21_54.mpg;Shinzo ABE.jpg;12473;12577;97161;624;629;5
/net/per610a/home/mvp/mvp_db/hodost-lv/2019/2019_06_10_04_56/2019_06_10_21_54.mpg;Shinzo ABE.jpg;13153;13229;97161;658;661;3
/net/per610a/home/mvp/mvp_db/hodost-lv/2019/2019_06_10_04_56/2019_06_10_21_54.mpg;Shinzo ABE.jpg;16421;16549;97161;821;828;7
/net/per610a/home/mvp/mvp_db/hodost-lv/2019/2019_06_10_04_56/2019_06_10_21_54.mpg;Shinzo ABE.jpg;17049;17049;97161;853;853;0
/net/per610a/home/mvp/mvp_db/hodost-lv/2019/2019_06_10_04_56/2019_06_10_21_54.mpg;Shinzo ABE.jpg;17361;17433;97161;868;872;4
/net/per610a/home/mvp/mvp_db/hodost-lv/2019/2019_06_10_04_56/2019_06_10_21_54.mpg;Shinzo ABE.jpg;17921;17981;97161;896;899;3
/net/per610a/home/mvp/mvp_db/hodost-lv/2019/2019_06_10_04_56/2019_06_10_21_54.mpg;Shinzo ABE.jpg;19101;19101;97161;955;955;0
/net/per610a/home/mvp/mvp_db/hodost-lv/2019/2019_06_10_04_56/2019_06_10_21_54.mpg;Shinzo ABE.jpg;19221;19241;97161;961;962;1
/net/per610a/home/mvp/mvp_db/hodost-lv/2019/2019_06_10_04_56/2019_06_10_21_54.mpg;Shinzo ABE.jpg;20473;20521;97161;1024;1026;2
/net/per610a/home/mvp/mvp_db/hodost-lv/2019/2019_06_10_04_56/2019_06_10_21_54.mpg;Taro ASO.jpg;13157;13177;97161;658;659;1
/net/per610a/home/mvp/mvp_db/hodost-lv/2019/2019_06_10_04_56/2019_06_10_21_54.mpg;Taro ASO.jpg;13445;13473;97161;672;674;2
/net/per610a/home/mvp/mvp_db/hodost-lv/2019/2019_06_10_04_56/2019_06_10_21_54.mpg;Taro ASO.jpg;13901;13997;97161;695;700;5
/net/per610a/home/mvp/mvp_db/hodost-lv/2019/2019_06_11_04_56/2019_06_11_21_54.mpg;Yukio EDANO.jpg;13261;13869;97169;663;694;31
/net/per610a/home/mvp/mvp_db/hodost-lv/2019/2019_06_11_04_56/2019_06_11_21_54.mpg;Shinzo ABE.jpg;33365;33549;97169;1669;1679;10
/net/per610a/home/mvp/mvp_db/hodost-lv/2019/2019_06_11_04_56/2019_06_11_21_54.mpg;Shinzo ABE.jpg;42421;42553;97169;2123;2129;6
/net/per610a/home/mvp/mvp_db/hodost-lv/2019/2019_06_12_04_56/2019_06_12_21_54.mpg;Shinzo ABE.jpg;59101;59349;97169;2957;2970;13
/net/per610a/home/mvp/mvp_db/hodost-lv/2019/2019_06_13_04_56/2019_06_13_22_09.mpg;Taro ASO.jpg;69893;70117;97161;3497;3508;11
/net/per610a/home/mvp/mvp_db/hodost-lv/2019/2019_06_14_04_56/2019_06_14_21_54.mpg;Taro ASO.jpg;11697;11769;91169;585;589;4
/net/per610a/home/mvp/mvp_db/hodost-lv/2019/2019_06_14_04_56/2019_06_14_21_54.mpg;Taro ASO.jpg;17849;17925;91169;893;897;4
/net/per610a/home/mvp/mvp_db/hodost-lv/2019/2019_06_14_04_56/2019_06_14_21_54.mpg;Taro ASO.jpg;11837;11905;91169;592;595;3
/net/per610a/home/mvp/mvp_db/hodost-lv/2019/2019_06_14_04_56/2019_06_14_21_54.mpg;Taro ASO.jpg;12185;12293;91169;609;615;6
/net/per610a/home/mvp/mvp_db/hodost-lv/2019/2019_06_14_04_56/2019_06_14_21_54.mpg;Taro ASO.jpg;12369;12865;91169;619;643;24
/net/per610a/home/mvp/mvp_db/hodost-lv/2019/2019_06_14_04_56/2019_06_14_21_54.mpg;Taro ASO.jpg;13133;13165;91169;657;658;1
/net/per610a/home/mvp/mvp_db/hodost-lv/2019/2019_06_14_04_56/2019_06_14_21_54.mpg;Taro ASO.jpg;13573;13573;91169;679;679;0
/net/per610a/home/mvp/mvp_db/hodost-lv/2019/2019_06_14_04_56/2019_06_14_21_54.mpg;Taro ASO.jpg;13661;13893;91169;683;695;12
/net/per610a/home/mvp/mvp_db/hodost-lv/2019/2019_06_14_04_56/2019_06_14_21_54.mpg;Taro ASO.jpg;13981;14049;91169;699;703;4
/net/per610a/home/mvp/mvp_db/hodost-lv/2019/2019_06_14_04_56/2019_06_14_21_54.mpg;Taro ASO.jpg;14165;14589;91169;708;730;22
/net/per610a/home/mvp/mvp_db/hodost-lv/2019/2019_06_14_04_56/2019_06_14_21_54.mpg;Taro ASO.jpg;15197;15241;91169;760;762;2
/net/per610a/home/mvp/mvp_db/hodost-lv/2019/2019_06_14_04_56/2019_06_14_21_54.mpg;Taro ASO.jpg;15885;16277;91169;795;814;19
/net/per610a/home/mvp/mvp_db/hodost-lv/2019/2019_06_14_04_56/2019_06_14_21_54.mpg;Taro ASO.jpg;16577;16593;91169;829;830;1
/net/per610a/home/mvp/mvp_db/hodost-lv/2019/2019_06_14_04_56/2019_06_14_21_54.mpg;Taro ASO.jpg;17289;17465;91169;865;874;9
/net/per610a/home/mvp/mvp_db/hodost-lv/2019/2019_06_14_04_56/2019_06_14_21_54.mpg;Taro ASO.jpg;17933;18009;91169;897;901;4
/net/per610a/home/mvp/mvp_db/hodost-lv/2019/2019_06_14_04_56/2019_06_14_21_54.mpg;Taro ASO.jpg;18205;18353;91169;911;918;7
/net/per610a/home/mvp/mvp_db/hodost-lv/2019/2019_06_14_04_56/2019_06_14_21_54.mpg;Shinzo ABE.jpg;34769;34789;91169;1740;1741;1
/net/per610a/home/mvp/mvp_db/hodost-lv/2019/2019_06_14_04_56/2019_06_14_21_54.mpg;Shinzo ABE.jpg;85877;86205;91169;4298;4314;16
/net/per610a/home/mvp/mvp_db/hodost-lv/2019/2019_06_15_04_56/2019_06_15_20_54.mpg;Taro ASO.jpg;49997;50093;91161;2502;2506;4
/net/per610a/home/mvp/mvp_db/hodost-lv/2019/2019_06_15_04_56/2019_06_15_20_54.mpg;Taro ASO.jpg;51325;51513;91161;2568;2577;9
/net/per610a/home/mvp/mvp_db/hodost-lv/2019/2019_06_15_04_56/2019_06_15_20_54.mpg;Taro ASO.jpg;51621;51773;91161;2583;2590;7
/net/per610a/home/mvp/mvp_db/hodost-lv/2019/2019_06_15_04_56/2019_06_15_20_54.mpg;Taro ASO.jpg;55689;55729;91161;2786;2788;2
/net/per610a/home/mvp/mvp_db/hodost-lv/2019/2019_06_15_04_56/2019_06_15_20_54.mpg;Taro ASO.jpg;56301;56345;91161;2817;2819;2
/net/per610a/home/mvp/mvp_db/hodost-lv/2019/2019_06_15_04_56/2019_06_15_20_54.mpg;Shinzo ABE.jpg;52465;52829;91161;2625;2643;18
/net/per610a/home/mvp/mvp_db/hodost-lv/2019/2019_06_16_04_56/2019_06_16_16_30.mpg;Shinzo ABE.jpg;35441;35573;107949;1773;1780;7
/net/per610a/home/mvp/mvp_db/hodost-lv/2019/2019_06_16_04_56/2019_06_16_16_30.mpg;Shinzo ABE.jpg;35637;35665;107949;1783;1784;1
/net/per610a/home/mvp/mvp_db/hodost-lv/2019/2019_06_19_04_56/2019_06_19_21_54.mpg;Shinzo ABE.jpg;14201;14625;97161;710;731;21
/net/per610a/home/mvp/mvp_db/hodost-lv/2019/2019_06_19_04_56/2019_06_19_21_54.mpg;Shinzo ABE.jpg;14705;14893;97161;735;745;10
/net/per610a/home/mvp/mvp_db/hodost-lv/2019/2019_06_19_04_56/2019_06_19_21_54.mpg;Shinzo ABE.jpg;16097;16137;97161;805;807;2
/net/per610a/home/mvp/mvp_db/hodost-lv/2019/2019_06_19_04_56/2019_06_19_21_54.mpg;Shinzo ABE.jpg;19261;19393;97161;963;970;7
/net/per610a/home/mvp/mvp_db/hodost-lv/2019/2019_06_19_04_56/2019_06_19_21_54.mpg;Shinzo ABE.jpg;19757;19809;97161;988;991;3
/net/per610a/home/mvp/mvp_db/hodost-lv/2019/2019_06_19_04_56/2019_06_19_21_54.mpg;Shinzo ABE.jpg;20117;20501;97161;1006;1025;19
/net/per610a/home/mvp/mvp_db/hodost-lv/2019/2019_06_19_04_56/2019_06_19_21_54.mpg;Shinzo ABE.jpg;21389;21461;97161;1070;1073;3
/net/per610a/home/mvp/mvp_db/hodost-lv/2019/2019_06_19_04_56/2019_06_19_21_54.mpg;Shinzo ABE.jpg;57533;57637;97161;2878;2884;6
/net/per610a/home/mvp/mvp_db/hodost-lv/2019/2019_06_19_04_56/2019_06_19_21_54.mpg;Shinzo ABE.jpg;58981;59053;97161;2951;2955;4
/net/per610a/home/mvp/mvp_db/hodost-lv/2019/2019_06_19_04_56/2019_06_19_21_54.mpg;Shinzo ABE.jpg;59201;59273;97161;2962;2966;4
/net/per610a/home/mvp/mvp_db/hodost-lv/2019/2019_06_19_04_56/2019_06_19_21_54.mpg;Kazuo SHII.jpg;17925;18093;97161;896;905;9
/net/per610a/home/mvp/mvp_db/hodost-lv/2019/2019_06_19_04_56/2019_06_19_21_54.mpg;Kazuo SHII.jpg;18677;18705;97161;934;936;2
/net/per610a/home/mvp/mvp_db/hodost-lv/2019/2019_06_20_04_56/2019_06_20_22_09.mpg;Taro ASO.jpg;27833;27881;97161;1392;1395;3
/net/per610a/home/mvp/mvp_db/hodost-lv/2019/2019_06_20_04_56/2019_06_20_22_09.mpg;Taro ASO.jpg;29257;29449;97161;1464;1473;9
/net/per610a/home/mvp/mvp_db/hodost-lv/2019/2019_06_20_04_56/2019_06_20_22_09.mpg;Taro ASO.jpg;29753;29929;97161;1488;1497;9
/net/per610a/home/mvp/mvp_db/hodost-lv/2019/2019_06_20_04_56/2019_06_20_22_09.mpg;Yoshihiko Noda.jpg;30281;30529;97161;1515;1527;12
/net/per610a/home/mvp/mvp_db/hodost-lv/2019/2019_06_21_04_56/2019_06_21_21_54.mpg;Taro ASO.jpg;40197;40329;91169;2011;2018;7
/net/per610a/home/mvp/mvp_db/hodost-lv/2019/2019_06_21_04_56/2019_06_21_21_54.mpg;Taro ASO.jpg;40833;40865;91169;2043;2045;2
/net/per610a/home/mvp/mvp_db/hodost-lv/2019/2019_06_21_04_56/2019_06_21_21_54.mpg;Taro ASO.jpg;41057;41253;91169;2054;2064;10
/net/per610a/home/mvp/mvp_db/hodost-lv/2019/2019_06_22_04_56/2019_06_22_20_54.mpg;Shinzo ABE.jpg;41237;41277;91169;2063;2065;2
/net/per610a/home/mvp/mvp_db/hodost-lv/2019/2019_06_22_04_56/2019_06_22_20_54.mpg;Shinzo ABE.jpg;41689;41701;91169;2086;2087;1
/net/per610a/home/mvp/mvp_db/hodost-lv/2019/2019_06_22_04_56/2019_06_22_20_54.mpg;Shinzo ABE.jpg;41869;41973;91169;2095;2100;5
/net/per610a/home/mvp/mvp_db/hodost-lv/2019/2019_06_23_04_56/2019_06_23_16_30.mpg;YUriko Koike.jpg;30745;30929;107949;1538;1547;9
/net/per610a/home/mvp/mvp_db/hodost-lv/2019/2019_06_23_04_56/2019_06_23_16_30.mpg;YUriko Koike.jpg;31005;31257;107949;1551;1564;13
/net/per610a/home/mvp/mvp_db/hodost-lv/2019/2019_06_24_04_56/2019_06_24_21_54.mpg;Taro ASO.jpg;21977;22133;97161;1099;1107;8
/net/per610a/home/mvp/mvp_db/hodost-lv/2019/2019_06_25_04_56/2019_06_25_21_54.mpg;Shinzo ABE.jpg;19389;19417;97161;970;971;1
/net/per610a/home/mvp/mvp_db/hodost-lv/2019/2019_06_25_04_56/2019_06_25_21_54.mpg;Shinzo ABE.jpg;22289;22373;97161;1115;1119;4
/net/per610a/home/mvp/mvp_db/hodost-lv/2019/2019_06_25_04_56/2019_06_25_21_54.mpg;Shinzo ABE.jpg;43633;43829;97161;2183;2193;10
/net/per610a/home/mvp/mvp_db/hodost-lv/2019/2019_06_25_04_56/2019_06_25_21_54.mpg;Taro ASO.jpg;19465;19569;97161;974;979;5
/net/per610a/home/mvp/mvp_db/hodost-lv/2019/2019_06_25_04_56/2019_06_25_21_54.mpg;Taro ASO.jpg;20693;20881;97161;1035;1044;9
/net/per610a/home/mvp/mvp_db/hodost-lv/2019/2019_06_25_04_56/2019_06_25_21_54.mpg;Taro ASO.jpg;21385;22133;97161;1070;1107;37
/net/per610a/home/mvp/mvp_db/hodost-lv/2019/2019_06_25_04_56/2019_06_25_21_54.mpg;Shinzo ABE.jpg;20693;21013;97161;1035;1051;16
/net/per610a/home/mvp/mvp_db/hodost-lv/2019/2019_06_25_04_56/2019_06_25_21_54.mpg;Shinzo ABE.jpg;22889;22957;97161;1145;1148;3
/net/per610a/home/mvp/mvp_db/hodost-lv/2019/2019_06_25_04_56/2019_06_25_21_54.mpg;Shinzo ABE.jpg;26249;26269;97161;1313;1314;1
/net/per610a/home/mvp/mvp_db/hodost-lv/2019/2019_06_26_04_56/2019_06_26_22_09.mpg;Shinzo ABE.jpg;33553;33577;97161;1679;1680;1
/net/per610a/home/mvp/mvp_db/hodost-lv/2019/2019_06_26_04_56/2019_06_26_22_09.mpg;Shinzo ABE.jpg;35217;35681;97161;1762;1785;23
/net/per610a/home/mvp/mvp_db/hodost-lv/2019/2019_06_26_04_56/2019_06_26_22_09.mpg;Shinzo ABE.jpg;35949;36465;97161;1798;1824;26
/net/per610a/home/mvp/mvp_db/hodost-lv/2019/2019_06_26_04_56/2019_06_26_22_09.mpg;Shinzo ABE.jpg;37513;37605;97161;1877;1881;4
/net/per610a/home/mvp/mvp_db/hodost-lv/2019/2019_06_26_04_56/2019_06_26_22_09.mpg;Shinzo ABE.jpg;66065;66097;97161;3305;3307;2
/net/per610a/home/mvp/mvp_db/hodost-lv/2019/2019_06_27_04_56/2019_06_27_21_54.mpg;Shinzo ABE.jpg;18421;18513;97161;921;926;5
/net/per610a/home/mvp/mvp_db/hodost-lv/2019/2019_06_27_04_56/2019_06_27_21_54.mpg;Shinzo ABE.jpg;22093;22153;97161;1105;1108;3
/net/per610a/home/mvp/mvp_db/hodost-lv/2019/2019_06_27_04_56/2019_06_27_21_54.mpg;Shinzo ABE.jpg;23241;23265;97161;1162;1164;2
/net/per610a/home/mvp/mvp_db/hodost-lv/2019/2019_06_27_04_56/2019_06_27_21_54.mpg;Shinzo ABE.jpg;35305;35333;97161;1766;1768;2
/net/per610a/home/mvp/mvp_db/hodost-lv/2019/2019_06_28_04_56/2019_06_28_21_54.mpg;Shinzo ABE.jpg;16649;16677;91169;833;834;1
/net/per610a/home/mvp/mvp_db/hodost-lv/2019/2019_06_28_04_56/2019_06_28_21_54.mpg;Shinzo ABE.jpg;18485;18485;91169;925;925;0
/net/per610a/home/mvp/mvp_db/hodost-lv/2019/2019_06_28_04_56/2019_06_28_21_54.mpg;Shinzo ABE.jpg;20557;20601;91169;1028;1031;3
/net/per610a/home/mvp/mvp_db/hodost-lv/2019/2019_07_01_04_56/2019_07_01_21_54.mpg;Shinzo ABE.jpg;32381;32609;97161;1620;1631;11
/net/per610a/home/mvp/mvp_db/hodost-lv/2019/2019_07_02_04_56/2019_07_02_21_54.mpg;Kyoko Nakayama.jpg;13485;13557;97161;674;678;4
/net/per610a/home/mvp/mvp_db/hodost-lv/2019/2019_07_02_04_56/2019_07_02_21_54.mpg;Kyoko Nakayama.jpg;13981;14473;97161;699;724;25
/net/per610a/home/mvp/mvp_db/hodost-lv/2019/2019_07_02_04_56/2019_07_02_21_54.mpg;Shinzo ABE.jpg;27941;28641;97161;1398;1433;35
/net/per610a/home/mvp/mvp_db/hodost-lv/2019/2019_07_02_04_56/2019_07_02_21_54.mpg;Shinzo ABE.jpg;28717;28717;97161;1437;1437;0
/net/per610a/home/mvp/mvp_db/hodost-lv/2019/2019_07_02_04_56/2019_07_02_21_54.mpg;Shinzo ABE.jpg;28909;29033;97161;1446;1452;6
/net/per610a/home/mvp/mvp_db/hodost-lv/2019/2019_07_02_04_56/2019_07_02_21_54.mpg;Shinzo ABE.jpg;37561;37749;97161;1879;1888;9
/net/per610a/home/mvp/mvp_db/hodost-lv/2019/2019_07_02_04_56/2019_07_02_21_54.mpg;Shinzo ABE.jpg;34741;34741;97161;1738;1738;0
/net/per610a/home/mvp/mvp_db/hodost-lv/2019/2019_07_02_04_56/2019_07_02_21_54.mpg;Shinzo ABE.jpg;35693;35701;97161;1786;1786;0
/net/per610a/home/mvp/mvp_db/hodost-lv/2019/2019_07_02_04_56/2019_07_02_21_54.mpg;Shinzo ABE.jpg;35769;35797;97161;1789;1791;2
/net/per610a/home/mvp/mvp_db/hodost-lv/2019/2019_07_02_04_56/2019_07_02_21_54.mpg;Shinzo ABE.jpg;37121;37165;97161;1857;1859;2
/net/per610a/home/mvp/mvp_db/hodost-lv/2019/2019_07_03_04_56/2019_07_03_21_54.mpg;Shinzo ABE.jpg;30345;31009;97169;1518;1551;33
/net/per610a/home/mvp/mvp_db/hodost-lv/2019/2019_07_03_04_56/2019_07_03_21_54.mpg;Shinzo ABE.jpg;31673;32157;97169;1585;1609;24
/net/per610a/home/mvp/mvp_db/hodost-lv/2019/2019_07_03_04_56/2019_07_03_21_54.mpg;Shinzo ABE.jpg;37633;38201;97169;1883;1911;28
/net/per610a/home/mvp/mvp_db/hodost-lv/2019/2019_07_03_04_56/2019_07_03_21_54.mpg;Shinzo ABE.jpg;38361;38781;97169;1919;1940;21
/net/per610a/home/mvp/mvp_db/hodost-lv/2019/2019_07_03_04_56/2019_07_03_21_54.mpg;Shinzo ABE.jpg;38893;39001;97169;1946;1951;5
/net/per610a/home/mvp/mvp_db/hodost-lv/2019/2019_07_03_04_56/2019_07_03_21_54.mpg;Shinzo ABE.jpg;41161;41193;97169;2059;2061;2
/net/per610a/home/mvp/mvp_db/hodost-lv/2019/2019_07_03_04_56/2019_07_03_21_54.mpg;Shinzo ABE.jpg;41317;41617;97169;2067;2082;15
/net/per610a/home/mvp/mvp_db/hodost-lv/2019/2019_07_03_04_56/2019_07_03_21_54.mpg;Shinzo ABE.jpg;41713;42037;97169;2087;2103;16
/net/per610a/home/mvp/mvp_db/hodost-lv/2019/2019_07_03_04_56/2019_07_03_21_54.mpg;Shinzo ABE.jpg;42645;42825;97169;2134;2143;9
/net/per610a/home/mvp/mvp_db/hodost-lv/2019/2019_07_03_04_56/2019_07_03_21_54.mpg;Shinzo ABE.jpg;44721;45493;97169;2238;2276;38
/net/per610a/home/mvp/mvp_db/hodost-lv/2019/2019_07_03_04_56/2019_07_03_21_54.mpg;Shinzo ABE.jpg;45565;45745;97169;2280;2289;9
/net/per610a/home/mvp/mvp_db/hodost-lv/2019/2019_07_03_04_56/2019_07_03_21_54.mpg;Shinzo ABE.jpg;45941;47485;97169;2299;2376;77
/net/per610a/home/mvp/mvp_db/hodost-lv/2019/2019_07_03_04_56/2019_07_03_21_54.mpg;Shinzo ABE.jpg;49013;49629;97169;2452;2483;31
/net/per610a/home/mvp/mvp_db/hodost-lv/2019/2019_07_03_04_56/2019_07_03_21_54.mpg;Shinzo ABE.jpg;50869;50881;97169;2545;2546;1
/net/per610a/home/mvp/mvp_db/hodost-lv/2019/2019_07_03_04_56/2019_07_03_21_54.mpg;Shinzo ABE.jpg;50977;51253;97169;2551;2565;14
/net/per610a/home/mvp/mvp_db/hodost-lv/2019/2019_07_03_04_56/2019_07_03_21_54.mpg;Shinzo ABE.jpg;51349;51365;97169;2569;2570;1
/net/per610a/home/mvp/mvp_db/hodost-lv/2019/2019_07_03_04_56/2019_07_03_21_54.mpg;Shinzo ABE.jpg;51617;51857;97169;2583;2595;12
/net/per610a/home/mvp/mvp_db/hodost-lv/2019/2019_07_03_04_56/2019_07_03_21_54.mpg;Shinzo ABE.jpg;55197;55789;97169;2762;2792;30
/net/per610a/home/mvp/mvp_db/hodost-lv/2019/2019_07_03_04_56/2019_07_03_21_54.mpg;Shinzo ABE.jpg;55957;56249;97169;2800;2815;15
/net/per610a/home/mvp/mvp_db/hodost-lv/2019/2019_07_03_04_56/2019_07_03_21_54.mpg;Shinzo ABE.jpg;56665;56673;97169;2835;2836;1
/net/per610a/home/mvp/mvp_db/hodost-lv/2019/2019_07_03_04_56/2019_07_03_21_54.mpg;Shinzo ABE.jpg;57137;57613;97169;2859;2883;24
/net/per610a/home/mvp/mvp_db/hodost-lv/2019/2019_07_03_04_56/2019_07_03_21_54.mpg;Shinzo ABE.jpg;57693;57949;97169;2887;2900;13
/net/per610a/home/mvp/mvp_db/hodost-lv/2019/2019_07_03_04_56/2019_07_03_21_54.mpg;Shinzo ABE.jpg;61573;62537;97169;3081;3129;48
/net/per610a/home/mvp/mvp_db/hodost-lv/2019/2019_07_03_04_56/2019_07_03_21_54.mpg;Shinzo ABE.jpg;62617;62753;97169;3133;3140;7
/net/per610a/home/mvp/mvp_db/hodost-lv/2019/2019_07_03_04_56/2019_07_03_21_54.mpg;Shinzo ABE.jpg;62997;63269;97169;3152;3166;14
/net/per610a/home/mvp/mvp_db/hodost-lv/2019/2019_07_03_04_56/2019_07_03_21_54.mpg;Shinzo ABE.jpg;64277;64297;97169;3216;3217;1
/net/per610a/home/mvp/mvp_db/hodost-lv/2019/2019_07_03_04_56/2019_07_03_21_54.mpg;Shinzo ABE.jpg;67153;67153;97169;3360;3360;0
/net/per610a/home/mvp/mvp_db/hodost-lv/2019/2019_07_03_04_56/2019_07_03_21_54.mpg;Shinzo ABE.jpg;67245;67949;97169;3365;3400;35
/net/per610a/home/mvp/mvp_db/hodost-lv/2019/2019_07_03_04_56/2019_07_03_21_54.mpg;Shinzo ABE.jpg;70581;70617;97169;3532;3534;2
/net/per610a/home/mvp/mvp_db/hodost-lv/2019/2019_07_03_04_56/2019_07_03_21_54.mpg;Shinzo ABE.jpg;73941;74545;97169;3700;3730;30
/net/per610a/home/mvp/mvp_db/hodost-lv/2019/2019_07_03_04_56/2019_07_03_21_54.mpg;Shinzo ABE.jpg;74729;74961;97169;3739;3751;12
/net/per610a/home/mvp/mvp_db/hodost-lv/2019/2019_07_03_04_56/2019_07_03_21_54.mpg;Shinzo ABE.jpg;75057;75365;97169;3756;3771;15
/net/per610a/home/mvp/mvp_db/hodost-lv/2019/2019_07_03_04_56/2019_07_03_21_54.mpg;Shinzo ABE.jpg;75545;75765;97169;3780;3791;11
/net/per610a/home/mvp/mvp_db/hodost-lv/2019/2019_07_03_04_56/2019_07_03_21_54.mpg;Shinzo ABE.jpg;75869;76365;97169;3797;3821;24
/net/per610a/home/mvp/mvp_db/hodost-lv/2019/2019_07_03_04_56/2019_07_03_21_54.mpg;Shinzo ABE.jpg;76881;77085;97169;3847;3857;10
/net/per610a/home/mvp/mvp_db/hodost-lv/2019/2019_07_03_04_56/2019_07_03_21_54.mpg;Shinzo ABE.jpg;77313;77361;97169;3869;3871;2
/net/per610a/home/mvp/mvp_db/hodost-lv/2019/2019_07_03_04_56/2019_07_03_21_54.mpg;Shinzo ABE.jpg;77461;77845;97169;3876;3895;19
/net/per610a/home/mvp/mvp_db/hodost-lv/2019/2019_07_03_04_56/2019_07_03_21_54.mpg;Shinzo ABE.jpg;78221;78233;97169;3914;3915;1
/net/per610a/home/mvp/mvp_db/hodost-lv/2019/2019_07_03_04_56/2019_07_03_21_54.mpg;Natsuo YAMAGUCHI.jpg;32969;33665;97169;1649;1684;35
/net/per610a/home/mvp/mvp_db/hodost-lv/2019/2019_07_03_04_56/2019_07_03_21_54.mpg;Natsuo YAMAGUCHI.jpg;47037;47481;97169;2354;2376;22
/net/per610a/home/mvp/mvp_db/hodost-lv/2019/2019_07_03_04_56/2019_07_03_21_54.mpg;Kazuo SHII.jpg;47593;47793;97169;2381;2391;10
/net/per610a/home/mvp/mvp_db/hodost-lv/2019/2019_07_03_04_56/2019_07_03_21_54.mpg;Kazuo SHII.jpg;47925;48177;97169;2398;2411;13
/net/per610a/home/mvp/mvp_db/hodost-lv/2019/2019_07_03_04_56/2019_07_03_21_54.mpg;Kazuo SHII.jpg;48257;48389;97169;2415;2421;6
/net/per610a/home/mvp/mvp_db/hodost-lv/2019/2019_07_03_04_56/2019_07_03_21_54.mpg;Kazuo SHII.jpg;48553;48629;97169;2429;2433;4
/net/per610a/home/mvp/mvp_db/hodost-lv/2019/2019_07_03_04_56/2019_07_03_21_54.mpg;Kazuo SHII.jpg;49929;50001;97169;2498;2502;4
/net/per610a/home/mvp/mvp_db/hodost-lv/2019/2019_07_03_04_56/2019_07_03_21_54.mpg;Kazuo SHII.jpg;50205;50269;97169;2512;2515;3
/net/per610a/home/mvp/mvp_db/hodost-lv/2019/2019_07_03_04_56/2019_07_03_21_54.mpg;Kazuo SHII.jpg;56665;56921;97169;2835;2848;13
/net/per610a/home/mvp/mvp_db/hodost-lv/2019/2019_07_03_04_56/2019_07_03_21_54.mpg;Kazuo SHII.jpg;64641;64981;97169;3235;3252;17
/net/per610a/home/mvp/mvp_db/hodost-lv/2019/2019_07_04_04_56/2019_07_04_21_54.mpg;Shinzo ABE.jpg;18145;18853;97161;907;943;36
/net/per610a/home/mvp/mvp_db/hodost-lv/2019/2019_07_04_04_56/2019_07_04_21_54.mpg;Shinzo ABE.jpg;45129;45621;97161;2258;2282;24
/net/per610a/home/mvp/mvp_db/hodost-lv/2019/2019_07_04_04_56/2019_07_04_21_54.mpg;Yukio EDANO.jpg;20129;20433;97161;1007;1022;15
/net/per610a/home/mvp/mvp_db/hodost-lv/2019/2019_07_06_04_56/2019_07_06_20_54.mpg;Shinzo ABE.jpg;57645;57697;91161;2884;2887;3
/net/per610a/home/mvp/mvp_db/hodost-lv/2019/2019_07_06_04_56/2019_07_06_20_54.mpg;Shinzo ABE.jpg;58813;58937;91161;2943;2949;6
/net/per610a/home/mvp/mvp_db/hodost-lv/2019/2019_07_08_04_56/2019_07_08_21_54.mpg;Natsuo YAMAGUCHI.jpg;15865;16241;97161;793;812;19
/net/per610a/home/mvp/mvp_db/hodost-lv/2019/2019_07_09_04_56/2019_07_09_21_54.mpg;Shinzo ABE.jpg;32681;32765;97169;1635;1639;4
/net/per610a/home/mvp/mvp_db/hodost-lv/2019/2019_07_09_04_56/2019_07_09_21_54.mpg;Shinzo ABE.jpg;35989;36325;97169;1801;1817;16
/net/per610a/home/mvp/mvp_db/hodost-lv/2019/2019_07_15_04_56/2019_07_15_21_54.mpg;Natsuo YAMAGUCHI.jpg;20841;21065;97161;1042;1054;12
/net/per610a/home/mvp/mvp_db/hodost-lv/2019/2019_07_15_04_56/2019_07_15_21_54.mpg;Shinzo ABE.jpg;44405;44453;97161;2222;2224;2
/net/per610a/home/mvp/mvp_db/hodost-lv/2019/2019_07_15_04_56/2019_07_15_21_54.mpg;Shinzo ABE.jpg;44625;44729;97161;2233;2238;5
/net/per610a/home/mvp/mvp_db/hodost-lv/2019/2019_07_16_04_56/2019_07_16_21_54.mpg;Kohei Otsuka.jpg;25597;25605;97169;1281;1281;0
/net/per610a/home/mvp/mvp_db/hodost-lv/2019/2019_07_16_04_56/2019_07_16_21_54.mpg;Kohei Otsuka.jpg;55557;55697;97169;2780;2787;7
/net/per610a/home/mvp/mvp_db/hodost-lv/2019/2019_07_16_04_56/2019_07_16_21_54.mpg;Kohei Otsuka.jpg;62645;62821;97169;3135;3143;8
/net/per610a/home/mvp/mvp_db/hodost-lv/2019/2019_07_18_04_56/2019_07_18_21_54.mpg;Yukio EDANO.jpg;52933;54209;97161;2648;2712;64
/net/per610a/home/mvp/mvp_db/hodost-lv/2019/2019_07_19_04_56/2019_07_19_22_24.mpg;Shinzo ABE.jpg;34577;35077;91169;1730;1755;25
/net/per610a/home/mvp/mvp_db/hodost-lv/2019/2019_07_19_04_56/2019_07_19_22_24.mpg;Shinzo ABE.jpg;35185;35373;91169;1761;1770;9
/net/per610a/home/mvp/mvp_db/hodost-lv/2019/2019_07_19_04_56/2019_07_19_22_24.mpg;Yukio EDANO.jpg;35577;36661;91169;1780;1834;54
/net/per610a/home/mvp/mvp_db/hodost-lv/2019/2019_07_19_04_56/2019_07_19_22_24.mpg;Ichiro Matsui.jpeg;37529;37553;91169;1878;1879;1
/net/per610a/home/mvp/mvp_db/hodost-lv/2019/2019_07_19_04_56/2019_07_19_22_24.mpg;Ichiro Matsui.jpeg;37657;37721;91169;1884;1887;3
/net/per610a/home/mvp/mvp_db/hodost-lv/2019/2019_07_22_04_56/2019_07_22_21_54.mpg;Shinzo ABE.jpg;20761;21057;97161;1038;1053;15
/net/per610a/home/mvp/mvp_db/hodost-lv/2019/2019_07_22_04_56/2019_07_22_21_54.mpg;Shinzo ABE.jpg;21289;21517;97161;1065;1076;11
/net/per610a/home/mvp/mvp_db/hodost-lv/2019/2019_07_22_04_56/2019_07_22_21_54.mpg;Shinzo ABE.jpg;23065;23177;97161;1154;1159;5
/net/per610a/home/mvp/mvp_db/hodost-lv/2019/2019_07_22_04_56/2019_07_22_21_54.mpg;Shinzo ABE.jpg;45549;45725;97161;2279;2288;9
/net/per610a/home/mvp/mvp_db/hodost-lv/2019/2019_07_22_04_56/2019_07_22_21_54.mpg;Taro Yamamoto.jpg;25749;26105;97161;1288;1306;18
/net/per610a/home/mvp/mvp_db/hodost-lv/2019/2019_07_22_04_56/2019_07_22_21_54.mpg;Taro Yamamoto.jpg;27417;27833;97161;1371;1392;21
/net/per610a/home/mvp/mvp_db/hodost-lv/2019/2019_07_22_04_56/2019_07_22_21_54.mpg;Yuichiro Tamaki.png;28469;28921;97161;1424;1447;23
/net/per610a/home/mvp/mvp_db/hodost-lv/2019/2019_07_30_04_56/2019_07_30_21_54.mpg;Yoshimi WATANABE.jpg;24033;24081;97161;1202;1205;3
/net/per610a/home/mvp/mvp_db/hodost-lv/2019/2019_07_30_04_56/2019_07_30_21_54.mpg;Yoshimi WATANABE.jpg;24165;24165;97161;1209;1209;0
/net/per610a/home/mvp/mvp_db/hodost-lv/2019/2019_07_30_04_56/2019_07_30_21_54.mpg;Yoshimi WATANABE.jpg;24393;24529;97161;1220;1227;7
/net/per610a/home/mvp/mvp_db/hodost-lv/2019/2019_07_30_04_56/2019_07_30_21_54.mpg;Yoshimi WATANABE.jpg;25113;25269;97161;1256;1264;8
/net/per610a/home/mvp/mvp_db/hodost-lv/2019/2019_07_30_04_56/2019_07_30_21_54.mpg;Yoshimi WATANABE.jpg;25489;25661;97161;1275;1284;9
/net/per610a/home/mvp/mvp_db/hodost-lv/2019/2019_07_30_04_56/2019_07_30_21_54.mpg;Yoshimi WATANABE.jpg;26321;26489;97161;1317;1325;8
/net/per610a/home/mvp/mvp_db/hodost-lv/2019/2019_07_30_04_56/2019_07_30_21_54.mpg;Yoshimi WATANABE.jpg;28905;28937;97161;1446;1448;2
/net/per610a/home/mvp/mvp_db/hodost-lv/2019/2019_07_30_04_56/2019_07_30_21_54.mpg;Yoshimi WATANABE.jpg;30137;30185;97161;1508;1510;2
/net/per610a/home/mvp/mvp_db/hodost-lv/2019/2019_07_30_04_56/2019_07_30_21_54.mpg;Yoshimi WATANABE.jpg;30321;30397;97161;1517;1521;4
/net/per610a/home/mvp/mvp_db/hodost-lv/2019/2019_07_31_04_56/2019_07_31_21_54.mpg;Shinzo ABE.jpg;26485;26525;97161;1325;1327;2
/net/per610a/home/mvp/mvp_db/hodost-lv/2019/2019_07_31_04_56/2019_07_31_21_54.mpg;Shinzo ABE.jpg;31313;31545;97161;1566;1578;12
/net/per610a/home/mvp/mvp_db/hodost-lv/2019/2019_07_31_04_56/2019_07_31_21_54.mpg;Shinzo ABE.jpg;50341;50649;97161;2519;2534;15
/net/per610a/home/mvp/mvp_db/hodost-lv/2019/2019_08_01_04_56/2019_08_01_21_54.mpg;Taro Yamamoto.jpg;8097;8589;97161;405;429;24
/net/per610a/home/mvp/mvp_db/hodost-lv/2019/2019_08_01_04_56/2019_08_01_21_54.mpg;Shinzo ABE.jpg;9609;10089;97161;480;504;24
/net/per610a/home/mvp/mvp_db/hodost-lv/2019/2019_08_01_04_56/2019_08_01_21_54.mpg;Yukio EDANO.jpg;13549;13637;97161;678;682;4
/net/per610a/home/mvp/mvp_db/hodost-lv/2019/2019_08_02_04_56/2019_08_02_21_54.mpg;Shinzo ABE.jpg;18197;18441;91169;910;922;12
/net/per610a/home/mvp/mvp_db/hodost-lv/2019/2019_08_02_04_56/2019_08_02_21_54.mpg;Shinzo ABE.jpg;24573;24597;91169;1229;1231;2
/net/per610a/home/mvp/mvp_db/hodost-lv/2019/2019_08_02_04_56/2019_08_02_21_54.mpg;Shinzo ABE.jpg;30849;31389;91169;1543;1571;28
/net/per610a/home/mvp/mvp_db/hodost-lv/2019/2019_08_02_04_56/2019_08_02_21_54.mpg;Shinzo ABE.jpg;43273;43437;91169;2165;2174;9
/net/per610a/home/mvp/mvp_db/hodost-lv/2019/2019_08_02_04_56/2019_08_02_21_54.mpg;Shinzo ABE.jpg;43581;43649;91169;2181;2184;3
/net/per610a/home/mvp/mvp_db/hodost-lv/2019/2019_08_03_04_56/2019_08_03_20_54.mpg;Shinzo ABE.jpg;42109;42549;91169;2107;2129;22
/net/per610a/home/mvp/mvp_db/hodost-lv/2019/2019_08_06_04_56/2019_08_06_21_54.mpg;Shinzo ABE.jpg;16593;16921;97161;830;846;16
/net/per610a/home/mvp/mvp_db/hodost-lv/2019/2019_08_06_04_56/2019_08_06_21_54.mpg;Shinzo ABE.jpg;59465;60073;97161;2975;3006;31
/net/per610a/home/mvp/mvp_db/hodost-lv/2019/2019_08_07_04_56/2019_08_07_21_54.mpg;Shinzo ABE.jpg;40825;40853;97169;2043;2044;1
/net/per610a/home/mvp/mvp_db/hodost-lv/2019/2019_08_07_04_56/2019_08_07_21_54.mpg;Shinzo ABE.jpg;44777;44869;97169;2240;2245;5
/net/per610a/home/mvp/mvp_db/hodost-lv/2019/2019_08_09_04_56/2019_08_09_21_54.mpg;Shinzo ABE.jpg;29365;29885;91169;1469;1495;26
/net/per610a/home/mvp/mvp_db/hodost-lv/2019/2019_08_10_04_56/2019_08_10_22_00.mpg;Shinzo ABE.jpg;42549;42685;83969;2129;2136;7
/net/per610a/home/mvp/mvp_db/hodost-lv/2019/2019_08_10_04_56/2019_08_10_22_00.mpg;Shinzo ABE.jpg;46169;46265;83969;2310;2315;5
/net/per610a/home/mvp/mvp_db/hodost-lv/2019/2019_08_18_04_56/2019_08_18_16_30.mpg;Shinzo ABE.jpg;103345;103377;107949;5171;5173;2
/net/per610a/home/mvp/mvp_db/hodost-lv/2019/2019_08_18_04_56/2019_08_18_16_30.mpg;Shinzo ABE.jpg;103717;103953;107949;5190;5202;12
/net/per610a/home/mvp/mvp_db/hodost-lv/2019/2019_08_20_04_56/2019_08_20_21_54.mpg;Yukio EDANO.jpg;51401;51465;97169;2572;2575;3
/net/per610a/home/mvp/mvp_db/hodost-lv/2019/2019_08_20_04_56/2019_08_20_21_54.mpg;Yukio EDANO.jpg;52029;52125;97169;2603;2608;5
/net/per610a/home/mvp/mvp_db/hodost-lv/2019/2019_08_20_04_56/2019_08_20_21_54.mpg;Yukio EDANO.jpg;53069;53149;97169;2655;2659;4
/net/per610a/home/mvp/mvp_db/hodost-lv/2019/2019_08_22_04_56/2019_08_22_21_54.mpg;Shinzo ABE.jpg;2865;2937;97161;143;146;3
/net/per610a/home/mvp/mvp_db/hodost-lv/2019/2019_08_22_04_56/2019_08_22_21_54.mpg;Shinzo ABE.jpg;11705;11785;97161;585;589;4
/net/per610a/home/mvp/mvp_db/hodost-lv/2019/2019_08_22_04_56/2019_08_22_21_54.mpg;Shinzo ABE.jpg;13729;13773;97161;687;689;2
/net/per610a/home/mvp/mvp_db/hodost-lv/2019/2019_08_22_04_56/2019_08_22_21_54.mpg;Shinzo ABE.jpg;13893;13973;97161;695;699;4
/net/per610a/home/mvp/mvp_db/hodost-lv/2019/2019_08_22_04_56/2019_08_22_21_54.mpg;Shinzo ABE.jpg;23105;23265;97161;1156;1164;8
/net/per610a/home/mvp/mvp_db/hodost-lv/2019/2019_08_22_04_56/2019_08_22_21_54.mpg;Shinzo ABE.jpg;23413;23469;97161;1171;1174;3
/net/per610a/home/mvp/mvp_db/hodost-lv/2019/2019_08_22_04_56/2019_08_22_21_54.mpg;Shinzo ABE.jpg;23537;23833;97161;1177;1192;15
/net/per610a/home/mvp/mvp_db/hodost-lv/2019/2019_08_22_04_56/2019_08_22_21_54.mpg;Shinzo ABE.jpg;12749;12829;97161;637;641;4
/net/per610a/home/mvp/mvp_db/hodost-lv/2019/2019_08_23_04_56/2019_08_23_21_54.mpg;Shinzo ABE.jpg;5037;5589;91169;252;279;27
/net/per610a/home/mvp/mvp_db/hodost-lv/2019/2019_08_23_04_56/2019_08_23_21_54.mpg;Shinzo ABE.jpg;8673;8821;91169;434;441;7
/net/per610a/home/mvp/mvp_db/hodost-lv/2019/2019_08_23_04_56/2019_08_23_21_54.mpg;Shinzo ABE.jpg;41553;41701;91169;2079;2087;8
/net/per610a/home/mvp/mvp_db/hodost-lv/2019/2019_08_23_04_56/2019_08_23_21_54.mpg;Shinzo ABE.jpg;41765;41873;91169;2090;2095;5
/net/per610a/home/mvp/mvp_db/hodost-lv/2019/2019_08_23_04_56/2019_08_23_21_54.mpg;Shinzo ABE.jpg;42141;42613;91169;2109;2132;23
/net/per610a/home/mvp/mvp_db/hodost-lv/2019/2019_08_26_04_56/2019_08_26_21_54.mpg;Shinzo ABE.jpg;10721;11265;97161;536;563;27
/net/per610a/home/mvp/mvp_db/hodost-lv/2019/2019_08_26_04_56/2019_08_26_21_54.mpg;Shinzo ABE.jpg;11445;11873;97161;572;594;22
/net/per610a/home/mvp/mvp_db/hodost-lv/2019/2019_08_26_04_56/2019_08_26_21_54.mpg;Shinzo ABE.jpg;13121;13229;97161;656;661;5
/net/per610a/home/mvp/mvp_db/hodost-lv/2019/2019_08_26_04_56/2019_08_26_21_54.mpg;Shinzo ABE.jpg;13301;13513;97161;665;676;11
/net/per610a/home/mvp/mvp_db/hodost-lv/2019/2019_08_26_04_56/2019_08_26_21_54.mpg;Shinzo ABE.jpg;14049;14125;97161;703;706;3
/net/per610a/home/mvp/mvp_db/hodost-lv/2019/2019_08_26_04_56/2019_08_26_21_54.mpg;Shinzo ABE.jpg;15793;15809;97161;790;791;1
/net/per610a/home/mvp/mvp_db/hodost-lv/2019/2019_08_26_04_56/2019_08_26_21_54.mpg;Shinzo ABE.jpg;23185;23217;97161;1160;1161;1
/net/per610a/home/mvp/mvp_db/hodost-lv/2019/2019_08_26_04_56/2019_08_26_21_54.mpg;Shinzo ABE.jpg;23433;23721;97161;1172;1187;15
/net/per610a/home/mvp/mvp_db/hodost-lv/2019/2019_08_28_04_56/2019_08_28_21_54.mpg;Shinzo ABE.jpg;39597;39685;97161;1981;1985;4
/net/per610a/home/mvp/mvp_db/hodost-lv/2019/2019_08_28_04_56/2019_08_28_21_54.mpg;Shinzo ABE.jpg;42637;42837;97161;2133;2143;10
/net/per610a/home/mvp/mvp_db/hodost-lv/2019/2019_08_28_04_56/2019_08_28_21_54.mpg;Shinzo ABE.jpg;53761;53801;97161;2690;2692;2
/net/per610a/home/mvp/mvp_db/hodost-lv/2019/2019_08_28_04_56/2019_08_28_21_54.mpg;Shinzo ABE.jpg;55545;55581;97161;2779;2781;2
/net/per610a/home/mvp/mvp_db/hodost-lv/2019/2019_08_28_04_56/2019_08_28_21_54.mpg;Shinzo ABE.jpg;56181;56313;97161;2811;2817;6
/net/per610a/home/mvp/mvp_db/hodost-lv/2019/2019_08_28_04_56/2019_08_28_21_54.mpg;Shinzo ABE.jpg;56577;56805;97161;2831;2842;11
/net/per610a/home/mvp/mvp_db/hodost-lv/2019/2019_08_31_04_56/2019_08_31_20_54.mpg;Shinzo ABE.jpg;27745;27917;91169;1388;1397;9
/net/per610a/home/mvp/mvp_db/hodost-lv/2019/2019_08_31_04_56/2019_08_31_20_54.mpg;Shinzo ABE.jpg;29129;29285;91169;1457;1465;8
/net/per610a/home/mvp/mvp_db/hodost-lv/2019/2019_09_04_04_56/2019_09_04_21_54.mpg;Shinzo ABE.jpg;62093;62285;97161;3107;3116;9
/net/per610a/home/mvp/mvp_db/hodost-lv/2019/2019_09_05_04_56/2019_09_05_21_54.mpg;Shinzo ABE.jpg;51197;51449;97161;2561;2574;13
/net/per610a/home/mvp/mvp_db/hodost-lv/2019/2019_09_05_04_56/2019_09_05_21_54.mpg;Shinzo ABE.jpg;52945;52989;97161;2649;2651;2
/net/per610a/home/mvp/mvp_db/hodost-lv/2019/2019_09_05_04_56/2019_09_05_21_54.mpg;Shinzo ABE.jpg;54569;54633;97161;2730;2733;3
/net/per610a/home/mvp/mvp_db/hodost-lv/2019/2019_09_05_04_56/2019_09_05_21_54.mpg;Shinzo ABE.jpg;56021;56085;97161;2803;2806;3
/net/per610a/home/mvp/mvp_db/hodost-lv/2019/2019_09_05_04_56/2019_09_05_21_54.mpg;Shinzo ABE.jpg;56201;56353;97161;2812;2819;7
/net/per610a/home/mvp/mvp_db/hodost-lv/2019/2019_09_06_04_56/2019_09_06_21_54.mpg;Shinzo ABE.jpg;37021;37209;91169;1852;1862;10
/net/per610a/home/mvp/mvp_db/hodost-lv/2019/2019_09_08_04_56/2019_09_08_16_30.mpg;Shinzo ABE.jpg;100161;100745;107949;5012;5041;29
/net/per610a/home/mvp/mvp_db/hodost-lv/2019/2019_09_08_04_56/2019_09_08_16_30.mpg;Shinzo ABE.jpg;100977;101161;107949;5053;5062;9
/net/per610a/home/mvp/mvp_db/hodost-lv/2019/2019_09_09_04_56/2019_09_09_21_54.mpg;Taro ASO.jpg;47841;48145;97161;2393;2409;16
/net/per610a/home/mvp/mvp_db/hodost-lv/2019/2019_09_09_04_56/2019_09_09_21_54.mpg;Ichiro OZAWA.jpg;47841;48145;97161;2393;2409;16
/net/per610a/home/mvp/mvp_db/hodost-lv/2019/2019_09_09_04_56/2019_09_09_21_54.mpg;Ichiro OZAWA.jpg;51057;51173;97161;2554;2560;6
/net/per610a/home/mvp/mvp_db/hodost-lv/2019/2019_09_11_04_56/2019_09_11_21_54.mpg;Shinzo ABE.jpg;24837;25405;97169;1243;1271;28
/net/per610a/home/mvp/mvp_db/hodost-lv/2019/2019_09_11_04_56/2019_09_11_21_54.mpg;Shinzo ABE.jpg;30573;30693;97169;1530;1536;6
/net/per610a/home/mvp/mvp_db/hodost-lv/2019/2019_09_11_04_56/2019_09_11_21_54.mpg;Taro ASO.jpg;25873;25917;97169;1294;1297;3
/net/per610a/home/mvp/mvp_db/hodost-lv/2019/2019_09_11_04_56/2019_09_11_21_54.mpg;Taro ASO.jpg;41761;41821;97169;2090;2093;3
/net/per610a/home/mvp/mvp_db/hodost-lv/2019/2019_09_11_04_56/2019_09_11_21_54.mpg;Yuichiro Tamaki.png;32141;32345;97169;1608;1618;10
/net/per610a/home/mvp/mvp_db/hodost-lv/2019/2019_09_11_04_56/2019_09_11_21_54.mpg;Shinzo ABE.jpg;33393;34077;97169;1671;1705;34
/net/per610a/home/mvp/mvp_db/hodost-lv/2019/2019_09_11_04_56/2019_09_11_21_54.mpg;Shinzo ABE.jpg;59609;59701;97169;2983;2987;4
/net/per610a/home/mvp/mvp_db/hodost-lv/2019/2019_09_11_04_56/2019_09_11_21_54.mpg;Shinzo ABE.jpg;34125;34125;97169;1707;1707;0
/net/per610a/home/mvp/mvp_db/hodost-lv/2019/2019_09_11_04_56/2019_09_11_21_54.mpg;Shinzo ABE.jpg;34281;34397;97169;1715;1721;6
/net/per610a/home/mvp/mvp_db/hodost-lv/2019/2019_09_17_04_56/2019_09_17_21_54.mpg;Shintaro ISHIHARA.jpg;1765;2069;97169;88;103;15
/net/per610a/home/mvp/mvp_db/hodost-lv/2019/2019_09_18_04_56/2019_09_18_22_09.mpg;Shinzo ABE.jpg;39877;39985;97169;1995;2001;6
/net/per610a/home/mvp/mvp_db/hodost-lv/2019/2019_09_18_04_56/2019_09_18_22_09.mpg;Shinzo ABE.jpg;51889;52281;97169;2596;2616;20
/net/per610a/home/mvp/mvp_db/hodost-lv/2019/2019_09_18_04_56/2019_09_18_22_09.mpg;Shinzo ABE.jpg;52473;52493;97169;2626;2627;1
/net/per610a/home/mvp/mvp_db/hodost-lv/2019/2019_09_19_04_56/2019_09_19_21_54.mpg;Yukio EDANO.jpg;59225;59541;97161;2963;2979;16
/net/per610a/home/mvp/mvp_db/hodost-lv/2019/2019_09_20_04_56/2019_09_20_21_54.mpg;Shinzo ABE.jpg;48065;48221;91169;2405;2413;8
/net/per610a/home/mvp/mvp_db/hodost-lv/2019/2019_09_20_04_56/2019_09_20_21_54.mpg;Shinzo ABE.jpg;50985;51285;91169;2551;2566;15
/net/per610a/home/mvp/mvp_db/hodost-lv/2019/2019_09_23_04_56/2019_09_23_21_54.mpg;Shinzo ABE.jpg;35645;35721;97161;1783;1787;4
/net/per610a/home/mvp/mvp_db/hodost-lv/2019/2019_09_23_04_56/2019_09_23_21_54.mpg;Shinzo ABE.jpg;37369;37477;97161;1869;1875;6
/net/per610a/home/mvp/mvp_db/hodost-lv/2019/2019_09_23_04_56/2019_09_23_21_54.mpg;Shinzo ABE.jpg;37605;37857;97161;1881;1894;13
/net/per610a/home/mvp/mvp_db/hodost-lv/2019/2019_09_23_04_56/2019_09_23_21_54.mpg;Shinzo ABE.jpg;38157;38253;97161;1909;1914;5
/net/per610a/home/mvp/mvp_db/hodost-lv/2019/2019_09_24_04_56/2019_09_24_21_54.mpg;Shinzo ABE.jpg;25577;25909;97169;1280;1296;16
/net/per610a/home/mvp/mvp_db/hodost-lv/2019/2019_09_25_04_56/2019_09_25_21_54.mpg;Shinzo ABE.jpg;41753;42001;97169;2089;2102;13
/net/per610a/home/mvp/mvp_db/hodost-lv/2019/2019_09_25_04_56/2019_09_25_21_54.mpg;Shinzo ABE.jpg;43213;43521;97169;2162;2178;16
/net/per610a/home/mvp/mvp_db/hodost-lv/2019/2019_09_25_04_56/2019_09_25_21_54.mpg;Shinzo ABE.jpg;44329;44365;97169;2218;2220;2
/net/per610a/home/mvp/mvp_db/hodost-lv/2019/2019_09_25_04_56/2019_09_25_21_54.mpg;Shinzo ABE.jpg;44541;44817;97169;2229;2242;13
/net/per610a/home/mvp/mvp_db/hodost-lv/2019/2019_09_26_04_56/2019_09_26_21_54.mpg;Shinzo ABE.jpg;14861;15193;97161;743;760;17
/net/per610a/home/mvp/mvp_db/hodost-lv/2019/2019_09_26_04_56/2019_09_26_21_54.mpg;Shinzo ABE.jpg;15573;15637;97161;779;782;3
/net/per610a/home/mvp/mvp_db/hodost-lv/2019/2019_09_26_04_56/2019_09_26_21_54.mpg;Shinzo ABE.jpg;15701;15785;97161;785;789;4
/net/per610a/home/mvp/mvp_db/hodost-lv/2019/2019_09_26_04_56/2019_09_26_21_54.mpg;Shinzo ABE.jpg;18581;18617;97161;929;931;2
/net/per610a/home/mvp/mvp_db/hodost-lv/2019/2019_09_26_04_56/2019_09_26_21_54.mpg;Shinzo ABE.jpg;90957;90989;97161;4551;4553;2
/net/per610a/home/mvp/mvp_db/hodost-lv/2019/2019_09_26_04_56/2019_09_26_21_54.mpg;Shinzo ABE.jpg;24257;24309;97161;1213;1216;3
/net/per610a/home/mvp/mvp_db/hodost-lv/2019/2019_09_26_04_56/2019_09_26_21_54.mpg;Shinzo ABE.jpg;25089;25141;97161;1255;1258;3
/net/per610a/home/mvp/mvp_db/hodost-lv/2019/2019_09_28_04_56/2019_09_28_20_54.mpg;Shinzo ABE.jpg;136625;136681;163089;6837;6840;3
/net/per610a/home/mvp/mvp_db/hodost-lv/2019/2019_09_28_04_56/2019_09_28_20_54.mpg;Shinzo ABE.jpg;146589;146717;163089;7336;7342;6
/net/per610a/home/mvp/mvp_db/hodost-lv/2019/2019_09_29_04_56/2019_09_29_16_30.mpg;Shinzo ABE.jpg;37345;37509;107949;1868;1877;9
/net/per610a/home/mvp/mvp_db/hodost-lv/2019/2019_09_29_04_56/2019_09_29_16_30.mpg;Shinzo ABE.jpg;37809;38017;107949;1892;1902;10
/net/per610a/home/mvp/mvp_db/hodost-lv/2019/2019_09_29_04_56/2019_09_29_16_30.mpg;Taro ASO.jpg;103817;104045;107949;5195;5206;11
/net/per610a/home/mvp/mvp_db/hodost-lv/2019/2019_10_01_04_56/2019_10_01_21_54.mpg;Shinzo ABE.jpg;14705;14745;91169;735;737;2
/net/per610a/home/mvp/mvp_db/hodost-lv/2019/2019_10_01_04_56/2019_10_01_21_54.mpg;Shinzo ABE.jpg;24085;24161;91169;1205;1209;4
/net/per610a/home/mvp/mvp_db/hodost-lv/2019/2019_10_01_04_56/2019_10_01_21_54.mpg;Shinzo ABE.jpg;29705;30009;91169;1486;1501;15
/net/per610a/home/mvp/mvp_db/hodost-lv/2019/2019_10_01_04_56/2019_10_01_21_54.mpg;Taro ASO.jpg;24213;24621;91169;1211;1232;21
/net/per610a/home/mvp/mvp_db/hodost-lv/2019/2019_10_02_04_56/2019_10_02_21_54.mpg;Shinzo ABE.jpg;29149;29533;91169;1458;1478;20
/net/per610a/home/mvp/mvp_db/hodost-lv/2019/2019_10_04_04_56/2019_10_04_21_54.mpg;Yuichiro Tamaki.png;22465;22877;91169;1124;1144;20
/net/per610a/home/mvp/mvp_db/hodost-lv/2019/2019_10_04_04_56/2019_10_04_21_54.mpg;Yuichiro Tamaki.png;27949;28025;91169;1398;1402;4
/net/per610a/home/mvp/mvp_db/hodost-lv/2019/2019_10_04_04_56/2019_10_04_21_54.mpg;Yukio EDANO.jpg;22465;22465;91169;1124;1124;0
/net/per610a/home/mvp/mvp_db/hodost-lv/2019/2019_10_04_04_56/2019_10_04_21_54.mpg;Yukio EDANO.jpg;27945;28029;91169;1398;1402;4
/net/per610a/home/mvp/mvp_db/hodost-lv/2019/2019_10_04_04_56/2019_10_04_21_54.mpg;Yukio EDANO.jpg;28169;28341;91169;1409;1418;9
/net/per610a/home/mvp/mvp_db/hodost-lv/2019/2019_10_04_04_56/2019_10_04_21_54.mpg;Shinzo ABE.jpg;27317;27433;91169;1367;1373;6
/net/per610a/home/mvp/mvp_db/hodost-lv/2019/2019_10_04_04_56/2019_10_04_21_54.mpg;Shinzo ABE.jpg;27549;27913;91169;1378;1397;19
/net/per610a/home/mvp/mvp_db/hodost-lv/2019/2019_10_07_04_56/2019_10_07_21_54.mpg;Shinzo ABE.jpg;26041;26329;91169;1303;1317;14
/net/per610a/home/mvp/mvp_db/hodost-lv/2019/2019_10_07_04_56/2019_10_07_21_54.mpg;Yukio EDANO.jpg;26849;27009;91169;1343;1351;8
/net/per610a/home/mvp/mvp_db/hodost-lv/2019/2019_10_10_04_56/2019_10_10_21_37.mpg;Shinzo ABE.jpg;51765;51897;111549;2590;2597;7
/net/per610a/home/mvp/mvp_db/hodost-lv/2019/2019_10_10_04_56/2019_10_10_21_37.mpg;Shinzo ABE.jpg;52169;52289;111549;2611;2617;6
/net/per610a/home/mvp/mvp_db/hodost-lv/2019/2019_10_10_04_56/2019_10_10_21_37.mpg;Shinzo ABE.jpg;53405;53441;111549;2672;2674;2
/net/per610a/home/mvp/mvp_db/hodost-lv/2019/2019_10_10_04_56/2019_10_10_21_37.mpg;Shinzo ABE.jpg;58445;58529;111549;2925;2929;4
/net/per610a/home/mvp/mvp_db/hodost-lv/2019/2019_10_10_04_56/2019_10_10_21_37.mpg;Yuichiro Tamaki.png;52893;53393;111549;2647;2672;25
/net/per610a/home/mvp/mvp_db/hodost-lv/2019/2019_10_17_04_56/2019_10_17_22_09.mpg;Shinzo ABE.jpg;1073;1413;91169;53;70;17
/net/per610a/home/mvp/mvp_db/hodost-lv/2019/2019_10_17_04_56/2019_10_17_22_09.mpg;Shinzo ABE.jpg;73797;73897;91169;3693;3698;5
/net/per610a/home/mvp/mvp_db/hodost-lv/2019/2019_10_18_04_56/2019_10_18_21_54.mpg;YUriko Koike.jpg;45153;45429;91169;2259;2273;14
/net/per610a/home/mvp/mvp_db/hodost-lv/2019/2019_10_18_04_56/2019_10_18_21_54.mpg;YUriko Koike.jpg;48813;49169;91169;2443;2460;17
/net/per610a/home/mvp/mvp_db/hodost-lv/2019/2019_10_22_04_56/2019_10_22_21_54.mpg;Shinzo ABE.jpg;68993;69069;91169;3453;3456;3
/net/per610a/home/mvp/mvp_db/hodost-lv/2019/2019_10_22_04_56/2019_10_22_21_54.mpg;Shinzo ABE.jpg;69233;69293;91169;3465;3468;3
/net/per610a/home/mvp/mvp_db/hodost-lv/2019/2019_10_23_04_56/2019_10_23_21_54.mpg;Shinzo ABE.jpg;36221;36229;91169;1812;1813;1
/net/per610a/home/mvp/mvp_db/hodost-lv/2019/2019_10_23_04_56/2019_10_23_21_54.mpg;Shinzo ABE.jpg;36577;36585;91169;1830;1831;1
/net/per610a/home/mvp/mvp_db/hodost-lv/2019/2019_10_23_04_56/2019_10_23_21_54.mpg;Shinzo ABE.jpg;36701;36753;91169;1836;1839;3
/net/per610a/home/mvp/mvp_db/hodost-lv/2019/2019_10_23_04_56/2019_10_23_21_54.mpg;Shinzo ABE.jpg;37409;37425;91169;1872;1873;1
/net/per610a/home/mvp/mvp_db/hodost-lv/2019/2019_10_24_04_56/2019_10_24_22_09.mpg;Shinzo ABE.jpg;41549;41625;91169;2079;2083;4
/net/per610a/home/mvp/mvp_db/hodost-lv/2019/2019_10_24_04_56/2019_10_24_22_09.mpg;Shinzo ABE.jpg;44249;44325;91169;2214;2218;4
/net/per610a/home/mvp/mvp_db/hodost-lv/2019/2019_10_24_04_56/2019_10_24_22_09.mpg;Shinzo ABE.jpg;44569;44661;91169;2230;2235;5
/net/per610a/home/mvp/mvp_db/hodost-lv/2019/2019_10_24_04_56/2019_10_24_22_09.mpg;Shinzo ABE.jpg;45785;45801;91169;2291;2292;1
/net/per610a/home/mvp/mvp_db/hodost-lv/2019/2019_10_24_04_56/2019_10_24_22_09.mpg;Shinzo ABE.jpg;45873;45929;91169;2295;2298;3
/net/per610a/home/mvp/mvp_db/hodost-lv/2019/2019_10_24_04_56/2019_10_24_22_09.mpg;Shinzo ABE.jpg;46485;46553;91169;2326;2329;3
/net/per610a/home/mvp/mvp_db/hodost-lv/2019/2019_10_24_04_56/2019_10_24_22_09.mpg;Shinzo ABE.jpg;46949;47101;91169;2349;2357;8
/net/per610a/home/mvp/mvp_db/hodost-lv/2019/2019_10_25_04_56/2019_10_25_21_54.mpg;YUriko Koike.jpg;53613;53801;91169;2683;2692;9
/net/per610a/home/mvp/mvp_db/hodost-lv/2019/2019_10_26_04_56/2019_10_26_20_54.mpg;YUriko Koike.jpg;18477;18505;91161;924;926;2
/net/per610a/home/mvp/mvp_db/hodost-lv/2019/2019_10_26_04_56/2019_10_26_20_54.mpg;YUriko Koike.jpg;21849;21917;91161;1093;1096;3
/net/per610a/home/mvp/mvp_db/hodost-lv/2019/2019_10_26_04_56/2019_10_26_20_54.mpg;YUriko Koike.jpg;25233;25289;91161;1262;1265;3
/net/per610a/home/mvp/mvp_db/hodost-lv/2019/2019_10_26_04_56/2019_10_26_20_54.mpg;YUriko Koike.jpg;26561;26661;91161;1329;1334;5
/net/per610a/home/mvp/mvp_db/hodost-lv/2019/2019_10_26_04_56/2019_10_26_20_54.mpg;YUriko Koike.jpg;26813;27401;91161;1341;1371;30
/net/per610a/home/mvp/mvp_db/hodost-lv/2019/2019_10_26_04_56/2019_10_26_20_54.mpg;YUriko Koike.jpg;27513;27777;91161;1376;1390;14
/net/per610a/home/mvp/mvp_db/hodost-lv/2019/2019_10_26_04_56/2019_10_26_20_54.mpg;YUriko Koike.jpg;27969;28601;91161;1399;1431;32
/net/per610a/home/mvp/mvp_db/hodost-lv/2019/2019_10_26_04_56/2019_10_26_20_54.mpg;YUriko Koike.jpg;29029;29473;91161;1452;1474;22
/net/per610a/home/mvp/mvp_db/hodost-lv/2019/2019_10_26_04_56/2019_10_26_20_54.mpg;YUriko Koike.jpg;29625;30081;91161;1482;1505;23
/net/per610a/home/mvp/mvp_db/hodost-lv/2019/2019_10_26_04_56/2019_10_26_20_54.mpg;YUriko Koike.jpg;31873;32173;91161;1595;1610;15
/net/per610a/home/mvp/mvp_db/hodost-lv/2019/2019_10_26_04_56/2019_10_26_20_54.mpg;YUriko Koike.jpg;35633;36141;91161;1783;1808;25
/net/per610a/home/mvp/mvp_db/hodost-lv/2019/2019_10_26_04_56/2019_10_26_20_54.mpg;YUriko Koike.jpg;38033;38097;91161;1903;1906;3
/net/per610a/home/mvp/mvp_db/hodost-lv/2019/2019_10_26_04_56/2019_10_26_20_54.mpg;YUriko Koike.jpg;41049;41809;91161;2054;2092;38
/net/per610a/home/mvp/mvp_db/hodost-lv/2019/2019_10_26_04_56/2019_10_26_20_54.mpg;YUriko Koike.jpg;43405;43501;91161;2172;2176;4
/net/per610a/home/mvp/mvp_db/hodost-lv/2019/2019_10_26_04_56/2019_10_26_20_54.mpg;YUriko Koike.jpg;43761;44013;91161;2189;2202;13
/net/per610a/home/mvp/mvp_db/hodost-lv/2019/2019_10_26_04_56/2019_10_26_20_54.mpg;YUriko Koike.jpg;44121;44365;91161;2207;2220;13
/net/per610a/home/mvp/mvp_db/hodost-lv/2019/2019_10_26_04_56/2019_10_26_20_54.mpg;YUriko Koike.jpg;47201;47809;91161;2362;2392;30
/net/per610a/home/mvp/mvp_db/hodost-lv/2019/2019_10_26_04_56/2019_10_26_20_54.mpg;YUriko Koike.jpg;48029;48149;91161;2403;2409;6
/net/per610a/home/mvp/mvp_db/hodost-lv/2019/2019_10_26_04_56/2019_10_26_20_54.mpg;YUriko Koike.jpg;48705;49781;91161;2437;2491;54
/net/per610a/home/mvp/mvp_db/hodost-lv/2019/2019_10_26_04_56/2019_10_26_20_54.mpg;YUriko Koike.jpg;49989;50001;91161;2501;2502;1
/net/per610a/home/mvp/mvp_db/hodost-lv/2019/2019_10_26_04_56/2019_10_26_20_54.mpg;YUriko Koike.jpg;18677;18885;91161;934;945;11
/net/per610a/home/mvp/mvp_db/hodost-lv/2019/2019_10_26_04_56/2019_10_26_20_54.mpg;YUriko Koike.jpg;19093;19145;91161;955;958;3
/net/per610a/home/mvp/mvp_db/hodost-lv/2019/2019_10_26_04_56/2019_10_26_20_54.mpg;Junichiro KOIZUMI.jpg;77965;78085;91161;3901;3907;6
/net/per610a/home/mvp/mvp_db/hodost-lv/2019/2019_10_30_04_56/2019_10_30_21_54.mpg;YUriko Koike.jpg;1177;1217;91169;58;60;2
/net/per610a/home/mvp/mvp_db/hodost-lv/2019/2019_10_30_04_56/2019_10_30_21_54.mpg;YUriko Koike.jpg;8821;9149;91169;441;457;16
/net/per610a/home/mvp/mvp_db/hodost-lv/2019/2019_10_31_04_56/2019_10_31_21_54.mpg;Shinzo ABE.jpg;28413;28437;91161;1421;1423;2
/net/per610a/home/mvp/mvp_db/hodost-lv/2019/2019_10_31_04_56/2019_10_31_21_54.mpg;Shinzo ABE.jpg;28681;28745;91161;1435;1438;3
/net/per610a/home/mvp/mvp_db/hodost-lv/2019/2019_10_31_04_56/2019_10_31_21_54.mpg;Shinzo ABE.jpg;31793;31953;91161;1591;1599;8
/net/per610a/home/mvp/mvp_db/hodost-lv/2019/2019_10_31_04_56/2019_10_31_21_54.mpg;Shinzo ABE.jpg;32333;32601;91161;1618;1631;13
/net/per610a/home/mvp/mvp_db/hodost-lv/2019/2019_11_01_04_56/2019_11_01_21_54.mpg;YUriko Koike.jpg;513;1245;79189;25;62;37
/net/per610a/home/mvp/mvp_db/hodost-lv/2019/2019_11_01_04_56/2019_11_01_21_54.mpg;YUriko Koike.jpg;7477;7965;79189;374;398;24
/net/per610a/home/mvp/mvp_db/hodost-lv/2019/2019_11_02_04_56/2019_11_02_20_54.mpg;YUriko Koike.jpg;14793;15385;43209;740;769;29
/net/per610a/home/mvp/mvp_db/hodost-lv/2019/2019_11_04_04_56/2019_11_04_21_54.mpg;Shinzo ABE.jpg;29081;29081;91161;1455;1455;0
/net/per610a/home/mvp/mvp_db/hodost-lv/2019/2019_11_04_04_56/2019_11_04_21_54.mpg;Shinzo ABE.jpg;30449;30557;91161;1523;1529;6
/net/per610a/home/mvp/mvp_db/hodost-lv/2019/2019_11_04_04_56/2019_11_04_21_54.mpg;Shinzo ABE.jpg;31205;31381;91161;1561;1570;9
/net/per610a/home/mvp/mvp_db/hodost-lv/2019/2019_11_04_04_56/2019_11_04_21_54.mpg;Shinzo ABE.jpg;31493;31517;91161;1576;1577;1
/net/per610a/home/mvp/mvp_db/hodost-lv/2019/2019_11_06_04_56/2019_11_06_21_54.mpg;Shinzo ABE.jpg;2357;2393;91169;117;119;2
/net/per610a/home/mvp/mvp_db/hodost-lv/2019/2019_11_06_04_56/2019_11_06_21_54.mpg;Shinzo ABE.jpg;2597;2945;91169;129;147;18
/net/per610a/home/mvp/mvp_db/hodost-lv/2019/2019_11_06_04_56/2019_11_06_21_54.mpg;Shinzo ABE.jpg;3017;3237;91169;151;162;11
/net/per610a/home/mvp/mvp_db/hodost-lv/2019/2019_11_06_04_56/2019_11_06_21_54.mpg;Shinzo ABE.jpg;7089;7445;91169;354;372;18
/net/per610a/home/mvp/mvp_db/hodost-lv/2019/2019_11_06_04_56/2019_11_06_21_54.mpg;Shinzo ABE.jpg;8245;8573;91169;412;429;17
/net/per610a/home/mvp/mvp_db/hodost-lv/2019/2019_11_06_04_56/2019_11_06_21_54.mpg;Shinzo ABE.jpg;9357;9645;91169;468;482;14
/net/per610a/home/mvp/mvp_db/hodost-lv/2019/2019_11_06_04_56/2019_11_06_21_54.mpg;Shinzo ABE.jpg;12669;12797;91169;634;640;6
/net/per610a/home/mvp/mvp_db/hodost-lv/2019/2019_11_07_04_56/2019_11_07_21_54.mpg;Shinzo ABE.jpg;85209;85417;91161;4264;4274;10
/net/per610a/home/mvp/mvp_db/hodost-lv/2019/2019_11_08_04_56/2019_11_08_21_54.mpg;Shinzo ABE.jpg;31413;31517;91169;1572;1577;5
/net/per610a/home/mvp/mvp_db/hodost-lv/2019/2019_11_08_04_56/2019_11_08_21_54.mpg;Shinzo ABE.jpg;33021;33033;91169;1652;1653;1
/net/per610a/home/mvp/mvp_db/hodost-lv/2019/2019_11_08_04_56/2019_11_08_21_54.mpg;Shinzo ABE.jpg;37401;37429;91169;1871;1873;2
/net/per610a/home/mvp/mvp_db/hodost-lv/2019/2019_11_08_04_56/2019_11_08_21_54.mpg;Shinzo ABE.jpg;39973;40053;91169;2000;2004;4
/net/per610a/home/mvp/mvp_db/hodost-lv/2019/2019_11_08_04_56/2019_11_08_21_54.mpg;Shinzo ABE.jpg;53321;53501;91169;2668;2677;9
/net/per610a/home/mvp/mvp_db/hodost-lv/2019/2019_11_12_04_56/2019_11_12_21_54.mpg;Shinzo ABE.jpg;9933;10049;91169;497;502;5
/net/per610a/home/mvp/mvp_db/hodost-lv/2019/2019_11_12_04_56/2019_11_12_21_54.mpg;Shinzo ABE.jpg;10261;10269;91169;513;513;0
/net/per610a/home/mvp/mvp_db/hodost-lv/2019/2019_11_12_04_56/2019_11_12_21_54.mpg;Shinzo ABE.jpg;24757;24821;91169;1239;1242;3
/net/per610a/home/mvp/mvp_db/hodost-lv/2019/2019_11_12_04_56/2019_11_12_21_54.mpg;Shinzo ABE.jpg;25005;25097;91169;1251;1256;5
/net/per610a/home/mvp/mvp_db/hodost-lv/2019/2019_11_12_04_56/2019_11_12_21_54.mpg;Shinzo ABE.jpg;25301;25381;91169;1266;1270;4
/net/per610a/home/mvp/mvp_db/hodost-lv/2019/2019_11_12_04_56/2019_11_12_21_54.mpg;Shinzo ABE.jpg;10389;10661;91169;519;533;14
/net/per610a/home/mvp/mvp_db/hodost-lv/2019/2019_11_13_04_56/2019_11_13_21_54.mpg;Shinzo ABE.jpg;19281;19693;91169;965;985;20
/net/per610a/home/mvp/mvp_db/hodost-lv/2019/2019_11_13_04_56/2019_11_13_21_54.mpg;Shinzo ABE.jpg;19701;19829;91169;986;992;6
/net/per610a/home/mvp/mvp_db/hodost-lv/2019/2019_11_13_04_56/2019_11_13_21_54.mpg;Shinzo ABE.jpg;29881;30233;91169;1495;1513;18
/net/per610a/home/mvp/mvp_db/hodost-lv/2019/2019_11_13_04_56/2019_11_13_21_54.mpg;Shinzo ABE.jpg;20137;20205;91169;1007;1011;4
/net/per610a/home/mvp/mvp_db/hodost-lv/2019/2019_11_13_04_56/2019_11_13_21_54.mpg;Shinzo ABE.jpg;20453;20481;91169;1023;1025;2
/net/per610a/home/mvp/mvp_db/hodost-lv/2019/2019_11_13_04_56/2019_11_13_21_54.mpg;Shinzo ABE.jpg;29757;29777;91169;1489;1490;1
/net/per610a/home/mvp/mvp_db/hodost-lv/2019/2019_11_13_04_56/2019_11_13_21_54.mpg;Ichiro OZAWA.jpg;42609;42869;91169;2132;2145;13
/net/per610a/home/mvp/mvp_db/hodost-lv/2019/2019_11_15_04_56/2019_11_15_21_54.mpg;Shinzo ABE.jpg;517;529;91169;25;26;1
/net/per610a/home/mvp/mvp_db/hodost-lv/2019/2019_11_15_04_56/2019_11_15_21_54.mpg;Shinzo ABE.jpg;825;1473;91169;41;73;32
/net/per610a/home/mvp/mvp_db/hodost-lv/2019/2019_11_15_04_56/2019_11_15_21_54.mpg;Shinzo ABE.jpg;1657;1701;91169;82;85;3
/net/per610a/home/mvp/mvp_db/hodost-lv/2019/2019_11_15_04_56/2019_11_15_21_54.mpg;Shinzo ABE.jpg;4737;4757;91169;237;238;1
/net/per610a/home/mvp/mvp_db/hodost-lv/2019/2019_11_15_04_56/2019_11_15_21_54.mpg;Shinzo ABE.jpg;4893;5137;91169;244;257;13
/net/per610a/home/mvp/mvp_db/hodost-lv/2019/2019_11_15_04_56/2019_11_15_21_54.mpg;Shinzo ABE.jpg;16949;16997;91169;848;850;2
/net/per610a/home/mvp/mvp_db/hodost-lv/2019/2019_11_15_04_56/2019_11_15_21_54.mpg;Shinzo ABE.jpg;50429;50505;91169;2523;2527;4
/net/per610a/home/mvp/mvp_db/hodost-lv/2019/2019_11_15_04_56/2019_11_15_21_54.mpg;Shinzo ABE.jpg;50573;50585;91169;2531;2531;0
/net/per610a/home/mvp/mvp_db/hodost-lv/2019/2019_11_15_04_56/2019_11_15_21_54.mpg;Shinzo ABE.jpg;54529;54961;91169;2729;2750;21
/net/per610a/home/mvp/mvp_db/hodost-lv/2019/2019_11_15_04_56/2019_11_15_21_54.mpg;Shinzo ABE.jpg;765;801;91169;38;40;2
/net/per610a/home/mvp/mvp_db/hodost-lv/2019/2019_11_15_04_56/2019_11_15_21_54.mpg;Shinzo ABE.jpg;1005;1017;91169;50;50;0
/net/per610a/home/mvp/mvp_db/hodost-lv/2019/2019_11_15_04_56/2019_11_15_21_54.mpg;Shinzo ABE.jpg;1129;1201;91169;56;60;4
/net/per610a/home/mvp/mvp_db/hodost-lv/2019/2019_11_15_04_56/2019_11_15_21_54.mpg;Shinzo ABE.jpg;4365;4733;91169;218;236;18
/net/per610a/home/mvp/mvp_db/hodost-lv/2019/2019_11_15_04_56/2019_11_15_21_54.mpg;Shinzo ABE.jpg;5657;5685;91169;283;284;1
/net/per610a/home/mvp/mvp_db/hodost-lv/2019/2019_11_15_04_56/2019_11_15_21_54.mpg;Shinzo ABE.jpg;9761;10285;91169;488;514;26
/net/per610a/home/mvp/mvp_db/hodost-lv/2019/2019_11_15_04_56/2019_11_15_21_54.mpg;Shinzo ABE.jpg;11917;12053;91169;596;603;7
/net/per610a/home/mvp/mvp_db/hodost-lv/2019/2019_11_15_04_56/2019_11_15_21_54.mpg;Shinzo ABE.jpg;14933;15921;91169;747;796;49
/net/per610a/home/mvp/mvp_db/hodost-lv/2019/2019_11_15_04_56/2019_11_15_21_54.mpg;Shinzo ABE.jpg;17141;17161;91169;857;858;1
/net/per610a/home/mvp/mvp_db/hodost-lv/2019/2019_11_15_04_56/2019_11_15_21_54.mpg;Shinzo ABE.jpg;17385;17409;91169;870;871;1
/net/per610a/home/mvp/mvp_db/hodost-lv/2019/2019_11_15_04_56/2019_11_15_21_54.mpg;Renho.jpg;7749;8045;91169;387;402;15
/net/per610a/home/mvp/mvp_db/hodost-lv/2019/2019_11_15_04_56/2019_11_15_21_54.mpg;Yukio EDANO.jpg;13821;13937;91169;691;697;6
/net/per610a/home/mvp/mvp_db/hodost-lv/2019/2019_11_15_04_56/2019_11_15_21_54.mpg;Yukio EDANO.jpg;14105;14489;91169;705;725;20
/net/per610a/home/mvp/mvp_db/hodost-lv/2019/2019_11_16_04_56/2019_11_16_21_24.mpg;Shinzo ABE.jpg;47849;47857;91169;2394;2395;1
/net/per610a/home/mvp/mvp_db/hodost-lv/2019/2019_11_16_04_56/2019_11_16_21_24.mpg;Shinzo ABE.jpg;47957;48033;91169;2400;2404;4
/net/per610a/home/mvp/mvp_db/hodost-lv/2019/2019_11_16_04_56/2019_11_16_21_24.mpg;Shinzo ABE.jpg;51541;51557;91169;2579;2580;1
/net/per610a/home/mvp/mvp_db/hodost-lv/2019/2019_11_16_04_56/2019_11_16_21_24.mpg;Shinzo ABE.jpg;49169;49217;91169;2460;2463;3
/net/per610a/home/mvp/mvp_db/hodost-lv/2019/2019_11_16_04_56/2019_11_16_21_24.mpg;Shinzo ABE.jpg;51565;51621;91169;2580;2583;3
/net/per610a/home/mvp/mvp_db/hodost-lv/2019/2019_11_16_04_56/2019_11_16_21_24.mpg;Shinzo ABE.jpg;50329;50385;91169;2518;2521;3
/net/per610a/home/mvp/mvp_db/hodost-lv/2019/2019_11_16_04_56/2019_11_16_21_24.mpg;Shinzo ABE.jpg;52709;52777;91169;2638;2641;3
/net/per610a/home/mvp/mvp_db/hodost-lv/2019/2019_11_16_04_56/2019_11_16_21_24.mpg;Shinzo ABE.jpg;53337;54041;91169;2669;2704;35
/net/per610a/home/mvp/mvp_db/hodost-lv/2019/2019_11_16_04_56/2019_11_16_21_24.mpg;Shinzo ABE.jpg;54121;54133;91169;2708;2709;1
/net/per610a/home/mvp/mvp_db/hodost-lv/2019/2019_11_17_04_56/2019_11_17_17_30.mpg;Shinzo ABE.jpg;5925;5925;36021;296;296;0
/net/per610a/home/mvp/mvp_db/hodost-lv/2019/2019_11_17_04_56/2019_11_17_17_30.mpg;Shinzo ABE.jpg;10681;10821;36021;534;541;7
/net/per610a/home/mvp/mvp_db/hodost-lv/2019/2019_11_17_04_56/2019_11_17_17_30.mpg;Yukio EDANO.jpg;5945;6185;36021;297;309;12
/net/per610a/home/mvp/mvp_db/hodost-lv/2019/2019_11_18_04_56/2019_11_18_21_54.mpg;Nariaki Nakayama.png;14333;14381;91169;717;719;2
/net/per610a/home/mvp/mvp_db/hodost-lv/2019/2019_11_18_04_56/2019_11_18_21_54.mpg;Nariaki Nakayama.png;14525;14553;91169;726;728;2
/net/per610a/home/mvp/mvp_db/hodost-lv/2019/2019_11_18_04_56/2019_11_18_21_54.mpg;Shinzo ABE.jpg;25813;25841;91169;1291;1293;2
/net/per610a/home/mvp/mvp_db/hodost-lv/2019/2019_11_18_04_56/2019_11_18_21_54.mpg;Shinzo ABE.jpg;25937;26577;91169;1298;1330;32
/net/per610a/home/mvp/mvp_db/hodost-lv/2019/2019_11_18_04_56/2019_11_18_21_54.mpg;Shinzo ABE.jpg;26793;27037;91169;1340;1353;13
/net/per610a/home/mvp/mvp_db/hodost-lv/2019/2019_11_18_04_56/2019_11_18_21_54.mpg;Shinzo ABE.jpg;29965;30309;91169;1499;1516;17
/net/per610a/home/mvp/mvp_db/hodost-lv/2019/2019_11_18_04_56/2019_11_18_21_54.mpg;Shinzo ABE.jpg;31709;31805;91169;1587;1591;4
/net/per610a/home/mvp/mvp_db/hodost-lv/2019/2019_11_18_04_56/2019_11_18_21_54.mpg;Shinzo ABE.jpg;43849;44145;91169;2194;2209;15
/net/per610a/home/mvp/mvp_db/hodost-lv/2019/2019_11_19_04_56/2019_11_19_21_54.mpg;Shinzo ABE.jpg;16501;16625;91169;825;832;7
/net/per610a/home/mvp/mvp_db/hodost-lv/2019/2019_11_19_04_56/2019_11_19_21_54.mpg;Shinzo ABE.jpg;16769;16937;91169;839;847;8
/net/per610a/home/mvp/mvp_db/hodost-lv/2019/2019_11_19_04_56/2019_11_19_21_54.mpg;Shinzo ABE.jpg;17141;17193;91169;857;860;3
/net/per610a/home/mvp/mvp_db/hodost-lv/2019/2019_11_19_04_56/2019_11_19_21_54.mpg;Shinzo ABE.jpg;17321;17533;91169;866;877;11
/net/per610a/home/mvp/mvp_db/hodost-lv/2019/2019_11_19_04_56/2019_11_19_21_54.mpg;Shinzo ABE.jpg;19497;19621;91169;975;982;7
/net/per610a/home/mvp/mvp_db/hodost-lv/2019/2019_11_19_04_56/2019_11_19_21_54.mpg;Shinzo ABE.jpg;19833;19933;91169;992;997;5
/net/per610a/home/mvp/mvp_db/hodost-lv/2019/2019_11_19_04_56/2019_11_19_21_54.mpg;Shinzo ABE.jpg;20301;20565;91169;1016;1029;13
/net/per610a/home/mvp/mvp_db/hodost-lv/2019/2019_11_19_04_56/2019_11_19_21_54.mpg;Shinzo ABE.jpg;20633;20709;91169;1032;1036;4
/net/per610a/home/mvp/mvp_db/hodost-lv/2019/2019_11_19_04_56/2019_11_19_21_54.mpg;Shinzo ABE.jpg;24181;24317;91169;1210;1217;7
/net/per610a/home/mvp/mvp_db/hodost-lv/2019/2019_11_19_04_56/2019_11_19_21_54.mpg;Taro ASO.jpg;18297;18665;91169;915;934;19
/net/per610a/home/mvp/mvp_db/hodost-lv/2019/2019_11_20_04_56/2019_11_20_21_54.mpg;Shinzo ABE.jpg;14141;14237;91169;707;712;5
/net/per610a/home/mvp/mvp_db/hodost-lv/2019/2019_11_20_04_56/2019_11_20_21_54.mpg;Shinzo ABE.jpg;16017;16017;91169;801;801;0
/net/per610a/home/mvp/mvp_db/hodost-lv/2019/2019_11_20_04_56/2019_11_20_21_54.mpg;Shinzo ABE.jpg;18521;18753;91169;926;938;12
/net/per610a/home/mvp/mvp_db/hodost-lv/2019/2019_11_21_04_56/2019_11_21_21_54.mpg;Shinzo ABE.jpg;30409;30525;91169;1521;1527;6
/net/per610a/home/mvp/mvp_db/hodost-lv/2019/2019_11_21_04_56/2019_11_21_21_54.mpg;Shinzo ABE.jpg;30917;30965;91169;1547;1549;2
/net/per610a/home/mvp/mvp_db/hodost-lv/2019/2019_11_22_04_56/2019_11_22_21_54.mpg;Shinzo ABE.jpg;741;1045;91169;37;52;15
/net/per610a/home/mvp/mvp_db/hodost-lv/2019/2019_11_22_04_56/2019_11_22_21_54.mpg;Shinzo ABE.jpg;3977;4177;91169;199;209;10
/net/per610a/home/mvp/mvp_db/hodost-lv/2019/2019_11_22_04_56/2019_11_22_21_54.mpg;Shinzo ABE.jpg;4457;4525;91169;223;226;3
/net/per610a/home/mvp/mvp_db/hodost-lv/2019/2019_11_22_04_56/2019_11_22_21_54.mpg;Shinzo ABE.jpg;20493;20561;91169;1025;1029;4
/net/per610a/home/mvp/mvp_db/hodost-lv/2019/2019_11_22_04_56/2019_11_22_21_54.mpg;Shinzo ABE.jpg;20913;20929;91169;1046;1047;1
/net/per610a/home/mvp/mvp_db/hodost-lv/2019/2019_11_22_04_56/2019_11_22_21_54.mpg;Shinzo ABE.jpg;22653;22673;91169;1133;1134;1
/net/per610a/home/mvp/mvp_db/hodost-lv/2019/2019_11_22_04_56/2019_11_22_21_54.mpg;Shinzo ABE.jpg;4533;4577;91169;226;229;3
/net/per610a/home/mvp/mvp_db/hodost-lv/2019/2019_11_22_04_56/2019_11_22_21_54.mpg;Shinzo ABE.jpg;12185;12273;91169;609;614;5
/net/per610a/home/mvp/mvp_db/hodost-lv/2019/2019_11_22_04_56/2019_11_22_21_54.mpg;Shinzo ABE.jpg;19149;19169;91169;958;959;1
/net/per610a/home/mvp/mvp_db/hodost-lv/2019/2019_11_22_04_56/2019_11_22_21_54.mpg;Shinzo ABE.jpg;20565;20873;91169;1029;1044;15
/net/per610a/home/mvp/mvp_db/hodost-lv/2019/2019_11_22_04_56/2019_11_22_21_54.mpg;Renho.jpg;52941;53309;91169;2649;2668;19
/net/per610a/home/mvp/mvp_db/hodost-lv/2019/2019_11_24_04_56/2019_11_24_16_30.mpg;Shinzo ABE.jpg;44257;44425;107949;2214;2223;9
/net/per610a/home/mvp/mvp_db/hodost-lv/2019/2019_11_24_04_56/2019_11_24_16_30.mpg;Shinzo ABE.jpg;45033;45313;107949;2253;2267;14
/net/per610a/home/mvp/mvp_db/hodost-lv/2019/2019_11_25_04_56/2019_11_25_21_54.mpg;Shinzo ABE.jpg;29397;29473;91169;1471;1475;4
/net/per610a/home/mvp/mvp_db/hodost-lv/2019/2019_11_25_04_56/2019_11_25_21_54.mpg;Shinzo ABE.jpg;48741;48781;91169;2439;2441;2
/net/per610a/home/mvp/mvp_db/hodost-lv/2019/2019_11_27_04_56/2019_11_27_21_54.mpg;Shinzo ABE.jpg;30513;30581;91169;1527;1530;3
/net/per610a/home/mvp/mvp_db/hodost-lv/2019/2019_11_27_04_56/2019_11_27_21_54.mpg;Shinzo ABE.jpg;33465;33473;91169;1674;1675;1
/net/per610a/home/mvp/mvp_db/hodost-lv/2019/2019_11_27_04_56/2019_11_27_21_54.mpg;Shinzo ABE.jpg;33673;33693;91169;1685;1686;1
/net/per610a/home/mvp/mvp_db/hodost-lv/2019/2019_11_27_04_56/2019_11_27_21_54.mpg;Shinzo ABE.jpg;59289;59397;91169;2967;2972;5
/net/per610a/home/mvp/mvp_db/hodost-lv/2019/2019_11_28_04_56/2019_11_28_21_54.mpg;Shinzo ABE.jpg;1433;1625;91169;71;81;10
/net/per610a/home/mvp/mvp_db/hodost-lv/2019/2019_11_28_04_56/2019_11_28_21_54.mpg;Shinzo ABE.jpg;28701;28713;91169;1436;1437;1
/net/per610a/home/mvp/mvp_db/hodost-lv/2019/2019_11_28_04_56/2019_11_28_21_54.mpg;Shinzo ABE.jpg;27657;27769;91169;1384;1389;5
/net/per610a/home/mvp/mvp_db/hodost-lv/2019/2019_11_29_04_56/2019_11_29_21_54.mpg;Shinzo ABE.jpg;4669;5337;91169;233;267;34
/net/per610a/home/mvp/mvp_db/hodost-lv/2019/2019_11_29_04_56/2019_11_29_21_54.mpg;Shinzo ABE.jpg;29669;29697;91169;1484;1486;2
/net/per610a/home/mvp/mvp_db/hodost-lv/2019/2019_11_29_04_56/2019_11_29_21_54.mpg;Yukio EDANO.jpg;33253;33549;91169;1664;1679;15
/net/per610a/home/mvp/mvp_db/hodost-lv/2019/2019_12_01_04_56/2019_12_01_16_30.mpg;Shinzo ABE.jpg;71217;71477;107949;3563;3576;13
/net/per610a/home/mvp/mvp_db/hodost-lv/2019/2019_12_01_04_56/2019_12_01_16_30.mpg;Shinzo ABE.jpg;72501;72665;107949;3628;3636;8
/net/per610a/home/mvp/mvp_db/hodost-lv/2019/2019_12_01_04_56/2019_12_01_16_30.mpg;Shinzo ABE.jpg;103205;103241;107949;5164;5166;2
/net/per610a/home/mvp/mvp_db/hodost-lv/2019/2019_12_03_04_56/2019_12_03_21_54.mpg;Shinzo ABE.jpg;32805;32993;91169;1641;1651;10
/net/per610a/home/mvp/mvp_db/hodost-lv/2019/2019_12_03_04_56/2019_12_03_21_54.mpg;Shinzo ABE.jpg;33101;33321;91169;1656;1667;11
/net/per610a/home/mvp/mvp_db/hodost-lv/2019/2019_12_03_04_56/2019_12_03_21_54.mpg;Ichiro OZAWA.jpg;33625;34193;91169;1682;1711;29
/net/per610a/home/mvp/mvp_db/hodost-lv/2019/2019_12_03_04_56/2019_12_03_21_54.mpg;Taro ASO.jpg;58309;58497;91169;2918;2927;9
/net/per610a/home/mvp/mvp_db/hodost-lv/2019/2019_12_03_04_56/2019_12_03_21_54.mpg;Taro ASO.jpg;59101;59297;91169;2957;2967;10
/net/per610a/home/mvp/mvp_db/hodost-lv/2019/2019_12_05_04_56/2019_12_05_21_54.mpg;Shinzo ABE.jpg;19453;19489;91161;973;975;2
/net/per610a/home/mvp/mvp_db/hodost-lv/2019/2019_12_05_04_56/2019_12_05_21_54.mpg;Shinzo ABE.jpg;19553;19653;91161;978;983;5
/net/per610a/home/mvp/mvp_db/hodost-lv/2019/2019_12_08_04_56/2019_12_08_16_30.mpg;Shinzo ABE.jpg;15577;15737;107961;779;787;8
/net/per610a/home/mvp/mvp_db/hodost-lv/2019/2019_12_09_04_56/2019_12_09_21_54.mpg;Shinzo ABE.jpg;15025;15025;91161;751;751;0
/net/per610a/home/mvp/mvp_db/hodost-lv/2019/2019_12_09_04_56/2019_12_09_21_54.mpg;Shinzo ABE.jpg;15105;15105;91161;755;755;0
/net/per610a/home/mvp/mvp_db/hodost-lv/2019/2019_12_09_04_56/2019_12_09_21_54.mpg;Shinzo ABE.jpg;15181;15249;91161;759;763;4
/net/per610a/home/mvp/mvp_db/hodost-lv/2019/2019_12_09_04_56/2019_12_09_21_54.mpg;Shinzo ABE.jpg;15349;15409;91161;768;771;3
/net/per610a/home/mvp/mvp_db/hodost-lv/2019/2019_12_09_04_56/2019_12_09_21_54.mpg;Shinzo ABE.jpg;15741;16245;91161;787;812;25
/net/per610a/home/mvp/mvp_db/hodost-lv/2019/2019_12_09_04_56/2019_12_09_21_54.mpg;Shinzo ABE.jpg;17669;17765;91161;884;889;5
/net/per610a/home/mvp/mvp_db/hodost-lv/2019/2019_12_09_04_56/2019_12_09_21_54.mpg;Shinzo ABE.jpg;20965;21449;91161;1049;1073;24
/net/per610a/home/mvp/mvp_db/hodost-lv/2019/2019_12_09_04_56/2019_12_09_21_54.mpg;Shinzo ABE.jpg;22433;22705;91161;1122;1136;14
/net/per610a/home/mvp/mvp_db/hodost-lv/2019/2019_12_09_04_56/2019_12_09_21_54.mpg;Shinzo ABE.jpg;22821;22829;91161;1142;1142;0
/net/per610a/home/mvp/mvp_db/hodost-lv/2019/2019_12_09_04_56/2019_12_09_21_54.mpg;Kyoko Nakayama.jpg;28005;28117;91161;1401;1407;6
/net/per610a/home/mvp/mvp_db/hodost-lv/2019/2019_12_09_04_56/2019_12_09_21_54.mpg;Kohei Otsuka.jpg;85337;85549;91161;4270;4281;11
/net/per610a/home/mvp/mvp_db/hodost-lv/2019/2019_12_10_04_56/2019_12_10_21_54.mpg;Shinzo ABE.jpg;34833;34945;91169;1743;1748;5
/net/per610a/home/mvp/mvp_db/hodost-lv/2019/2019_12_10_04_56/2019_12_10_21_54.mpg;Shinzo ABE.jpg;37493;37585;91169;1876;1881;5
/net/per610a/home/mvp/mvp_db/hodost-lv/2019/2019_12_10_04_56/2019_12_10_21_54.mpg;Shinzo ABE.jpg;40433;40565;91169;2023;2030;7
/net/per610a/home/mvp/mvp_db/hodost-lv/2019/2019_12_10_04_56/2019_12_10_21_54.mpg;Shinzo ABE.jpg;40665;40929;91169;2035;2048;13
/net/per610a/home/mvp/mvp_db/hodost-lv/2019/2019_12_10_04_56/2019_12_10_21_54.mpg;Yukio EDANO.jpg;38769;39061;91169;1940;1954;14
/net/per610a/home/mvp/mvp_db/hodost-lv/2019/2019_12_12_04_56/2019_12_12_21_54.mpg;Kohei Otsuka.jpg;11797;11861;91161;590;593;3
/net/per610a/home/mvp/mvp_db/hodost-lv/2019/2019_12_12_04_56/2019_12_12_21_54.mpg;Kohei Otsuka.jpg;42149;42177;91161;2109;2110;1
/net/per610a/home/mvp/mvp_db/hodost-lv/2019/2019_12_12_04_56/2019_12_12_21_54.mpg;Kohei Otsuka.jpg;59653;59861;91161;2985;2995;10
/net/per610a/home/mvp/mvp_db/hodost-lv/2019/2019_12_13_04_56/2019_12_13_21_54.mpg;Shinzo ABE.jpg;47141;47365;91169;2359;2370;11
/net/per610a/home/mvp/mvp_db/hodost-lv/2019/2019_12_13_04_56/2019_12_13_21_54.mpg;Shinzo ABE.jpg;47961;48073;91169;2400;2406;6
/net/per610a/home/mvp/mvp_db/hodost-lv/2019/2019_12_13_04_56/2019_12_13_21_54.mpg;Shinzo ABE.jpg;48561;48581;91169;2430;2431;1
/net/per610a/home/mvp/mvp_db/hodost-lv/2019/2019_12_13_04_56/2019_12_13_21_54.mpg;Shinzo ABE.jpg;48745;48789;91169;2439;2441;2
/net/per610a/home/mvp/mvp_db/hodost-lv/2019/2019_12_15_04_56/2019_12_15_16_30.mpg;Shinzo ABE.jpg;102789;102897;107949;5143;5149;6
/net/per610a/home/mvp/mvp_db/hodost-lv/2019/2019_12_15_04_56/2019_12_15_16_30.mpg;Shinzo ABE.jpg;103341;103457;107949;5171;5177;6
/net/per610a/home/mvp/mvp_db/hodost-lv/2019/2019_12_20_04_56/2019_12_20_21_54.mpg;Shinzo ABE.jpg;20281;20325;91169;1015;1017;2
/net/per610a/home/mvp/mvp_db/hodost-lv/2019/2019_12_20_04_56/2019_12_20_21_54.mpg;Shinzo ABE.jpg;23485;23525;91169;1175;1177;2
/net/per610a/home/mvp/mvp_db/hodost-lv/2019/2019_12_20_04_56/2019_12_20_21_54.mpg;Shinzo ABE.jpg;52421;52441;91169;2623;2624;1
/net/per610a/home/mvp/mvp_db/hodost-lv/2019/2019_12_20_04_56/2019_12_20_21_54.mpg;Shinzo ABE.jpg;55753;56253;91169;2790;2815;25
/net/per610a/home/mvp/mvp_db/hodost-lv/2019/2019_12_20_04_56/2019_12_20_21_54.mpg;Shinzo ABE.jpg;56369;56765;91169;2821;2841;20
/net/per610a/home/mvp/mvp_db/hodost-lv/2019/2019_12_20_04_56/2019_12_20_21_54.mpg;Shinzo ABE.jpg;56945;56989;91169;2850;2852;2
/net/per610a/home/mvp/mvp_db/hodost-lv/2019/2019_12_22_04_56/2019_12_22_16_30.mpg;Shinzo ABE.jpg;101457;101537;107949;5077;5081;4
/net/per610a/home/mvp/mvp_db/hodost-lv/2019/2019_12_23_04_56/2019_12_23_22_15.mpg;Kohei Otsuka.jpg;8137;8333;89969;407;417;10
/net/per610a/home/mvp/mvp_db/hodost-lv/2019/2019_12_23_04_56/2019_12_23_22_15.mpg;Kohei Otsuka.jpg;9325;9341;89969;466;467;1
/net/per610a/home/mvp/mvp_db/hodost-lv/2019/2019_12_23_04_56/2019_12_23_22_15.mpg;Kohei Otsuka.jpg;9445;9481;89969;472;474;2
/net/per610a/home/mvp/mvp_db/hodost-lv/2019/2019_12_23_04_56/2019_12_23_22_15.mpg;Shinzo ABE.jpg;11829;12429;89969;592;622;30
/net/per610a/home/mvp/mvp_db/hodost-lv/2019/2019_12_23_04_56/2019_12_23_22_15.mpg;Shinzo ABE.jpg;12493;12521;89969;625;626;1
/net/per610a/home/mvp/mvp_db/hodost-lv/2019/2019_12_23_04_56/2019_12_23_22_15.mpg;Shinzo ABE.jpg;15001;15337;89969;750;767;17
/net/per610a/home/mvp/mvp_db/hodost-lv/2019/2019_12_23_04_56/2019_12_23_22_15.mpg;Shinzo ABE.jpg;15401;15425;89969;770;772;2
/net/per610a/home/mvp/mvp_db/hodost-lv/2019/2019_12_25_04_56/2019_12_25_22_15.mpg;Shinzo ABE.jpg;8009;8229;89969;400;411;11
/net/per610a/home/mvp/mvp_db/hodost-lv/2019/2019_12_25_04_56/2019_12_25_22_15.mpg;Masashi Nakano.jpg;81297;81425;89969;4068;4074;6
/net/per610a/home/mvp/mvp_db/hodost-lv/2020/2020_01_06_04_56/2020_01_06_21_54.mpg;Shinzo ABE.jpg;13897;14325;91161;695;716;21
/net/per610a/home/mvp/mvp_db/hodost-lv/2020/2020_01_10_04_56/2020_01_10_21_54.mpg;Shinzo ABE.jpg;14621;14681;91169;731;734;3
/net/per610a/home/mvp/mvp_db/hodost-lv/2020/2020_01_10_04_56/2020_01_10_21_54.mpg;Shinzo ABE.jpg;18233;18317;91169;912;916;4
/net/per610a/home/mvp/mvp_db/hodost-lv/2020/2020_01_12_04_56/2020_01_12_16_30.mpg;Shinzo ABE.jpg;20601;20605;107961;1030;1031;1
/net/per610a/home/mvp/mvp_db/hodost-lv/2020/2020_01_12_04_56/2020_01_12_16_30.mpg;Shinzo ABE.jpg;20681;20933;107961;1034;1047;13
/net/per610a/home/mvp/mvp_db/hodost-lv/2020/2020_01_14_04_56/2020_01_14_21_54.mpg;Taro ASO.jpg;43149;43365;91169;2159;2170;11
/net/per610a/home/mvp/mvp_db/hodost-lv/2020/2020_01_14_04_56/2020_01_14_21_54.mpg;Taro ASO.jpg;43485;43961;91169;2176;2200;24
/net/per610a/home/mvp/mvp_db/hodost-lv/2020/2020_01_14_04_56/2020_01_14_21_54.mpg;Taro ASO.jpg;44161;44441;91169;2210;2224;14
/net/per610a/home/mvp/mvp_db/hodost-lv/2020/2020_01_17_04_56/2020_01_17_21_54.mpg;Shinzo ABE.jpg;40401;40685;91169;2022;2036;14
/net/per610a/home/mvp/mvp_db/hodost-lv/2020/2020_01_17_04_56/2020_01_17_21_54.mpg;Shinzo ABE.jpg;40757;40841;91169;2039;2044;5
/net/per610a/home/mvp/mvp_db/hodost-lv/2020/2020_01_20_04_56/2020_01_20_21_54.mpg;Shinzo ABE.jpg;15113;15201;91169;756;760;4
/net/per610a/home/mvp/mvp_db/hodost-lv/2020/2020_01_20_04_56/2020_01_20_21_54.mpg;Shinzo ABE.jpg;18089;18205;91169;905;911;6
/net/per610a/home/mvp/mvp_db/hodost-lv/2020/2020_01_20_04_56/2020_01_20_21_54.mpg;Shinzo ABE.jpg;21653;21785;91169;1083;1090;7
/net/per610a/home/mvp/mvp_db/hodost-lv/2020/2020_01_20_04_56/2020_01_20_21_54.mpg;Shinzo ABE.jpg;36569;36613;91169;1830;1832;2
/net/per610a/home/mvp/mvp_db/hodost-lv/2020/2020_01_20_04_56/2020_01_20_21_54.mpg;Shinzo ABE.jpg;18249;18381;91169;913;919;6
/net/per610a/home/mvp/mvp_db/hodost-lv/2020/2020_01_20_04_56/2020_01_20_21_54.mpg;Shinzo ABE.jpg;21293;21333;91169;1065;1067;2
/net/per610a/home/mvp/mvp_db/hodost-lv/2020/2020_01_20_04_56/2020_01_20_21_54.mpg;Shinzo ABE.jpg;21445;21641;91169;1073;1083;10
/net/per610a/home/mvp/mvp_db/hodost-lv/2020/2020_01_21_04_56/2020_01_21_21_54.mpg;Shinzo ABE.jpg;9585;9749;91169;479;487;8
/net/per610a/home/mvp/mvp_db/hodost-lv/2020/2020_01_21_04_56/2020_01_21_21_54.mpg;Ichiro OZAWA.jpg;37665;38377;91169;1885;1920;35
/net/per610a/home/mvp/mvp_db/hodost-lv/2020/2020_01_22_04_56/2020_01_22_21_54.mpg;Shinzo ABE.jpg;13641;13685;91169;682;684;2
/net/per610a/home/mvp/mvp_db/hodost-lv/2020/2020_01_22_04_56/2020_01_22_21_54.mpg;Shinzo ABE.jpg;14509;14649;91169;726;733;7
/net/per610a/home/mvp/mvp_db/hodost-lv/2020/2020_01_22_04_56/2020_01_22_21_54.mpg;Shinzo ABE.jpg;14737;14821;91169;737;741;4
/net/per610a/home/mvp/mvp_db/hodost-lv/2020/2020_01_22_04_56/2020_01_22_21_54.mpg;Yuichiro Tamaki.png;20241;20497;91169;1013;1025;12
/net/per610a/home/mvp/mvp_db/hodost-lv/2020/2020_01_22_04_56/2020_01_22_21_54.mpg;Yuichiro Tamaki.png;22205;22781;91169;1111;1140;29
/net/per610a/home/mvp/mvp_db/hodost-lv/2020/2020_01_22_04_56/2020_01_22_21_54.mpg;Yuichiro Tamaki.png;22889;24233;91169;1145;1212;67
/net/per610a/home/mvp/mvp_db/hodost-lv/2020/2020_01_22_04_56/2020_01_22_21_54.mpg;Shinzo ABE.jpg;20681;21085;91169;1035;1055;20
/net/per610a/home/mvp/mvp_db/hodost-lv/2020/2020_01_22_04_56/2020_01_22_21_54.mpg;Shinzo ABE.jpg;26357;26605;91169;1319;1331;12
/net/per610a/home/mvp/mvp_db/hodost-lv/2020/2020_01_22_04_56/2020_01_22_21_54.mpg;Shinzo ABE.jpg;24837;24981;91169;1243;1250;7
/net/per610a/home/mvp/mvp_db/hodost-lv/2020/2020_01_25_04_56/2020_01_25_20_54.mpg;Yuichiro Tamaki.png;83957;84477;91169;4202;4228;26
/net/per610a/home/mvp/mvp_db/hodost-lv/2020/2020_01_25_04_56/2020_01_25_20_54.mpg;Yuichiro Tamaki.png;85057;85301;91169;4257;4269;12
/net/per610a/home/mvp/mvp_db/hodost-lv/2020/2020_01_26_04_56/2020_01_26_16_30.mpg;Shinzo ABE.jpg;36841;36961;107949;1843;1849;6
/net/per610a/home/mvp/mvp_db/hodost-lv/2020/2020_01_26_04_56/2020_01_26_16_30.mpg;Yuichiro Tamaki.png;56149;56365;107949;2809;2820;11
/net/per610a/home/mvp/mvp_db/hodost-lv/2020/2020_01_28_04_56/2020_01_28_21_54.mpg;Shinzo ABE.jpg;19133;19257;91169;957;963;6
/net/per610a/home/mvp/mvp_db/hodost-lv/2020/2020_01_29_04_56/2020_01_29_21_54.mpg;Shinzo ABE.jpg;40541;40757;91169;2029;2039;10
/net/per610a/home/mvp/mvp_db/hodost-lv/2020/2020_01_30_04_56/2020_01_30_21_54.mpg;Shinzo ABE.jpg;56473;56629;91169;2826;2834;8
/net/per610a/home/mvp/mvp_db/hodost-lv/2020/2020_01_30_04_56/2020_01_30_21_54.mpg;Shinzo ABE.jpg;57089;57357;91169;2857;2870;13
/net/per610a/home/mvp/mvp_db/hodost-lv/2020/2020_01_30_04_56/2020_01_30_21_54.mpg;Shinzo ABE.jpg;58737;59069;91169;2939;2956;17
/net/per610a/home/mvp/mvp_db/hodost-lv/2020/2020_01_30_04_56/2020_01_30_21_54.mpg;Shinzo ABE.jpg;59585;59665;91169;2982;2986;4
/net/per610a/home/mvp/mvp_db/hodost-lv/2020/2020_02_01_04_56/2020_02_01_20_54.mpg;Shinzo ABE.jpg;10041;10281;91169;502;514;12
/net/per610a/home/mvp/mvp_db/hodost-lv/2020/2020_02_01_04_56/2020_02_01_20_54.mpg;Shinzo ABE.jpg;21101;21421;91169;1056;1072;16
/net/per610a/home/mvp/mvp_db/hodost-lv/2020/2020_02_01_04_56/2020_02_01_20_54.mpg;YUriko Koike.jpg;15301;15609;91169;765;781;16
/net/per610a/home/mvp/mvp_db/hodost-lv/2020/2020_02_04_04_56/2020_02_04_21_54.mpg;Shinzo ABE.jpg;44525;44817;91169;2228;2243;15
/net/per610a/home/mvp/mvp_db/hodost-lv/2020/2020_02_04_04_56/2020_02_04_21_54.mpg;Shinzo ABE.jpg;44901;45205;91169;2247;2262;15
/net/per610a/home/mvp/mvp_db/hodost-lv/2020/2020_02_04_04_56/2020_02_04_21_54.mpg;Shinzo ABE.jpg;46493;46565;91169;2326;2330;4
/net/per610a/home/mvp/mvp_db/hodost-lv/2020/2020_02_04_04_56/2020_02_04_21_54.mpg;Shinzo ABE.jpg;47041;47145;91169;2354;2359;5
/net/per610a/home/mvp/mvp_db/hodost-lv/2020/2020_02_04_04_56/2020_02_04_21_54.mpg;Shinzo ABE.jpg;47381;47505;91169;2371;2377;6
/net/per610a/home/mvp/mvp_db/hodost-lv/2020/2020_02_04_04_56/2020_02_04_21_54.mpg;Shinzo ABE.jpg;48801;49113;91169;2442;2458;16
/net/per610a/home/mvp/mvp_db/hodost-lv/2020/2020_02_04_04_56/2020_02_04_21_54.mpg;Shinzo ABE.jpg;49513;49529;91169;2478;2478;0
